"date","geography","geography code","Rural Urban","Variable: All usual residents; measures: Value","Variable: Males; measures: Value","Variable: Females; measures: Value","Variable: Lives in a household; measures: Value","Variable: Lives in a communal establishment; measures: Value","Variable: Schoolchild or full-time student aged 4 and over at their non term-time address; measures: Value","Variable: Area (Hectares); measures: Value","Variable: Density (number of persons per hectare); measures: Value"
"2011","Darlington 001B","E01012334","Total",2466,1220,1246,2466,0,42,6033.58,0.4
"2011","Darlington 001C","E01012335","Total",1383,682,701,1383,0,21,114.01,12.1
"2011","Darlington 001D","E01012366","Total",2008,972,1036,2008,0,30,6718.16,0.3
"2011","Darlington 001E","E01033481","Total",1364,680,684,1350,14,21,146.95,9.3
"2011","Darlington 001F","E01033482","Total",1621,810,811,1621,0,16,234.31,6.9
"2011","Darlington 002C","E01012323","Total",1563,799,764,1563,0,12,55.47,28.2
"2011","Darlington 002D","E01012324","Total",1399,671,728,1399,0,15,20.68,67.6
"2011","Darlington 002E","E01032545","Total",1259,631,628,1257,2,9,36.06,34.9
"2011","Darlington 002F","E01032546","Total",1776,886,890,1775,1,15,93.82,18.9
"2011","Darlington 003A","E01012328","Total",1571,768,803,1571,0,11,25.72,61.1
"2011","Darlington 003B","E01012329","Total",1770,855,915,1770,0,41,69.44,25.5
"2011","Darlington 003C","E01012330","Total",1145,549,596,1145,0,18,28.43,40.3
"2011","Darlington 003D","E01012331","Total",1255,609,646,1223,32,17,23.36,53.7
"2011","Darlington 004A","E01012349","Total",1532,762,770,1502,30,6,32.27,47.5
"2011","Darlington 004B","E01012350","Total",1517,747,770,1517,0,7,27.56,55.0
"2011","Darlington 004C","E01012351","Total",1438,718,720,1438,0,20,28.09,51.2
"2011","Darlington 004D","E01012352","Total",1579,774,805,1516,63,5,36.30,43.5
"2011","Darlington 005A","E01012325","Total",1456,709,747,1435,21,10,43.36,33.6
"2011","Darlington 005B","E01012326","Total",1129,550,579,1116,13,5,48.73,23.2
"2011","Darlington 005C","E01012332","Total",1427,656,771,1330,97,7,24.54,58.1
"2011","Darlington 005D","E01012333","Total",1451,691,760,1405,46,16,39.56,36.7
"2011","Darlington 006A","E01012309","Total",1858,916,942,1858,0,25,37.37,49.7
"2011","Darlington 006B","E01012310","Total",1960,961,999,1956,4,17,40.42,48.5
"2011","Darlington 006C","E01012311","Total",1567,731,836,1567,0,22,29.04,54.0
"2011","Darlington 006D","E01012312","Total",1351,649,702,1351,0,13,21.36,63.2
"2011","Darlington 006E","E01012313","Total",1402,662,740,1393,9,8,40.12,34.9
"2011","Darlington 006F","E01012314","Total",1364,652,712,1364,0,12,28.09,48.6
"2011","Darlington 007A","E01012362","Total",1376,677,699,1376,0,6,13.96,98.6
"2011","Darlington 007B","E01012363","Total",1334,647,687,1334,0,4,12.99,102.7
"2011","Darlington 007C","E01012364","Total",1485,690,795,1451,34,18,19.62,75.7
"2011","Darlington 007D","E01012365","Total",1255,587,668,1251,4,20,21.96,57.1
"2011","Darlington 008B","E01012353","Total",1612,822,790,1612,0,11,12.90,125.0
"2011","Darlington 008C","E01012354","Total",1608,870,738,1570,38,11,24.37,66.0
"2011","Darlington 008D","E01012355","Total",1491,756,735,1439,52,21,25.80,57.8
"2011","Darlington 008E","E01033483","Total",1040,570,470,993,47,16,59.40,17.5
"2011","Darlington 008F","E01033484","Total",1167,595,572,1143,24,7,53.72,21.7
"2011","Darlington 009A","E01012307","Total",1897,969,928,1848,49,13,85.56,22.2
"2011","Darlington 009B","E01012327","Total",1575,697,878,1575,0,4,48.78,32.3
"2011","Darlington 009C","E01012342","Total",1778,829,949,1730,48,12,110.56,16.1
"2011","Darlington 009D","E01012343","Total",2004,984,1020,2004,0,12,165.93,12.1
"2011","Darlington 010A","E01012315","Total",1648,781,867,1646,2,35,40.92,40.3
"2011","Darlington 010B","E01012316","Total",2515,1256,1259,2443,72,77,55.80,45.1
"2011","Darlington 010C","E01012360","Total",1742,820,922,1702,40,44,58.84,29.6
"2011","Darlington 011A","E01012336","Total",1745,815,930,1681,64,57,109.32,16.0
"2011","Darlington 011B","E01012337","Total",1733,831,902,1682,51,40,68.78,25.2
"2011","Darlington 011C","E01012347","Total",1722,829,893,1722,0,39,40.88,42.1
"2011","Darlington 011D","E01012348","Total",1986,952,1034,1986,0,25,61.39,32.4
"2011","Darlington 011E","E01012361","Total",1909,897,1012,1897,12,41,225.58,8.5
"2011","Darlington 012A","E01012304","Total",1210,588,622,1191,19,1,17.56,68.9
"2011","Darlington 012B","E01012305","Total",1231,624,607,1231,0,7,14.69,83.8
"2011","Darlington 012C","E01012306","Total",1591,764,827,1415,176,18,30.17,52.7
"2011","Darlington 012D","E01012340","Total",2422,1197,1225,2349,73,14,39.89,60.7
"2011","Darlington 012E","E01012341","Total",1759,832,927,1759,0,3,24.93,70.6
"2011","Darlington 013A","E01012317","Total",1370,675,695,1370,0,7,31.63,43.3
"2011","Darlington 013B","E01012318","Total",2335,1149,1186,2297,38,13,77.51,30.1
"2011","Darlington 013C","E01012319","Total",2811,1357,1454,2811,0,20,88.33,31.8
"2011","Darlington 014A","E01012356","Total",1600,790,810,1558,42,22,41.23,38.8
"2011","Darlington 014B","E01012357","Total",1447,742,705,1447,0,8,24.45,59.2
"2011","Darlington 014C","E01012358","Total",1679,835,844,1655,24,13,58.80,28.6
"2011","Darlington 014D","E01012359","Total",1586,707,879,1586,0,13,26.70,59.4
"2011","Darlington 015A","E01012338","Total",1908,918,990,1908,0,24,2045.19,0.9
"2011","Darlington 015B","E01012339","Total",1732,843,889,1719,13,46,338.45,5.1
"2011","Darlington 015C","E01012344","Total",1337,649,688,1337,0,9,466.48,2.9
"2011","Darlington 015D","E01012345","Total",1480,718,762,1291,189,28,871.56,1.7
"2011","Darlington 015E","E01012346","Total",1833,911,922,1823,10,18,156.08,11.7
"2011","County Durham 002A","E01020613","Total",1392,688,704,1392,0,12,212.55,6.5
"2011","County Durham 002B","E01020614","Total",1429,678,751,1429,0,7,41.06,34.8
"2011","County Durham 002C","E01020622","Total",1657,829,828,1657,0,19,577.51,2.9
"2011","County Durham 002D","E01020623","Total",1503,756,747,1503,0,21,52.50,28.6
"2011","County Durham 005A","E01020606","Total",1509,751,758,1492,17,5,387.44,3.9
"2011","County Durham 005B","E01020615","Total",1778,844,934,1727,51,10,63.19,28.1
"2011","County Durham 005C","E01020616","Total",1688,807,881,1671,17,9,91.05,18.5
"2011","County Durham 005D","E01020617","Total",1812,884,928,1812,0,11,245.39,7.4
"2011","County Durham 007A","E01020596","Total",1679,787,892,1679,0,6,34.40,48.8
"2011","County Durham 007B","E01020597","Total",1495,733,762,1495,0,10,46.89,31.9
"2011","County Durham 007C","E01020598","Total",1770,871,899,1770,0,15,56.38,31.4
"2011","County Durham 007D","E01020611","Total",1346,635,711,1346,0,16,318.38,4.2
"2011","County Durham 007E","E01020612","Total",1626,798,828,1626,0,15,205.59,7.9
"2011","County Durham 011A","E01020592","Total",1514,684,830,1514,0,2,29.45,51.4
"2011","County Durham 011B","E01020593","Total",1227,594,633,1227,0,12,29.78,41.2
"2011","County Durham 011C","E01020599","Total",1701,845,856,1685,16,12,23.95,71.0
"2011","County Durham 011D","E01020601","Total",1550,745,805,1550,0,20,68.41,22.7
"2011","County Durham 011E","E01020602","Total",1829,833,996,1744,85,13,49.04,37.3
"2011","County Durham 011F","E01020618","Total",1558,775,783,1558,0,8,251.25,6.2
"2011","County Durham 013A","E01020594","Total",1641,819,822,1625,16,10,22.94,71.5
"2011","County Durham 013B","E01020595","Total",1728,809,919,1681,47,29,214.01,8.1
"2011","County Durham 013C","E01020600","Total",1515,753,762,1515,0,31,45.46,33.3
"2011","County Durham 013D","E01020603","Total",1843,917,926,1843,0,29,34.62,53.2
"2011","County Durham 013E","E01020605","Total",1757,847,910,1757,0,27,38.40,45.8
"2011","County Durham 015A","E01020590","Total",1369,657,712,1335,34,13,370.07,3.7
"2011","County Durham 015B","E01020591","Total",1481,676,805,1437,44,7,427.35,3.5
"2011","County Durham 015C","E01020608","Total",1786,836,950,1786,0,23,382.33,4.7
"2011","County Durham 015D","E01020609","Total",1403,667,736,1403,0,12,91.77,15.3
"2011","County Durham 015E","E01020610","Total",1498,728,770,1498,0,18,345.73,4.3
"2011","County Durham 019A","E01020604","Total",1420,712,708,1420,0,15,933.53,1.5
"2011","County Durham 019B","E01020607","Total",1614,817,797,1545,69,10,656.57,2.5
"2011","County Durham 019C","E01020619","Total",1540,735,805,1540,0,11,108.50,14.2
"2011","County Durham 019D","E01020620","Total",1603,796,807,1575,28,17,227.25,7.1
"2011","County Durham 019E","E01020621","Total",1856,936,920,1856,0,11,75.41,24.6
"2011","County Durham 001A","E01020634","Total",1563,756,807,1517,46,16,649.75,2.4
"2011","County Durham 001B","E01020635","Total",1379,689,690,1379,0,19,169.63,8.1
"2011","County Durham 001C","E01020636","Total",1698,851,847,1698,0,11,92.72,18.3
"2011","County Durham 001D","E01020654","Total",1746,869,877,1717,29,13,98.84,17.7
"2011","County Durham 001E","E01020676","Total",1514,753,761,1514,0,12,547.17,2.8
"2011","County Durham 003A","E01020627","Total",1538,766,772,1538,0,22,32.22,47.7
"2011","County Durham 003B","E01020628","Total",1648,820,828,1637,11,26,65.92,25.0
"2011","County Durham 003C","E01020629","Total",1507,716,791,1500,7,17,47.07,32.0
"2011","County Durham 003D","E01020655","Total",2008,988,1020,1925,83,28,845.27,2.4
"2011","County Durham 003E","E01020656","Total",1458,695,763,1392,66,8,385.46,3.8
"2011","County Durham 003F","E01020657","Total",1544,772,772,1494,50,21,501.62,3.1
"2011","County Durham 004A","E01020661","Total",1880,911,969,1763,117,13,90.58,20.8
"2011","County Durham 004B","E01020662","Total",1792,903,889,1792,0,18,47.68,37.6
"2011","County Durham 004C","E01020663","Total",1847,921,926,1842,5,23,539.13,3.4
"2011","County Durham 004D","E01020674","Total",1586,771,815,1586,0,5,143.05,11.1
"2011","County Durham 004E","E01020678","Total",1369,663,706,1369,0,10,77.87,17.6
"2011","County Durham 006A","E01020626","Total",1541,750,791,1539,2,3,49.07,31.4
"2011","County Durham 006B","E01020638","Total",1562,769,793,1562,0,13,50.46,31.0
"2011","County Durham 006C","E01020639","Total",1500,724,776,1500,0,10,328.48,4.6
"2011","County Durham 006D","E01020653","Total",1549,736,813,1540,9,13,468.25,3.3
"2011","County Durham 006E","E01020677","Total",1534,741,793,1522,12,9,298.40,5.1
"2011","County Durham 008A","E01020647","Total",2142,1036,1106,2142,0,9,50.85,42.1
"2011","County Durham 008B","E01020648","Total",1879,897,982,1879,0,7,143.75,13.1
"2011","County Durham 008C","E01020649","Total",1547,765,782,1547,0,2,209.85,7.4
"2011","County Durham 008D","E01020673","Total",1626,816,810,1577,49,5,41.27,39.4
"2011","County Durham 008E","E01020675","Total",1700,829,871,1625,75,4,47.02,36.2
"2011","County Durham 009A","E01020624","Total",1562,767,795,1542,20,4,76.10,20.5
"2011","County Durham 009B","E01020625","Total",1609,779,830,1574,35,6,295.08,5.5
"2011","County Durham 009C","E01020670","Total",1559,717,842,1559,0,13,137.76,11.3
"2011","County Durham 009D","E01020671","Total",1346,676,670,1346,0,2,15.79,85.2
"2011","County Durham 009E","E01020672","Total",1671,857,814,1671,0,13,466.19,3.6
"2011","County Durham 010A","E01020632","Total",1818,921,897,1766,52,14,58.74,30.9
"2011","County Durham 010B","E01020640","Total",2354,1212,1142,2354,0,25,59.52,39.5
"2011","County Durham 010C","E01020641","Total",2196,1101,1095,2112,84,16,78.96,27.8
"2011","County Durham 010D","E01020642","Total",1395,666,729,1378,17,17,69.12,20.2
"2011","County Durham 010E","E01020643","Total",2157,1065,1092,2157,0,13,53.58,40.3
"2011","County Durham 010F","E01020667","Total",1537,749,788,1537,0,7,297.01,5.2
"2011","County Durham 012A","E01020650","Total",2183,1058,1125,2183,0,16,75.68,28.8
"2011","County Durham 012B","E01020651","Total",1736,820,916,1711,25,8,116.95,14.8
"2011","County Durham 012C","E01020652","Total",2006,974,1032,1953,53,13,160.51,12.5
"2011","County Durham 012D","E01020668","Total",1493,726,767,1487,6,5,58.20,25.7
"2011","County Durham 012E","E01020669","Total",1474,694,780,1436,38,10,500.47,2.9
"2011","County Durham 014A","E01020630","Total",1388,643,745,1388,0,10,79.01,17.6
"2011","County Durham 014B","E01020631","Total",1649,779,870,1649,0,2,45.56,36.2
"2011","County Durham 014C","E01020637","Total",1657,819,838,1657,0,30,6334.85,0.3
"2011","County Durham 014D","E01020644","Total",2457,1234,1223,2447,10,22,367.83,6.7
"2011","County Durham 014E","E01020645","Total",1489,720,769,1466,23,10,160.20,9.3
"2011","County Durham 020A","E01020633","Total",1564,774,790,1564,0,9,1430.74,1.1
"2011","County Durham 020B","E01020664","Total",1410,692,718,1410,0,31,4609.34,0.3
"2011","County Durham 020C","E01020665","Total",1356,647,709,1355,1,22,109.48,12.4
"2011","County Durham 020D","E01020666","Total",1459,726,733,1456,3,19,72.02,20.3
"2011","County Durham 024A","E01020646","Total",1586,782,804,1586,0,12,4020.54,0.4
"2011","County Durham 024B","E01020658","Total",1811,822,989,1734,77,14,80.61,22.5
"2011","County Durham 024C","E01020659","Total",1576,768,808,1574,2,15,38.02,41.5
"2011","County Durham 024D","E01020660","Total",1597,782,815,1564,33,19,1189.75,1.3
"2011","County Durham 022A","E01020709","Total",2464,1531,933,1408,1056,37,1018.42,2.4
"2011","County Durham 022B","E01020717","Total",1614,777,837,1614,0,32,35.35,45.7
"2011","County Durham 022C","E01020718","Total",1323,631,692,1323,0,29,28.34,46.7
"2011","County Durham 022D","E01020719","Total",1236,596,640,1236,0,31,32.07,38.5
"2011","County Durham 022E","E01020721","Total",1182,601,581,1182,0,26,31.05,38.1
"2011","County Durham 023A","E01020708","Total",1160,560,600,1160,0,23,65.18,17.8
"2011","County Durham 023B","E01020710","Total",1581,782,799,1579,2,30,106.11,14.9
"2011","County Durham 023C","E01020711","Total",1747,806,941,1689,58,11,54.10,32.3
"2011","County Durham 023D","E01020720","Total",1414,629,785,1414,0,12,28.54,49.5
"2011","County Durham 026A","E01020679","Total",1600,792,808,1561,39,11,137.30,11.7
"2011","County Durham 026B","E01020680","Total",1635,824,811,1607,28,32,1382.59,1.2
"2011","County Durham 026C","E01020681","Total",1467,709,758,1467,0,10,59.23,24.8
"2011","County Durham 026D","E01020714","Total",1551,756,795,1551,0,22,371.64,4.2
"2011","County Durham 026E","E01020716","Total",1709,793,916,1709,0,13,77.28,22.1
"2011","County Durham 027A","E01020725","Total",1534,746,788,1534,0,23,825.43,1.9
"2011","County Durham 027B","E01020726","Total",1229,593,636,1193,36,13,314.94,3.9
"2011","County Durham 027C","E01020727","Total",1087,506,581,1087,0,1,526.00,2.1
"2011","County Durham 027D","E01020729","Total",2118,1017,1101,2118,0,24,1264.14,1.7
"2011","County Durham 027E","E01020730","Total",1685,810,875,1685,0,7,110.02,15.3
"2011","County Durham 027F","E01020731","Total",1455,744,711,1455,0,12,393.10,3.7
"2011","County Durham 028A","E01020682","Total",1884,894,990,1884,0,23,58.97,31.9
"2011","County Durham 028B","E01020683","Total",1653,795,858,1596,57,20,54.69,30.2
"2011","County Durham 028C","E01020690","Total",1290,618,672,1290,0,17,370.75,3.5
"2011","County Durham 028D","E01020691","Total",1332,641,691,1332,0,12,22.93,58.1
"2011","County Durham 028E","E01020692","Total",1390,691,699,1390,0,17,61.94,22.4
"2011","County Durham 029A","E01020693","Total",1332,675,657,1321,11,3,81.72,16.3
"2011","County Durham 029B","E01020722","Total",2008,1001,1007,2008,0,14,33.34,60.2
"2011","County Durham 029C","E01020723","Total",1731,880,851,1729,2,12,35.55,48.7
"2011","County Durham 029D","E01020724","Total",1613,764,849,1613,0,5,172.66,9.3
"2011","County Durham 030A","E01020703","Total",2073,1059,1014,1963,110,28,36.10,57.4
"2011","County Durham 030D","E01033164","Total",2284,1155,1129,1004,1280,34,55.71,41.0
"2011","County Durham 030E","E01033195","Total",1387,695,692,954,433,21,43.30,32.0
"2011","County Durham 030F","E01033197","Total",2010,1216,794,1131,879,19,61.21,32.8
"2011","County Durham 030G","E01033221","Total",4494,2229,2265,992,3502,65,512.14,8.8
"2011","County Durham 033A","E01020684","Total",2317,1145,1172,2310,7,42,535.64,4.3
"2011","County Durham 033B","E01020702","Total",2331,1138,1193,2034,297,60,290.97,8.0
"2011","County Durham 033C","E01020704","Total",1898,977,921,1768,130,48,50.16,37.8
"2011","County Durham 033D","E01020712","Total",1610,815,795,1610,0,39,97.15,16.6
"2011","County Durham 033E","E01020713","Total",2028,1043,985,2028,0,75,289.65,7.0
"2011","County Durham 031A","E01020705","Total",1450,713,737,1450,0,7,97.87,14.8
"2011","County Durham 031B","E01020706","Total",1840,901,939,1840,0,14,943.81,1.9
"2011","County Durham 031C","E01020715","Total",2393,1180,1213,2393,0,12,714.82,3.3
"2011","County Durham 038A","E01020685","Total",1657,803,854,1633,24,33,1603.40,1.0
"2011","County Durham 038B","E01020686","Total",1572,792,780,1564,8,10,45.72,34.4
"2011","County Durham 038C","E01020687","Total",1427,688,739,1427,0,11,30.70,46.5
"2011","County Durham 038D","E01020688","Total",1530,708,822,1529,1,15,272.76,5.6
"2011","County Durham 038E","E01020689","Total",1477,719,758,1437,40,3,145.68,10.1
"2011","County Durham 041A","E01020694","Total",1451,706,745,1451,0,17,34.85,41.6
"2011","County Durham 041B","E01020696","Total",1276,622,654,1276,0,18,1455.06,0.9
"2011","County Durham 041C","E01020697","Total",1576,777,799,1509,67,10,112.82,14.0
"2011","County Durham 041D","E01020732","Total",1796,845,951,1732,64,48,948.38,1.9
"2011","County Durham 044A","E01020695","Total",1782,898,884,1782,0,13,922.40,1.9
"2011","County Durham 044B","E01020698","Total",1600,789,811,1594,6,15,164.04,9.8
"2011","County Durham 044C","E01020699","Total",1172,594,578,1172,0,5,194.04,6.0
"2011","County Durham 044D","E01020700","Total",1575,777,798,1563,12,6,1195.12,1.3
"2011","County Durham 044E","E01020701","Total",1345,646,699,1345,0,20,61.31,21.9
"2011","County Durham 016A","E01020750","Total",1247,617,630,1247,0,10,22.20,56.2
"2011","County Durham 016B","E01020781","Total",1126,534,592,1064,62,7,42.29,26.6
"2011","County Durham 016D","E01020786","Total",1606,829,777,1606,0,12,627.16,2.6
"2011","County Durham 016E","E01020787","Total",1833,881,952,1803,30,5,44.90,40.8
"2011","County Durham 016F","E01033163","Total",1978,975,1003,1972,6,7,272.00,7.3
"2011","County Durham 016G","E01033202","Total",1166,576,590,1166,0,4,32.57,35.8
"2011","County Durham 017A","E01020740","Total",1414,711,703,1399,15,7,37.95,37.3
"2011","County Durham 017B","E01020741","Total",1245,665,580,1240,5,6,23.86,52.2
"2011","County Durham 017C","E01020742","Total",1681,825,856,1656,25,4,141.91,11.8
"2011","County Durham 017D","E01020782","Total",1196,567,629,1100,96,2,31.71,37.7
"2011","County Durham 017E","E01020783","Total",1347,650,697,1347,0,10,22.72,59.3
"2011","County Durham 017F","E01020784","Total",1462,732,730,1450,12,8,65.34,22.4
"2011","County Durham 018A","E01020743","Total",1418,673,745,1418,0,5,130.02,10.9
"2011","County Durham 018B","E01020747","Total",1298,584,714,1248,50,3,29.96,43.3
"2011","County Durham 018C","E01020748","Total",1285,619,666,1285,0,9,20.98,61.2
"2011","County Durham 018D","E01020749","Total",1388,640,748,1388,0,1,41.48,33.5
"2011","County Durham 018E","E01020773","Total",1389,680,709,1385,4,6,369.10,3.8
"2011","County Durham 018F","E01020775","Total",1712,771,941,1712,0,4,65.74,26.0
"2011","County Durham 021C","E01020776","Total",1855,893,962,1806,49,9,352.02,5.3
"2011","County Durham 021D","E01033161","Total",1549,802,747,1507,42,9,286.83,5.4
"2011","County Durham 021E","E01033198","Total",1470,757,713,1470,0,3,21.15,69.5
"2011","County Durham 021F","E01033205","Total",1497,764,733,1494,3,4,274.99,5.4
"2011","County Durham 021G","E01033206","Total",1535,765,770,1525,10,12,92.17,16.7
"2011","County Durham 025A","E01020751","Total",1862,931,931,1862,0,7,103.98,17.9
"2011","County Durham 025B","E01020752","Total",1199,614,585,1199,0,7,321.78,3.7
"2011","County Durham 025C","E01020754","Total",1323,667,656,1323,0,7,961.01,1.4
"2011","County Durham 025D","E01020756","Total",1348,676,672,1348,0,11,795.45,1.7
"2011","County Durham 032A","E01020745","Total",1347,621,726,1298,49,7,30.77,43.8
"2011","County Durham 032B","E01020753","Total",1961,923,1038,1876,85,13,101.78,19.3
"2011","County Durham 032C","E01020757","Total",1145,555,590,1089,56,8,25.11,45.6
"2011","County Durham 032D","E01020758","Total",1441,685,756,1441,0,9,58.74,24.5
"2011","County Durham 032E","E01020759","Total",1115,531,584,1115,0,9,68.75,16.2
"2011","County Durham 032F","E01020765","Total",1713,884,829,1713,0,11,215.70,7.9
"2011","County Durham 034A","E01020760","Total",1634,812,822,1621,13,10,222.50,7.3
"2011","County Durham 034B","E01020761","Total",1291,639,652,1291,0,7,459.06,2.8
"2011","County Durham 034C","E01020762","Total",1434,710,724,1420,14,8,52.89,27.1
"2011","County Durham 034D","E01020763","Total",1831,921,910,1812,19,13,1159.06,1.6
"2011","County Durham 036A","E01020764","Total",1370,658,712,1370,0,2,36.56,37.5
"2011","County Durham 036B","E01020766","Total",1452,681,771,1427,25,5,23.98,60.6
"2011","County Durham 036C","E01020767","Total",1961,948,1013,1914,47,11,123.71,15.9
"2011","County Durham 036D","E01020768","Total",1591,809,782,1591,0,7,75.09,21.2
"2011","County Durham 035A","E01020733","Total",1251,585,666,1251,0,11,24.73,50.6
"2011","County Durham 035B","E01020734","Total",1225,554,671,1225,0,5,43.72,28.0
"2011","County Durham 035C","E01020735","Total",1416,685,731,1416,0,7,24.82,57.1
"2011","County Durham 035D","E01020770","Total",1228,577,651,1228,0,6,40.98,30.0
"2011","County Durham 035E","E01020771","Total",1050,516,534,1049,1,6,33.32,31.5
"2011","County Durham 035F","E01020780","Total",1167,565,602,1167,0,11,48.43,24.1
"2011","County Durham 037A","E01020746","Total",1179,575,604,1101,78,11,55.04,21.4
"2011","County Durham 037B","E01020769","Total",1268,630,638,1268,0,4,40.44,31.4
"2011","County Durham 037C","E01020777","Total",1472,698,774,1467,5,3,53.03,27.8
"2011","County Durham 037D","E01020778","Total",1196,606,590,1196,0,14,83.64,14.3
"2011","County Durham 037E","E01020779","Total",1657,823,834,1657,0,18,89.63,18.5
"2011","County Durham 039A","E01020736","Total",1204,590,614,1204,0,4,358.51,3.4
"2011","County Durham 039B","E01020737","Total",1395,652,743,1355,40,12,256.54,5.4
"2011","County Durham 039C","E01020738","Total",1013,495,518,1013,0,8,84.38,12.0
"2011","County Durham 039D","E01020739","Total",1325,638,687,1325,0,4,20.00,66.2
"2011","County Durham 039E","E01020744","Total",1007,512,495,1007,0,8,89.19,11.3
"2011","County Durham 040A","E01020788","Total",1538,770,768,1530,8,6,223.58,6.9
"2011","County Durham 040B","E01020789","Total",1436,706,730,1398,38,3,436.52,3.3
"2011","County Durham 040C","E01020790","Total",1328,664,664,1328,0,11,344.54,3.9
"2011","County Durham 040D","E01020791","Total",1299,652,647,1299,0,7,50.28,25.8
"2011","County Durham 040E","E01020792","Total",1484,723,761,1431,53,6,201.76,7.4
"2011","County Durham 043A","E01020772","Total",2001,995,1006,1993,8,17,2532.50,0.8
"2011","County Durham 043B","E01020793","Total",1707,833,874,1707,0,6,128.73,13.3
"2011","County Durham 043C","E01020794","Total",1780,877,903,1780,0,17,118.19,15.1
"2011","County Durham 043D","E01020795","Total",1790,835,955,1770,20,18,1188.18,1.5
"2011","County Durham 047A","E01020817","Total",1279,646,633,1279,0,12,70.84,18.1
"2011","County Durham 047B","E01020818","Total",1477,734,743,1477,0,10,48.44,30.5
"2011","County Durham 047C","E01020819","Total",1078,528,550,1078,0,4,21.72,49.6
"2011","County Durham 047D","E01020837","Total",1734,857,877,1734,0,22,34.55,50.2
"2011","County Durham 047E","E01020843","Total",1613,805,808,1613,0,16,494.51,3.3
"2011","County Durham 048A","E01020809","Total",1435,691,744,1435,0,4,373.29,3.8
"2011","County Durham 048B","E01020810","Total",1310,637,673,1310,0,8,945.80,1.4
"2011","County Durham 048C","E01020811","Total",1278,611,667,1278,0,17,46.47,27.5
"2011","County Durham 048D","E01020812","Total",1523,747,776,1523,0,17,241.47,6.3
"2011","County Durham 048E","E01020827","Total",1824,900,924,1805,19,12,410.13,4.4
"2011","County Durham 049A","E01020806","Total",1437,695,742,1416,21,12,342.71,4.2
"2011","County Durham 049B","E01020807","Total",1323,660,663,1323,0,5,22.34,59.2
"2011","County Durham 049C","E01020820","Total",1516,720,796,1516,0,10,172.43,8.8
"2011","County Durham 049D","E01020842","Total",2013,956,1057,2013,0,23,115.17,17.5
"2011","County Durham 050A","E01020797","Total",2501,1238,1263,2467,34,14,672.69,3.7
"2011","County Durham 050B","E01020798","Total",1484,684,800,1484,0,5,39.12,37.9
"2011","County Durham 050C","E01020799","Total",1470,717,753,1470,0,10,26.28,55.9
"2011","County Durham 050D","E01020808","Total",1421,712,709,1371,50,8,348.15,4.1
"2011","County Durham 052A","E01020821","Total",1872,926,946,1870,2,16,767.45,2.4
"2011","County Durham 052B","E01020822","Total",1834,922,912,1834,0,24,894.62,2.1
"2011","County Durham 052C","E01020823","Total",1769,872,897,1764,5,8,33.98,52.1
"2011","County Durham 052D","E01020835","Total",1664,812,852,1626,38,14,58.26,28.6
"2011","County Durham 052E","E01020836","Total",1967,967,1000,1964,3,11,336.21,5.9
"2011","County Durham 053B","E01020803","Total",1975,991,984,1939,36,17,1357.57,1.5
"2011","County Durham 053D","E01020805","Total",1981,928,1053,1981,0,16,55.86,35.5
"2011","County Durham 053E","E01033203","Total",2805,1389,1416,2805,0,15,444.20,6.3
"2011","County Durham 054A","E01020796","Total",1275,609,666,1275,0,18,1015.40,1.3
"2011","County Durham 054B","E01020828","Total",1651,820,831,1600,51,28,8190.17,0.2
"2011","County Durham 054C","E01020829","Total",2443,1221,1222,2436,7,36,170.04,14.4
"2011","County Durham 054D","E01020830","Total",1510,721,789,1510,0,16,97.94,15.4
"2011","County Durham 059A","E01020801","Total",1548,756,792,1544,4,17,41.81,37.0
"2011","County Durham 059B","E01020802","Total",2105,1021,1084,1989,116,10,613.31,3.4
"2011","County Durham 059C","E01020838","Total",1730,885,845,1730,0,11,470.61,3.7
"2011","County Durham 059D","E01020839","Total",1637,789,848,1637,0,6,78.10,21.0
"2011","County Durham 059E","E01020840","Total",1580,783,797,1576,4,12,199.11,7.9
"2011","County Durham 059F","E01020841","Total",1763,833,930,1763,0,11,35.70,49.4
"2011","County Durham 060A","E01020813","Total",1245,629,616,1245,0,20,41.17,30.2
"2011","County Durham 060B","E01020814","Total",1465,717,748,1412,53,20,38.65,37.9
"2011","County Durham 060C","E01020815","Total",1218,597,621,1218,0,14,362.97,3.4
"2011","County Durham 060D","E01020848","Total",1142,550,592,1113,29,15,31.50,36.3
"2011","County Durham 060E","E01020850","Total",1926,984,942,1926,0,37,97.24,19.8
"2011","County Durham 060F","E01020851","Total",1421,700,721,1421,0,21,109.96,12.9
"2011","County Durham 061A","E01020816","Total",1529,732,797,1472,57,20,46.49,32.9
"2011","County Durham 061B","E01020844","Total",1584,788,796,1584,0,11,36.50,43.4
"2011","County Durham 061C","E01020847","Total",1568,739,829,1568,0,13,32.24,48.6
"2011","County Durham 061D","E01020849","Total",1286,611,675,1215,71,4,33.27,38.7
"2011","County Durham 062A","E01020825","Total",1569,762,807,1564,5,16,47.40,33.1
"2011","County Durham 062B","E01020831","Total",1439,642,797,1399,40,11,41.79,34.4
"2011","County Durham 062C","E01020833","Total",1236,608,628,1195,41,12,513.56,2.4
"2011","County Durham 062D","E01020834","Total",1283,587,696,1283,0,5,28.50,45.0
"2011","County Durham 063A","E01020824","Total",1544,706,838,1544,0,11,52.63,29.3
"2011","County Durham 063B","E01020826","Total",1510,729,781,1510,0,18,727.25,2.1
"2011","County Durham 063C","E01020832","Total",1392,669,723,1392,0,9,45.58,30.5
"2011","County Durham 063D","E01020845","Total",1351,632,719,1351,0,11,31.29,43.2
"2011","County Durham 063E","E01020846","Total",1237,611,626,1237,0,19,132.11,9.4
"2011","County Durham 064A","E01020856","Total",1531,767,764,1530,1,9,650.03,2.4
"2011","County Durham 064B","E01020858","Total",1062,532,530,1028,34,17,582.22,1.8
"2011","County Durham 064C","E01020859","Total",1228,573,655,1208,20,15,1575.05,0.8
"2011","County Durham 064D","E01020860","Total",1056,522,534,1008,48,6,106.75,9.9
"2011","County Durham 064E","E01020861","Total",1169,555,614,1169,0,7,1892.28,0.6
"2011","County Durham 064F","E01020862","Total",2391,1164,1227,2391,0,32,4610.16,0.5
"2011","County Durham 064G","E01020864","Total",2068,1059,1009,2068,0,18,8797.41,0.2
"2011","County Durham 064H","E01020867","Total",2254,1090,1164,2206,48,33,6864.67,0.3
"2011","County Durham 065A","E01020857","Total",1522,744,778,1520,2,27,11345.21,0.1
"2011","County Durham 065B","E01020863","Total",1390,699,691,1385,5,33,16734.54,0.1
"2011","County Durham 065C","E01020865","Total",1328,652,676,1324,4,26,16455.71,0.1
"2011","County Durham 065D","E01020866","Total",1001,500,501,996,5,14,13085.42,0.1
"2011","County Durham 066A","E01020852","Total",1676,823,853,1494,182,18,66.82,25.1
"2011","County Durham 066B","E01020853","Total",1528,697,831,1426,102,24,306.52,5.0
"2011","County Durham 066C","E01020854","Total",2632,1505,1127,2118,514,46,492.42,5.3
"2011","County Durham 066D","E01020855","Total",1204,560,644,1202,2,29,47.52,25.3
"2011","County Durham 042A","E01020889","Total",1481,732,749,1478,3,22,10357.00,0.1
"2011","County Durham 042B","E01020890","Total",1777,902,875,1733,44,19,3621.79,0.5
"2011","County Durham 042C","E01020891","Total",1612,805,807,1612,0,35,16729.42,0.1
"2011","County Durham 042D","E01020905","Total",1530,731,799,1530,0,24,177.55,8.6
"2011","County Durham 042E","E01020906","Total",1663,797,866,1663,0,31,8707.00,0.2
"2011","County Durham 045A","E01020876","Total",1738,848,890,1733,5,14,467.69,3.7
"2011","County Durham 045B","E01020878","Total",1721,849,872,1721,0,16,51.41,33.5
"2011","County Durham 045C","E01020887","Total",1883,970,913,1881,2,12,571.19,3.3
"2011","County Durham 045D","E01020892","Total",1104,543,561,1104,0,6,107.31,10.3
"2011","County Durham 045E","E01020894","Total",1251,617,634,1219,32,8,1274.37,1.0
"2011","County Durham 045F","E01020898","Total",1531,698,833,1531,0,6,38.44,39.8
"2011","County Durham 046A","E01020877","Total",1562,764,798,1502,60,12,45.53,34.3
"2011","County Durham 046B","E01020879","Total",2146,1037,1109,2146,0,22,122.43,17.5
"2011","County Durham 046C","E01020893","Total",1695,819,876,1637,58,11,992.31,1.7
"2011","County Durham 046D","E01020899","Total",1292,651,641,1292,0,14,398.42,3.2
"2011","County Durham 046E","E01020903","Total",1164,589,575,1157,7,10,1104.39,1.1
"2011","County Durham 046F","E01020904","Total",1755,860,895,1755,0,16,298.83,5.9
"2011","County Durham 051A","E01020873","Total",1453,701,752,1453,0,8,66.50,21.8
"2011","County Durham 051B","E01020875","Total",1301,647,654,1301,0,2,1156.98,1.1
"2011","County Durham 051C","E01020900","Total",1409,705,704,1407,2,25,118.26,11.9
"2011","County Durham 051D","E01020901","Total",1414,697,717,1300,114,6,53.68,26.3
"2011","County Durham 051E","E01020902","Total",1448,703,745,1448,0,7,76.60,18.9
"2011","County Durham 055A","E01020868","Total",1785,855,930,1756,29,23,180.93,9.9
"2011","County Durham 055B","E01020869","Total",1396,689,707,1360,36,15,252.59,5.5
"2011","County Durham 055C","E01020874","Total",1468,752,716,1438,30,7,194.48,7.5
"2011","County Durham 055D","E01020880","Total",1561,781,780,1561,0,5,275.41,5.7
"2011","County Durham 055E","E01020881","Total",1356,645,711,1290,66,18,138.80,9.8
"2011","County Durham 056A","E01020870","Total",1360,652,708,1360,0,21,48.28,28.2
"2011","County Durham 056B","E01020871","Total",1411,663,748,1411,0,14,23.01,61.3
"2011","County Durham 056C","E01020872","Total",1808,825,983,1692,116,17,74.37,24.3
"2011","County Durham 056D","E01020883","Total",1711,825,886,1711,0,28,81.56,21.0
"2011","County Durham 056E","E01020886","Total",1259,595,664,1257,2,13,18.90,66.6
"2011","County Durham 057A","E01020882","Total",1460,744,716,1460,0,31,586.84,2.5
"2011","County Durham 057B","E01020888","Total",1957,974,983,1957,0,16,1195.29,1.6
"2011","County Durham 057C","E01020895","Total",1485,705,780,1457,28,5,77.45,19.2
"2011","County Durham 057D","E01020896","Total",1380,663,717,1380,0,16,35.99,38.3
"2011","County Durham 057E","E01020897","Total",2473,1190,1283,2443,30,14,365.51,6.8
"2011","County Durham 058A","E01020884","Total",1417,637,780,1365,52,4,26.33,53.8
"2011","County Durham 058B","E01020885","Total",1143,558,585,1143,0,11,34.56,33.1
"2011","County Durham 058C","E01020907","Total",1608,758,850,1608,0,13,58.45,27.5
"2011","County Durham 058D","E01020908","Total",1404,664,740,1404,0,9,57.17,24.6
"2011","County Durham 058E","E01020909","Total",1685,780,905,1681,4,11,32.98,51.1
"2011","Hartlepool 001A","E01011954","Total",2171,1019,1152,2171,0,10,42.04,51.6
"2011","Hartlepool 001B","E01011969","Total",1373,686,687,1373,0,17,89.13,15.4
"2011","Hartlepool 001C","E01011970","Total",1156,578,578,1156,0,11,36.72,31.5
"2011","Hartlepool 001D","E01011971","Total",1452,698,754,1452,0,19,21.87,66.4
"2011","Hartlepool 001F","E01033465","Total",1754,852,902,1754,0,7,45.34,38.7
"2011","Hartlepool 001G","E01033467","Total",1178,528,650,1178,0,5,41.00,28.7
"2011","Hartlepool 002A","E01011952","Total",1670,766,904,1581,89,9,46.41,36.0
"2011","Hartlepool 002B","E01011953","Total",1886,924,962,1886,0,13,88.33,21.4
"2011","Hartlepool 002C","E01011991","Total",1830,918,912,1821,9,18,33.96,53.9
"2011","Hartlepool 002D","E01011992","Total",1582,791,791,1582,0,8,134.25,11.8
"2011","Hartlepool 002E","E01011993","Total",1775,889,886,1775,0,8,60.54,29.3
"2011","Hartlepool 002F","E01011994","Total",1573,782,791,1478,95,2,113.13,13.9
"2011","Hartlepool 003A","E01011955","Total",1366,677,689,1357,9,5,28.90,47.3
"2011","Hartlepool 003C","E01011957","Total",1317,666,651,1317,0,2,25.79,51.1
"2011","Hartlepool 003G","E01032540","Total",999,470,529,999,0,4,29.67,33.7
"2011","Hartlepool 003H","E01032541","Total",2171,1022,1149,2138,33,9,62.30,34.8
"2011","Hartlepool 003I","E01033466","Total",1982,938,1044,1982,0,11,32.84,60.4
"2011","Hartlepool 005A","E01011973","Total",1320,683,637,1320,0,4,15.94,82.8
"2011","Hartlepool 005B","E01011974","Total",1687,897,790,1684,3,14,86.46,19.5
"2011","Hartlepool 005C","E01011975","Total",1324,637,687,1324,0,10,11.05,119.8
"2011","Hartlepool 005D","E01011976","Total",1026,537,489,1026,0,4,11.84,86.7
"2011","Hartlepool 006A","E01011965","Total",1649,796,853,1621,28,41,36.84,44.8
"2011","Hartlepool 006B","E01011966","Total",1367,679,688,1363,4,21,18.60,73.5
"2011","Hartlepool 006C","E01011983","Total",1716,826,890,1666,50,37,89.31,19.2
"2011","Hartlepool 006D","E01012002","Total",1378,659,719,1378,0,13,29.30,47.0
"2011","Hartlepool 007A","E01011951","Total",1391,702,689,1391,0,5,20.86,66.7
"2011","Hartlepool 007B","E01011964","Total",1489,755,734,1440,49,18,19.96,74.6
"2011","Hartlepool 007C","E01011967","Total",1497,733,764,1461,36,10,14.86,100.7
"2011","Hartlepool 007D","E01011999","Total",2191,1097,1094,2128,63,9,79.78,27.5
"2011","Hartlepool 007E","E01012000","Total",1359,706,653,1357,2,4,51.93,26.2
"2011","Hartlepool 008A","E01011950","Total",1452,730,722,1435,17,1,13.25,109.6
"2011","Hartlepool 008B","E01011986","Total",1274,608,666,1274,0,10,25.50,50.0
"2011","Hartlepool 008C","E01011987","Total",1402,662,740,1399,3,9,16.05,87.4
"2011","Hartlepool 008D","E01012001","Total",1951,927,1024,1949,2,15,120.59,16.2
"2011","Hartlepool 009A","E01011949","Total",1942,937,1005,1942,0,16,51.89,37.4
"2011","Hartlepool 009B","E01011980","Total",1701,832,869,1701,0,10,80.80,21.1
"2011","Hartlepool 009C","E01011981","Total",1666,772,894,1613,53,8,48.07,34.7
"2011","Hartlepool 009D","E01011984","Total",1250,590,660,1250,0,12,50.74,24.6
"2011","Hartlepool 010A","E01011985","Total",1169,572,597,1126,43,10,34.16,34.2
"2011","Hartlepool 010B","E01011988","Total",1914,899,1015,1852,62,11,46.93,40.8
"2011","Hartlepool 010C","E01011989","Total",1877,881,996,1877,0,14,269.18,7.0
"2011","Hartlepool 010D","E01011990","Total",1724,824,900,1718,6,7,97.73,17.6
"2011","Hartlepool 011A","E01011995","Total",1429,695,734,1429,0,20,26.48,54.0
"2011","Hartlepool 011B","E01011996","Total",1518,756,762,1420,98,13,34.43,44.1
"2011","Hartlepool 011C","E01011997","Total",2041,986,1055,2041,0,19,147.81,13.8
"2011","Hartlepool 011D","E01011998","Total",1470,705,765,1436,34,22,1025.06,1.4
"2011","Hartlepool 012A","E01011961","Total",1442,694,748,1442,0,12,31.81,45.3
"2011","Hartlepool 012B","E01011962","Total",1456,668,788,1456,0,1,26.70,54.5
"2011","Hartlepool 012C","E01011977","Total",1748,844,904,1748,0,4,34.08,51.3
"2011","Hartlepool 012D","E01011978","Total",1557,758,799,1508,49,8,39.79,39.1
"2011","Hartlepool 012E","E01011979","Total",1547,723,824,1521,26,14,21.25,72.8
"2011","Hartlepool 014A","E01011959","Total",2061,1006,1055,2023,38,35,4120.92,0.5
"2011","Hartlepool 014B","E01011960","Total",1394,688,706,1394,0,12,28.53,48.9
"2011","Hartlepool 014C","E01011963","Total",1418,706,712,1418,0,26,29.20,48.6
"2011","Hartlepool 014D","E01011968","Total",2132,1010,1122,2096,36,34,1172.10,1.8
"2011","Hartlepool 014E","E01011982","Total",1300,639,661,1300,0,29,195.64,6.6
"2011","Hartlepool 014F","E01012003","Total",1541,725,816,1541,0,26,134.96,11.4
"2011","Hartlepool 014G","E01012005","Total",2023,1003,1020,2023,0,34,43.51,46.5
"2011","Middlesbrough 001A","E01012068","Total",2369,1321,1048,1883,486,32,37.33,63.5
"2011","Middlesbrough 001D","E01012092","Total",2191,1216,975,1623,568,32,24.55,89.2
"2011","Middlesbrough 001E","E01012093","Total",1975,1066,909,1975,0,14,11.40,173.2
"2011","Middlesbrough 001F","E01012094","Total",2574,1381,1193,2571,3,10,41.00,62.8
"2011","Middlesbrough 001G","E01033468","Total",2537,1416,1121,2525,12,17,460.84,5.5
"2011","Middlesbrough 002A","E01012058","Total",1625,818,807,1625,0,10,15.85,102.5
"2011","Middlesbrough 002B","E01012059","Total",1497,710,787,1497,0,3,40.69,36.8
"2011","Middlesbrough 002C","E01012060","Total",1683,761,922,1683,0,8,49.76,33.8
"2011","Middlesbrough 002D","E01012061","Total",1463,689,774,1463,0,2,65.21,22.4
"2011","Middlesbrough 003A","E01012036","Total",1534,820,714,1534,0,12,10.01,153.2
"2011","Middlesbrough 003B","E01012037","Total",1540,814,726,1540,0,9,17.49,88.1
"2011","Middlesbrough 003C","E01012038","Total",1506,777,729,1506,0,8,8.70,173.1
"2011","Middlesbrough 003D","E01012039","Total",1510,901,609,1510,0,7,14.62,103.3
"2011","Middlesbrough 003E","E01012040","Total",1466,739,727,1466,0,14,8.98,163.3
"2011","Middlesbrough 003F","E01012041","Total",1028,542,486,1027,1,2,53.27,19.3
"2011","Middlesbrough 004A","E01012074","Total",1550,732,818,1550,0,4,33.64,46.1
"2011","Middlesbrough 004B","E01012075","Total",1605,694,911,1557,48,1,55.38,29.0
"2011","Middlesbrough 004C","E01012076","Total",1551,654,897,1551,0,8,22.73,68.2
"2011","Middlesbrough 004D","E01012077","Total",1363,631,732,1363,0,3,45.08,30.2
"2011","Middlesbrough 004E","E01012088","Total",1447,663,784,1411,36,4,29.79,48.6
"2011","Middlesbrough 005A","E01012078","Total",1453,724,729,1450,3,16,13.26,109.6
"2011","Middlesbrough 005B","E01012079","Total",1443,700,743,1387,56,11,22.19,65.0
"2011","Middlesbrough 005C","E01012080","Total",1269,626,643,1269,0,9,48.16,26.3
"2011","Middlesbrough 005D","E01012081","Total",1754,872,882,1681,73,15,23.10,75.9
"2011","Middlesbrough 006A","E01012026","Total",1594,791,803,1571,23,6,36.50,43.7
"2011","Middlesbrough 006B","E01012027","Total",1754,833,921,1691,63,7,35.36,49.6
"2011","Middlesbrough 006E","E01033469","Total",1998,982,1016,1998,0,8,46.36,43.1
"2011","Middlesbrough 007A","E01012015","Total",1501,727,774,1501,0,3,23.57,63.7
"2011","Middlesbrough 007B","E01012016","Total",1698,818,880,1650,48,8,48.09,35.3
"2011","Middlesbrough 007C","E01012017","Total",1573,802,771,1573,0,6,35.64,44.1
"2011","Middlesbrough 007D","E01012089","Total",1549,745,804,1549,0,3,38.07,40.7
"2011","Middlesbrough 007E","E01012090","Total",1546,784,762,1546,0,2,31.77,48.7
"2011","Middlesbrough 007F","E01012091","Total",1748,824,924,1740,8,2,49.64,35.2
"2011","Middlesbrough 008A","E01012011","Total",1861,854,1007,1861,0,3,79.33,23.5
"2011","Middlesbrough 008B","E01012012","Total",1795,879,916,1791,4,11,41.67,43.1
"2011","Middlesbrough 008C","E01012013","Total",1307,628,679,1307,0,3,92.33,14.2
"2011","Middlesbrough 008D","E01012014","Total",1552,735,817,1544,8,9,29.79,52.1
"2011","Middlesbrough 009A","E01012053","Total",1686,833,853,1680,6,26,28.65,58.8
"2011","Middlesbrough 009B","E01012054","Total",1760,865,895,1760,0,17,23.36,75.3
"2011","Middlesbrough 009C","E01012055","Total",1941,979,962,1928,13,32,35.51,54.7
"2011","Middlesbrough 009D","E01012056","Total",2304,1175,1129,2304,0,12,28.89,79.8
"2011","Middlesbrough 009E","E01012057","Total",2020,985,1035,1953,67,29,51.19,39.5
"2011","Middlesbrough 010A","E01012082","Total",1578,729,849,1576,2,1,27.79,56.8
"2011","Middlesbrough 010B","E01012083","Total",1555,717,838,1555,0,4,31.58,49.2
"2011","Middlesbrough 010C","E01012084","Total",1650,720,930,1650,0,7,30.27,54.5
"2011","Middlesbrough 010D","E01012085","Total",1471,670,801,1443,28,8,29.77,49.4
"2011","Middlesbrough 011A","E01012018","Total",1676,856,820,1379,297,5,74.37,22.5
"2011","Middlesbrough 011B","E01012019","Total",1296,582,714,1296,0,3,18.70,69.3
"2011","Middlesbrough 011C","E01012020","Total",1577,751,826,1558,19,8,41.86,37.7
"2011","Middlesbrough 011D","E01012021","Total",1383,644,739,1380,3,5,72.99,18.9
"2011","Middlesbrough 012A","E01012007","Total",1485,712,773,1485,0,16,86.34,17.2
"2011","Middlesbrough 012B","E01012008","Total",1421,670,751,1421,0,19,29.86,47.6
"2011","Middlesbrough 012C","E01012009","Total",1757,869,888,1757,0,15,46.24,38.0
"2011","Middlesbrough 012D","E01012010","Total",1364,676,688,1358,6,27,40.32,33.8
"2011","Middlesbrough 013A","E01012046","Total",1730,820,910,1727,3,9,170.16,10.2
"2011","Middlesbrough 013B","E01012047","Total",1610,771,839,1610,0,11,35.94,44.8
"2011","Middlesbrough 013C","E01012048","Total",1734,838,896,1734,0,21,58.43,29.7
"2011","Middlesbrough 014A","E01012049","Total",1414,696,718,1414,0,8,29.62,47.7
"2011","Middlesbrough 014B","E01012050","Total",1478,705,773,1472,6,12,19.61,75.4
"2011","Middlesbrough 014C","E01012051","Total",1364,658,706,1364,0,9,18.72,72.9
"2011","Middlesbrough 014D","E01012052","Total",1327,649,678,1293,34,16,58.69,22.6
"2011","Middlesbrough 015A","E01012022","Total",1518,747,771,1518,0,14,220.38,6.9
"2011","Middlesbrough 015B","E01012023","Total",1372,626,746,1372,0,13,49.26,27.9
"2011","Middlesbrough 015C","E01012024","Total",1525,731,794,1525,0,4,36.79,41.5
"2011","Middlesbrough 015D","E01012025","Total",1297,639,658,1297,0,9,22.35,58.0
"2011","Middlesbrough 017A","E01012065","Total",1662,796,866,1662,0,26,68.90,24.1
"2011","Middlesbrough 017B","E01012066","Total",2041,1024,1017,2001,40,23,120.74,16.9
"2011","Middlesbrough 017C","E01012067","Total",1602,765,837,1602,0,13,48.53,33.0
"2011","Middlesbrough 018A","E01012042","Total",1457,706,751,1449,8,3,34.86,41.8
"2011","Middlesbrough 018B","E01012043","Total",1452,712,740,1452,0,11,36.83,39.4
"2011","Middlesbrough 018C","E01012044","Total",1574,745,829,1574,0,7,46.78,33.6
"2011","Middlesbrough 018D","E01012045","Total",1471,688,783,1471,0,7,28.88,50.9
"2011","Middlesbrough 018G","E01032552","Total",1647,775,872,1585,62,14,38.55,42.7
"2011","Middlesbrough 018H","E01032553","Total",1243,589,654,1214,29,10,459.16,2.7
"2011","Middlesbrough 019A","E01012030","Total",1528,694,834,1466,62,15,60.73,25.2
"2011","Middlesbrough 019B","E01012031","Total",1559,750,809,1559,0,8,67.25,23.2
"2011","Middlesbrough 019C","E01012032","Total",1735,870,865,1735,0,24,51.21,33.9
"2011","Middlesbrough 019D","E01012033","Total",1303,600,703,1224,79,5,36.03,36.2
"2011","Middlesbrough 019E","E01012034","Total",1501,726,775,1501,0,21,148.02,10.1
"2011","Middlesbrough 019F","E01012035","Total",1341,650,691,1341,0,5,45.37,29.6
"2011","Middlesbrough 020A","E01012062","Total",1477,703,774,1477,0,17,49.95,29.6
"2011","Middlesbrough 020B","E01012063","Total",1413,646,767,1413,0,16,28.51,49.6
"2011","Middlesbrough 020C","E01012064","Total",1838,918,920,1835,3,34,193.40,9.5
"2011","Middlesbrough 020D","E01012071","Total",1472,734,738,1472,0,32,54.72,26.9
"2011","Middlesbrough 020E","E01012073","Total",1424,701,723,1424,0,23,39.73,35.8
"2011","Middlesbrough 020F","E01032593","Total",1970,958,1012,1921,49,44,570.53,3.5
"2011","Northumberland 004A","E01027356","Total",1719,833,886,1708,11,32,6931.22,0.2
"2011","Northumberland 004B","E01027357","Total",1350,641,709,1228,122,26,187.81,7.2
"2011","Northumberland 004C","E01027366","Total",1525,726,799,1494,31,27,5749.06,0.3
"2011","Northumberland 004D","E01027367","Total",1960,1035,925,1740,220,22,2296.46,0.9
"2011","Northumberland 005A","E01027358","Total",2000,930,1070,1980,20,19,1590.95,1.3
"2011","Northumberland 005B","E01027359","Total",2317,1108,1209,2270,47,19,45.95,50.4
"2011","Northumberland 005D","E01033715","Total",1037,499,538,1031,6,16,25.06,41.4
"2011","Northumberland 005E","E01033717","Total",1412,669,743,1383,29,27,82.87,17.0
"2011","Northumberland 006A","E01027361","Total",2109,1048,1061,2067,42,18,72.21,29.2
"2011","Northumberland 006B","E01027362","Total",1259,611,648,1259,0,9,895.01,1.4
"2011","Northumberland 006C","E01027363","Total",1197,568,629,1197,0,2,62.15,19.3
"2011","Northumberland 006D","E01027364","Total",2054,1002,1052,2050,4,28,219.03,9.4
"2011","Northumberland 006E","E01027370","Total",1837,887,950,1837,0,41,3623.88,0.5
"2011","Northumberland 006F","E01027371","Total",1834,905,929,1834,0,20,1441.20,1.3
"2011","Northumberland 006G","E01027372","Total",2118,1018,1100,2094,24,42,3922.40,0.5
"2011","Northumberland 007A","E01027365","Total",2193,1076,1117,2166,27,45,16547.23,0.1
"2011","Northumberland 007B","E01027368","Total",1766,863,903,1743,23,30,14171.12,0.1
"2011","Northumberland 007C","E01027369","Total",1547,762,785,1542,5,28,603.54,2.6
"2011","Northumberland 007D","E01027373","Total",2003,1007,996,1987,16,54,49483.71,0.0
"2011","Northumberland 001A","E01027376","Total",1741,822,919,1690,51,19,166.68,10.4
"2011","Northumberland 001B","E01027377","Total",1672,801,871,1646,26,23,94.24,17.7
"2011","Northumberland 001C","E01027385","Total",1333,611,722,1266,67,8,28.05,47.5
"2011","Northumberland 001D","E01027387","Total",1803,839,964,1710,93,11,115.46,15.6
"2011","Northumberland 001E","E01027388","Total",1446,688,758,1446,0,9,54.91,26.3
"2011","Northumberland 001F","E01027389","Total",1625,799,826,1582,43,13,107.58,15.1
"2011","Northumberland 002A","E01027378","Total",1064,519,545,1022,42,27,1854.26,0.6
"2011","Northumberland 002B","E01027379","Total",1374,664,710,1374,0,16,1484.96,0.9
"2011","Northumberland 002C","E01027380","Total",1413,715,698,1412,1,27,9171.63,0.2
"2011","Northumberland 002D","E01027382","Total",1687,817,870,1647,40,34,8126.74,0.2
"2011","Northumberland 002E","E01027386","Total",1359,649,710,1354,5,13,175.05,7.8
"2011","Northumberland 003A","E01027374","Total",2053,1010,1043,2047,6,35,7817.65,0.3
"2011","Northumberland 003B","E01027375","Total",1773,883,890,1757,16,35,41272.13,0.0
"2011","Northumberland 003C","E01027381","Total",1848,932,916,1848,0,50,19648.77,0.1
"2011","Northumberland 003D","E01027383","Total",1346,655,691,1342,4,10,464.74,2.9
"2011","Northumberland 003E","E01027384","Total",1447,721,726,1441,6,31,5312.28,0.3
"2011","Northumberland 003F","E01027390","Total",1983,940,1043,1961,22,16,1285.30,1.5
"2011","Northumberland 022A","E01027392","Total",1703,797,906,1652,51,6,101.79,16.7
"2011","Northumberland 022B","E01027393","Total",1539,735,804,1539,0,3,25.06,61.4
"2011","Northumberland 022C","E01027416","Total",1558,745,813,1525,33,7,22.55,69.1
"2011","Northumberland 022D","E01027424","Total",2060,999,1061,1955,105,4,82.52,25.0
"2011","Northumberland 023A","E01027414","Total",1469,753,716,1439,30,7,17.43,84.3
"2011","Northumberland 023B","E01027415","Total",1665,781,884,1573,92,13,47.97,34.7
"2011","Northumberland 023C","E01027431","Total",1707,835,872,1707,0,11,29.15,58.6
"2011","Northumberland 023D","E01027441","Total",2011,989,1022,2011,0,11,72.95,27.6
"2011","Northumberland 023E","E01027442","Total",1579,806,773,1579,0,9,46.48,34.0
"2011","Northumberland 024A","E01027391","Total",1503,700,803,1466,37,7,34.18,44.0
"2011","Northumberland 024B","E01027422","Total",1845,915,930,1845,0,7,33.35,55.3
"2011","Northumberland 024C","E01027423","Total",1515,748,767,1515,0,4,32.97,46.0
"2011","Northumberland 024D","E01027429","Total",1849,852,997,1841,8,6,39.02,47.4
"2011","Northumberland 024E","E01027430","Total",1629,784,845,1629,0,6,32.74,49.8
"2011","Northumberland 025A","E01027425","Total",2288,1104,1184,2279,9,14,456.89,5.0
"2011","Northumberland 025B","E01027426","Total",1542,730,812,1542,0,8,126.93,12.1
"2011","Northumberland 025C","E01027427","Total",1657,842,815,1646,11,9,379.12,4.4
"2011","Northumberland 025D","E01027428","Total",1543,757,786,1543,0,4,36.83,41.9
"2011","Northumberland 026A","E01027437","Total",1817,906,911,1817,0,13,42.26,43.0
"2011","Northumberland 026B","E01027438","Total",1488,734,754,1488,0,11,22.13,67.2
"2011","Northumberland 026C","E01027439","Total",1954,959,995,1954,0,18,46.74,41.8
"2011","Northumberland 026D","E01027440","Total",1418,701,717,1418,0,4,183.42,7.7
"2011","Northumberland 027A","E01027400","Total",1360,665,695,1360,0,11,25.16,54.1
"2011","Northumberland 027B","E01027401","Total",1500,757,743,1500,0,19,36.62,41.0
"2011","Northumberland 027C","E01027402","Total",1334,657,677,1334,0,31,32.18,41.5
"2011","Northumberland 027D","E01027403","Total",1186,567,619,1186,0,22,38.17,31.1
"2011","Northumberland 029A","E01027398","Total",2301,1090,1211,2301,0,20,343.92,6.7
"2011","Northumberland 029B","E01027409","Total",1531,722,809,1469,62,8,74.62,20.5
"2011","Northumberland 029C","E01027411","Total",1358,600,758,1273,85,5,26.18,51.9
"2011","Northumberland 029D","E01027412","Total",1571,757,814,1527,44,4,978.95,1.6
"2011","Northumberland 029E","E01027413","Total",1872,908,964,1872,0,13,152.13,12.3
"2011","Northumberland 028A","E01027395","Total",1491,704,787,1428,63,11,108.19,13.8
"2011","Northumberland 028B","E01027396","Total",1392,655,737,1392,0,4,24.17,57.6
"2011","Northumberland 028C","E01027397","Total",1404,649,755,1404,0,7,30.71,45.7
"2011","Northumberland 028D","E01027399","Total",1508,737,771,1508,0,11,27.56,54.7
"2011","Northumberland 028E","E01027404","Total",1540,759,781,1461,79,9,78.70,19.6
"2011","Northumberland 028F","E01027405","Total",1448,688,760,1448,0,19,28.14,51.5
"2011","Northumberland 030A","E01027417","Total",1525,711,814,1508,17,9,710.11,2.1
"2011","Northumberland 030B","E01027418","Total",1841,894,947,1841,0,8,114.63,16.1
"2011","Northumberland 030C","E01027419","Total",1557,754,803,1546,11,11,71.26,21.8
"2011","Northumberland 030D","E01027420","Total",1412,665,747,1381,31,10,403.24,3.5
"2011","Northumberland 030E","E01027421","Total",1470,691,779,1470,0,6,173.54,8.5
"2011","Northumberland 031A","E01027394","Total",1153,578,575,1153,0,8,41.61,27.7
"2011","Northumberland 031B","E01027406","Total",1284,627,657,1284,0,12,89.26,14.4
"2011","Northumberland 031C","E01027407","Total",1277,634,643,1277,0,11,26.89,47.5
"2011","Northumberland 031D","E01027408","Total",1289,615,674,1289,0,8,33.94,38.0
"2011","Northumberland 031E","E01027410","Total",1614,777,837,1614,0,15,89.91,18.0
"2011","Northumberland 032A","E01027432","Total",1549,785,764,1536,13,1,37.58,41.2
"2011","Northumberland 032B","E01027433","Total",1678,826,852,1678,0,9,720.76,2.3
"2011","Northumberland 032C","E01027434","Total",1400,701,699,1400,0,4,44.86,31.2
"2011","Northumberland 032D","E01027435","Total",1431,699,732,1431,0,6,197.75,7.2
"2011","Northumberland 032E","E01027436","Total",1559,773,786,1559,0,11,363.07,4.3
"2011","Northumberland 008A","E01027443","Total",1483,693,790,1483,0,10,40.07,37.0
"2011","Northumberland 008B","E01027444","Total",2468,1760,708,1353,1115,11,2185.22,1.1
"2011","Northumberland 008C","E01027445","Total",1617,813,804,1585,32,20,1627.11,1.0
"2011","Northumberland 008D","E01027446","Total",1367,672,695,1367,0,17,88.49,15.4
"2011","Northumberland 008E","E01027451","Total",1858,919,939,1847,11,11,139.70,13.3
"2011","Northumberland 008F","E01027474","Total",1884,914,970,1884,0,20,97.01,19.4
"2011","Northumberland 008G","E01027475","Total",1415,687,728,1392,23,20,3016.72,0.5
"2011","Northumberland 011A","E01027457","Total",1590,807,783,1259,331,33,211.85,7.5
"2011","Northumberland 011B","E01027462","Total",1881,909,972,1873,8,13,126.27,14.9
"2011","Northumberland 011C","E01027463","Total",1709,870,839,1706,3,21,1479.11,1.2
"2011","Northumberland 015A","E01027447","Total",1777,867,910,1768,9,40,18273.87,0.1
"2011","Northumberland 015B","E01027448","Total",1939,946,993,1908,31,59,4502.41,0.4
"2011","Northumberland 015C","E01027450","Total",1645,804,841,1645,0,44,7341.62,0.2
"2011","Northumberland 015D","E01027473","Total",1754,871,883,1749,5,25,6855.11,0.3
"2011","Northumberland 016A","E01027452","Total",1429,688,741,1367,62,31,166.96,8.6
"2011","Northumberland 016B","E01027453","Total",1427,641,786,1424,3,16,54.27,26.3
"2011","Northumberland 016E","E01027461","Total",1341,619,722,1339,2,14,26.56,50.5
"2011","Northumberland 016F","E01033718","Total",2084,969,1115,2084,0,21,53.35,39.1
"2011","Northumberland 018A","E01027455","Total",1520,769,751,1520,0,35,119.35,12.7
"2011","Northumberland 018B","E01027456","Total",1341,673,668,1341,0,39,88.24,15.2
"2011","Northumberland 018C","E01027458","Total",1603,765,838,1556,47,48,132.59,12.1
"2011","Northumberland 018D","E01027460","Total",1682,828,854,1682,0,24,44.17,38.1
"2011","Northumberland 033A","E01027464","Total",1353,630,723,1353,0,22,124.46,10.9
"2011","Northumberland 033B","E01027465","Total",1493,713,780,1485,8,31,1894.13,0.8
"2011","Northumberland 033C","E01027466","Total",1215,552,663,1164,51,20,35.03,34.7
"2011","Northumberland 033F","E01033714","Total",2455,1191,1264,2391,64,50,2379.07,1.0
"2011","Northumberland 034A","E01027449","Total",1563,773,790,1563,0,25,1880.06,0.8
"2011","Northumberland 034B","E01027468","Total",1268,636,632,1268,0,42,82.37,15.4
"2011","Northumberland 034C","E01027469","Total",1464,743,721,1464,0,38,251.49,5.8
"2011","Northumberland 034D","E01027471","Total",1673,831,842,1673,0,52,990.43,1.7
"2011","Northumberland 034E","E01027472","Total",1740,929,811,1571,169,31,7516.19,0.2
"2011","Northumberland 019A","E01027479","Total",2312,1144,1168,2310,2,39,18445.59,0.1
"2011","Northumberland 019B","E01027480","Total",1219,601,618,1219,0,52,8724.22,0.1
"2011","Northumberland 019C","E01027503","Total",1762,891,871,1741,21,44,67283.52,0.0
"2011","Northumberland 019D","E01027511","Total",1105,557,548,1105,0,17,17262.58,0.1
"2011","Northumberland 037A","E01027484","Total",2270,1117,1153,2205,65,47,15936.37,0.1
"2011","Northumberland 037B","E01027485","Total",1492,728,764,1488,4,12,650.50,2.3
"2011","Northumberland 037C","E01027486","Total",1153,578,575,1148,5,15,77.80,14.8
"2011","Northumberland 037D","E01027487","Total",1146,552,594,1146,0,19,539.36,2.1
"2011","Northumberland 037E","E01027512","Total",1041,544,497,1041,0,19,21746.60,0.0
"2011","Northumberland 036A","E01027483","Total",1388,673,715,1268,120,38,4114.70,0.3
"2011","Northumberland 036B","E01027496","Total",1222,580,642,1222,0,21,226.19,5.4
"2011","Northumberland 036C","E01027508","Total",1086,517,569,1086,0,12,607.04,1.8
"2011","Northumberland 036D","E01027513","Total",1924,926,998,1891,33,43,391.99,4.9
"2011","Northumberland 035A","E01027476","Total",2311,1119,1192,2300,11,26,1240.25,1.9
"2011","Northumberland 035B","E01027489","Total",1605,784,821,1605,0,53,244.54,6.6
"2011","Northumberland 035C","E01027490","Total",1840,844,996,1807,33,38,46.52,39.6
"2011","Northumberland 035D","E01027491","Total",1608,775,833,1557,51,56,1404.65,1.1
"2011","Northumberland 035E","E01027492","Total",1873,902,971,1867,6,62,49.23,38.0
"2011","Northumberland 035F","E01027493","Total",1622,745,877,1464,158,9,47.94,33.8
"2011","Northumberland 035G","E01027494","Total",2238,1055,1183,2157,81,42,512.98,4.4
"2011","Northumberland 038A","E01027497","Total",2688,1322,1366,2688,0,30,270.43,9.9
"2011","Northumberland 038B","E01027498","Total",2653,1278,1375,2633,20,9,106.88,24.8
"2011","Northumberland 038C","E01027499","Total",1487,729,758,1465,22,18,409.20,3.6
"2011","Northumberland 038D","E01027500","Total",1689,791,898,1651,38,10,41.71,40.5
"2011","Northumberland 038E","E01027501","Total",1093,519,574,1093,0,8,29.51,37.0
"2011","Northumberland 038F","E01027502","Total",1243,603,640,1228,15,33,36.15,34.4
"2011","Northumberland 039A","E01027481","Total",1647,769,878,1604,43,36,2080.37,0.8
"2011","Northumberland 039B","E01027482","Total",1519,738,781,1515,4,25,84.56,18.0
"2011","Northumberland 039C","E01027504","Total",1991,953,1038,1831,160,73,3831.42,0.5
"2011","Northumberland 039D","E01027506","Total",1148,568,580,1132,16,25,10704.94,0.1
"2011","Northumberland 039E","E01027507","Total",1386,691,695,1386,0,47,1499.59,0.9
"2011","Northumberland 039F","E01027509","Total",1361,647,714,1340,21,36,237.71,5.7
"2011","Northumberland 040A","E01027477","Total",1223,615,608,1193,30,33,14709.73,0.1
"2011","Northumberland 040B","E01027478","Total",1077,518,559,1063,14,23,438.35,2.5
"2011","Northumberland 040C","E01027488","Total",2184,1076,1108,2154,30,52,7129.36,0.3
"2011","Northumberland 040D","E01027495","Total",1080,538,542,1075,5,29,3669.71,0.3
"2011","Northumberland 040E","E01027505","Total",1408,700,708,1348,60,46,12289.63,0.1
"2011","Northumberland 040F","E01027510","Total",1164,584,580,1161,3,19,3513.61,0.3
"2011","Northumberland 009A","E01027541","Total",1792,872,920,1744,48,8,73.30,24.4
"2011","Northumberland 009B","E01027542","Total",1811,831,980,1811,0,7,533.71,3.4
"2011","Northumberland 009C","E01027543","Total",1344,660,684,1344,0,6,229.65,5.9
"2011","Northumberland 009D","E01027544","Total",1361,671,690,1343,18,9,28.26,48.2
"2011","Northumberland 010A","E01027528","Total",1279,662,617,1279,0,7,30.80,41.5
"2011","Northumberland 010B","E01027529","Total",1153,606,547,1142,11,11,44.12,26.1
"2011","Northumberland 010C","E01027539","Total",1725,842,883,1672,53,4,23.56,73.2
"2011","Northumberland 010D","E01027545","Total",2049,969,1080,2049,0,9,30.04,68.2
"2011","Northumberland 010E","E01027546","Total",1734,849,885,1734,0,8,19.39,89.4
"2011","Northumberland 013A","E01027533","Total",1709,850,859,1709,0,5,34.33,49.8
"2011","Northumberland 013B","E01027540","Total",1899,896,1003,1859,40,7,442.17,4.3
"2011","Northumberland 013E","E01027549","Total",1573,801,772,1566,7,14,106.40,14.8
"2011","Northumberland 013F","E01033716","Total",2374,1185,1189,2374,0,15,126.05,18.8
"2011","Northumberland 012A","E01027524","Total",1469,691,778,1402,67,8,92.35,15.9
"2011","Northumberland 012B","E01027525","Total",1708,834,874,1670,38,14,1099.75,1.6
"2011","Northumberland 012C","E01027526","Total",1271,612,659,1271,0,19,37.98,33.5
"2011","Northumberland 012D","E01027527","Total",1317,614,703,1317,0,9,22.26,59.2
"2011","Northumberland 012E","E01027536","Total",1462,718,744,1462,0,36,36.44,40.1
"2011","Northumberland 014A","E01027532","Total",1890,939,951,1890,0,11,103.76,18.2
"2011","Northumberland 014B","E01027537","Total",1377,664,713,1377,0,3,23.64,58.2
"2011","Northumberland 014C","E01027538","Total",1800,874,926,1800,0,24,85.82,21.0
"2011","Northumberland 017A","E01027530","Total",1442,679,763,1442,0,8,83.54,17.3
"2011","Northumberland 017B","E01027531","Total",1700,836,864,1686,14,14,441.40,3.9
"2011","Northumberland 017C","E01027534","Total",1909,908,1001,1909,0,7,59.41,32.1
"2011","Northumberland 017D","E01027535","Total",1434,668,766,1434,0,16,50.71,28.3
"2011","Northumberland 017E","E01027553","Total",1643,786,857,1596,47,13,299.67,5.5
"2011","Northumberland 017F","E01027554","Total",1336,658,678,1336,0,8,38.78,34.5
"2011","Northumberland 020A","E01027515","Total",1433,692,741,1430,3,4,37.11,38.6
"2011","Northumberland 020B","E01027517","Total",1923,943,980,1890,33,9,147.87,13.0
"2011","Northumberland 020C","E01027518","Total",1469,706,763,1469,0,6,35.79,41.0
"2011","Northumberland 020D","E01027519","Total",1452,694,758,1429,23,6,29.81,48.7
"2011","Northumberland 020E","E01027550","Total",1288,625,663,1288,0,5,51.53,25.0
"2011","Northumberland 020F","E01027551","Total",1445,724,721,1437,8,15,36.23,39.9
"2011","Northumberland 020G","E01027552","Total",1265,640,625,1232,33,7,835.12,1.5
"2011","Northumberland 021A","E01027514","Total",1597,746,851,1591,6,17,317.23,5.0
"2011","Northumberland 021B","E01027516","Total",1264,605,659,1156,108,8,54.81,23.1
"2011","Northumberland 021C","E01027520","Total",1512,749,763,1512,0,18,75.91,19.9
"2011","Northumberland 021D","E01027521","Total",1708,858,850,1703,5,29,718.82,2.4
"2011","Northumberland 021E","E01027522","Total",1285,585,700,1285,0,5,90.40,14.2
"2011","Northumberland 021F","E01027523","Total",1152,559,593,1152,0,7,47.62,24.2
"2011","Redcar and Cleveland 001A","E01012100","Total",1603,871,732,1560,43,5,41.68,38.5
"2011","Redcar and Cleveland 001B","E01012101","Total",1511,753,758,1442,69,8,38.26,39.5
"2011","Redcar and Cleveland 001C","E01012102","Total",2212,1081,1131,2206,6,11,26.40,83.8
"2011","Redcar and Cleveland 001D","E01012184","Total",1484,754,730,1447,37,8,26.55,55.9
"2011","Redcar and Cleveland 002A","E01012105","Total",1375,682,693,1375,0,20,38.77,35.5
"2011","Redcar and Cleveland 002B","E01012142","Total",1694,821,873,1681,13,12,43.19,39.2
"2011","Redcar and Cleveland 002C","E01012143","Total",1278,607,671,1278,0,11,18.98,67.3
"2011","Redcar and Cleveland 002D","E01012144","Total",1387,681,706,1377,10,8,30.43,45.6
"2011","Redcar and Cleveland 003C","E01012106","Total",1369,685,684,1369,0,7,27.40,50.0
"2011","Redcar and Cleveland 003D","E01012107","Total",1404,669,735,1404,0,4,1788.49,0.8
"2011","Redcar and Cleveland 003E","E01032560","Total",1069,529,540,1060,9,10,1485.24,0.7
"2011","Redcar and Cleveland 003F","E01032561","Total",1538,705,833,1538,0,7,54.57,28.2
"2011","Redcar and Cleveland 004A","E01012176","Total",1432,691,741,1432,0,30,37.33,38.4
"2011","Redcar and Cleveland 004B","E01012177","Total",1486,733,753,1486,0,26,40.39,36.8
"2011","Redcar and Cleveland 004C","E01012178","Total",1424,664,760,1424,0,25,67.48,21.1
"2011","Redcar and Cleveland 004D","E01012179","Total",1482,690,792,1438,44,13,50.76,29.2
"2011","Redcar and Cleveland 004E","E01012180","Total",1792,897,895,1792,0,31,32.58,55.0
"2011","Redcar and Cleveland 004F","E01012185","Total",1465,686,779,1465,0,15,18.94,77.3
"2011","Redcar and Cleveland 004G","E01012186","Total",1642,804,838,1642,0,15,51.01,32.2
"2011","Redcar and Cleveland 005A","E01012127","Total",1042,479,563,1018,24,3,17.54,59.4
"2011","Redcar and Cleveland 005B","E01012128","Total",1119,519,600,1119,0,8,22.07,50.7
"2011","Redcar and Cleveland 005C","E01012129","Total",2185,1048,1137,2132,53,12,45.80,47.7
"2011","Redcar and Cleveland 005D","E01012130","Total",1284,611,673,1284,0,12,34.69,37.0
"2011","Redcar and Cleveland 005E","E01012131","Total",1415,656,759,1362,53,3,35.69,39.6
"2011","Redcar and Cleveland 006A","E01012138","Total",2691,1349,1342,2691,0,32,689.87,3.9
"2011","Redcar and Cleveland 006B","E01012139","Total",1942,970,972,1942,0,17,51.28,37.9
"2011","Redcar and Cleveland 006C","E01012140","Total",1329,630,699,1329,0,8,55.75,23.8
"2011","Redcar and Cleveland 006D","E01012141","Total",1099,547,552,1099,0,5,66.48,16.5
"2011","Redcar and Cleveland 006E","E01012154","Total",1271,611,660,1271,0,15,27.43,46.3
"2011","Redcar and Cleveland 006F","E01012155","Total",1472,695,777,1472,0,15,263.23,5.6
"2011","Redcar and Cleveland 006G","E01012156","Total",1738,835,903,1738,0,14,40.92,42.5
"2011","Redcar and Cleveland 006H","E01012157","Total",1634,779,855,1604,30,17,39.51,41.4
"2011","Redcar and Cleveland 007A","E01012158","Total",1412,672,740,1390,22,20,106.66,13.2
"2011","Redcar and Cleveland 007B","E01012159","Total",1611,855,756,1564,47,4,26.62,60.5
"2011","Redcar and Cleveland 007C","E01012160","Total",1434,660,774,1384,50,17,91.94,15.6
"2011","Redcar and Cleveland 007D","E01012161","Total",1501,685,816,1379,122,23,82.32,18.2
"2011","Redcar and Cleveland 009A","E01012113","Total",1429,643,786,1429,0,2,24.96,57.3
"2011","Redcar and Cleveland 009B","E01012114","Total",1396,678,718,1396,0,6,50.45,27.7
"2011","Redcar and Cleveland 009E","E01012175","Total",1426,688,738,1426,0,5,20.52,69.5
"2011","Redcar and Cleveland 009F","E01033471","Total",2263,1054,1209,2263,0,6,122.81,18.4
"2011","Redcar and Cleveland 010A","E01012095","Total",1353,675,678,1339,14,11,517.41,2.6
"2011","Redcar and Cleveland 010B","E01012097","Total",1180,587,593,1174,6,6,71.80,16.4
"2011","Redcar and Cleveland 010C","E01012098","Total",1302,629,673,1302,0,12,130.89,9.9
"2011","Redcar and Cleveland 010D","E01012099","Total",1559,778,781,1559,0,5,52.42,29.7
"2011","Redcar and Cleveland 011A","E01012108","Total",1462,683,779,1462,0,6,24.29,60.2
"2011","Redcar and Cleveland 011B","E01012109","Total",1396,667,729,1313,83,6,277.59,5.0
"2011","Redcar and Cleveland 011C","E01012110","Total",1393,711,682,1393,0,8,21.39,65.1
"2011","Redcar and Cleveland 011D","E01012111","Total",1288,601,687,1247,41,4,24.63,52.3
"2011","Redcar and Cleveland 011E","E01012171","Total",1435,669,766,1435,0,3,33.28,43.1
"2011","Redcar and Cleveland 011F","E01012172","Total",1383,676,707,1383,0,6,23.91,57.8
"2011","Redcar and Cleveland 012A","E01012162","Total",1464,724,740,1464,0,10,96.27,15.2
"2011","Redcar and Cleveland 012B","E01012163","Total",2181,1104,1077,2181,0,26,327.41,6.7
"2011","Redcar and Cleveland 012C","E01012164","Total",1594,763,831,1594,0,18,896.54,1.8
"2011","Redcar and Cleveland 012D","E01012165","Total",2215,1031,1184,2203,12,20,72.13,30.7
"2011","Redcar and Cleveland 013A","E01012096","Total",1606,831,775,1606,0,2,208.17,7.7
"2011","Redcar and Cleveland 013D","E01012136","Total",1426,712,714,1367,59,5,61.21,23.3
"2011","Redcar and Cleveland 013E","E01033473","Total",2145,1026,1119,2122,23,7,139.56,15.4
"2011","Redcar and Cleveland 015A","E01012112","Total",1466,741,725,1466,0,14,107.22,13.7
"2011","Redcar and Cleveland 015B","E01012145","Total",1472,710,762,1457,15,12,29.59,49.7
"2011","Redcar and Cleveland 015C","E01012147","Total",1595,785,810,1595,0,11,41.29,38.6
"2011","Redcar and Cleveland 015D","E01012149","Total",1203,597,606,1203,0,9,115.94,10.4
"2011","Redcar and Cleveland 016A","E01012132","Total",2022,1011,1011,2003,19,11,3085.55,0.7
"2011","Redcar and Cleveland 016B","E01012134","Total",1447,723,724,1447,0,13,1365.16,1.1
"2011","Redcar and Cleveland 016C","E01012137","Total",1364,696,668,1364,0,4,2379.28,0.6
"2011","Redcar and Cleveland 016D","E01012181","Total",1686,859,827,1679,7,8,866.41,1.9
"2011","Redcar and Cleveland 018A","E01012117","Total",1420,674,746,1358,62,11,61.31,23.2
"2011","Redcar and Cleveland 018B","E01012118","Total",1358,643,715,1358,0,11,16.55,82.1
"2011","Redcar and Cleveland 018C","E01012119","Total",2129,1022,1107,2096,33,25,1931.71,1.1
"2011","Redcar and Cleveland 018D","E01012121","Total",1354,675,679,1354,0,6,82.24,16.5
"2011","Redcar and Cleveland 019E","E01032548","Total",1566,752,814,1566,0,34,94.03,16.7
"2011","Redcar and Cleveland 019F","E01032549","Total",1664,791,873,1599,65,26,75.90,21.9
"2011","Redcar and Cleveland 019G","E01033472","Total",2528,1245,1283,2528,0,27,38.12,66.3
"2011","Redcar and Cleveland 020A","E01012120","Total",1361,646,715,1314,47,28,1199.90,1.1
"2011","Redcar and Cleveland 020B","E01012124","Total",1433,722,711,1432,1,31,1824.07,0.8
"2011","Redcar and Cleveland 020C","E01012182","Total",1423,694,729,1377,46,11,1104.80,1.3
"2011","Redcar and Cleveland 020D","E01012183","Total",1541,754,787,1541,0,26,237.68,6.5
"2011","Redcar and Cleveland 021A","E01012148","Total",1411,709,702,1411,0,7,33.67,41.9
"2011","Redcar and Cleveland 021B","E01012150","Total",1532,693,839,1532,0,12,51.12,30.0
"2011","Redcar and Cleveland 021C","E01012151","Total",1471,692,779,1471,0,9,121.02,12.2
"2011","Redcar and Cleveland 021D","E01012152","Total",1563,780,783,1563,0,10,93.10,16.8
"2011","Redcar and Cleveland 021E","E01032594","Total",1376,645,731,1376,0,14,95.31,14.4
"2011","Redcar and Cleveland 022A","E01012146","Total",1249,629,620,1243,6,14,43.81,28.5
"2011","Redcar and Cleveland 022B","E01012167","Total",1478,698,780,1478,0,11,110.38,13.4
"2011","Redcar and Cleveland 022C","E01012168","Total",1920,910,1010,1920,0,8,52.09,36.9
"2011","Redcar and Cleveland 022D","E01012170","Total",1377,645,732,1323,54,2,153.95,8.9
"2011","Redcar and Cleveland 022E","E01012173","Total",1163,567,596,1163,0,11,38.38,30.3
"2011","Redcar and Cleveland 022F","E01012174","Total",1110,515,595,1110,0,6,31.11,35.7
"2011","Redcar and Cleveland 022G","E01033470","Total",1773,898,875,1750,23,9,194.93,9.1
"2011","Stockton-on-Tees 001A","E01012242","Total",1519,758,761,1519,0,15,41.41,36.7
"2011","Stockton-on-Tees 001B","E01012243","Total",1606,746,860,1567,39,16,23.96,67.0
"2011","Stockton-on-Tees 001C","E01012244","Total",1445,700,745,1445,0,21,27.76,52.1
"2011","Stockton-on-Tees 001D","E01012246","Total",1451,736,715,1451,0,26,25.56,56.8
"2011","Stockton-on-Tees 001E","E01012296","Total",1367,666,701,1312,55,10,46.03,29.7
"2011","Stockton-on-Tees 001F","E01012297","Total",2644,1296,1348,2644,0,39,181.61,14.6
"2011","Stockton-on-Tees 002A","E01012197","Total",2029,943,1086,2027,2,11,38.83,52.3
"2011","Stockton-on-Tees 002B","E01012256","Total",1321,646,675,1321,0,15,31.29,42.2
"2011","Stockton-on-Tees 002C","E01012257","Total",1433,699,734,1433,0,9,24.60,58.3
"2011","Stockton-on-Tees 002D","E01012275","Total",1544,737,807,1544,0,6,31.07,49.7
"2011","Stockton-on-Tees 002E","E01012276","Total",1603,744,859,1603,0,11,50.87,31.5
"2011","Stockton-on-Tees 002F","E01012277","Total",1665,792,873,1653,12,9,34.00,49.0
"2011","Stockton-on-Tees 003A","E01012196","Total",1670,804,866,1670,0,12,37.85,44.1
"2011","Stockton-on-Tees 003B","E01012198","Total",1475,720,755,1475,0,9,2439.83,0.6
"2011","Stockton-on-Tees 003C","E01012214","Total",1654,796,858,1654,0,15,28.16,58.7
"2011","Stockton-on-Tees 003D","E01012215","Total",1307,625,682,1238,69,9,24.15,54.1
"2011","Stockton-on-Tees 003E","E01012216","Total",1302,625,677,1302,0,8,130.17,10.0
"2011","Stockton-on-Tees 003F","E01012245","Total",1605,756,849,1605,0,5,44.03,36.5
"2011","Stockton-on-Tees 004A","E01012278","Total",1335,674,661,1300,35,13,398.76,3.3
"2011","Stockton-on-Tees 004B","E01012279","Total",1776,867,909,1718,58,6,165.42,10.7
"2011","Stockton-on-Tees 004C","E01012280","Total",1569,773,796,1569,0,20,32.76,47.9
"2011","Stockton-on-Tees 004D","E01012281","Total",1309,627,682,1309,0,7,30.03,43.6
"2011","Stockton-on-Tees 005A","E01012255","Total",1423,696,727,1423,0,15,90.94,15.6
"2011","Stockton-on-Tees 005B","E01012269","Total",1673,822,851,1621,52,23,3814.04,0.4
"2011","Stockton-on-Tees 005D","E01012294","Total",1209,594,615,1175,34,28,1011.44,1.2
"2011","Stockton-on-Tees 005E","E01012295","Total",1210,588,622,1210,0,8,560.37,2.2
"2011","Stockton-on-Tees 005F","E01033476","Total",1639,806,833,1639,0,43,365.96,4.5
"2011","Stockton-on-Tees 005G","E01033480","Total",1639,804,835,1636,3,40,2187.41,0.7
"2011","Stockton-on-Tees 006A","E01012210","Total",1584,783,801,1584,0,21,76.16,20.8
"2011","Stockton-on-Tees 006B","E01012211","Total",1840,891,949,1840,0,29,93.26,19.7
"2011","Stockton-on-Tees 006C","E01012212","Total",1469,737,732,1469,0,22,48.82,30.1
"2011","Stockton-on-Tees 006D","E01012213","Total",1393,616,777,1393,0,9,29.21,47.7
"2011","Stockton-on-Tees 007A","E01012192","Total",1583,787,796,1583,0,13,29.88,53.0
"2011","Stockton-on-Tees 007B","E01012193","Total",1556,781,775,1538,18,12,27.85,55.9
"2011","Stockton-on-Tees 007C","E01012260","Total",1653,806,847,1651,2,24,56.39,29.3
"2011","Stockton-on-Tees 007D","E01012261","Total",1509,774,735,1509,0,10,67.41,22.4
"2011","Stockton-on-Tees 008A","E01012247","Total",1277,599,678,1277,0,4,24.60,51.9
"2011","Stockton-on-Tees 008B","E01012249","Total",1580,767,813,1554,26,5,60.63,26.1
"2011","Stockton-on-Tees 008C","E01012271","Total",1496,704,792,1496,0,7,41.68,35.9
"2011","Stockton-on-Tees 008D","E01012272","Total",1065,524,541,1065,0,4,21.09,50.5
"2011","Stockton-on-Tees 008E","E01012273","Total",1582,768,814,1582,0,6,23.90,66.2
"2011","Stockton-on-Tees 008F","E01012274","Total",1341,641,700,1340,1,3,28.60,46.9
"2011","Stockton-on-Tees 009D","E01012248","Total",1428,679,749,1428,0,9,45.85,31.1
"2011","Stockton-on-Tees 009E","E01012250","Total",1461,710,751,1427,34,5,83.24,17.6
"2011","Stockton-on-Tees 009F","E01032542","Total",1120,530,590,1120,0,9,20.49,54.7
"2011","Stockton-on-Tees 009G","E01032543","Total",2213,1025,1188,2213,0,6,29.35,75.4
"2011","Stockton-on-Tees 009H","E01032544","Total",2033,973,1060,1981,52,11,60.75,33.5
"2011","Stockton-on-Tees 010A","E01012194","Total",1539,762,777,1491,48,9,31.49,48.9
"2011","Stockton-on-Tees 010B","E01012195","Total",1563,741,822,1563,0,8,27.71,56.4
"2011","Stockton-on-Tees 010C","E01012258","Total",2054,1425,629,1116,938,7,165.19,12.4
"2011","Stockton-on-Tees 010D","E01012259","Total",1776,876,900,1771,5,11,27.40,64.8
"2011","Stockton-on-Tees 010E","E01012268","Total",1662,858,804,1601,61,8,42.25,39.3
"2011","Stockton-on-Tees 011A","E01012187","Total",1390,697,693,1387,3,11,88.69,15.7
"2011","Stockton-on-Tees 011B","E01012188","Total",1205,596,609,1205,0,13,99.57,12.1
"2011","Stockton-on-Tees 011C","E01012189","Total",1398,676,722,1398,0,13,23.57,59.3
"2011","Stockton-on-Tees 011D","E01012205","Total",1402,672,730,1402,0,16,26.74,52.4
"2011","Stockton-on-Tees 012A","E01012219","Total",1775,878,897,1775,0,23,52.30,33.9
"2011","Stockton-on-Tees 012B","E01012251","Total",1665,827,838,1663,2,8,21.29,78.2
"2011","Stockton-on-Tees 012C","E01012252","Total",1550,719,831,1539,11,5,44.60,34.8
"2011","Stockton-on-Tees 012D","E01012253","Total",1310,641,669,1262,48,12,33.15,39.5
"2011","Stockton-on-Tees 012E","E01012254","Total",1439,726,713,1439,0,7,46.47,31.0
"2011","Stockton-on-Tees 013A","E01012204","Total",1303,609,694,1303,0,14,42.08,31.0
"2011","Stockton-on-Tees 013B","E01012206","Total",1460,679,781,1458,2,8,34.43,42.4
"2011","Stockton-on-Tees 013C","E01012207","Total",1932,958,974,1911,21,28,80.45,24.0
"2011","Stockton-on-Tees 013D","E01012208","Total",1648,799,849,1648,0,25,32.45,50.8
"2011","Stockton-on-Tees 014A","E01012262","Total",2224,1133,1091,1883,341,21,52.44,42.4
"2011","Stockton-on-Tees 014C","E01012264","Total",2384,1198,1186,2355,29,14,392.78,6.1
"2011","Stockton-on-Tees 014E","E01012266","Total",2435,1180,1255,2290,145,16,273.27,8.9
"2011","Stockton-on-Tees 014F","E01012267","Total",1672,820,852,1669,3,6,32.95,50.7
"2011","Stockton-on-Tees 014G","E01033477","Total",2518,1421,1097,2438,80,33,52.21,48.2
"2011","Stockton-on-Tees 015A","E01012190","Total",1493,730,763,1493,0,14,39.04,38.2
"2011","Stockton-on-Tees 015B","E01012191","Total",1658,731,927,1576,82,18,31.60,52.5
"2011","Stockton-on-Tees 015C","E01012224","Total",1781,848,933,1781,0,12,33.47,53.2
"2011","Stockton-on-Tees 015D","E01012225","Total",1531,727,804,1531,0,24,222.62,6.9
"2011","Stockton-on-Tees 015E","E01012226","Total",1381,676,705,1381,0,10,39.03,35.4
"2011","Stockton-on-Tees 016A","E01012209","Total",1709,827,882,1690,19,26,35.50,48.1
"2011","Stockton-on-Tees 016B","E01012217","Total",1546,781,765,1513,33,7,20.27,76.3
"2011","Stockton-on-Tees 016C","E01012218","Total",1579,765,814,1565,14,30,59.41,26.6
"2011","Stockton-on-Tees 016D","E01012223","Total",1564,753,811,1528,36,27,152.88,10.2
"2011","Stockton-on-Tees 017A","E01012286","Total",1443,690,753,1443,0,9,79.50,18.2
"2011","Stockton-on-Tees 017B","E01012287","Total",2332,1180,1152,1734,598,42,86.92,26.8
"2011","Stockton-on-Tees 017C","E01012288","Total",1473,711,762,1473,0,15,13.57,108.5
"2011","Stockton-on-Tees 017D","E01012289","Total",1283,634,649,1245,38,8,161.59,7.9
"2011","Stockton-on-Tees 018A","E01012238","Total",1545,745,800,1545,0,8,37.54,41.2
"2011","Stockton-on-Tees 018B","E01012239","Total",1994,1002,992,1994,0,12,39.71,50.2
"2011","Stockton-on-Tees 018C","E01012240","Total",1786,863,923,1786,0,12,47.92,37.3
"2011","Stockton-on-Tees 018D","E01012241","Total",1489,722,767,1489,0,11,41.95,35.5
"2011","Stockton-on-Tees 019A","E01012290","Total",1759,845,914,1759,0,18,63.72,27.6
"2011","Stockton-on-Tees 019B","E01012291","Total",1816,893,923,1772,44,11,49.15,36.9
"2011","Stockton-on-Tees 019C","E01012292","Total",2316,1133,1183,2316,0,12,37.75,61.4
"2011","Stockton-on-Tees 020A","E01012282","Total",1299,616,683,1299,0,4,112.92,11.5
"2011","Stockton-on-Tees 020B","E01012283","Total",1328,633,695,1328,0,5,93.93,14.1
"2011","Stockton-on-Tees 020C","E01012284","Total",1553,702,851,1482,71,3,49.89,31.1
"2011","Stockton-on-Tees 020D","E01012285","Total",1325,641,684,1317,8,11,57.57,23.0
"2011","Stockton-on-Tees 021A","E01012199","Total",1446,701,745,1446,0,25,202.39,7.1
"2011","Stockton-on-Tees 021B","E01012200","Total",2005,971,1034,2005,0,38,86.45,23.2
"2011","Stockton-on-Tees 021C","E01012201","Total",1803,876,927,1795,8,18,96.55,18.7
"2011","Stockton-on-Tees 021D","E01012202","Total",1508,709,799,1423,85,27,44.01,34.3
"2011","Stockton-on-Tees 021E","E01012203","Total",1797,898,899,1797,0,34,187.33,9.6
"2011","Stockton-on-Tees 021F","E01012270","Total",1369,658,711,1361,8,31,80.21,17.1
"2011","Stockton-on-Tees 022A","E01012228","Total",1421,716,705,1421,0,25,30.38,46.8
"2011","Stockton-on-Tees 022B","E01012230","Total",1588,802,786,1588,0,29,32.23,49.3
"2011","Stockton-on-Tees 022C","E01012233","Total",1437,708,729,1437,0,29,1192.99,1.2
"2011","Stockton-on-Tees 022D","E01012236","Total",1351,684,667,1351,0,17,47.87,28.2
"2011","Stockton-on-Tees 022E","E01012237","Total",1363,693,670,1363,0,35,35.58,38.3
"2011","Stockton-on-Tees 023A","E01012227","Total",1559,748,811,1546,13,14,37.94,41.1
"2011","Stockton-on-Tees 023C","E01012231","Total",2022,992,1030,2022,0,13,50.40,40.1
"2011","Stockton-on-Tees 023D","E01012232","Total",1431,713,718,1431,0,30,21.74,65.8
"2011","Stockton-on-Tees 023E","E01012234","Total",1694,827,867,1694,0,21,44.78,37.8
"2011","Stockton-on-Tees 023F","E01033474","Total",1645,789,856,1608,37,4,46.14,35.7
"2011","Stockton-on-Tees 023G","E01033475","Total",1840,925,915,1840,0,29,52.71,34.9
"2011","Stockton-on-Tees 023H","E01033478","Total",1891,957,934,1891,0,45,139.95,13.5
"2011","Stockton-on-Tees 023I","E01033479","Total",1803,907,896,1803,0,24,37.09,48.6
"2011","Stockton-on-Tees 024A","E01012235","Total",1361,817,544,1099,262,28,1323.18,1.0
"2011","Stockton-on-Tees 024B","E01012298","Total",1393,705,688,1393,0,45,57.73,24.1
"2011","Stockton-on-Tees 024C","E01012299","Total",1481,773,708,1481,0,30,66.45,22.3
"2011","Stockton-on-Tees 024D","E01012300","Total",1516,663,853,1516,0,13,41.58,36.5
"2011","Stockton-on-Tees 024E","E01012301","Total",1368,684,684,1368,0,26,101.51,13.5
"2011","Stockton-on-Tees 024F","E01012302","Total",1245,610,635,1179,66,19,39.11,31.8
"2011","Stockton-on-Tees 024G","E01012303","Total",1381,682,699,1381,0,19,178.36,7.7
"2011","Gateshead 001A","E01008246","Total",1458,712,746,1458,0,14,26.00,56.1
"2011","Gateshead 001B","E01008247","Total",1616,757,859,1616,0,14,71.92,22.5
"2011","Gateshead 001C","E01008248","Total",1752,888,864,1751,1,14,524.21,3.3
"2011","Gateshead 001D","E01008249","Total",1554,739,815,1525,29,19,135.25,11.5
"2011","Gateshead 001E","E01008250","Total",1473,704,769,1469,4,17,44.59,33.0
"2011","Gateshead 002A","E01008195","Total",2065,1000,1065,2065,0,9,219.29,9.4
"2011","Gateshead 002B","E01008197","Total",1486,735,751,1486,0,9,124.91,11.9
"2011","Gateshead 002C","E01008198","Total",1431,676,755,1387,44,1,46.33,30.9
"2011","Gateshead 002D","E01008199","Total",1379,635,744,1323,56,18,23.57,58.5
"2011","Gateshead 002E","E01008200","Total",1336,649,687,1336,0,22,768.03,1.7
"2011","Gateshead 002F","E01008245","Total",1437,697,740,1437,0,23,118.44,12.1
"2011","Gateshead 003A","E01008214","Total",1680,769,911,1638,42,10,69.16,24.3
"2011","Gateshead 003B","E01008215","Total",1598,829,769,1586,12,6,111.78,14.3
"2011","Gateshead 003C","E01008243","Total",1525,720,805,1525,0,10,100.59,15.2
"2011","Gateshead 003D","E01008244","Total",2064,1018,1046,2064,0,8,90.36,22.8
"2011","Gateshead 004A","E01008178","Total",1710,818,892,1706,4,8,29.14,58.7
"2011","Gateshead 004B","E01008180","Total",1519,709,810,1519,0,2,24.10,63.0
"2011","Gateshead 004C","E01008182","Total",1641,805,836,1636,5,8,32.22,50.9
"2011","Gateshead 004D","E01008277","Total",1531,747,784,1531,0,10,44.26,34.6
"2011","Gateshead 004E","E01008280","Total",1855,884,971,1855,0,5,53.35,34.8
"2011","Gateshead 005A","E01008177","Total",1468,669,799,1364,104,10,48.84,30.1
"2011","Gateshead 005B","E01008179","Total",1224,593,631,1224,0,8,36.26,33.8
"2011","Gateshead 005C","E01008181","Total",1477,703,774,1477,0,13,304.91,4.8
"2011","Gateshead 005D","E01008276","Total",1459,688,771,1459,0,10,136.11,10.7
"2011","Gateshead 005E","E01008279","Total",1471,718,753,1425,46,11,36.97,39.8
"2011","Gateshead 007A","E01008209","Total",2088,1028,1060,2088,0,4,108.76,19.2
"2011","Gateshead 007B","E01008210","Total",1399,676,723,1370,29,3,30.33,46.1
"2011","Gateshead 007C","E01008258","Total",2320,1177,1143,2320,0,8,60.68,38.2
"2011","Gateshead 007D","E01008259","Total",1919,1050,869,1894,25,8,293.87,6.5
"2011","Gateshead 008A","E01008167","Total",1668,864,804,1601,67,9,18.86,88.4
"2011","Gateshead 008B","E01008169","Total",1646,869,777,1593,53,53,11.43,144.0
"2011","Gateshead 008C","E01008170","Total",2008,1029,979,1980,28,10,34.10,58.9
"2011","Gateshead 008D","E01008171","Total",1479,908,571,1172,307,8,12.09,122.3
"2011","Gateshead 008E","E01008257","Total",1442,689,753,1372,70,2,36.96,39.0
"2011","Gateshead 009A","E01008262","Total",1783,903,880,1724,59,15,182.40,9.8
"2011","Gateshead 009B","E01008263","Total",1532,732,800,1523,9,3,26.82,57.1
"2011","Gateshead 009C","E01008264","Total",1419,707,712,1419,0,14,41.41,34.3
"2011","Gateshead 009D","E01008265","Total",1479,732,747,1479,0,8,28.08,52.7
"2011","Gateshead 009E","E01008266","Total",1366,661,705,1366,0,15,85.70,15.9
"2011","Gateshead 010A","E01008251","Total",1756,906,850,1748,8,5,15.77,111.4
"2011","Gateshead 010B","E01008252","Total",1765,884,881,1749,16,21,18.78,94.0
"2011","Gateshead 010C","E01008253","Total",1713,875,838,1713,0,8,12.37,138.5
"2011","Gateshead 010D","E01008254","Total",1352,679,673,1352,0,4,14.86,91.0
"2011","Gateshead 010E","E01008255","Total",1741,858,883,1706,35,4,83.18,20.9
"2011","Gateshead 011A","E01008165","Total",1399,695,704,1399,0,3,31.93,43.8
"2011","Gateshead 011B","E01008201","Total",1596,756,840,1596,0,10,32.22,49.5
"2011","Gateshead 011C","E01008202","Total",1869,885,984,1869,0,5,29.10,64.2
"2011","Gateshead 011D","E01008204","Total",1550,749,801,1550,0,5,26.16,59.3
"2011","Gateshead 012A","E01008212","Total",1381,698,683,1381,0,8,31.67,43.6
"2011","Gateshead 012B","E01008213","Total",1483,707,776,1483,0,6,26.45,56.1
"2011","Gateshead 012C","E01008216","Total",1556,757,799,1515,41,4,32.67,47.6
"2011","Gateshead 012D","E01008228","Total",1193,565,628,1191,2,2,17.92,66.6
"2011","Gateshead 013A","E01008206","Total",1748,851,897,1748,0,11,46.32,37.7
"2011","Gateshead 013B","E01008207","Total",1457,720,737,1457,0,9,51.86,28.1
"2011","Gateshead 013C","E01008208","Total",1650,791,859,1647,3,14,105.00,15.7
"2011","Gateshead 013D","E01008211","Total",1710,834,876,1710,0,7,35.31,48.4
"2011","Gateshead 014A","E01008283","Total",1311,658,653,1311,0,7,255.35,5.1
"2011","Gateshead 014B","E01008284","Total",1471,742,729,1471,0,8,25.37,58.0
"2011","Gateshead 014C","E01008286","Total",1492,709,783,1492,0,6,55.80,26.7
"2011","Gateshead 014D","E01008287","Total",2071,1019,1052,2071,0,19,47.95,43.2
"2011","Gateshead 015A","E01008231","Total",1590,757,833,1590,0,5,40.06,39.7
"2011","Gateshead 015B","E01008240","Total",1514,721,793,1514,0,12,34.16,44.3
"2011","Gateshead 015C","E01008241","Total",1637,766,871,1637,0,3,61.14,26.8
"2011","Gateshead 015D","E01008242","Total",1670,791,879,1670,0,4,31.46,53.1
"2011","Gateshead 015E","E01008281","Total",1501,699,802,1501,0,1,42.01,35.7
"2011","Gateshead 015F","E01008282","Total",1487,719,768,1487,0,6,19.03,78.1
"2011","Gateshead 016A","E01008219","Total",1735,830,905,1661,74,15,37.11,46.8
"2011","Gateshead 016B","E01008235","Total",1466,709,757,1466,0,10,28.95,50.6
"2011","Gateshead 016C","E01008236","Total",1513,714,799,1476,37,9,29.94,50.5
"2011","Gateshead 016D","E01008237","Total",1554,762,792,1554,0,23,28.61,54.3
"2011","Gateshead 016E","E01008238","Total",1555,765,790,1552,3,16,18.75,82.9
"2011","Gateshead 017A","E01008267","Total",1538,764,774,1469,69,16,61.20,25.1
"2011","Gateshead 017B","E01008269","Total",1489,715,774,1489,0,14,31.08,47.9
"2011","Gateshead 017C","E01008270","Total",1330,651,679,1330,0,16,33.07,40.2
"2011","Gateshead 017D","E01008271","Total",1410,701,709,1410,0,19,30.65,46.0
"2011","Gateshead 017E","E01008275","Total",1505,728,777,1505,0,15,41.35,36.4
"2011","Gateshead 018A","E01008229","Total",1380,678,702,1365,15,3,60.18,22.9
"2011","Gateshead 018B","E01008230","Total",1399,666,733,1376,23,6,41.79,33.5
"2011","Gateshead 018C","E01008232","Total",1388,675,713,1388,0,7,26.01,53.4
"2011","Gateshead 018D","E01008233","Total",1374,688,686,1374,0,11,45.07,30.5
"2011","Gateshead 018E","E01008285","Total",1439,687,752,1439,0,6,37.97,37.9
"2011","Gateshead 019A","E01008256","Total",1771,845,926,1771,0,7,39.04,45.4
"2011","Gateshead 019B","E01008260","Total",1554,761,793,1532,22,16,71.84,21.6
"2011","Gateshead 019C","E01008261","Total",1460,688,772,1460,0,2,24.13,60.5
"2011","Gateshead 019D","E01008268","Total",1477,713,764,1477,0,18,166.15,8.9
"2011","Gateshead 019E","E01008272","Total",1417,669,748,1414,3,21,275.81,5.1
"2011","Gateshead 019F","E01008273","Total",1473,735,738,1473,0,10,1052.80,1.4
"2011","Gateshead 019G","E01008274","Total",1454,679,775,1452,2,13,24.52,59.3
"2011","Gateshead 020A","E01008193","Total",1283,588,695,1175,108,14,26.36,48.7
"2011","Gateshead 020B","E01008194","Total",1390,680,710,1390,0,14,32.04,43.4
"2011","Gateshead 020C","E01008234","Total",2123,1056,1067,2097,26,11,57.21,37.1
"2011","Gateshead 020D","E01008239","Total",1524,746,778,1490,34,23,39.52,38.6
"2011","Gateshead 021A","E01008218","Total",1639,802,837,1600,39,6,40.34,40.6
"2011","Gateshead 021B","E01008220","Total",1284,635,649,1284,0,8,23.94,53.6
"2011","Gateshead 021C","E01008221","Total",1735,835,900,1730,5,7,43.76,39.6
"2011","Gateshead 021D","E01008225","Total",1691,832,859,1691,0,8,52.40,32.3
"2011","Gateshead 021E","E01008227","Total",1706,795,911,1692,14,8,32.26,52.9
"2011","Gateshead 022A","E01008184","Total",1409,679,730,1406,3,12,123.38,11.4
"2011","Gateshead 022B","E01008185","Total",1411,660,751,1411,0,9,36.40,38.8
"2011","Gateshead 022C","E01008188","Total",1458,696,762,1458,0,31,283.75,5.1
"2011","Gateshead 022D","E01008278","Total",1424,707,717,1424,0,22,564.54,2.5
"2011","Gateshead 023A","E01008189","Total",1381,679,702,1381,0,2,17.73,77.9
"2011","Gateshead 023B","E01008190","Total",1295,611,684,1295,0,7,30.28,42.8
"2011","Gateshead 023C","E01008191","Total",1484,728,756,1484,0,5,18.56,80.0
"2011","Gateshead 023D","E01008192","Total",1433,709,724,1433,0,6,22.04,65.0
"2011","Gateshead 023E","E01008217","Total",1563,727,836,1557,6,4,64.51,24.2
"2011","Gateshead 024A","E01008183","Total",1478,690,788,1478,0,12,1001.19,1.5
"2011","Gateshead 024B","E01008186","Total",1965,1000,965,1965,0,19,133.67,14.7
"2011","Gateshead 024C","E01008187","Total",1674,805,869,1674,0,18,393.99,4.2
"2011","Gateshead 024D","E01008196","Total",1928,924,1004,1862,66,15,386.58,5.0
"2011","Gateshead 025A","E01008222","Total",1521,715,806,1521,0,4,33.34,45.6
"2011","Gateshead 025B","E01008223","Total",1782,835,947,1782,0,9,74.31,24.0
"2011","Gateshead 025C","E01008224","Total",1852,899,953,1817,35,19,337.53,5.5
"2011","Gateshead 025D","E01008226","Total",1498,734,764,1477,21,10,2017.06,0.7
"2011","Gateshead 026A","E01008172","Total",1703,814,889,1703,0,3,61.12,27.9
"2011","Gateshead 026B","E01008173","Total",1606,769,837,1557,49,6,37.33,43.0
"2011","Gateshead 026C","E01008174","Total",2087,989,1098,2084,3,15,151.68,13.8
"2011","Gateshead 026D","E01008175","Total",1475,708,767,1408,67,14,67.82,21.7
"2011","Gateshead 026E","E01008176","Total",1496,765,731,1496,0,9,63.27,23.6
"2011","Gateshead 027A","E01008162","Total",2377,1248,1129,2377,0,5,48.09,49.4
"2011","Gateshead 027B","E01008164","Total",1313,684,629,1239,74,12,22.00,59.7
"2011","Gateshead 027C","E01008166","Total",1559,946,613,1559,0,4,144.20,10.8
"2011","Gateshead 027D","E01008168","Total",2238,1093,1145,1911,327,8,62.90,35.6
"2011","Gateshead 028A","E01008163","Total",2000,1018,982,1818,182,20,29.45,67.9
"2011","Gateshead 028B","E01008203","Total",1779,918,861,1733,46,11,17.19,103.5
"2011","Gateshead 028C","E01008205","Total",1549,754,795,1513,36,13,21.00,73.8
"2011","Newcastle upon Tyne 001A","E01008294","Total",1517,731,786,1488,29,15,37.28,40.7
"2011","Newcastle upon Tyne 001B","E01008306","Total",1636,803,833,1636,0,17,1263.37,1.3
"2011","Newcastle upon Tyne 001C","E01008307","Total",1029,455,574,1007,22,4,361.84,2.8
"2011","Newcastle upon Tyne 001D","E01008308","Total",1395,686,709,1395,0,10,404.63,3.4
"2011","Newcastle upon Tyne 001E","E01008311","Total",1677,850,827,1677,0,13,59.87,28.0
"2011","Newcastle upon Tyne 001F","E01008312","Total",1264,598,666,1264,0,11,26.61,47.5
"2011","Newcastle upon Tyne 001G","E01008313","Total",1217,606,611,1217,0,21,24.67,49.3
"2011","Newcastle upon Tyne 002A","E01008309","Total",1829,884,945,1802,27,34,37.55,48.7
"2011","Newcastle upon Tyne 002C","E01008352","Total",1484,728,756,1484,0,18,98.57,15.1
"2011","Newcastle upon Tyne 002D","E01008357","Total",1637,797,840,1637,0,57,71.09,23.0
"2011","Newcastle upon Tyne 002E","E01008358","Total",1477,676,801,1477,0,13,66.43,22.2
"2011","Newcastle upon Tyne 002F","E01033550","Total",2056,1027,1029,2056,0,33,66.77,30.8
"2011","Newcastle upon Tyne 002G","E01033551","Total",1754,870,884,1751,3,39,465.99,3.8
"2011","Newcastle upon Tyne 003A","E01008336","Total",1366,658,708,1366,0,2,27.84,49.1
"2011","Newcastle upon Tyne 003B","E01008337","Total",1445,719,726,1406,39,3,23.31,62.0
"2011","Newcastle upon Tyne 003C","E01008338","Total",1259,613,646,1259,0,4,32.55,38.7
"2011","Newcastle upon Tyne 003D","E01008339","Total",1457,722,735,1443,14,10,36.97,39.4
"2011","Newcastle upon Tyne 003E","E01008340","Total",1488,728,760,1477,11,7,22.67,65.6
"2011","Newcastle upon Tyne 003F","E01008341","Total",1423,672,751,1387,36,1,21.16,67.2
"2011","Newcastle upon Tyne 003G","E01008342","Total",1388,669,719,1388,0,4,34.32,40.4
"2011","Newcastle upon Tyne 004A","E01008293","Total",1447,747,700,1446,1,17,67.71,21.4
"2011","Newcastle upon Tyne 004B","E01008456","Total",1498,707,791,1498,0,6,27.84,53.8
"2011","Newcastle upon Tyne 004C","E01008457","Total",1565,749,816,1522,43,6,42.31,37.0
"2011","Newcastle upon Tyne 004D","E01008458","Total",1661,788,873,1628,33,23,1560.00,1.1
"2011","Newcastle upon Tyne 004E","E01008459","Total",1982,925,1057,1915,67,4,32.45,61.1
"2011","Newcastle upon Tyne 004F","E01008460","Total",1550,738,812,1550,0,5,57.22,27.1
"2011","Newcastle upon Tyne 005A","E01008351","Total",1469,701,768,1419,50,21,52.52,28.0
"2011","Newcastle upon Tyne 005B","E01008354","Total",1708,852,856,1708,0,13,30.65,55.7
"2011","Newcastle upon Tyne 005C","E01008418","Total",2011,1016,995,1978,33,54,36.53,55.1
"2011","Newcastle upon Tyne 005D","E01008420","Total",1347,663,684,1305,42,46,25.87,52.1
"2011","Newcastle upon Tyne 005E","E01008422","Total",1646,810,836,1613,33,22,39.29,41.9
"2011","Newcastle upon Tyne 005F","E01008424","Total",1743,896,847,1565,178,15,20.36,85.6
"2011","Newcastle upon Tyne 006A","E01008353","Total",1533,712,821,1533,0,7,31.26,49.0
"2011","Newcastle upon Tyne 006B","E01008355","Total",1554,733,821,1544,10,27,31.55,49.3
"2011","Newcastle upon Tyne 006C","E01008356","Total",1523,852,671,1377,146,45,38.35,39.7
"2011","Newcastle upon Tyne 006D","E01008378","Total",1452,691,761,1452,0,39,31.99,45.4
"2011","Newcastle upon Tyne 006E","E01008419","Total",1521,741,780,1493,28,56,32.13,47.3
"2011","Newcastle upon Tyne 006F","E01008421","Total",1521,729,792,1521,0,24,22.15,68.7
"2011","Newcastle upon Tyne 006G","E01008423","Total",1388,679,709,1346,42,58,50.84,27.3
"2011","Newcastle upon Tyne 007A","E01008317","Total",1529,748,781,1528,1,32,47.49,32.2
"2011","Newcastle upon Tyne 007B","E01008319","Total",1870,949,921,1870,0,41,66.57,28.1
"2011","Newcastle upon Tyne 007C","E01008320","Total",1462,720,742,1462,0,12,40.79,35.8
"2011","Newcastle upon Tyne 007D","E01008321","Total",1756,833,923,1689,67,36,83.69,21.0
"2011","Newcastle upon Tyne 007E","E01008322","Total",1530,787,743,1528,2,24,29.59,51.7
"2011","Newcastle upon Tyne 007F","E01008323","Total",1670,796,874,1449,221,18,32.51,51.4
"2011","Newcastle upon Tyne 008A","E01008295","Total",1588,737,851,1588,0,1,60.41,26.3
"2011","Newcastle upon Tyne 008B","E01008374","Total",1580,781,799,1580,0,20,25.64,61.6
"2011","Newcastle upon Tyne 008C","E01008375","Total",1514,746,768,1514,0,7,43.12,35.1
"2011","Newcastle upon Tyne 008D","E01008376","Total",1197,588,609,1197,0,29,19.79,60.5
"2011","Newcastle upon Tyne 008E","E01008377","Total",2215,1088,1127,2163,52,7,36.25,61.1
"2011","Newcastle upon Tyne 008F","E01008379","Total",1527,759,768,1527,0,23,92.16,16.6
"2011","Newcastle upon Tyne 008G","E01008380","Total",1702,878,824,1702,0,13,69.78,24.4
"2011","Newcastle upon Tyne 011A","E01008296","Total",1409,659,750,1409,0,3,34.73,40.6
"2011","Newcastle upon Tyne 011B","E01008297","Total",1397,696,701,1380,17,1,35.13,39.8
"2011","Newcastle upon Tyne 011C","E01008298","Total",1507,734,773,1507,0,7,34.61,43.5
"2011","Newcastle upon Tyne 011D","E01008299","Total",1342,648,694,1342,0,1,27.00,49.7
"2011","Newcastle upon Tyne 012A","E01008314","Total",1495,741,754,1077,418,18,44.27,33.8
"2011","Newcastle upon Tyne 012B","E01008315","Total",1556,745,811,1556,0,19,42.58,36.5
"2011","Newcastle upon Tyne 012C","E01008316","Total",1609,815,794,1609,0,11,23.11,69.6
"2011","Newcastle upon Tyne 012D","E01008318","Total",1405,697,708,1405,0,8,18.84,74.6
"2011","Newcastle upon Tyne 012E","E01008363","Total",1595,767,828,1595,0,6,43.81,36.4
"2011","Newcastle upon Tyne 012F","E01008365","Total",1679,856,823,1679,0,35,26.87,62.5
"2011","Newcastle upon Tyne 013A","E01008366","Total",2081,1072,1009,2077,4,27,19.74,105.4
"2011","Newcastle upon Tyne 013B","E01008369","Total",1997,1125,872,1977,20,34,43.61,45.8
"2011","Newcastle upon Tyne 013C","E01008371","Total",1365,662,703,1365,0,58,45.71,29.9
"2011","Newcastle upon Tyne 013D","E01008372","Total",1935,1063,872,1902,33,24,12.81,151.1
"2011","Newcastle upon Tyne 013E","E01008373","Total",2348,1210,1138,2348,0,24,10.52,223.2
"2011","Newcastle upon Tyne 014A","E01008400","Total",1317,614,703,1317,0,6,186.57,7.1
"2011","Newcastle upon Tyne 014B","E01008401","Total",1514,733,781,1441,73,4,38.99,38.8
"2011","Newcastle upon Tyne 014C","E01008402","Total",1476,726,750,1476,0,11,212.43,6.9
"2011","Newcastle upon Tyne 014D","E01008403","Total",1457,705,752,1440,17,11,96.45,15.1
"2011","Newcastle upon Tyne 014E","E01008404","Total",1647,790,857,1647,0,2,63.91,25.8
"2011","Newcastle upon Tyne 014F","E01008405","Total",1417,698,719,1417,0,3,80.53,17.6
"2011","Newcastle upon Tyne 014G","E01008443","Total",1433,698,735,1433,0,11,280.61,5.1
"2011","Newcastle upon Tyne 015A","E01008324","Total",1350,646,704,1322,28,8,22.33,60.5
"2011","Newcastle upon Tyne 015B","E01008325","Total",1420,667,753,1420,0,3,44.90,31.6
"2011","Newcastle upon Tyne 015C","E01008326","Total",1488,702,786,1444,44,8,27.19,54.7
"2011","Newcastle upon Tyne 015D","E01008327","Total",1295,635,660,1295,0,4,28.91,44.8
"2011","Newcastle upon Tyne 015E","E01008328","Total",1267,610,657,1267,0,15,39.81,31.8
"2011","Newcastle upon Tyne 015F","E01008329","Total",1462,704,758,1462,0,10,27.62,52.9
"2011","Newcastle upon Tyne 015G","E01008330","Total",1385,618,767,1385,0,3,22.22,62.3
"2011","Newcastle upon Tyne 016A","E01008300","Total",1672,802,870,1612,60,7,34.16,48.9
"2011","Newcastle upon Tyne 016B","E01008450","Total",1480,640,840,1480,0,8,24.92,59.4
"2011","Newcastle upon Tyne 016C","E01008451","Total",1788,822,966,1788,0,5,24.32,73.5
"2011","Newcastle upon Tyne 016D","E01008452","Total",1428,717,711,1424,4,36,49.71,28.7
"2011","Newcastle upon Tyne 017A","E01008367","Total",2192,1191,1001,2041,151,28,26.79,81.8
"2011","Newcastle upon Tyne 017B","E01008368","Total",1816,965,851,1780,36,30,12.47,145.6
"2011","Newcastle upon Tyne 017C","E01008370","Total",1716,870,846,1656,60,16,40.56,42.3
"2011","Newcastle upon Tyne 017D","E01008409","Total",1710,885,825,1684,26,15,26.66,64.1
"2011","Newcastle upon Tyne 017E","E01008411","Total",1777,920,857,1774,3,17,15.78,112.6
"2011","Newcastle upon Tyne 018A","E01008303","Total",1977,1023,954,1955,22,3,33.66,58.7
"2011","Newcastle upon Tyne 018B","E01008359","Total",1607,862,745,1600,7,8,11.07,145.2
"2011","Newcastle upon Tyne 018C","E01008360","Total",1668,879,789,1547,121,15,24.67,67.6
"2011","Newcastle upon Tyne 018D","E01008361","Total",1593,873,720,1593,0,8,9.83,162.1
"2011","Newcastle upon Tyne 018E","E01008362","Total",1795,952,843,1795,0,16,11.45,156.8
"2011","Newcastle upon Tyne 018F","E01008364","Total",1696,902,794,1651,45,8,17.02,99.6
"2011","Newcastle upon Tyne 019A","E01008343","Total",1547,756,791,1547,0,12,35.15,44.0
"2011","Newcastle upon Tyne 019B","E01008344","Total",1602,773,829,1597,5,9,45.70,35.1
"2011","Newcastle upon Tyne 019C","E01008345","Total",1591,745,846,1591,0,1,35.51,44.8
"2011","Newcastle upon Tyne 019D","E01008346","Total",1626,779,847,1308,318,16,24.34,66.8
"2011","Newcastle upon Tyne 019E","E01008347","Total",1430,681,749,1408,22,11,22.29,64.2
"2011","Newcastle upon Tyne 019F","E01008348","Total",1177,536,641,1177,0,15,23.51,50.1
"2011","Newcastle upon Tyne 019G","E01008349","Total",1565,818,747,1565,0,18,19.99,78.3
"2011","Newcastle upon Tyne 019H","E01008350","Total",1301,615,686,1301,0,8,36.09,36.0
"2011","Newcastle upon Tyne 020A","E01008430","Total",1354,652,702,1354,0,9,17.02,79.6
"2011","Newcastle upon Tyne 020B","E01008431","Total",1353,682,671,1353,0,2,22.83,59.3
"2011","Newcastle upon Tyne 020C","E01008433","Total",1383,686,697,1373,10,11,54.68,25.3
"2011","Newcastle upon Tyne 020D","E01008434","Total",1477,732,745,1477,0,16,23.44,63.0
"2011","Newcastle upon Tyne 020E","E01008435","Total",1474,684,790,1474,0,6,24.80,59.4
"2011","Newcastle upon Tyne 020F","E01008436","Total",1489,774,715,1489,0,5,69.20,21.5
"2011","Newcastle upon Tyne 021A","E01008381","Total",1376,680,696,1375,1,5,73.04,18.8
"2011","Newcastle upon Tyne 021B","E01008382","Total",1339,622,717,1287,52,2,25.92,51.7
"2011","Newcastle upon Tyne 021C","E01008383","Total",1494,707,787,1494,0,2,35.16,42.5
"2011","Newcastle upon Tyne 021D","E01008384","Total",1399,671,728,1387,12,10,37.10,37.7
"2011","Newcastle upon Tyne 021E","E01008385","Total",1398,696,702,1398,0,3,25.65,54.5
"2011","Newcastle upon Tyne 021F","E01008386","Total",1364,664,700,1364,0,10,24.91,54.8
"2011","Newcastle upon Tyne 021G","E01008387","Total",1364,655,709,1364,0,5,164.91,8.3
"2011","Newcastle upon Tyne 022B","E01008396","Total",2991,1647,1344,1747,1244,53,26.76,111.8
"2011","Newcastle upon Tyne 022C","E01008398","Total",1695,986,709,1695,0,7,12.45,136.1
"2011","Newcastle upon Tyne 022D","E01008449","Total",1783,1052,731,1755,28,17,22.00,81.0
"2011","Newcastle upon Tyne 022E","E01008453","Total",1669,833,836,1619,50,36,37.91,44.0
"2011","Newcastle upon Tyne 022G","E01008455","Total",1646,880,766,1646,0,14,17.19,95.8
"2011","Newcastle upon Tyne 022H","E01033556","Total",2512,1436,1076,2512,0,36,48.76,51.5
"2011","Newcastle upon Tyne 023A","E01008406","Total",1557,831,726,1415,142,8,31.43,49.5
"2011","Newcastle upon Tyne 023B","E01008407","Total",2794,1453,1341,1827,967,44,28.74,97.2
"2011","Newcastle upon Tyne 023D","E01008410","Total",1720,878,842,1720,0,16,47.03,36.6
"2011","Newcastle upon Tyne 023E","E01008412","Total",1657,878,779,1657,0,19,16.70,99.2
"2011","Newcastle upon Tyne 023F","E01008413","Total",1473,812,661,1473,0,6,13.40,109.9
"2011","Newcastle upon Tyne 023G","E01033548","Total",1117,628,489,1091,26,2,25.30,44.2
"2011","Newcastle upon Tyne 023H","E01033553","Total",2608,1353,1255,1278,1330,54,24.55,106.2
"2011","Newcastle upon Tyne 024A","E01008394","Total",1439,694,745,1439,0,20,7.10,202.7
"2011","Newcastle upon Tyne 024B","E01008395","Total",1522,749,773,1269,253,7,180.46,8.4
"2011","Newcastle upon Tyne 024C","E01008397","Total",1794,1016,778,919,875,47,137.33,13.1
"2011","Newcastle upon Tyne 024D","E01008399","Total",1896,927,969,1896,0,7,23.84,79.5
"2011","Newcastle upon Tyne 024E","E01008439","Total",1828,935,893,1708,120,12,29.31,62.4
"2011","Newcastle upon Tyne 024G","E01033543","Total",1302,826,476,1195,107,14,45.76,28.5
"2011","Newcastle upon Tyne 024H","E01033545","Total",1187,743,444,1133,54,10,49.80,23.8
"2011","Newcastle upon Tyne 024I","E01033554","Total",1313,775,538,1291,22,7,28.83,45.5
"2011","Newcastle upon Tyne 025B","E01008415","Total",1214,581,633,1214,0,6,68.95,17.6
"2011","Newcastle upon Tyne 025C","E01008416","Total",1690,828,862,1690,0,2,29.61,57.1
"2011","Newcastle upon Tyne 025E","E01033547","Total",2127,1040,1087,2096,31,7,107.86,19.7
"2011","Newcastle upon Tyne 026A","E01008301","Total",1776,936,840,1776,0,5,52.09,34.1
"2011","Newcastle upon Tyne 026B","E01008302","Total",1642,790,852,1580,62,5,27.02,60.8
"2011","Newcastle upon Tyne 026C","E01008304","Total",1900,1010,890,1866,34,3,51.40,37.0
"2011","Newcastle upon Tyne 026D","E01008305","Total",2176,1030,1146,2099,77,9,41.40,52.6
"2011","Newcastle upon Tyne 026E","E01008391","Total",1485,706,779,1485,0,7,24.35,61.0
"2011","Newcastle upon Tyne 026F","E01008392","Total",1551,784,767,1535,16,4,98.03,15.8
"2011","Newcastle upon Tyne 026G","E01008432","Total",1355,673,682,1344,11,5,32.22,42.1
"2011","Newcastle upon Tyne 027A","E01008288","Total",1321,655,666,1321,0,9,37.78,35.0
"2011","Newcastle upon Tyne 027B","E01008289","Total",1590,714,876,1503,87,6,36.94,43.0
"2011","Newcastle upon Tyne 027C","E01008290","Total",1277,633,644,1277,0,3,54.91,23.3
"2011","Newcastle upon Tyne 027D","E01008291","Total",2133,1040,1093,2133,0,8,52.47,40.7
"2011","Newcastle upon Tyne 027E","E01008292","Total",1342,664,678,1342,0,14,21.01,63.9
"2011","Newcastle upon Tyne 028A","E01008388","Total",1801,870,931,1801,0,1,19.76,91.1
"2011","Newcastle upon Tyne 028B","E01008389","Total",1739,783,956,1739,0,4,25.03,69.5
"2011","Newcastle upon Tyne 028C","E01008426","Total",1654,765,889,1654,0,5,23.64,70.0
"2011","Newcastle upon Tyne 028D","E01008429","Total",1420,645,775,1374,46,4,39.16,36.3
"2011","Newcastle upon Tyne 029A","E01008331","Total",1882,952,930,1882,0,27,19.86,94.8
"2011","Newcastle upon Tyne 029B","E01008332","Total",2271,1208,1063,2271,0,16,19.25,118.0
"2011","Newcastle upon Tyne 029C","E01008333","Total",1851,1041,810,1615,236,16,28.80,64.3
"2011","Newcastle upon Tyne 029D","E01008334","Total",2040,1064,976,2040,0,13,28.05,72.7
"2011","Newcastle upon Tyne 029E","E01008335","Total",2079,1097,982,2075,4,15,17.77,117.0
"2011","Newcastle upon Tyne 029F","E01008437","Total",1219,654,565,1115,104,11,93.73,13.0
"2011","Newcastle upon Tyne 029G","E01008438","Total",1648,907,741,1630,18,4,63.12,26.1
"2011","Newcastle upon Tyne 030A","E01008390","Total",1792,885,907,1792,0,11,28.26,63.4
"2011","Newcastle upon Tyne 030B","E01008425","Total",1795,994,801,1737,58,9,65.61,27.4
"2011","Newcastle upon Tyne 030C","E01008427","Total",1172,582,590,1172,0,1,60.14,19.5
"2011","Newcastle upon Tyne 030D","E01008428","Total",1295,634,661,1230,65,8,29.20,44.3
"2011","Newcastle upon Tyne 031A","E01008441","Total",1649,783,866,1649,0,6,36.55,45.1
"2011","Newcastle upon Tyne 031B","E01008442","Total",1374,668,706,1374,0,2,25.51,53.9
"2011","Newcastle upon Tyne 031C","E01008444","Total",1545,747,798,1541,4,7,52.48,29.4
"2011","Newcastle upon Tyne 031D","E01008445","Total",1930,924,1006,1875,55,12,41.66,46.3
"2011","Newcastle upon Tyne 031E","E01008446","Total",1417,678,739,1417,0,13,30.81,46.0
"2011","Newcastle upon Tyne 031F","E01008447","Total",1317,619,698,1317,0,10,32.16,41.0
"2011","Newcastle upon Tyne 031G","E01008448","Total",1482,732,750,1482,0,24,70.20,21.1
"2011","North Tyneside 001A","E01008547","Total",1384,702,682,1384,0,17,39.93,34.7
"2011","North Tyneside 001B","E01008548","Total",1297,636,661,1294,3,28,88.33,14.7
"2011","North Tyneside 001C","E01008549","Total",1486,706,780,1486,0,25,253.64,5.9
"2011","North Tyneside 001D","E01008551","Total",1458,702,756,1458,0,24,219.77,6.6
"2011","North Tyneside 002A","E01008478","Total",1565,749,816,1565,0,4,228.80,6.8
"2011","North Tyneside 002B","E01008480","Total",1555,738,817,1504,51,2,31.55,49.3
"2011","North Tyneside 002C","E01008504","Total",1528,781,747,1528,0,8,95.41,16.0
"2011","North Tyneside 002D","E01008578","Total",1396,684,712,1396,0,10,60.04,23.3
"2011","North Tyneside 002E","E01008583","Total",1464,717,747,1461,3,9,71.58,20.5
"2011","North Tyneside 003A","E01008520","Total",1373,674,699,1363,10,30,30.38,45.2
"2011","North Tyneside 003B","E01008523","Total",1317,652,665,1317,0,33,24.13,54.6
"2011","North Tyneside 003C","E01008546","Total",1477,724,753,1477,0,34,43.52,33.9
"2011","North Tyneside 003D","E01008550","Total",1622,788,834,1622,0,36,20.43,79.4
"2011","North Tyneside 004A","E01008577","Total",1365,655,710,1365,0,10,426.04,3.2
"2011","North Tyneside 004B","E01008579","Total",1497,673,824,1497,0,17,54.25,27.6
"2011","North Tyneside 004C","E01008580","Total",1389,660,729,1389,0,16,26.22,53.0
"2011","North Tyneside 004D","E01008581","Total",1367,631,736,1322,45,19,58.41,23.4
"2011","North Tyneside 004E","E01008582","Total",1349,670,679,1349,0,6,159.64,8.5
"2011","North Tyneside 005A","E01008517","Total",1593,772,821,1593,0,19,40.49,39.3
"2011","North Tyneside 005B","E01008519","Total",1361,612,749,1361,0,23,23.27,58.5
"2011","North Tyneside 005C","E01008521","Total",1486,669,817,1446,40,16,28.11,52.9
"2011","North Tyneside 005D","E01008522","Total",1597,771,826,1597,0,30,23.07,69.2
"2011","North Tyneside 006A","E01008584","Total",1544,811,733,1427,117,9,24.29,63.6
"2011","North Tyneside 006B","E01008585","Total",1615,777,838,1563,52,29,30.25,53.4
"2011","North Tyneside 006C","E01008587","Total",1390,695,695,1310,80,12,19.91,69.8
"2011","North Tyneside 006D","E01008588","Total",1574,782,792,1535,39,11,17.43,90.3
"2011","North Tyneside 006E","E01008589","Total",1446,709,737,1446,0,26,37.80,38.3
"2011","North Tyneside 007A","E01008518","Total",1639,789,850,1610,29,9,31.81,51.5
"2011","North Tyneside 007B","E01008564","Total",1452,712,740,1424,28,11,99.83,14.5
"2011","North Tyneside 007C","E01008565","Total",2026,950,1076,2026,0,14,562.66,3.6
"2011","North Tyneside 007D","E01008567","Total",1414,662,752,1382,32,5,63.15,22.4
"2011","North Tyneside 008A","E01008475","Total",1656,813,843,1656,0,8,29.35,56.4
"2011","North Tyneside 008B","E01008476","Total",1703,820,883,1698,5,2,90.91,18.7
"2011","North Tyneside 008C","E01008477","Total",1642,760,882,1642,0,12,76.06,21.6
"2011","North Tyneside 008D","E01008479","Total",1356,644,712,1356,0,9,40.82,33.2
"2011","North Tyneside 009A","E01008552","Total",1630,784,846,1620,10,14,243.41,6.7
"2011","North Tyneside 009B","E01008553","Total",1832,865,967,1795,37,22,25.37,72.2
"2011","North Tyneside 009C","E01008554","Total",1690,822,868,1690,0,21,27.34,61.8
"2011","North Tyneside 009D","E01008555","Total",1629,774,855,1629,0,9,37.75,43.2
"2011","North Tyneside 009E","E01008586","Total",1553,748,805,1526,27,22,23.89,65.0
"2011","North Tyneside 010A","E01008495","Total",1723,842,881,1723,0,35,27.07,63.6
"2011","North Tyneside 010B","E01008496","Total",1497,739,758,1483,14,10,26.99,55.5
"2011","North Tyneside 010C","E01008497","Total",1451,701,750,1451,0,16,25.95,55.9
"2011","North Tyneside 010D","E01008498","Total",1509,711,798,1509,0,8,44.59,33.8
"2011","North Tyneside 011B","E01008568","Total",1479,708,771,1479,0,12,41.56,35.6
"2011","North Tyneside 011C","E01008569","Total",1462,676,786,1460,2,3,53.95,27.1
"2011","North Tyneside 011D","E01008570","Total",1337,643,694,1337,0,5,61.15,21.9
"2011","North Tyneside 011E","E01032647","Total",1724,860,864,1719,5,17,73.62,23.4
"2011","North Tyneside 011F","E01032648","Total",1530,721,809,1530,0,8,36.55,41.9
"2011","North Tyneside 012A","E01008500","Total",1601,785,816,1555,46,11,56.45,28.4
"2011","North Tyneside 012B","E01008505","Total",1668,828,840,1668,0,16,72.30,23.1
"2011","North Tyneside 012C","E01008506","Total",1390,653,737,1390,0,7,20.43,68.0
"2011","North Tyneside 012D","E01008507","Total",1502,741,761,1502,0,10,99.08,15.2
"2011","North Tyneside 013A","E01008493","Total",1503,722,781,1503,0,20,34.98,43.0
"2011","North Tyneside 013B","E01008494","Total",1519,698,821,1519,0,10,32.20,47.2
"2011","North Tyneside 013C","E01008556","Total",1984,934,1050,1924,60,24,89.99,22.0
"2011","North Tyneside 013D","E01008557","Total",1630,804,826,1630,0,25,39.86,40.9
"2011","North Tyneside 014A","E01008470","Total",1409,655,754,1349,60,19,26.57,53.0
"2011","North Tyneside 014B","E01008499","Total",1683,809,874,1679,4,2,29.88,56.3
"2011","North Tyneside 014C","E01008502","Total",1630,776,854,1630,0,9,27.10,60.1
"2011","North Tyneside 014D","E01008516","Total",1317,633,684,1313,4,1,74.77,17.6
"2011","North Tyneside 015A","E01008488","Total",1423,682,741,1423,0,9,151.07,9.4
"2011","North Tyneside 015B","E01008489","Total",1728,770,958,1728,0,13,26.39,65.5
"2011","North Tyneside 015C","E01008490","Total",1552,760,792,1552,0,8,32.47,47.8
"2011","North Tyneside 015D","E01008491","Total",1578,752,826,1578,0,5,105.95,14.9
"2011","North Tyneside 016A","E01008558","Total",1527,712,815,1527,0,13,58.45,26.1
"2011","North Tyneside 016B","E01008560","Total",1700,832,868,1681,19,19,40.75,41.7
"2011","North Tyneside 016C","E01008561","Total",1582,773,809,1582,0,6,46.94,33.7
"2011","North Tyneside 016D","E01008562","Total",1495,712,783,1460,35,22,40.76,36.7
"2011","North Tyneside 017A","E01008525","Total",1558,747,811,1489,69,10,40.03,38.9
"2011","North Tyneside 017B","E01008527","Total",1495,731,764,1475,20,23,20.38,73.4
"2011","North Tyneside 017C","E01008559","Total",1524,707,817,1502,22,11,28.81,52.9
"2011","North Tyneside 017D","E01008563","Total",1448,715,733,1448,0,36,70.13,20.6
"2011","North Tyneside 018A","E01008469","Total",1473,734,739,1456,17,17,90.21,16.3
"2011","North Tyneside 018B","E01008472","Total",1494,711,783,1494,0,18,35.62,41.9
"2011","North Tyneside 018C","E01008473","Total",1289,629,660,1236,53,22,37.43,34.4
"2011","North Tyneside 018D","E01008501","Total",2091,1025,1066,2091,0,9,206.09,10.1
"2011","North Tyneside 018E","E01008503","Total",1638,779,859,1588,50,3,188.71,8.7
"2011","North Tyneside 019A","E01008471","Total",1629,769,860,1629,0,14,51.68,31.5
"2011","North Tyneside 019B","E01008474","Total",1454,707,747,1454,0,7,30.65,47.4
"2011","North Tyneside 019C","E01008513","Total",2235,1059,1176,2235,0,10,62.65,35.7
"2011","North Tyneside 019D","E01008514","Total",1807,841,966,1807,0,7,126.30,14.3
"2011","North Tyneside 019F","E01032649","Total",1095,532,563,1095,0,3,18.13,60.4
"2011","North Tyneside 019G","E01032650","Total",1038,511,527,1038,0,13,22.22,46.7
"2011","North Tyneside 020A","E01008486","Total",1420,678,742,1415,5,10,25.91,54.8
"2011","North Tyneside 020B","E01008487","Total",1429,695,734,1429,0,4,45.64,31.3
"2011","North Tyneside 020C","E01008526","Total",1464,685,779,1464,0,17,59.14,24.8
"2011","North Tyneside 020D","E01008530","Total",1605,742,863,1575,30,12,25.14,63.8
"2011","North Tyneside 021A","E01008461","Total",1428,639,789,1428,0,5,25.59,55.8
"2011","North Tyneside 021B","E01008466","Total",1326,647,679,1326,0,11,71.78,18.5
"2011","North Tyneside 021C","E01008467","Total",1409,675,734,1409,0,11,28.11,50.1
"2011","North Tyneside 021D","E01008468","Total",1436,661,775,1436,0,13,38.77,37.0
"2011","North Tyneside 022A","E01008483","Total",1561,789,772,1561,0,5,15.11,103.3
"2011","North Tyneside 022B","E01008524","Total",1681,848,833,1674,7,2,44.33,37.9
"2011","North Tyneside 022C","E01008528","Total",1427,707,720,1381,46,13,17.11,83.4
"2011","North Tyneside 022D","E01008529","Total",1625,781,844,1566,59,12,18.62,87.3
"2011","North Tyneside 023A","E01008481","Total",1480,667,813,1480,0,9,138.98,10.6
"2011","North Tyneside 023B","E01008482","Total",1679,774,905,1615,64,3,24.28,69.2
"2011","North Tyneside 023C","E01008484","Total",1342,650,692,1342,0,4,19.96,67.2
"2011","North Tyneside 023D","E01008485","Total",1550,735,815,1545,5,1,26.08,59.4
"2011","North Tyneside 023E","E01008492","Total",1724,836,888,1724,0,9,24.39,70.7
"2011","North Tyneside 024A","E01008462","Total",1253,604,649,1198,55,3,27.62,45.4
"2011","North Tyneside 024B","E01008463","Total",1334,641,693,1334,0,3,23.94,55.7
"2011","North Tyneside 024C","E01008464","Total",1383,647,736,1383,0,8,35.63,38.8
"2011","North Tyneside 024D","E01008465","Total",1427,687,740,1427,0,6,26.11,54.7
"2011","North Tyneside 025A","E01008531","Total",1439,720,719,1439,0,5,70.02,20.6
"2011","North Tyneside 025B","E01008532","Total",1526,734,792,1526,0,8,80.37,19.0
"2011","North Tyneside 025C","E01008534","Total",1372,685,687,1372,0,7,31.80,43.1
"2011","North Tyneside 025D","E01008538","Total",1251,625,626,1251,0,8,54.39,23.0
"2011","North Tyneside 026A","E01008508","Total",1567,768,799,1556,11,5,29.50,53.1
"2011","North Tyneside 026B","E01008509","Total",1627,794,833,1627,0,12,31.15,52.2
"2011","North Tyneside 026C","E01008510","Total",1561,759,802,1559,2,3,26.06,59.9
"2011","North Tyneside 026D","E01008512","Total",1552,731,821,1520,32,9,34.29,45.3
"2011","North Tyneside 027A","E01008539","Total",1428,711,717,1428,0,8,143.83,9.9
"2011","North Tyneside 027B","E01008540","Total",1637,779,858,1633,4,8,120.04,13.6
"2011","North Tyneside 027C","E01008541","Total",1579,797,782,1579,0,1,56.51,27.9
"2011","North Tyneside 027D","E01008544","Total",1625,899,726,1614,11,5,19.74,82.3
"2011","North Tyneside 027E","E01008545","Total",1290,669,621,1234,56,2,39.51,32.6
"2011","North Tyneside 028A","E01008511","Total",1684,805,879,1684,0,6,22.94,73.4
"2011","North Tyneside 028B","E01008542","Total",1579,735,844,1579,0,7,58.09,27.2
"2011","North Tyneside 028C","E01008543","Total",2222,1080,1142,2152,70,3,77.18,28.8
"2011","North Tyneside 028D","E01008571","Total",1796,861,935,1722,74,2,93.14,19.3
"2011","North Tyneside 029A","E01008572","Total",1651,890,761,1651,0,6,72.69,22.7
"2011","North Tyneside 029B","E01008573","Total",1604,814,790,1604,0,7,16.39,97.9
"2011","North Tyneside 029C","E01008574","Total",1593,762,831,1593,0,13,59.52,26.8
"2011","North Tyneside 029D","E01008576","Total",2079,1001,1078,2079,0,6,64.79,32.1
"2011","North Tyneside 030A","E01008533","Total",1489,675,814,1489,0,7,32.50,45.8
"2011","North Tyneside 030B","E01008535","Total",1473,676,797,1473,0,8,100.56,14.6
"2011","North Tyneside 030C","E01008536","Total",1433,734,699,1432,1,4,22.35,64.1
"2011","North Tyneside 030D","E01008537","Total",1310,652,658,1310,0,2,11.91,110.0
"2011","North Tyneside 030E","E01008575","Total",1333,627,706,1294,39,10,51.69,25.8
"2011","South Tyneside 001A","E01008595","Total",1562,758,804,1555,7,6,21.70,72.0
"2011","South Tyneside 001B","E01008596","Total",1485,711,774,1424,61,15,23.83,62.3
"2011","South Tyneside 001C","E01008597","Total",2354,1212,1142,2265,89,13,93.73,25.1
"2011","South Tyneside 001D","E01008598","Total",1572,814,758,1534,38,18,27.42,57.3
"2011","South Tyneside 001E","E01008599","Total",1473,688,785,1473,0,4,31.12,47.3
"2011","South Tyneside 002A","E01008664","Total",1481,798,683,1435,46,15,16.75,88.4
"2011","South Tyneside 002B","E01008665","Total",1434,742,692,1428,6,6,23.94,59.9
"2011","South Tyneside 002C","E01008666","Total",1394,718,676,1394,0,1,33.93,41.1
"2011","South Tyneside 002D","E01008667","Total",1572,802,770,1570,2,8,107.73,14.6
"2011","South Tyneside 002E","E01008668","Total",1515,768,747,1515,0,3,20.84,72.7
"2011","South Tyneside 003A","E01008673","Total",1199,586,613,1199,0,19,17.62,68.0
"2011","South Tyneside 003B","E01008675","Total",1423,712,711,1423,0,7,10.44,136.3
"2011","South Tyneside 003C","E01008676","Total",1242,605,637,1173,69,8,12.99,95.6
"2011","South Tyneside 003D","E01008677","Total",1422,761,661,1252,170,21,26.25,54.2
"2011","South Tyneside 003E","E01008678","Total",1266,642,624,1225,41,8,16.34,77.5
"2011","South Tyneside 004A","E01008647","Total",1460,701,759,1460,0,12,27.12,53.8
"2011","South Tyneside 004B","E01008648","Total",1383,673,710,1369,14,7,58.99,23.4
"2011","South Tyneside 004C","E01008649","Total",1645,749,896,1624,21,4,112.81,14.6
"2011","South Tyneside 004D","E01008651","Total",1917,873,1044,1852,65,10,28.52,67.2
"2011","South Tyneside 005A","E01008679","Total",1303,617,686,1303,0,2,51.57,25.3
"2011","South Tyneside 005B","E01008680","Total",1425,694,731,1425,0,12,29.90,47.7
"2011","South Tyneside 005C","E01008682","Total",1242,580,662,1238,4,4,27.57,45.0
"2011","South Tyneside 005D","E01008683","Total",1442,725,717,1409,33,10,13.52,106.7
"2011","South Tyneside 006A","E01008635","Total",1370,627,743,1370,0,6,30.53,44.9
"2011","South Tyneside 006B","E01008650","Total",1419,688,731,1419,0,9,19.66,72.2
"2011","South Tyneside 006C","E01008674","Total",1266,614,652,1266,0,17,38.83,32.6
"2011","South Tyneside 006D","E01008681","Total",1402,659,743,1402,0,17,37.31,37.6
"2011","South Tyneside 007A","E01008600","Total",1318,650,668,1318,0,3,104.12,12.7
"2011","South Tyneside 007B","E01008604","Total",1630,795,835,1538,92,10,165.35,9.9
"2011","South Tyneside 007C","E01008660","Total",1414,721,693,1413,1,11,27.64,51.2
"2011","South Tyneside 007D","E01008661","Total",1133,558,575,1099,34,11,29.49,38.4
"2011","South Tyneside 008A","E01008633","Total",1423,680,743,1423,0,4,24.55,58.0
"2011","South Tyneside 008B","E01008634","Total",1318,605,713,1318,0,3,19.12,68.9
"2011","South Tyneside 008C","E01008636","Total",1442,695,747,1426,16,5,21.50,67.1
"2011","South Tyneside 008D","E01008637","Total",1454,723,731,1454,0,4,21.57,67.4
"2011","South Tyneside 009A","E01008639","Total",1944,931,1013,1933,11,4,72.88,26.7
"2011","South Tyneside 009B","E01008652","Total",1103,558,545,1059,44,3,26.54,41.6
"2011","South Tyneside 009C","E01008653","Total",1273,578,695,1273,0,8,21.37,59.6
"2011","South Tyneside 009D","E01008654","Total",1234,634,600,1227,7,6,14.02,88.0
"2011","South Tyneside 009E","E01008655","Total",1470,730,740,1435,35,4,34.87,42.2
"2011","South Tyneside 009F","E01008657","Total",1363,651,712,1362,1,13,26.00,52.4
"2011","South Tyneside 010A","E01008638","Total",1405,701,704,1405,0,10,48.18,29.2
"2011","South Tyneside 010B","E01008640","Total",1976,955,1021,1948,28,9,58.03,34.1
"2011","South Tyneside 010C","E01008641","Total",1511,758,753,1511,0,5,19.71,76.7
"2011","South Tyneside 010D","E01008642","Total",1438,681,757,1380,58,10,78.56,18.3
"2011","South Tyneside 011A","E01008590","Total",1501,736,765,1501,0,4,25.55,58.7
"2011","South Tyneside 011B","E01008591","Total",1411,702,709,1411,0,3,15.41,91.6
"2011","South Tyneside 011C","E01008592","Total",1457,721,736,1381,76,2,23.08,63.1
"2011","South Tyneside 011D","E01008594","Total",1783,848,935,1720,63,6,41.82,42.6
"2011","South Tyneside 012A","E01008601","Total",1537,696,841,1482,55,4,81.87,18.8
"2011","South Tyneside 012B","E01008669","Total",1377,661,716,1377,0,9,30.42,45.3
"2011","South Tyneside 012C","E01008671","Total",1219,645,574,1194,25,2,83.33,14.6
"2011","South Tyneside 012D","E01008672","Total",1316,661,655,1316,0,2,72.78,18.1
"2011","South Tyneside 013A","E01008622","Total",1605,762,843,1605,0,12,51.12,31.4
"2011","South Tyneside 013C","E01008625","Total",1470,695,775,1470,0,5,28.18,52.2
"2011","South Tyneside 013E","E01033074","Total",2119,973,1146,2115,4,13,40.76,52.0
"2011","South Tyneside 014A","E01008602","Total",1466,708,758,1458,8,8,31.75,46.2
"2011","South Tyneside 014B","E01008603","Total",1294,670,624,1294,0,2,36.75,35.2
"2011","South Tyneside 014C","E01008608","Total",1141,507,634,1141,0,4,16.20,70.4
"2011","South Tyneside 014D","E01008670","Total",1518,692,826,1511,7,4,30.93,49.1
"2011","South Tyneside 015A","E01008643","Total",1430,684,746,1430,0,10,48.71,29.4
"2011","South Tyneside 015B","E01008644","Total",1503,739,764,1503,0,6,27.17,55.3
"2011","South Tyneside 015C","E01008645","Total",1454,696,758,1454,0,4,92.90,15.7
"2011","South Tyneside 015D","E01008646","Total",1406,652,754,1351,55,5,69.19,20.3
"2011","South Tyneside 015E","E01008656","Total",1420,661,759,1388,32,6,56.13,25.3
"2011","South Tyneside 015F","E01008658","Total",1443,674,769,1443,0,6,31.57,45.7
"2011","South Tyneside 016A","E01008593","Total",1262,578,684,1262,0,3,24.16,52.2
"2011","South Tyneside 016B","E01008605","Total",1163,548,615,1163,0,2,24.37,47.7
"2011","South Tyneside 016C","E01008606","Total",1413,685,728,1413,0,5,48.77,29.0
"2011","South Tyneside 016D","E01008607","Total",1380,618,762,1380,0,5,24.64,56.0
"2011","South Tyneside 016E","E01008609","Total",1461,669,792,1461,0,12,26.03,56.1
"2011","South Tyneside 017A","E01008631","Total",1472,698,774,1472,0,6,43.63,33.7
"2011","South Tyneside 017B","E01008632","Total",1236,573,663,1236,0,8,32.62,37.9
"2011","South Tyneside 017C","E01008659","Total",1483,720,763,1483,0,10,31.06,47.7
"2011","South Tyneside 017D","E01008662","Total",1247,597,650,1247,0,4,48.80,25.6
"2011","South Tyneside 017E","E01008663","Total",1399,661,738,1372,27,5,76.47,18.3
"2011","South Tyneside 018A","E01008624","Total",1417,673,744,1417,0,9,30.86,45.9
"2011","South Tyneside 018B","E01008684","Total",1215,574,641,1204,11,7,27.92,43.5
"2011","South Tyneside 018C","E01008685","Total",1858,896,962,1858,0,13,308.59,6.0
"2011","South Tyneside 018D","E01008686","Total",1705,803,902,1705,0,8,179.83,9.5
"2011","South Tyneside 018E","E01008687","Total",1707,807,900,1707,0,14,110.09,15.5
"2011","South Tyneside 019A","E01008688","Total",1417,647,770,1387,30,9,72.70,19.5
"2011","South Tyneside 019B","E01008689","Total",1539,739,800,1533,6,5,24.50,62.8
"2011","South Tyneside 019C","E01008690","Total",1430,704,726,1430,0,7,17.47,81.9
"2011","South Tyneside 019D","E01008691","Total",1262,636,626,1262,0,9,60.41,20.9
"2011","South Tyneside 019E","E01008692","Total",1367,659,708,1361,6,6,21.10,64.8
"2011","South Tyneside 020A","E01008627","Total",1316,645,671,1316,0,5,22.39,58.8
"2011","South Tyneside 020B","E01008628","Total",1445,674,771,1445,0,7,30.69,47.1
"2011","South Tyneside 020C","E01008629","Total",1417,695,722,1417,0,6,707.25,2.0
"2011","South Tyneside 020D","E01008630","Total",1445,672,773,1445,0,4,43.68,33.1
"2011","South Tyneside 021A","E01008610","Total",1407,667,740,1407,0,4,55.54,25.3
"2011","South Tyneside 021B","E01008611","Total",1475,731,744,1475,0,11,34.77,42.4
"2011","South Tyneside 021C","E01008612","Total",1468,721,747,1468,0,15,70.18,20.9
"2011","South Tyneside 021D","E01008613","Total",1549,782,767,1549,0,7,46.95,33.0
"2011","South Tyneside 022A","E01008616","Total",1570,750,820,1570,0,24,162.78,9.6
"2011","South Tyneside 022B","E01008618","Total",1274,613,661,1274,0,33,75.94,16.8
"2011","South Tyneside 022C","E01008619","Total",1566,726,840,1566,0,23,362.12,4.3
"2011","South Tyneside 022D","E01008621","Total",1419,678,741,1419,0,29,35.05,40.5
"2011","South Tyneside 023A","E01008614","Total",1636,779,857,1636,0,7,87.61,18.7
"2011","South Tyneside 023B","E01008615","Total",1389,628,761,1389,0,14,292.23,4.8
"2011","South Tyneside 023C","E01008617","Total",1482,741,741,1482,0,22,333.46,4.4
"2011","South Tyneside 023D","E01008620","Total",1449,669,780,1449,0,7,136.57,10.6
"2011","Sunderland 001A","E01008713","Total",1604,814,790,1604,0,17,112.20,14.3
"2011","Sunderland 001B","E01008722","Total",1479,694,785,1474,5,7,23.86,62.0
"2011","Sunderland 001C","E01008724","Total",1206,565,641,1206,0,10,16.45,73.3
"2011","Sunderland 001D","E01008726","Total",1499,716,783,1499,0,3,39.21,38.2
"2011","Sunderland 002A","E01008723","Total",1406,678,728,1381,25,14,66.34,21.2
"2011","Sunderland 002B","E01008725","Total",1407,677,730,1404,3,6,27.48,51.2
"2011","Sunderland 002C","E01008727","Total",1539,720,819,1539,0,7,15.91,96.7
"2011","Sunderland 002D","E01008728","Total",1453,696,757,1453,0,14,16.57,87.7
"2011","Sunderland 002E","E01008792","Total",1328,632,696,1174,154,14,37.59,35.3
"2011","Sunderland 003A","E01008698","Total",1466,693,773,1459,7,8,24.71,59.3
"2011","Sunderland 003B","E01008837","Total",1292,590,702,1292,0,3,30.80,41.9
"2011","Sunderland 003C","E01008838","Total",1590,743,847,1590,0,2,21.03,75.6
"2011","Sunderland 003D","E01008839","Total",1368,639,729,1359,9,8,59.46,23.0
"2011","Sunderland 003E","E01008840","Total",1462,707,755,1462,0,4,26.90,54.3
"2011","Sunderland 003F","E01008841","Total",1205,562,643,1195,10,2,28.49,42.3
"2011","Sunderland 004A","E01008712","Total",1650,789,861,1638,12,2,91.67,18.0
"2011","Sunderland 004B","E01008817","Total",1158,522,636,1118,40,2,23.73,48.8
"2011","Sunderland 004C","E01008819","Total",1408,661,747,1408,0,4,30.88,45.6
"2011","Sunderland 004D","E01008821","Total",1392,621,771,1306,86,5,56.69,24.6
"2011","Sunderland 004E","E01008822","Total",1621,770,851,1621,0,5,28.53,56.8
"2011","Sunderland 004F","E01008842","Total",1445,710,735,1411,34,6,26.50,54.5
"2011","Sunderland 005A","E01008708","Total",1480,715,765,1480,0,4,29.21,50.7
"2011","Sunderland 005B","E01008709","Total",1412,671,741,1412,0,9,19.74,71.5
"2011","Sunderland 005D","E01008711","Total",1463,703,760,1439,24,5,47.29,30.9
"2011","Sunderland 005F","E01008820","Total",1153,572,581,1153,0,4,85.24,13.5
"2011","Sunderland 005G","E01033075","Total",2077,1011,1066,2037,40,4,61.05,34.0
"2011","Sunderland 006A","E01008786","Total",1431,683,748,1431,0,5,21.24,67.4
"2011","Sunderland 006B","E01008787","Total",1632,833,799,1574,58,6,24.97,65.4
"2011","Sunderland 006C","E01008788","Total",1510,737,773,1510,0,6,18.86,80.1
"2011","Sunderland 006D","E01008789","Total",1396,710,686,1375,21,4,34.80,40.1
"2011","Sunderland 006E","E01008790","Total",1522,768,754,1514,8,6,22.31,68.2
"2011","Sunderland 006F","E01008791","Total",1786,949,837,1740,46,14,58.33,30.6
"2011","Sunderland 007A","E01008855","Total",1486,764,722,1486,0,5,880.58,1.7
"2011","Sunderland 007B","E01008856","Total",1385,675,710,1385,0,12,45.39,30.5
"2011","Sunderland 007C","E01008876","Total",1523,763,760,1468,55,18,218.53,7.0
"2011","Sunderland 007D","E01008877","Total",1457,706,751,1427,30,4,115.64,12.6
"2011","Sunderland 008A","E01008693","Total",1260,620,640,1212,48,2,94.04,13.4
"2011","Sunderland 008B","E01008694","Total",1430,673,757,1430,0,6,24.19,59.1
"2011","Sunderland 008C","E01008695","Total",1534,741,793,1527,7,10,88.80,17.3
"2011","Sunderland 008D","E01008696","Total",1312,672,640,1306,6,8,39.52,33.2
"2011","Sunderland 008E","E01008697","Total",1312,601,711,1275,37,7,29.43,44.6
"2011","Sunderland 008F","E01008699","Total",1412,664,748,1406,6,2,23.83,59.3
"2011","Sunderland 009A","E01008853","Total",1371,641,730,1371,0,6,70.90,19.3
"2011","Sunderland 009B","E01008854","Total",1521,783,738,1465,56,6,23.90,63.6
"2011","Sunderland 009C","E01008857","Total",1390,657,733,1390,0,8,21.70,64.1
"2011","Sunderland 009D","E01008858","Total",1368,594,774,1368,0,7,24.12,56.7
"2011","Sunderland 009E","E01008859","Total",1382,645,737,1382,0,6,52.89,26.1
"2011","Sunderland 009F","E01008860","Total",1394,672,722,1394,0,4,39.47,35.3
"2011","Sunderland 009G","E01008878","Total",1578,745,833,1578,0,8,24.37,64.8
"2011","Sunderland 010A","E01008873","Total",1299,636,663,1299,0,11,179.35,7.2
"2011","Sunderland 010B","E01008874","Total",1803,854,949,1803,0,6,30.62,58.9
"2011","Sunderland 010C","E01008875","Total",1571,767,804,1567,4,3,59.84,26.3
"2011","Sunderland 010D","E01008879","Total",1443,707,736,1443,0,4,45.03,32.0
"2011","Sunderland 010E","E01008880","Total",1159,570,589,1155,4,3,24.17,48.0
"2011","Sunderland 011A","E01008701","Total",1829,898,931,1524,305,21,21.08,86.8
"2011","Sunderland 011B","E01008704","Total",1531,749,782,1445,86,9,32.54,47.0
"2011","Sunderland 011C","E01008706","Total",1648,837,811,1618,30,16,20.65,79.8
"2011","Sunderland 011D","E01008707","Total",1615,797,818,1303,312,17,13.05,123.8
"2011","Sunderland 012A","E01008756","Total",1513,710,803,1513,0,10,26.16,57.8
"2011","Sunderland 012B","E01008762","Total",1518,686,832,1518,0,3,77.80,19.5
"2011","Sunderland 012C","E01008812","Total",1723,770,953,1723,0,9,23.64,72.9
"2011","Sunderland 012F","E01033076","Total",1548,750,798,1548,0,2,41.48,37.3
"2011","Sunderland 013A","E01008700","Total",1257,616,641,1106,151,14,107.14,11.7
"2011","Sunderland 013B","E01008703","Total",2180,1234,946,1712,468,29,61.64,35.4
"2011","Sunderland 013C","E01008705","Total",1129,570,559,1109,20,7,19.77,57.1
"2011","Sunderland 013D","E01008831","Total",2242,1292,950,2181,61,28,33.80,66.3
"2011","Sunderland 013E","E01008834","Total",1836,1023,813,1789,47,22,30.06,61.1
"2011","Sunderland 014A","E01008810","Total",1652,823,829,1635,17,7,52.66,31.4
"2011","Sunderland 014B","E01008811","Total",1651,809,842,1619,32,8,45.02,36.7
"2011","Sunderland 014C","E01008813","Total",1601,768,833,1512,89,2,33.44,47.9
"2011","Sunderland 014D","E01008814","Total",1553,754,799,1551,2,1,94.82,16.4
"2011","Sunderland 015A","E01008757","Total",1478,710,768,1442,36,6,18.18,81.3
"2011","Sunderland 015B","E01008758","Total",1445,690,755,1445,0,15,43.54,33.2
"2011","Sunderland 015C","E01008759","Total",1491,752,739,1465,26,9,26.46,56.3
"2011","Sunderland 015D","E01008761","Total",1444,674,770,1359,85,9,38.95,37.1
"2011","Sunderland 016A","E01008702","Total",1107,526,581,1107,0,0,99.89,11.1
"2011","Sunderland 016B","E01008735","Total",2007,1023,984,1962,45,14,44.86,44.7
"2011","Sunderland 016C","E01008736","Total",1232,613,619,1232,0,2,75.89,16.2
"2011","Sunderland 016D","E01008737","Total",1388,710,678,1364,24,4,17.19,80.7
"2011","Sunderland 016E","E01008738","Total",1316,678,638,1316,0,4,22.28,59.1
"2011","Sunderland 016F","E01008836","Total",1515,851,664,1354,161,8,37.01,40.9
"2011","Sunderland 017A","E01008845","Total",1423,733,690,1423,0,9,60.00,23.7
"2011","Sunderland 017B","E01008846","Total",1183,526,657,1146,37,8,22.47,52.6
"2011","Sunderland 017C","E01008847","Total",1376,667,709,1376,0,4,17.61,78.1
"2011","Sunderland 017D","E01008850","Total",1723,845,878,1723,0,16,392.35,4.4
"2011","Sunderland 017E","E01008851","Total",1592,755,837,1592,0,12,32.02,49.7
"2011","Sunderland 018A","E01008760","Total",1495,731,764,1495,0,10,46.97,31.8
"2011","Sunderland 018B","E01008830","Total",1523,797,726,1523,0,7,14.45,105.4
"2011","Sunderland 018C","E01008832","Total",1570,743,827,1570,0,8,11.82,132.8
"2011","Sunderland 018D","E01008833","Total",1470,725,745,1467,3,9,17.76,82.8
"2011","Sunderland 019A","E01008843","Total",1282,648,634,1282,0,11,36.14,35.5
"2011","Sunderland 019B","E01008844","Total",1432,686,746,1420,12,4,47.90,29.9
"2011","Sunderland 019C","E01008848","Total",1343,659,684,1343,0,5,94.15,14.3
"2011","Sunderland 019D","E01008849","Total",1257,577,680,1257,0,5,17.60,71.4
"2011","Sunderland 019E","E01008852","Total",1245,620,625,1245,0,5,23.26,53.5
"2011","Sunderland 020A","E01008867","Total",1662,873,789,1657,5,4,35.39,47.0
"2011","Sunderland 020B","E01008868","Total",1219,608,611,1219,0,9,26.97,45.2
"2011","Sunderland 020C","E01008869","Total",1315,637,678,1315,0,7,34.02,38.7
"2011","Sunderland 020D","E01008870","Total",1443,735,708,1443,0,10,30.32,47.6
"2011","Sunderland 020E","E01008871","Total",1466,689,777,1466,0,17,21.22,69.1
"2011","Sunderland 020F","E01008872","Total",1477,722,755,1477,0,3,80.61,18.3
"2011","Sunderland 021A","E01008729","Total",1072,489,583,1066,6,1,31.38,34.2
"2011","Sunderland 021B","E01008730","Total",1661,771,890,1661,0,12,45.93,36.2
"2011","Sunderland 021C","E01008731","Total",1277,610,667,1273,4,4,28.56,44.7
"2011","Sunderland 021D","E01008732","Total",2119,994,1125,2119,0,3,39.32,53.9
"2011","Sunderland 021E","E01008733","Total",1641,792,849,1641,0,6,28.55,57.5
"2011","Sunderland 021F","E01008734","Total",1414,696,718,1414,0,6,60.82,23.2
"2011","Sunderland 022A","E01008740","Total",1454,715,739,1381,73,22,60.22,24.1
"2011","Sunderland 022B","E01008781","Total",1554,769,785,1540,14,22,40.37,38.5
"2011","Sunderland 022C","E01008782","Total",1459,709,750,1459,0,9,38.56,37.8
"2011","Sunderland 022D","E01008783","Total",1410,693,717,1410,0,9,30.03,47.0
"2011","Sunderland 022E","E01008784","Total",1584,781,803,1584,0,10,38.90,40.7
"2011","Sunderland 022F","E01008785","Total",1439,686,753,1439,0,10,34.45,41.8
"2011","Sunderland 022G","E01008835","Total",1568,810,758,1503,65,32,28.57,54.9
"2011","Sunderland 023A","E01008823","Total",1407,678,729,1407,0,5,34.12,41.2
"2011","Sunderland 023B","E01008824","Total",1507,720,787,1507,0,5,27.74,54.3
"2011","Sunderland 023C","E01008825","Total",1533,755,778,1533,0,2,39.69,38.6
"2011","Sunderland 023D","E01008826","Total",1446,673,773,1446,0,8,26.91,53.7
"2011","Sunderland 023E","E01008827","Total",1245,587,658,1245,0,6,33.00,37.7
"2011","Sunderland 023F","E01008828","Total",1585,732,853,1585,0,2,20.36,77.8
"2011","Sunderland 023G","E01008829","Total",1370,668,702,1331,39,2,41.81,32.8
"2011","Sunderland 024A","E01008739","Total",1585,756,829,1585,0,5,25.54,62.1
"2011","Sunderland 024B","E01008741","Total",1451,720,731,1451,0,12,86.74,16.7
"2011","Sunderland 024C","E01008779","Total",1446,675,771,1446,0,8,51.11,28.3
"2011","Sunderland 024D","E01008780","Total",1925,959,966,1884,41,6,62.44,30.8
"2011","Sunderland 025A","E01008799","Total",1665,819,846,1665,0,18,90.38,18.4
"2011","Sunderland 025B","E01008861","Total",1523,746,777,1523,0,13,65.61,23.2
"2011","Sunderland 025C","E01008862","Total",1441,717,724,1441,0,24,52.72,27.3
"2011","Sunderland 025D","E01008863","Total",1621,801,820,1621,0,25,97.33,16.7
"2011","Sunderland 025E","E01008864","Total",1289,642,647,1289,0,28,70.59,18.3
"2011","Sunderland 025F","E01008865","Total",1379,664,715,1377,2,7,64.69,21.3
"2011","Sunderland 025G","E01008866","Total",1410,664,746,1410,0,5,54.17,26.0
"2011","Sunderland 026A","E01008773","Total",1402,653,749,1396,6,10,30.13,46.5
"2011","Sunderland 026B","E01008776","Total",1243,554,689,1182,61,5,23.60,52.7
"2011","Sunderland 026C","E01008777","Total",1348,619,729,1341,7,5,34.58,39.0
"2011","Sunderland 026D","E01008778","Total",1379,629,750,1379,0,6,21.80,63.3
"2011","Sunderland 026E","E01008809","Total",1541,721,820,1541,0,5,143.25,10.8
"2011","Sunderland 027A","E01008803","Total",1433,681,752,1422,11,4,23.18,61.8
"2011","Sunderland 027B","E01008804","Total",1633,778,855,1589,44,8,43.02,38.0
"2011","Sunderland 027C","E01008805","Total",1426,690,736,1426,0,2,17.42,81.9
"2011","Sunderland 027F","E01033077","Total",1798,865,933,1798,0,9,66.94,26.9
"2011","Sunderland 028A","E01008763","Total",1505,709,796,1500,5,5,48.86,30.8
"2011","Sunderland 028B","E01008764","Total",1496,720,776,1496,0,7,60.65,24.7
"2011","Sunderland 028C","E01008766","Total",2280,1104,1176,2228,52,9,120.05,19.0
"2011","Sunderland 028D","E01008768","Total",1437,706,731,1411,26,4,164.29,8.7
"2011","Sunderland 028E","E01008769","Total",1717,796,921,1700,17,5,31.19,55.0
"2011","Sunderland 029A","E01008772","Total",1366,672,694,1366,0,18,132.16,10.3
"2011","Sunderland 029B","E01008774","Total",1304,621,683,1304,0,4,24.20,53.9
"2011","Sunderland 029C","E01008775","Total",1407,690,717,1407,0,8,82.87,17.0
"2011","Sunderland 029D","E01008802","Total",1422,679,743,1422,0,11,53.51,26.6
"2011","Sunderland 029E","E01008808","Total",1442,717,725,1442,0,14,79.74,18.1
"2011","Sunderland 030A","E01008793","Total",1701,791,910,1701,0,6,42.68,39.9
"2011","Sunderland 030B","E01008795","Total",1797,892,905,1797,0,22,58.27,30.8
"2011","Sunderland 030C","E01008797","Total",1997,986,1011,1997,0,13,185.27,10.8
"2011","Sunderland 030D","E01008800","Total",1436,708,728,1436,0,2,25.57,56.2
"2011","Sunderland 030E","E01008801","Total",1597,795,802,1590,7,5,73.86,21.6
"2011","Sunderland 031A","E01008765","Total",1531,739,792,1531,0,6,564.00,2.7
"2011","Sunderland 031B","E01008767","Total",1492,698,794,1492,0,4,107.09,13.9
"2011","Sunderland 031C","E01008770","Total",1404,685,719,1404,0,12,78.06,18.0
"2011","Sunderland 031D","E01008771","Total",1521,747,774,1515,6,9,30.76,49.4
"2011","Sunderland 032A","E01008720","Total",1389,682,707,1389,0,8,522.68,2.7
"2011","Sunderland 032B","E01008721","Total",1620,799,821,1602,18,10,32.33,50.1
"2011","Sunderland 032D","E01008796","Total",1596,770,826,1523,73,7,72.37,22.1
"2011","Sunderland 032F","E01032483","Total",1702,841,861,1702,0,11,440.90,3.9
"2011","Sunderland 032G","E01032484","Total",1290,637,653,1281,9,11,602.86,2.1
"2011","Sunderland 033A","E01008750","Total",1906,944,962,1867,39,11,79.78,23.9
"2011","Sunderland 033B","E01008751","Total",1038,503,535,1038,0,5,46.82,22.2
"2011","Sunderland 033C","E01008752","Total",1634,786,848,1634,0,6,61.03,26.8
"2011","Sunderland 033D","E01008753","Total",1213,588,625,1213,0,3,42.15,28.8
"2011","Sunderland 033E","E01008755","Total",1338,634,704,1338,0,4,41.77,32.0
"2011","Sunderland 034A","E01008714","Total",1284,595,689,1284,0,10,34.74,37.0
"2011","Sunderland 034B","E01008715","Total",1303,654,649,1291,12,11,27.41,47.5
"2011","Sunderland 034C","E01008716","Total",1345,661,684,1345,0,5,106.87,12.6
"2011","Sunderland 034D","E01008717","Total",1635,772,863,1635,0,7,37.03,44.2
"2011","Sunderland 034E","E01008749","Total",1422,700,722,1422,0,11,54.82,25.9
"2011","Sunderland 034F","E01008754","Total",1417,654,763,1390,27,4,58.04,24.4
"2011","Sunderland 035A","E01008718","Total",1390,700,690,1384,6,8,57.91,24.0
"2011","Sunderland 035B","E01008719","Total",1228,583,645,1175,53,6,443.40,2.8
"2011","Sunderland 035C","E01008742","Total",1692,819,873,1689,3,15,78.36,21.6
"2011","Sunderland 035D","E01008747","Total",1410,656,754,1410,0,6,333.33,4.2
"2011","Sunderland 035E","E01008748","Total",1345,658,687,1345,0,7,139.70,9.6
"2011","Sunderland 036A","E01008743","Total",1688,798,890,1688,0,6,80.78,20.9
"2011","Sunderland 036B","E01008744","Total",1623,809,814,1616,7,9,489.68,3.3
"2011","Sunderland 036C","E01008745","Total",1645,799,846,1645,0,3,76.00,21.6
"2011","Sunderland 036D","E01008746","Total",1643,785,858,1643,0,7,361.42,4.5
"2011","Blackburn with Darwen 001A","E01012607","Total",1504,727,777,1504,0,11,167.95,9.0
"2011","Blackburn with Darwen 001B","E01012608","Total",1672,816,856,1640,32,7,55.25,30.3
"2011","Blackburn with Darwen 001C","E01012633","Total",1592,770,822,1592,0,15,74.75,21.3
"2011","Blackburn with Darwen 001D","E01012634","Total",1386,699,687,1386,0,15,37.16,37.3
"2011","Blackburn with Darwen 001E","E01012635","Total",1641,825,816,1641,0,23,48.45,33.9
"2011","Blackburn with Darwen 001F","E01012636","Total",1503,722,781,1503,0,14,92.28,16.3
"2011","Blackburn with Darwen 002A","E01012581","Total",1243,628,615,1243,0,19,61.29,20.3
"2011","Blackburn with Darwen 002B","E01012582","Total",1639,808,831,1618,21,46,40.86,40.1
"2011","Blackburn with Darwen 002C","E01012583","Total",1642,803,839,1642,0,27,75.71,21.7
"2011","Blackburn with Darwen 002D","E01012587","Total",1988,988,1000,1938,50,36,59.95,33.2
"2011","Blackburn with Darwen 002E","E01012588","Total",2105,1035,1070,2086,19,40,14.44,145.8
"2011","Blackburn with Darwen 003A","E01012574","Total",1447,729,718,1439,8,4,14.79,97.8
"2011","Blackburn with Darwen 003B","E01012577","Total",1914,953,961,1914,0,24,16.83,113.7
"2011","Blackburn with Darwen 003C","E01012578","Total",1976,979,997,1976,0,18,20.25,97.6
"2011","Blackburn with Darwen 003D","E01012605","Total",1895,942,953,1883,12,12,17.46,108.5
"2011","Blackburn with Darwen 003E","E01012606","Total",1681,856,825,1681,0,8,75.70,22.2
"2011","Blackburn with Darwen 004A","E01012579","Total",1650,812,838,1650,0,17,17.38,94.9
"2011","Blackburn with Darwen 004B","E01012580","Total",2159,1118,1041,2159,0,22,19.45,111.0
"2011","Blackburn with Darwen 004C","E01012642","Total",1742,873,869,1643,99,15,19.53,89.2
"2011","Blackburn with Darwen 004D","E01012645","Total",1992,958,1034,1948,44,30,21.02,94.8
"2011","Blackburn with Darwen 005A","E01012585","Total",1633,799,834,1512,121,24,28.11,58.1
"2011","Blackburn with Darwen 005B","E01012586","Total",1627,866,761,1594,33,20,15.33,106.1
"2011","Blackburn with Darwen 005C","E01012656","Total",1668,872,796,1648,20,18,23.83,70.0
"2011","Blackburn with Darwen 005D","E01012657","Total",2031,1061,970,2029,2,20,13.80,147.2
"2011","Blackburn with Darwen 005E","E01012658","Total",1825,918,907,1799,26,7,28.70,63.6
"2011","Blackburn with Darwen 006A","E01012629","Total",1145,599,546,1109,36,8,50.70,22.6
"2011","Blackburn with Darwen 006B","E01012631","Total",1292,652,640,1279,13,6,33.23,38.9
"2011","Blackburn with Darwen 006C","E01012643","Total",1635,805,830,1600,35,12,50.10,32.6
"2011","Blackburn with Darwen 006D","E01012644","Total",2539,1325,1214,2507,32,23,35.54,71.4
"2011","Blackburn with Darwen 006E","E01012655","Total",1854,1070,784,1668,186,6,75.67,24.5
"2011","Blackburn with Darwen 007A","E01012571","Total",1474,756,718,1474,0,23,15.07,97.8
"2011","Blackburn with Darwen 007B","E01012572","Total",1552,788,764,1552,0,12,22.84,68.0
"2011","Blackburn with Darwen 007C","E01012573","Total",1800,924,876,1800,0,12,10.64,169.2
"2011","Blackburn with Darwen 007D","E01012575","Total",1284,622,662,1284,0,17,49.22,26.1
"2011","Blackburn with Darwen 007E","E01012630","Total",2271,1172,1099,2271,0,29,21.62,105.0
"2011","Blackburn with Darwen 008A","E01012576","Total",1626,888,738,1450,176,15,47.26,34.4
"2011","Blackburn with Darwen 008B","E01012637","Total",1583,764,819,1583,0,16,74.48,21.3
"2011","Blackburn with Darwen 008C","E01012638","Total",1662,845,817,1607,55,17,28.75,57.8
"2011","Blackburn with Darwen 008D","E01012639","Total",1803,905,898,1803,0,9,45.33,39.8
"2011","Blackburn with Darwen 008E","E01012640","Total",1751,887,864,1751,0,7,30.10,58.2
"2011","Blackburn with Darwen 008F","E01012641","Total",1712,812,900,1672,40,4,31.24,54.8
"2011","Blackburn with Darwen 009A","E01012595","Total",1903,927,976,1866,37,10,53.86,35.3
"2011","Blackburn with Darwen 009B","E01012596","Total",1776,865,911,1773,3,8,19.96,89.0
"2011","Blackburn with Darwen 009C","E01012622","Total",1651,836,815,1651,0,7,37.70,43.8
"2011","Blackburn with Darwen 009D","E01012623","Total",1533,775,758,1530,3,6,21.83,70.2
"2011","Blackburn with Darwen 009E","E01012624","Total",1570,799,771,1570,0,13,30.65,51.2
"2011","Blackburn with Darwen 009F","E01012625","Total",1633,821,812,1616,17,12,41.26,39.6
"2011","Blackburn with Darwen 010A","E01012584","Total",1473,739,734,1445,28,40,297.77,4.9
"2011","Blackburn with Darwen 010B","E01012609","Total",1577,779,798,1577,0,29,240.42,6.6
"2011","Blackburn with Darwen 010C","E01012610","Total",1274,622,652,1274,0,25,51.52,24.7
"2011","Blackburn with Darwen 010D","E01012611","Total",1051,516,535,1051,0,21,750.39,1.4
"2011","Blackburn with Darwen 010E","E01012612","Total",1399,675,724,1395,4,26,31.63,44.2
"2011","Blackburn with Darwen 010F","E01012613","Total",1347,675,672,1314,33,18,50.81,26.5
"2011","Blackburn with Darwen 011A","E01012600","Total",1442,715,727,1336,106,8,37.96,38.0
"2011","Blackburn with Darwen 011B","E01012601","Total",1531,747,784,1531,0,10,36.40,42.1
"2011","Blackburn with Darwen 011C","E01012602","Total",1601,786,815,1601,0,11,74.58,21.5
"2011","Blackburn with Darwen 011D","E01012603","Total",1580,775,805,1573,7,7,35.79,44.1
"2011","Blackburn with Darwen 011E","E01012604","Total",1686,777,909,1652,34,11,36.28,46.5
"2011","Blackburn with Darwen 011F","E01012632","Total",2090,1039,1051,2090,0,23,277.37,7.5
"2011","Blackburn with Darwen 012A","E01012594","Total",1473,697,776,1473,0,8,21.67,68.0
"2011","Blackburn with Darwen 012B","E01012618","Total",1465,711,754,1424,41,20,47.09,31.1
"2011","Blackburn with Darwen 012C","E01012619","Total",1400,692,708,1400,0,12,24.58,57.0
"2011","Blackburn with Darwen 012D","E01012620","Total",1388,680,708,1388,0,11,76.62,18.1
"2011","Blackburn with Darwen 012E","E01012621","Total",1490,709,781,1482,8,16,18.39,81.0
"2011","Blackburn with Darwen 013A","E01012593","Total",1775,886,889,1768,7,7,37.48,47.4
"2011","Blackburn with Darwen 013B","E01012597","Total",1767,907,860,1767,0,20,64.78,27.3
"2011","Blackburn with Darwen 013C","E01012598","Total",2992,1511,1481,2992,0,23,132.47,22.6
"2011","Blackburn with Darwen 013D","E01012599","Total",1169,596,573,1145,24,6,57.94,20.2
"2011","Blackburn with Darwen 014A","E01012589","Total",1422,684,738,1386,36,2,37.24,38.2
"2011","Blackburn with Darwen 014B","E01012590","Total",1356,635,721,1345,11,10,67.99,19.9
"2011","Blackburn with Darwen 014C","E01012591","Total",1561,742,819,1466,95,5,135.76,11.5
"2011","Blackburn with Darwen 014D","E01012648","Total",1178,591,587,1178,0,10,38.53,30.6
"2011","Blackburn with Darwen 014E","E01012652","Total",1539,755,784,1536,3,25,103.25,14.9
"2011","Blackburn with Darwen 015A","E01012617","Total",1393,675,718,1393,0,8,38.60,36.1
"2011","Blackburn with Darwen 015B","E01012646","Total",1669,815,854,1653,16,4,28.33,58.9
"2011","Blackburn with Darwen 015C","E01012647","Total",1342,652,690,1342,0,6,47.40,28.3
"2011","Blackburn with Darwen 015D","E01012650","Total",1379,686,693,1379,0,8,13.70,100.7
"2011","Blackburn with Darwen 016A","E01012649","Total",1462,712,750,1407,55,14,47.14,31.0
"2011","Blackburn with Darwen 016B","E01012651","Total",1693,824,869,1684,9,7,23.55,71.9
"2011","Blackburn with Darwen 016C","E01012653","Total",1294,644,650,1294,0,13,247.86,5.2
"2011","Blackburn with Darwen 016D","E01012654","Total",1657,860,797,1657,0,15,42.61,38.9
"2011","Blackburn with Darwen 017A","E01012614","Total",1745,878,867,1745,0,13,48.31,36.1
"2011","Blackburn with Darwen 017B","E01012615","Total",1495,730,765,1495,0,6,39.82,37.5
"2011","Blackburn with Darwen 017C","E01012616","Total",1782,895,887,1782,0,19,255.69,7.0
"2011","Blackburn with Darwen 017D","E01012659","Total",1411,683,728,1386,25,17,53.78,26.2
"2011","Blackburn with Darwen 017E","E01012660","Total",1170,599,571,1170,0,19,690.08,1.7
"2011","Blackburn with Darwen 017F","E01012661","Total",1498,769,729,1498,0,14,21.78,68.8
"2011","Blackburn with Darwen 018A","E01012592","Total",1924,950,974,1924,0,31,1132.74,1.7
"2011","Blackburn with Darwen 018D","E01012628","Total",1165,591,574,1165,0,27,3315.38,0.4
"2011","Blackburn with Darwen 018E","E01032485","Total",1766,874,892,1766,0,45,2868.37,0.6
"2011","Blackburn with Darwen 018F","E01032486","Total",1414,675,739,1414,0,33,114.01,12.4
"2011","Blackpool 001A","E01012663","Total",1602,765,837,1602,0,13,44.99,35.6
"2011","Blackpool 001B","E01012664","Total",1639,739,900,1616,23,15,25.71,63.7
"2011","Blackpool 001C","E01012665","Total",1642,773,869,1642,0,13,35.37,46.4
"2011","Blackpool 001D","E01012716","Total",1479,715,764,1427,52,19,44.14,33.5
"2011","Blackpool 001E","E01012719","Total",1446,668,778,1396,50,11,24.86,58.2
"2011","Blackpool 002A","E01012662","Total",1459,643,816,1459,0,14,27.65,52.8
"2011","Blackpool 002B","E01012703","Total",1499,714,785,1494,5,11,36.22,41.4
"2011","Blackpool 002C","E01012704","Total",1993,990,1003,1993,0,12,81.19,24.5
"2011","Blackpool 002D","E01012706","Total",1645,789,856,1645,0,18,36.07,45.6
"2011","Blackpool 002E","E01012717","Total",1660,819,841,1660,0,30,76.63,21.7
"2011","Blackpool 003A","E01012666","Total",1458,724,734,1341,117,8,27.94,52.2
"2011","Blackpool 003B","E01012667","Total",1563,752,811,1536,27,19,26.22,59.6
"2011","Blackpool 003C","E01012668","Total",1570,758,812,1535,35,12,45.38,34.6
"2011","Blackpool 003D","E01012669","Total",1784,883,901,1751,33,24,54.91,32.5
"2011","Blackpool 003E","E01012718","Total",1621,764,857,1621,0,15,37.34,43.4
"2011","Blackpool 004A","E01012690","Total",1727,834,893,1727,0,22,41.57,41.5
"2011","Blackpool 004B","E01012691","Total",1868,887,981,1863,5,14,45.27,41.3
"2011","Blackpool 004C","E01012692","Total",1720,813,907,1720,0,14,82.91,20.7
"2011","Blackpool 004D","E01012705","Total",1624,779,845,1618,6,9,40.77,39.8
"2011","Blackpool 004E","E01012723","Total",1435,666,769,1435,0,18,52.42,27.4
"2011","Blackpool 005A","E01012693","Total",1550,741,809,1550,0,11,36.06,43.0
"2011","Blackpool 005B","E01012711","Total",1384,684,700,1367,17,9,33.80,40.9
"2011","Blackpool 005C","E01012747","Total",1515,734,781,1494,21,21,24.47,61.9
"2011","Blackpool 005D","E01012750","Total",1740,859,881,1732,8,14,26.63,65.3
"2011","Blackpool 006A","E01012681","Total",1550,989,561,1203,347,4,37.42,41.4
"2011","Blackpool 006B","E01012683","Total",1445,826,619,1418,27,8,18.89,76.5
"2011","Blackpool 006C","E01012748","Total",1656,837,819,1471,185,7,37.76,43.9
"2011","Blackpool 006D","E01012749","Total",1755,926,829,1578,177,8,24.17,72.6
"2011","Blackpool 007A","E01012707","Total",1228,593,635,1228,0,12,26.90,45.7
"2011","Blackpool 007B","E01012720","Total",1601,743,858,1588,13,7,27.92,57.3
"2011","Blackpool 007C","E01012721","Total",1679,819,860,1679,0,8,23.08,72.7
"2011","Blackpool 007D","E01012724","Total",1262,648,614,1251,11,9,35.27,35.8
"2011","Blackpool 008A","E01012678","Total",1386,786,600,1386,0,0,15.43,89.8
"2011","Blackpool 008B","E01012679","Total",1448,715,733,1438,10,5,13.72,105.5
"2011","Blackpool 008C","E01012680","Total",1593,780,813,1593,0,7,27.03,58.9
"2011","Blackpool 008D","E01012682","Total",1433,721,712,1421,12,4,19.01,75.4
"2011","Blackpool 008E","E01012684","Total",1457,710,747,1421,36,0,11.92,122.2
"2011","Blackpool 009A","E01012676","Total",1370,636,734,1364,6,10,18.06,75.9
"2011","Blackpool 009B","E01012677","Total",1381,656,725,1381,0,15,22.53,61.3
"2011","Blackpool 009C","E01012708","Total",1359,638,721,1359,0,13,21.96,61.9
"2011","Blackpool 009D","E01012709","Total",1612,739,873,1612,0,12,21.00,76.8
"2011","Blackpool 009E","E01012710","Total",1262,586,676,1177,85,18,27.65,45.6
"2011","Blackpool 009F","E01012722","Total",1284,648,636,1213,71,15,96.93,13.2
"2011","Blackpool 010A","E01012673","Total",1367,744,623,1339,28,4,15.85,86.2
"2011","Blackpool 010B","E01012675","Total",1553,793,760,1550,3,12,14.63,106.2
"2011","Blackpool 010C","E01012735","Total",1322,690,632,1214,108,5,16.88,78.3
"2011","Blackpool 010D","E01012736","Total",1382,754,628,734,648,1,45.19,30.6
"2011","Blackpool 010E","E01012737","Total",1457,855,602,1387,70,11,30.53,47.7
"2011","Blackpool 011A","E01012670","Total",1248,613,635,1199,49,8,8.77,142.3
"2011","Blackpool 011B","E01012733","Total",1027,540,487,1012,15,2,9.96,103.1
"2011","Blackpool 011C","E01012734","Total",1430,700,730,1418,12,10,15.42,92.7
"2011","Blackpool 011D","E01012738","Total",1272,646,626,1272,0,14,11.59,109.7
"2011","Blackpool 011E","E01012739","Total",1383,674,709,1383,0,10,15.41,89.7
"2011","Blackpool 011F","E01012742","Total",1142,547,595,1138,4,6,18.95,60.3
"2011","Blackpool 012A","E01012712","Total",1698,831,867,1698,0,24,115.16,14.7
"2011","Blackpool 012B","E01012713","Total",1918,916,1002,1918,0,23,124.53,15.4
"2011","Blackpool 012C","E01012715","Total",1555,742,813,1555,0,15,24.42,63.7
"2011","Blackpool 012D","E01012740","Total",1502,738,764,1429,73,18,25.33,59.3
"2011","Blackpool 012E","E01012741","Total",1362,659,703,1362,0,6,20.83,65.4
"2011","Blackpool 013A","E01012671","Total",1385,734,651,1058,327,3,28.40,48.8
"2011","Blackpool 013B","E01012672","Total",1282,704,578,983,299,8,27.24,47.1
"2011","Blackpool 013C","E01012674","Total",1645,893,752,1592,53,6,35.41,46.5
"2011","Blackpool 013D","E01012751","Total",1465,816,649,1178,287,6,26.12,56.1
"2011","Blackpool 014A","E01012686","Total",1472,705,767,1472,0,6,25.53,57.7
"2011","Blackpool 014B","E01012687","Total",1425,700,725,1425,0,10,63.19,22.6
"2011","Blackpool 014C","E01012688","Total",1231,565,666,1230,1,3,74.31,16.6
"2011","Blackpool 014D","E01012689","Total",1293,641,652,1292,1,9,28.88,44.8
"2011","Blackpool 014E","E01012714","Total",1681,787,894,1650,31,14,168.83,10.0
"2011","Blackpool 015A","E01012695","Total",1395,686,709,1395,0,14,15.01,92.9
"2011","Blackpool 015B","E01012743","Total",1707,843,864,1699,8,13,24.92,68.5
"2011","Blackpool 015C","E01012744","Total",1609,738,871,1609,0,6,18.18,88.5
"2011","Blackpool 015D","E01012745","Total",1682,852,830,1674,8,11,30.76,54.7
"2011","Blackpool 015E","E01012746","Total",1810,875,935,1780,30,5,28.55,63.4
"2011","Blackpool 016A","E01012685","Total",1489,721,768,1484,5,6,34.77,42.8
"2011","Blackpool 016B","E01012694","Total",1380,670,710,1380,0,15,18.56,74.4
"2011","Blackpool 016C","E01012696","Total",1563,739,824,1563,0,14,19.83,78.8
"2011","Blackpool 016D","E01012697","Total",1377,656,721,1375,2,17,26.74,51.5
"2011","Blackpool 016E","E01012698","Total",1520,739,781,1520,0,7,19.96,76.2
"2011","Blackpool 017A","E01012726","Total",1805,853,952,1690,115,17,27.29,66.1
"2011","Blackpool 017B","E01012728","Total",1554,775,779,1509,45,7,20.14,77.2
"2011","Blackpool 017C","E01012752","Total",1367,651,716,1189,178,8,52.22,26.2
"2011","Blackpool 017D","E01012753","Total",1189,582,607,1154,35,5,22.22,53.5
"2011","Blackpool 017E","E01012754","Total",1197,597,600,1151,46,12,16.49,72.6
"2011","Blackpool 017F","E01012755","Total",1475,746,729,1430,45,19,28.75,51.3
"2011","Blackpool 018A","E01012701","Total",1453,695,758,1453,0,19,29.86,48.7
"2011","Blackpool 018B","E01012729","Total",1600,758,842,1600,0,8,32.38,49.4
"2011","Blackpool 018C","E01012730","Total",1640,781,859,1628,12,20,147.52,11.1
"2011","Blackpool 018D","E01012731","Total",1602,736,866,1591,11,5,144.29,11.1
"2011","Blackpool 018E","E01012732","Total",1688,774,914,1688,0,12,71.76,23.5
"2011","Blackpool 019A","E01012699","Total",1725,831,894,1722,3,18,27.26,63.3
"2011","Blackpool 019B","E01012700","Total",1825,880,945,1825,0,4,23.23,78.6
"2011","Blackpool 019C","E01012702","Total",1454,664,790,1424,30,7,22.22,65.4
"2011","Blackpool 019D","E01012725","Total",1468,672,796,1359,109,23,22.18,66.2
"2011","Blackpool 019E","E01012727","Total",1610,785,825,1575,35,19,36.48,44.1
"2011","Cheshire East 022A","E01018393","Total",2047,1028,1019,2045,2,53,4050.78,0.5
"2011","Cheshire East 022B","E01018411","Total",2320,1169,1151,2319,1,62,1054.44,2.2
"2011","Cheshire East 022C","E01018412","Total",1526,744,782,1516,10,34,2177.11,0.7
"2011","Cheshire East 023A","E01018413","Total",1277,622,655,1277,0,40,204.79,6.2
"2011","Cheshire East 023B","E01018414","Total",1372,684,688,1372,0,40,192.28,7.1
"2011","Cheshire East 023C","E01018415","Total",1642,745,897,1613,29,28,60.98,26.9
"2011","Cheshire East 023D","E01018416","Total",1314,648,666,1314,0,37,57.27,22.9
"2011","Cheshire East 024A","E01018424","Total",1696,839,857,1695,1,21,68.43,24.8
"2011","Cheshire East 024B","E01018425","Total",1625,799,826,1564,61,14,48.02,33.8
"2011","Cheshire East 024C","E01018426","Total",1602,814,788,1602,0,17,33.38,48.0
"2011","Cheshire East 024D","E01018427","Total",1325,634,691,1283,42,23,72.11,18.4
"2011","Cheshire East 025A","E01018419","Total",1361,696,665,1361,0,24,92.93,14.6
"2011","Cheshire East 025B","E01018420","Total",1902,940,962,1902,0,20,53.00,35.9
"2011","Cheshire East 025C","E01018421","Total",1342,669,673,1342,0,6,78.86,17.0
"2011","Cheshire East 025D","E01018422","Total",1286,632,654,1285,1,14,327.70,3.9
"2011","Cheshire East 025E","E01018423","Total",1456,691,765,1456,0,7,25.41,57.3
"2011","Cheshire East 026A","E01018395","Total",1603,822,781,1603,0,11,428.99,3.7
"2011","Cheshire East 026B","E01018396","Total",1482,710,772,1479,3,22,36.28,40.8
"2011","Cheshire East 026C","E01018400","Total",2157,1055,1102,2090,67,16,59.90,36.0
"2011","Cheshire East 026D","E01018401","Total",1576,804,772,1575,1,20,41.35,38.1
"2011","Cheshire East 027A","E01018398","Total",1459,695,764,1451,8,3,41.86,34.9
"2011","Cheshire East 027B","E01018399","Total",1501,745,756,1471,30,28,66.59,22.5
"2011","Cheshire East 027C","E01018402","Total",1910,964,946,1828,82,13,68.84,27.7
"2011","Cheshire East 027D","E01018403","Total",1953,967,986,1953,0,24,87.19,22.4
"2011","Cheshire East 028A","E01018397","Total",1831,881,950,1788,43,26,109.45,16.7
"2011","Cheshire East 028B","E01018408","Total",1784,878,906,1782,2,26,70.29,25.4
"2011","Cheshire East 028C","E01018409","Total",1847,901,946,1838,9,21,64.88,28.5
"2011","Cheshire East 028D","E01018410","Total",1567,766,801,1543,24,32,71.83,21.8
"2011","Cheshire East 029A","E01018404","Total",1490,731,759,1458,32,29,228.01,6.5
"2011","Cheshire East 029B","E01018405","Total",1397,698,699,1362,35,17,36.27,38.5
"2011","Cheshire East 029C","E01018406","Total",1444,726,718,1444,0,22,757.71,1.9
"2011","Cheshire East 029D","E01018407","Total",1481,699,782,1481,0,30,85.93,17.2
"2011","Cheshire East 030A","E01018436","Total",1416,679,737,1392,24,26,83.55,16.9
"2011","Cheshire East 030B","E01018437","Total",1579,749,830,1567,12,19,39.83,39.6
"2011","Cheshire East 030C","E01018438","Total",1414,687,727,1414,0,30,115.70,12.2
"2011","Cheshire East 030D","E01018439","Total",1339,638,701,1308,31,32,224.81,6.0
"2011","Cheshire East 031A","E01018440","Total",1780,888,892,1733,47,31,93.44,19.0
"2011","Cheshire East 031B","E01018441","Total",1690,845,845,1690,0,29,129.68,13.0
"2011","Cheshire East 031C","E01018442","Total",1829,886,943,1829,0,31,163.81,11.2
"2011","Cheshire East 031D","E01018443","Total",1493,760,733,1493,0,30,297.13,5.0
"2011","Cheshire East 032A","E01018432","Total",1495,759,736,1492,3,29,43.84,34.1
"2011","Cheshire East 032B","E01018433","Total",1253,590,663,1228,25,26,132.80,9.4
"2011","Cheshire East 032C","E01018434","Total",1335,639,696,1335,0,17,122.66,10.9
"2011","Cheshire East 032D","E01018435","Total",1353,661,692,1353,0,15,55.72,24.3
"2011","Cheshire East 033A","E01018394","Total",2053,1031,1022,2047,6,38,4227.98,0.5
"2011","Cheshire East 033B","E01018417","Total",1629,793,836,1577,52,19,449.81,3.6
"2011","Cheshire East 033C","E01018418","Total",1510,749,761,1485,25,31,1619.63,0.9
"2011","Cheshire East 033D","E01018428","Total",1399,692,707,1399,0,13,348.33,4.0
"2011","Cheshire East 033E","E01018429","Total",1492,733,759,1492,0,14,157.33,9.5
"2011","Cheshire East 033F","E01018430","Total",1388,694,694,1388,0,13,84.32,16.5
"2011","Cheshire East 033G","E01018431","Total",1163,594,569,1163,0,23,949.01,1.2
"2011","Cheshire East 040A","E01018387","Total",1684,807,877,1684,0,46,165.02,10.2
"2011","Cheshire East 040B","E01018388","Total",1568,773,795,1568,0,19,39.42,39.8
"2011","Cheshire East 040C","E01018389","Total",1607,741,866,1586,21,35,95.03,16.9
"2011","Cheshire East 040D","E01018390","Total",1666,815,851,1666,0,16,227.69,7.3
"2011","Cheshire East 042A","E01018386","Total",1418,715,703,1333,85,35,101.95,13.9
"2011","Cheshire East 042B","E01018391","Total",1933,931,1002,1931,2,22,231.19,8.4
"2011","Cheshire East 042C","E01018392","Total",1899,936,963,1899,0,42,46.74,40.6
"2011","Cheshire East 034A","E01018472","Total",1386,685,701,1386,0,8,25.99,53.3
"2011","Cheshire East 034B","E01018473","Total",1671,873,798,1671,0,16,26.88,62.2
"2011","Cheshire East 034C","E01018474","Total",1870,947,923,1838,32,27,33.21,56.3
"2011","Cheshire East 034D","E01018475","Total",1873,974,899,1873,0,22,41.59,45.0
"2011","Cheshire East 035A","E01018463","Total",1482,721,761,1482,0,3,32.25,46.0
"2011","Cheshire East 035B","E01018476","Total",1428,648,780,1358,70,4,19.55,73.0
"2011","Cheshire East 035C","E01018477","Total",1533,744,789,1492,41,10,46.64,32.9
"2011","Cheshire East 035D","E01018478","Total",1467,717,750,1467,0,7,107.10,13.7
"2011","Cheshire East 035E","E01018479","Total",1603,797,806,1603,0,8,209.31,7.7
"2011","Cheshire East 036A","E01018459","Total",1410,660,750,1410,0,6,23.95,58.9
"2011","Cheshire East 036B","E01018460","Total",1400,675,725,1400,0,13,32.88,42.6
"2011","Cheshire East 036C","E01018461","Total",1401,684,717,1401,0,4,31.36,44.7
"2011","Cheshire East 036D","E01018466","Total",2304,1154,1150,2304,0,9,34.86,66.1
"2011","Cheshire East 036E","E01018467","Total",2192,1134,1058,2192,0,19,49.12,44.6
"2011","Cheshire East 037A","E01018482","Total",1401,689,712,1401,0,5,217.90,6.4
"2011","Cheshire East 037B","E01018483","Total",1370,683,687,1370,0,5,79.14,17.3
"2011","Cheshire East 037C","E01018484","Total",2402,1114,1288,2353,49,16,80.48,29.8
"2011","Cheshire East 037D","E01018485","Total",1540,773,767,1540,0,6,21.39,72.0
"2011","Cheshire East 038A","E01018499","Total",1544,764,780,1544,0,12,70.32,22.0
"2011","Cheshire East 038B","E01018500","Total",1254,621,633,1254,0,7,27.16,46.2
"2011","Cheshire East 038C","E01018501","Total",1579,771,808,1572,7,6,141.43,11.2
"2011","Cheshire East 038D","E01018502","Total",2059,1000,1059,1176,883,57,151.21,13.6
"2011","Cheshire East 039A","E01018462","Total",1473,727,746,1417,56,8,38.30,38.5
"2011","Cheshire East 039B","E01018464","Total",1390,712,678,1375,15,6,73.06,19.0
"2011","Cheshire East 039C","E01018496","Total",1687,842,845,1680,7,13,29.00,58.2
"2011","Cheshire East 039D","E01018497","Total",1174,588,586,1174,0,7,34.25,34.3
"2011","Cheshire East 039E","E01018498","Total",1570,737,833,1517,53,8,46.96,33.4
"2011","Cheshire East 041A","E01018465","Total",2843,1421,1422,2842,1,28,3087.80,0.9
"2011","Cheshire East 041B","E01018468","Total",1623,790,833,1623,0,51,43.13,37.6
"2011","Cheshire East 041C","E01018469","Total",1621,766,855,1529,92,26,517.52,3.1
"2011","Cheshire East 041D","E01018470","Total",1482,715,767,1481,1,45,345.82,4.3
"2011","Cheshire East 041E","E01018471","Total",1493,727,766,1493,0,23,42.63,35.0
"2011","Cheshire East 043A","E01018486","Total",1474,792,682,1474,0,8,28.37,52.0
"2011","Cheshire East 043B","E01018487","Total",1650,832,818,1650,0,13,16.66,99.0
"2011","Cheshire East 043C","E01018488","Total",1518,771,747,1518,0,18,47.06,32.3
"2011","Cheshire East 043D","E01018489","Total",1366,726,640,1366,0,9,10.82,126.2
"2011","Cheshire East 044A","E01018510","Total",1616,806,810,1603,13,19,326.92,4.9
"2011","Cheshire East 044B","E01018511","Total",1445,693,752,1445,0,7,43.28,33.4
"2011","Cheshire East 044C","E01018512","Total",1690,791,899,1690,0,14,42.60,39.7
"2011","Cheshire East 044D","E01018513","Total",1623,817,806,1623,0,13,40.13,40.4
"2011","Cheshire East 045A","E01018445","Total",1927,962,965,1910,17,9,72.36,26.6
"2011","Cheshire East 045B","E01018446","Total",1336,654,682,1289,47,17,35.18,38.0
"2011","Cheshire East 045C","E01018447","Total",1739,901,838,1737,2,15,21.11,82.4
"2011","Cheshire East 045D","E01018448","Total",1735,882,853,1735,0,18,38.02,45.6
"2011","Cheshire East 046A","E01018490","Total",1448,699,749,1448,0,17,62.51,23.2
"2011","Cheshire East 046B","E01018491","Total",1428,699,729,1428,0,21,190.72,7.5
"2011","Cheshire East 046C","E01018492","Total",1066,524,542,1066,0,7,24.01,44.4
"2011","Cheshire East 046D","E01018505","Total",1086,546,540,1083,3,20,184.21,5.9
"2011","Cheshire East 046E","E01018506","Total",1421,709,712,1421,0,35,43.77,32.5
"2011","Cheshire East 046F","E01018507","Total",1404,716,688,1400,4,30,41.33,34.0
"2011","Cheshire East 047A","E01018451","Total",1324,605,719,1324,0,11,24.60,53.8
"2011","Cheshire East 047B","E01018454","Total",1522,766,756,1517,5,7,24.59,61.9
"2011","Cheshire East 047C","E01018455","Total",1325,635,690,1292,33,11,147.96,9.0
"2011","Cheshire East 047D","E01018456","Total",1294,593,701,1235,59,22,57.24,22.6
"2011","Cheshire East 047E","E01018457","Total",1433,699,734,1419,14,10,28.00,51.2
"2011","Cheshire East 049A","E01018444","Total",2157,1072,1085,2122,35,48,4502.58,0.5
"2011","Cheshire East 049B","E01018480","Total",2172,1090,1082,1939,233,58,6074.61,0.4
"2011","Cheshire East 049C","E01018515","Total",2325,1173,1152,2322,3,52,3746.96,0.6
"2011","Cheshire East 049D","E01018516","Total",1460,733,727,1460,0,22,481.55,3.0
"2011","Cheshire East 049F","E01033375","Total",1342,660,682,1317,25,20,43.40,30.9
"2011","Cheshire East 049G","E01033376","Total",1178,589,589,1178,0,13,15.71,75.0
"2011","Cheshire East 049H","E01033378","Total",1401,701,700,1401,0,14,1174.54,1.2
"2011","Cheshire East 048A","E01018493","Total",1236,595,641,1236,0,8,48.09,25.7
"2011","Cheshire East 048B","E01018494","Total",1345,670,675,1345,0,16,278.78,4.8
"2011","Cheshire East 048C","E01018495","Total",1241,619,622,1241,0,6,102.85,12.1
"2011","Cheshire East 048D","E01018508","Total",1180,581,599,1180,0,29,140.00,8.4
"2011","Cheshire East 048E","E01018509","Total",1102,497,605,1102,0,8,47.31,23.3
"2011","Cheshire East 050A","E01018452","Total",1139,551,588,1139,0,12,22.84,49.9
"2011","Cheshire East 050C","E01018503","Total",1630,767,863,1566,64,36,63.88,25.5
"2011","Cheshire East 050D","E01018504","Total",1765,845,920,1727,38,16,51.95,34.0
"2011","Cheshire East 050E","E01033372","Total",1259,605,654,1259,0,12,27.70,45.5
"2011","Cheshire East 050F","E01033373","Total",1273,627,646,1273,0,9,59.84,21.3
"2011","Cheshire East 051A","E01018449","Total",1725,843,882,1725,0,24,1960.72,0.9
"2011","Cheshire East 051B","E01018450","Total",2221,1084,1137,2136,85,36,4157.86,0.5
"2011","Cheshire East 051C","E01018458","Total",2136,1038,1098,2136,0,58,2272.85,0.9
"2011","Cheshire East 051D","E01018481","Total",1985,1018,967,1985,0,81,6579.27,0.3
"2011","Cheshire East 051E","E01018514","Total",1976,982,994,1959,17,40,3874.28,0.5
"2011","Cheshire East 001A","E01018585","Total",1382,672,710,1382,0,29,69.24,20.0
"2011","Cheshire East 001B","E01018586","Total",1536,771,765,1521,15,18,2154.78,0.7
"2011","Cheshire East 001C","E01018587","Total",1526,737,789,1491,35,35,181.62,8.4
"2011","Cheshire East 001D","E01018661","Total",1244,625,619,1244,0,21,389.54,3.2
"2011","Cheshire East 002A","E01018657","Total",1104,531,573,1104,0,17,22.74,48.5
"2011","Cheshire East 002B","E01018662","Total",1190,571,619,1190,0,21,81.64,14.6
"2011","Cheshire East 002C","E01018663","Total",1529,720,809,1529,0,31,80.78,18.9
"2011","Cheshire East 002D","E01018664","Total",1462,727,735,1462,0,45,185.24,7.9
"2011","Cheshire East 002E","E01018665","Total",1117,533,584,1117,0,19,61.70,18.1
"2011","Cheshire East 003A","E01018655","Total",1514,718,796,1478,36,28,61.91,24.5
"2011","Cheshire East 003B","E01018656","Total",1551,727,824,1452,99,32,47.19,32.9
"2011","Cheshire East 003C","E01018658","Total",1296,654,642,1296,0,35,19.58,66.2
"2011","Cheshire East 003D","E01018659","Total",1248,618,630,1248,0,30,199.13,6.3
"2011","Cheshire East 003E","E01018660","Total",1005,498,507,1005,0,21,51.63,19.5
"2011","Cheshire East 004A","E01018582","Total",1753,876,877,1694,59,37,243.56,7.2
"2011","Cheshire East 004B","E01018592","Total",1714,828,886,1710,4,25,90.50,18.9
"2011","Cheshire East 004C","E01018593","Total",1674,834,840,1674,0,42,289.68,5.8
"2011","Cheshire East 004D","E01018594","Total",1662,830,832,1649,13,12,29.79,55.8
"2011","Cheshire East 004E","E01018595","Total",1520,744,776,1520,0,22,50.37,30.2
"2011","Cheshire East 004F","E01018596","Total",1918,927,991,1918,0,24,36.81,52.1
"2011","Cheshire East 005A","E01018583","Total",1822,915,907,1822,0,33,53.59,34.0
"2011","Cheshire East 005B","E01018584","Total",1885,950,935,1885,0,68,72.18,26.1
"2011","Cheshire East 005C","E01018612","Total",1206,593,613,1206,0,19,65.53,18.4
"2011","Cheshire East 005D","E01018613","Total",1483,723,760,1483,0,8,35.12,42.2
"2011","Cheshire East 006A","E01018600","Total",1609,791,818,1609,0,46,467.05,3.4
"2011","Cheshire East 006B","E01018601","Total",1717,787,930,1686,31,23,41.13,41.7
"2011","Cheshire East 006C","E01018602","Total",1710,859,851,1710,0,72,113.17,15.1
"2011","Cheshire East 006D","E01018652","Total",1569,767,802,1563,6,77,74.68,21.0
"2011","Cheshire East 007A","E01018598","Total",1581,796,785,1578,3,40,3503.30,0.5
"2011","Cheshire East 007B","E01018599","Total",1145,552,593,1145,0,31,203.64,5.6
"2011","Cheshire East 007C","E01018648","Total",2172,1070,1102,2072,100,51,5614.61,0.4
"2011","Cheshire East 007D","E01018649","Total",1362,656,706,1283,79,29,1284.53,1.1
"2011","Cheshire East 007E","E01018650","Total",1688,802,886,1642,46,24,852.01,2.0
"2011","Cheshire East 007F","E01018651","Total",1582,621,961,1170,412,27,930.33,1.7
"2011","Cheshire East 007G","E01018654","Total",2277,1143,1134,2088,189,56,3904.07,0.6
"2011","Cheshire East 008A","E01018588","Total",1543,749,794,1543,0,35,39.48,39.1
"2011","Cheshire East 008B","E01018589","Total",1608,800,808,1608,0,42,67.72,23.7
"2011","Cheshire East 008C","E01018590","Total",1840,912,928,1840,0,50,71.29,25.8
"2011","Cheshire East 008D","E01018653","Total",1999,952,1047,1997,2,40,163.88,12.2
"2011","Cheshire East 009A","E01018605","Total",1137,545,592,1136,1,22,250.35,4.5
"2011","Cheshire East 009B","E01018609","Total",1688,795,893,1645,43,30,51.86,32.5
"2011","Cheshire East 009C","E01018610","Total",1910,906,1004,1910,0,22,40.78,46.8
"2011","Cheshire East 009D","E01018611","Total",1683,842,841,1683,0,7,89.77,18.7
"2011","Cheshire East 011A","E01018666","Total",1783,880,903,1783,0,93,497.25,3.6
"2011","Cheshire East 011B","E01018667","Total",1615,749,866,1590,25,44,1334.88,1.2
"2011","Cheshire East 011C","E01018668","Total",1730,791,939,1597,133,53,1734.31,1.0
"2011","Cheshire East 010A","E01018603","Total",1280,629,651,1280,0,44,58.21,22.0
"2011","Cheshire East 010B","E01018604","Total",1340,622,718,1340,0,27,59.96,22.3
"2011","Cheshire East 010C","E01018606","Total",1472,681,791,1461,11,18,65.45,22.5
"2011","Cheshire East 010D","E01018607","Total",1299,643,656,1299,0,41,291.17,4.5
"2011","Cheshire East 010E","E01018608","Total",1382,694,688,1382,0,51,97.68,14.1
"2011","Cheshire East 012A","E01018572","Total",1797,812,985,1661,136,57,471.53,3.8
"2011","Cheshire East 012B","E01018573","Total",1544,766,778,1544,0,44,192.23,8.0
"2011","Cheshire East 012C","E01018574","Total",1935,931,1004,1929,6,43,87.41,22.1
"2011","Cheshire East 012D","E01018580","Total",1531,751,780,1459,72,42,1971.67,0.8
"2011","Cheshire East 012E","E01018581","Total",1219,593,626,1219,0,28,296.29,4.1
"2011","Cheshire East 013A","E01018575","Total",1101,553,548,1101,0,22,47.04,23.4
"2011","Cheshire East 013B","E01018576","Total",1748,863,885,1748,0,22,129.91,13.5
"2011","Cheshire East 013C","E01018577","Total",2435,1196,1239,2399,36,32,193.35,12.6
"2011","Cheshire East 013D","E01018578","Total",1214,595,619,1191,23,24,123.95,9.8
"2011","Cheshire East 013E","E01018579","Total",1095,534,561,1083,12,4,88.13,12.4
"2011","Cheshire East 014A","E01018641","Total",1280,641,639,1280,0,37,48.07,26.6
"2011","Cheshire East 014B","E01018642","Total",1382,655,727,1382,0,34,40.99,33.7
"2011","Cheshire East 014C","E01018643","Total",1925,972,953,1925,0,92,118.86,16.2
"2011","Cheshire East 014D","E01018644","Total",1374,693,681,1372,2,20,50.59,27.2
"2011","Cheshire East 015A","E01018614","Total",1899,928,971,1882,17,44,43.64,43.5
"2011","Cheshire East 015B","E01018618","Total",1467,710,757,1467,0,11,35.02,41.9
"2011","Cheshire East 015C","E01018619","Total",1426,691,735,1426,0,47,130.08,11.0
"2011","Cheshire East 015D","E01018620","Total",1432,702,730,1355,77,38,127.15,11.3
"2011","Cheshire East 015E","E01018621","Total",1320,618,702,1320,0,28,29.44,44.8
"2011","Cheshire East 016A","E01018626","Total",2149,1049,1100,2136,13,19,69.90,30.7
"2011","Cheshire East 016B","E01018628","Total",1590,786,804,1590,0,31,218.18,7.3
"2011","Cheshire East 016C","E01018629","Total",1858,880,978,1858,0,18,64.72,28.7
"2011","Cheshire East 016D","E01018630","Total",1280,613,667,1280,0,18,24.58,52.1
"2011","Cheshire East 016E","E01018631","Total",1380,721,659,1380,0,9,79.18,17.4
"2011","Cheshire East 017A","E01018615","Total",1178,604,574,1161,17,17,45.30,26.0
"2011","Cheshire East 017B","E01018616","Total",1320,638,682,1207,113,40,67.10,19.7
"2011","Cheshire East 017C","E01018617","Total",1437,708,729,1413,24,13,37.77,38.0
"2011","Cheshire East 017D","E01018632","Total",1584,789,795,1573,11,23,47.70,33.2
"2011","Cheshire East 017E","E01018633","Total",1501,719,782,1465,36,38,40.44,37.1
"2011","Cheshire East 018A","E01018622","Total",1325,640,685,1325,0,13,18.50,71.6
"2011","Cheshire East 018B","E01018623","Total",1489,738,751,1489,0,14,17.39,85.6
"2011","Cheshire East 018C","E01018624","Total",1824,960,864,1824,0,19,56.29,32.4
"2011","Cheshire East 018D","E01018625","Total",1425,654,771,1384,41,21,12.87,110.7
"2011","Cheshire East 018E","E01018627","Total",1579,818,761,1571,8,17,39.08,40.4
"2011","Cheshire East 018F","E01018635","Total",1225,606,619,1187,38,13,43.71,28.0
"2011","Cheshire East 018G","E01018636","Total",1421,682,739,1421,0,21,36.87,38.5
"2011","Cheshire East 019A","E01018634","Total",1874,924,950,1874,0,36,34.71,54.0
"2011","Cheshire East 019B","E01018645","Total",1797,852,945,1797,0,14,28.53,63.0
"2011","Cheshire East 019C","E01018646","Total",1781,847,934,1781,0,16,45.74,38.9
"2011","Cheshire East 019D","E01018647","Total",1544,758,786,1544,0,26,41.84,36.9
"2011","Cheshire East 020A","E01018591","Total",2339,1138,1201,2339,0,42,4168.38,0.6
"2011","Cheshire East 020B","E01018597","Total",2373,1180,1193,2370,3,58,5877.34,0.4
"2011","Cheshire East 020C","E01018669","Total",2588,1261,1327,2571,17,75,3717.11,0.7
"2011","Cheshire East 020D","E01018670","Total",2357,1159,1198,2308,49,47,6612.25,0.4
"2011","Cheshire East 021A","E01018637","Total",1823,839,984,1737,86,18,102.52,17.8
"2011","Cheshire East 021B","E01018638","Total",1585,753,832,1539,46,20,166.59,9.5
"2011","Cheshire East 021C","E01018639","Total",1401,688,713,1384,17,9,59.64,23.5
"2011","Cheshire East 021D","E01018640","Total",1311,653,658,1311,0,0,21.15,62.0
"2011","Cheshire West and Chester 022A","E01018308","Total",1902,992,910,1867,35,35,2525.28,0.8
"2011","Cheshire West and Chester 022B","E01018336","Total",1233,602,631,1233,0,11,40.27,30.6
"2011","Cheshire West and Chester 022C","E01018337","Total",1331,661,670,1284,47,19,1621.01,0.8
"2011","Cheshire West and Chester 022D","E01018338","Total",1790,874,916,1790,0,24,65.24,27.4
"2011","Cheshire West and Chester 022E","E01018358","Total",1272,600,672,1176,96,32,563.18,2.3
"2011","Cheshire West and Chester 022F","E01018359","Total",1081,542,539,1076,5,30,844.38,1.3
"2011","Cheshire West and Chester 025A","E01018360","Total",2096,1005,1091,2006,90,38,2437.12,0.9
"2011","Cheshire West and Chester 025B","E01018366","Total",1515,752,763,1515,0,21,319.06,4.7
"2011","Cheshire West and Chester 025C","E01018367","Total",1984,973,1011,1933,51,37,1641.83,1.2
"2011","Cheshire West and Chester 027A","E01018364","Total",1565,745,820,1565,0,9,32.00,48.9
"2011","Cheshire West and Chester 027B","E01018365","Total",1860,876,984,1860,0,41,44.58,41.7
"2011","Cheshire West and Chester 027C","E01018378","Total",1230,577,653,1230,0,7,17.96,68.5
"2011","Cheshire West and Chester 027D","E01018379","Total",1347,639,708,1347,0,19,37.75,35.7
"2011","Cheshire West and Chester 027E","E01018380","Total",1176,565,611,1167,9,21,126.58,9.3
"2011","Cheshire West and Chester 028A","E01018362","Total",1516,711,805,1516,0,39,34.10,44.5
"2011","Cheshire West and Chester 028B","E01018363","Total",1048,510,538,1044,4,13,24.71,42.4
"2011","Cheshire West and Chester 028C","E01018374","Total",1894,913,981,1767,127,43,101.17,18.7
"2011","Cheshire West and Chester 028D","E01018375","Total",1802,881,921,1734,68,25,30.86,58.4
"2011","Cheshire West and Chester 028E","E01018376","Total",1640,759,881,1565,75,24,84.36,19.4
"2011","Cheshire West and Chester 028F","E01018377","Total",1647,833,814,1626,21,26,144.68,11.4
"2011","Cheshire West and Chester 029A","E01018309","Total",1648,778,870,1648,0,10,30.39,54.2
"2011","Cheshire West and Chester 029B","E01018310","Total",1531,711,820,1520,11,16,62.60,24.5
"2011","Cheshire West and Chester 029C","E01018311","Total",1388,671,717,1348,40,12,25.23,55.0
"2011","Cheshire West and Chester 029D","E01018312","Total",1493,717,776,1493,0,10,30.14,49.5
"2011","Cheshire West and Chester 031A","E01018313","Total",1357,658,699,1357,0,5,31.16,43.5
"2011","Cheshire West and Chester 031B","E01018314","Total",1644,768,876,1644,0,6,39.09,42.1
"2011","Cheshire West and Chester 031C","E01018315","Total",1125,551,574,1125,0,13,33.35,33.7
"2011","Cheshire West and Chester 031D","E01018316","Total",1431,696,735,1430,1,11,24.41,58.6
"2011","Cheshire West and Chester 031E","E01018317","Total",1482,748,734,1438,44,10,26.60,55.7
"2011","Cheshire West and Chester 030A","E01018349","Total",1618,781,837,1618,0,20,842.50,1.9
"2011","Cheshire West and Chester 030B","E01018350","Total",1927,934,993,1897,30,46,223.81,8.6
"2011","Cheshire West and Chester 030C","E01018368","Total",1377,645,732,1377,0,16,150.76,9.1
"2011","Cheshire West and Chester 030D","E01018370","Total",1351,665,686,1351,0,41,674.24,2.0
"2011","Cheshire West and Chester 032A","E01018345","Total",1317,625,692,1317,0,23,30.22,43.6
"2011","Cheshire West and Chester 032B","E01018346","Total",1370,673,697,1328,42,27,30.88,44.4
"2011","Cheshire West and Chester 032C","E01018347","Total",1355,685,670,1355,0,20,24.22,55.9
"2011","Cheshire West and Chester 032D","E01018383","Total",1531,752,779,1531,0,22,30.47,50.2
"2011","Cheshire West and Chester 032E","E01018384","Total",1446,691,755,1446,0,20,38.80,37.3
"2011","Cheshire West and Chester 033B","E01018327","Total",1998,1037,961,1989,9,20,32.52,61.4
"2011","Cheshire West and Chester 033C","E01018343","Total",1645,790,855,1497,148,15,28.61,57.5
"2011","Cheshire West and Chester 033D","E01018361","Total",1471,750,721,1453,18,22,26.05,56.5
"2011","Cheshire West and Chester 033E","E01032930","Total",1852,1014,838,1809,43,11,28.72,64.5
"2011","Cheshire West and Chester 033F","E01032931","Total",1085,588,497,1083,2,10,21.01,51.6
"2011","Cheshire West and Chester 034A","E01018326","Total",2012,1046,966,1955,57,20,130.79,15.4
"2011","Cheshire West and Chester 034B","E01018328","Total",1867,789,1078,1500,367,35,20.65,90.4
"2011","Cheshire West and Chester 034C","E01018329","Total",2137,1006,1131,2065,72,30,33.51,63.8
"2011","Cheshire West and Chester 034D","E01018330","Total",1243,547,696,1243,0,13,237.91,5.2
"2011","Cheshire West and Chester 034E","E01018331","Total",1650,750,900,1642,8,20,14.93,110.5
"2011","Cheshire West and Chester 036A","E01018319","Total",2109,1023,1086,2105,4,19,41.62,50.7
"2011","Cheshire West and Chester 036B","E01018344","Total",1936,953,983,1931,5,21,28.60,67.7
"2011","Cheshire West and Chester 036C","E01018381","Total",1196,591,605,1196,0,20,50.46,23.7
"2011","Cheshire West and Chester 036D","E01018382","Total",1532,745,787,1532,0,26,33.62,45.6
"2011","Cheshire West and Chester 039A","E01018323","Total",1383,627,756,1301,82,27,225.97,6.1
"2011","Cheshire West and Chester 039B","E01018324","Total",1317,653,664,1317,0,36,493.37,2.7
"2011","Cheshire West and Chester 039C","E01018325","Total",1467,718,749,1467,0,41,396.28,3.7
"2011","Cheshire West and Chester 039D","E01018385","Total",2028,980,1048,2028,0,47,836.18,2.4
"2011","Cheshire West and Chester 041A","E01018320","Total",1455,688,767,1455,0,27,40.65,35.8
"2011","Cheshire West and Chester 041B","E01018321","Total",1200,584,616,1200,0,28,46.09,26.0
"2011","Cheshire West and Chester 041C","E01018322","Total",1172,570,602,1172,0,35,62.96,18.6
"2011","Cheshire West and Chester 041D","E01018348","Total",2115,1042,1073,2115,0,37,585.54,3.6
"2011","Cheshire West and Chester 043A","E01018332","Total",1063,544,519,1062,1,32,56.72,18.7
"2011","Cheshire West and Chester 043B","E01018333","Total",1503,708,795,1455,48,45,122.25,12.3
"2011","Cheshire West and Chester 043C","E01018334","Total",1511,731,780,1511,0,38,47.35,31.9
"2011","Cheshire West and Chester 043D","E01018340","Total",1428,687,741,1427,1,29,93.56,15.3
"2011","Cheshire West and Chester 043E","E01018341","Total",1108,524,584,1108,0,13,153.11,7.2
"2011","Cheshire West and Chester 043F","E01018342","Total",1568,718,850,1566,2,10,50.04,31.3
"2011","Cheshire West and Chester 044A","E01018351","Total",1448,743,705,1448,0,6,23.58,61.4
"2011","Cheshire West and Chester 044B","E01018352","Total",1790,881,909,1790,0,16,33.92,52.8
"2011","Cheshire West and Chester 044C","E01018353","Total",1575,770,805,1575,0,20,35.70,44.1
"2011","Cheshire West and Chester 044D","E01018354","Total",1606,763,843,1606,0,15,37.82,42.5
"2011","Cheshire West and Chester 046A","E01018335","Total",2115,1049,1066,2115,0,39,4582.94,0.5
"2011","Cheshire West and Chester 046B","E01018369","Total",1678,794,884,1590,88,42,3554.76,0.5
"2011","Cheshire West and Chester 046C","E01018371","Total",1807,859,948,1807,0,41,2870.97,0.6
"2011","Cheshire West and Chester 046D","E01018372","Total",1896,950,946,1894,2,48,3431.20,0.6
"2011","Cheshire West and Chester 047A","E01018339","Total",2018,977,1041,2018,0,29,1293.35,1.6
"2011","Cheshire West and Chester 047B","E01018355","Total",1210,532,678,1152,58,20,397.33,3.0
"2011","Cheshire West and Chester 047C","E01018356","Total",1474,747,727,1474,0,30,3355.18,0.4
"2011","Cheshire West and Chester 047D","E01018357","Total",1291,631,660,1291,0,42,2730.04,0.5
"2011","Cheshire West and Chester 047E","E01018373","Total",1980,984,996,1980,0,49,5433.31,0.4
"2011","Cheshire West and Chester 001A","E01018534","Total",2521,1217,1304,2521,0,22,70.49,35.8
"2011","Cheshire West and Chester 001B","E01018535","Total",1524,736,788,1499,25,12,441.02,3.5
"2011","Cheshire West and Chester 001C","E01018536","Total",1647,787,860,1647,0,29,71.15,23.1
"2011","Cheshire West and Chester 001D","E01018537","Total",1944,901,1043,1906,38,44,713.41,2.7
"2011","Cheshire West and Chester 004A","E01018518","Total",1507,734,773,1507,0,37,1594.63,0.9
"2011","Cheshire West and Chester 004B","E01018569","Total",1283,645,638,1283,0,43,312.69,4.1
"2011","Cheshire West and Chester 004C","E01018570","Total",1200,588,612,1166,34,35,826.58,1.5
"2011","Cheshire West and Chester 004D","E01018571","Total",1342,625,717,1324,18,30,266.83,5.0
"2011","Cheshire West and Chester 005A","E01018546","Total",1479,704,775,1467,12,12,32.77,45.1
"2011","Cheshire West and Chester 005B","E01018547","Total",1384,675,709,1384,0,12,36.69,37.7
"2011","Cheshire West and Chester 005C","E01018548","Total",1577,758,819,1561,16,10,134.62,11.7
"2011","Cheshire West and Chester 005D","E01018549","Total",1412,715,697,1412,0,13,43.40,32.5
"2011","Cheshire West and Chester 006A","E01018532","Total",1855,884,971,1855,0,18,44.65,41.5
"2011","Cheshire West and Chester 006B","E01018533","Total",1506,756,750,1506,0,15,141.87,10.6
"2011","Cheshire West and Chester 006C","E01018544","Total",1491,711,780,1487,4,44,33.24,44.9
"2011","Cheshire West and Chester 006D","E01018545","Total",1920,918,1002,1913,7,35,172.87,11.1
"2011","Cheshire West and Chester 007A","E01018519","Total",1416,695,721,1416,0,4,22.10,64.1
"2011","Cheshire West and Chester 007B","E01018520","Total",1035,491,544,1035,0,5,41.12,25.2
"2011","Cheshire West and Chester 007C","E01018525","Total",1329,577,752,1261,68,8,34.02,39.1
"2011","Cheshire West and Chester 007D","E01018563","Total",2101,1060,1041,2041,60,13,147.16,14.3
"2011","Cheshire West and Chester 007E","E01018564","Total",2247,1106,1141,2247,0,14,461.86,4.9
"2011","Cheshire West and Chester 008A","E01018523","Total",1347,680,667,1347,0,5,36.91,36.5
"2011","Cheshire West and Chester 008B","E01018524","Total",1413,655,758,1413,0,8,32.18,43.9
"2011","Cheshire West and Chester 008C","E01018541","Total",1385,674,711,1340,45,8,32.81,42.2
"2011","Cheshire West and Chester 008D","E01018542","Total",1317,586,731,1317,0,4,21.38,61.6
"2011","Cheshire West and Chester 008E","E01018543","Total",1319,597,722,1319,0,5,20.98,62.9
"2011","Cheshire West and Chester 009A","E01018528","Total",1176,582,594,1176,0,10,65.22,18.0
"2011","Cheshire West and Chester 009B","E01018529","Total",1507,745,762,1507,0,16,52.35,28.8
"2011","Cheshire West and Chester 009C","E01018530","Total",1517,772,745,1517,0,41,89.93,16.9
"2011","Cheshire West and Chester 009D","E01018531","Total",1566,750,816,1566,0,19,47.85,32.7
"2011","Cheshire West and Chester 009E","E01018560","Total",1169,576,593,1169,0,17,59.13,19.8
"2011","Cheshire West and Chester 009F","E01018561","Total",1236,630,606,1236,0,24,35.75,34.6
"2011","Cheshire West and Chester 009G","E01018562","Total",1454,727,727,1454,0,22,46.51,31.3
"2011","Cheshire West and Chester 010A","E01018522","Total",1382,677,705,1353,29,12,27.76,49.8
"2011","Cheshire West and Chester 010B","E01018538","Total",1199,564,635,1165,34,9,29.24,41.0
"2011","Cheshire West and Chester 010C","E01018539","Total",1088,504,584,1088,0,3,15.65,69.5
"2011","Cheshire West and Chester 010D","E01018540","Total",1444,720,724,1442,2,11,45.84,31.5
"2011","Cheshire West and Chester 011A","E01018521","Total",1213,598,615,1197,16,3,30.23,40.1
"2011","Cheshire West and Chester 011B","E01018550","Total",1074,508,566,1074,0,5,14.55,73.8
"2011","Cheshire West and Chester 011C","E01018551","Total",1504,777,727,1485,19,4,75.88,19.8
"2011","Cheshire West and Chester 011D","E01018552","Total",1554,761,793,1554,0,8,1898.53,0.8
"2011","Cheshire West and Chester 011E","E01018553","Total",1510,727,783,1510,0,5,51.39,29.4
"2011","Cheshire West and Chester 013A","E01018556","Total",1435,684,751,1435,0,14,33.15,43.3
"2011","Cheshire West and Chester 013B","E01018557","Total",1455,662,793,1455,0,6,33.36,43.6
"2011","Cheshire West and Chester 013C","E01018558","Total",1293,647,646,1293,0,12,16.73,77.3
"2011","Cheshire West and Chester 013D","E01018559","Total",1168,600,568,1168,0,14,28.70,40.7
"2011","Cheshire West and Chester 014A","E01018565","Total",1568,756,812,1513,55,16,35.25,44.5
"2011","Cheshire West and Chester 014B","E01018566","Total",1332,641,691,1332,0,8,86.83,15.3
"2011","Cheshire West and Chester 014C","E01018567","Total",1424,709,715,1414,10,18,38.79,36.7
"2011","Cheshire West and Chester 014D","E01018568","Total",1567,780,787,1567,0,20,60.20,26.0
"2011","Cheshire West and Chester 016A","E01018526","Total",1624,778,846,1624,0,22,40.16,40.4
"2011","Cheshire West and Chester 016B","E01018527","Total",1727,858,869,1686,41,20,31.24,55.3
"2011","Cheshire West and Chester 016C","E01018554","Total",2347,1175,1172,2347,0,25,48.46,48.4
"2011","Cheshire West and Chester 016D","E01018555","Total",1172,609,563,1172,0,10,16.58,70.7
"2011","Cheshire West and Chester 002A","E01018685","Total",1216,570,646,1216,0,5,31.30,38.8
"2011","Cheshire West and Chester 002B","E01018686","Total",1414,664,750,1414,0,13,104.51,13.5
"2011","Cheshire West and Chester 002C","E01018687","Total",1365,652,713,1365,0,39,256.29,5.3
"2011","Cheshire West and Chester 002D","E01018688","Total",1560,747,813,1560,0,29,57.19,27.3
"2011","Cheshire West and Chester 002E","E01018689","Total",1450,683,767,1389,61,16,968.32,1.5
"2011","Cheshire West and Chester 002F","E01018690","Total",2072,1019,1053,2041,31,59,669.62,3.1
"2011","Cheshire West and Chester 003A","E01018675","Total",2092,1072,1020,2092,0,39,1372.89,1.5
"2011","Cheshire West and Chester 003B","E01018708","Total",2121,1092,1029,2117,4,48,3186.49,0.7
"2011","Cheshire West and Chester 003C","E01018721","Total",2201,1100,1101,2201,0,76,2993.73,0.7
"2011","Cheshire West and Chester 012A","E01018671","Total",1258,631,627,1258,0,11,53.83,23.4
"2011","Cheshire West and Chester 012B","E01018672","Total",1606,766,840,1606,0,10,86.02,18.7
"2011","Cheshire West and Chester 012C","E01018673","Total",1192,564,628,1192,0,12,31.36,38.0
"2011","Cheshire West and Chester 012D","E01018674","Total",1558,741,817,1545,13,18,134.15,11.6
"2011","Cheshire West and Chester 015A","E01018684","Total",2255,1116,1139,2230,25,70,2458.05,0.9
"2011","Cheshire West and Chester 015B","E01018695","Total",1684,802,882,1684,0,33,62.53,26.9
"2011","Cheshire West and Chester 015C","E01018696","Total",1473,739,734,1473,0,29,417.87,3.5
"2011","Cheshire West and Chester 015D","E01018697","Total",1815,870,945,1753,62,24,69.13,26.3
"2011","Cheshire West and Chester 015E","E01018698","Total",1987,965,1022,1958,29,61,1294.18,1.5
"2011","Cheshire West and Chester 017A","E01018704","Total",1184,603,581,1184,0,8,409.70,2.9
"2011","Cheshire West and Chester 017B","E01018705","Total",1530,777,753,1530,0,35,96.47,15.9
"2011","Cheshire West and Chester 017C","E01018706","Total",1398,693,705,1268,130,2,79.79,17.5
"2011","Cheshire West and Chester 017D","E01018718","Total",1633,819,814,1631,2,20,370.21,4.4
"2011","Cheshire West and Chester 017E","E01018722","Total",2264,1111,1153,2229,35,39,5029.25,0.5
"2011","Cheshire West and Chester 018A","E01018713","Total",2713,1319,1394,2713,0,26,299.17,9.1
"2011","Cheshire West and Chester 018B","E01018714","Total",1828,902,926,1703,125,9,128.08,14.3
"2011","Cheshire West and Chester 018C","E01018715","Total",1729,868,861,1729,0,5,158.25,10.9
"2011","Cheshire West and Chester 019A","E01018726","Total",1503,746,757,1473,30,11,81.84,18.4
"2011","Cheshire West and Chester 019B","E01018727","Total",1652,776,876,1652,0,36,545.29,3.0
"2011","Cheshire West and Chester 019C","E01018728","Total",1563,761,802,1563,0,21,104.85,14.9
"2011","Cheshire West and Chester 019D","E01018729","Total",1673,818,855,1673,0,6,69.62,24.0
"2011","Cheshire West and Chester 020A","E01018709","Total",1492,756,736,1492,0,9,19.43,76.8
"2011","Cheshire West and Chester 020B","E01018710","Total",1487,693,794,1470,17,14,53.33,27.9
"2011","Cheshire West and Chester 020C","E01018711","Total",1526,754,772,1513,13,26,62.82,24.3
"2011","Cheshire West and Chester 020D","E01018712","Total",1564,819,745,1561,3,19,36.99,42.3
"2011","Cheshire West and Chester 021A","E01018699","Total",1629,798,831,1628,1,18,38.23,42.6
"2011","Cheshire West and Chester 021B","E01018701","Total",1462,726,736,1462,0,2,63.70,23.0
"2011","Cheshire West and Chester 021C","E01018716","Total",1544,803,741,1544,0,8,50.52,30.6
"2011","Cheshire West and Chester 021D","E01018717","Total",1763,855,908,1763,0,17,44.51,39.6
"2011","Cheshire West and Chester 021E","E01018719","Total",1550,769,781,1550,0,13,28.44,54.5
"2011","Cheshire West and Chester 021F","E01018720","Total",1565,760,805,1565,0,3,38.27,40.9
"2011","Cheshire West and Chester 023A","E01018691","Total",1582,757,825,1582,0,34,132.54,11.9
"2011","Cheshire West and Chester 023B","E01018693","Total",1589,758,831,1589,0,42,179.18,8.9
"2011","Cheshire West and Chester 023C","E01018694","Total",1584,770,814,1582,2,49,165.39,9.6
"2011","Cheshire West and Chester 023D","E01018700","Total",2041,1032,1009,2041,0,44,48.59,42.0
"2011","Cheshire West and Chester 023E","E01018702","Total",1286,608,678,1286,0,34,42.62,30.2
"2011","Cheshire West and Chester 023F","E01018703","Total",1811,899,912,1811,0,40,111.62,16.2
"2011","Cheshire West and Chester 024A","E01018676","Total",1451,709,742,1443,8,32,227.94,6.4
"2011","Cheshire West and Chester 024B","E01018677","Total",1430,692,738,1430,0,42,1379.68,1.0
"2011","Cheshire West and Chester 024C","E01018678","Total",1314,637,677,1209,105,25,285.20,4.6
"2011","Cheshire West and Chester 024D","E01018679","Total",1727,826,901,1727,0,15,120.37,14.3
"2011","Cheshire West and Chester 024E","E01018692","Total",1975,1014,961,1975,0,60,1783.48,1.1
"2011","Cheshire West and Chester 026A","E01018680","Total",1622,833,789,1622,0,47,2017.73,0.8
"2011","Cheshire West and Chester 026B","E01018681","Total",1451,727,724,1451,0,22,77.32,18.8
"2011","Cheshire West and Chester 026C","E01018682","Total",1075,524,551,1075,0,19,263.24,4.1
"2011","Cheshire West and Chester 026D","E01018683","Total",1498,717,781,1434,64,27,148.73,10.1
"2011","Cheshire West and Chester 035A","E01018733","Total",1475,712,763,1401,74,9,345.42,4.3
"2011","Cheshire West and Chester 035B","E01018734","Total",1273,618,655,1232,41,3,27.12,46.9
"2011","Cheshire West and Chester 035C","E01018748","Total",1390,641,749,1390,0,3,16.57,83.9
"2011","Cheshire West and Chester 035D","E01018749","Total",2509,1240,1269,2509,0,23,291.50,8.6
"2011","Cheshire West and Chester 037A","E01018736","Total",1629,803,826,1629,0,15,40.22,40.5
"2011","Cheshire West and Chester 037B","E01018737","Total",1338,659,679,1338,0,21,152.17,8.8
"2011","Cheshire West and Chester 037C","E01018743","Total",1463,713,750,1463,0,24,372.12,3.9
"2011","Cheshire West and Chester 037D","E01018744","Total",1707,834,873,1707,0,21,84.33,20.2
"2011","Cheshire West and Chester 038A","E01018732","Total",1425,656,769,1290,135,18,36.32,39.2
"2011","Cheshire West and Chester 038B","E01018745","Total",1556,781,775,1556,0,10,25.41,61.2
"2011","Cheshire West and Chester 038C","E01018746","Total",1632,802,830,1632,0,17,86.83,18.8
"2011","Cheshire West and Chester 038D","E01018747","Total",1511,748,763,1511,0,20,78.34,19.3
"2011","Cheshire West and Chester 040A","E01018730","Total",1463,699,764,1463,0,7,28.56,51.2
"2011","Cheshire West and Chester 040B","E01018738","Total",1474,670,804,1474,0,11,162.49,9.1
"2011","Cheshire West and Chester 040C","E01018739","Total",1443,659,784,1443,0,7,46.03,31.3
"2011","Cheshire West and Chester 040D","E01018741","Total",1263,641,622,1263,0,13,34.15,37.0
"2011","Cheshire West and Chester 042A","E01018731","Total",1600,765,835,1600,0,21,76.22,21.0
"2011","Cheshire West and Chester 042B","E01018735","Total",1301,621,680,1301,0,12,104.03,12.5
"2011","Cheshire West and Chester 042C","E01018740","Total",1537,719,818,1537,0,18,26.01,59.1
"2011","Cheshire West and Chester 042D","E01018742","Total",1492,769,723,1485,7,21,167.55,8.9
"2011","Cheshire West and Chester 045A","E01018707","Total",1731,856,875,1729,2,39,2409.89,0.7
"2011","Cheshire West and Chester 045B","E01018723","Total",1124,543,581,1124,0,24,336.25,3.3
"2011","Cheshire West and Chester 045C","E01018724","Total",1490,725,765,1481,9,47,173.66,8.6
"2011","Cheshire West and Chester 045D","E01018725","Total",1310,656,654,1310,0,33,3857.71,0.3
"2011","Halton 001A","E01012392","Total",2350,1141,1209,2350,0,29,146.38,16.1
"2011","Halton 001B","E01012393","Total",2028,1000,1028,1989,39,22,235.03,8.6
"2011","Halton 001C","E01012395","Total",1445,711,734,1445,0,16,67.02,21.6
"2011","Halton 001D","E01012411","Total",1314,668,646,1310,4,13,42.88,30.6
"2011","Halton 002A","E01012374","Total",2733,1364,1369,2733,0,39,67.38,40.6
"2011","Halton 002B","E01012375","Total",1583,800,783,1583,0,34,46.29,34.2
"2011","Halton 002C","E01012376","Total",2593,1334,1259,2593,0,33,69.56,37.3
"2011","Halton 002D","E01012421","Total",1339,672,667,1339,0,21,36.16,37.0
"2011","Halton 002E","E01012423","Total",1418,705,713,1394,24,11,21.71,65.3
"2011","Halton 003A","E01012368","Total",1938,915,1023,1892,46,10,40.08,48.4
"2011","Halton 003B","E01012410","Total",1265,628,637,1265,0,11,47.54,26.6
"2011","Halton 003C","E01012412","Total",1449,746,703,1411,38,7,192.54,7.5
"2011","Halton 003D","E01012413","Total",1485,717,768,1456,29,4,32.33,45.9
"2011","Halton 003E","E01012414","Total",1232,615,617,1232,0,20,18.95,65.0
"2011","Halton 004A","E01012377","Total",1794,918,876,1788,6,7,29.80,60.2
"2011","Halton 004B","E01012390","Total",1597,749,848,1529,68,5,34.68,46.0
"2011","Halton 004C","E01012419","Total",1143,519,624,1143,0,7,14.26,80.2
"2011","Halton 004D","E01012420","Total",1481,710,771,1481,0,12,30.32,48.8
"2011","Halton 004E","E01012422","Total",1480,683,797,1474,6,12,31.30,47.3
"2011","Halton 005A","E01012369","Total",1517,752,765,1517,0,16,43.36,35.0
"2011","Halton 005B","E01012394","Total",1485,682,803,1467,18,12,36.13,41.1
"2011","Halton 005C","E01012425","Total",1613,770,843,1613,0,6,23.82,67.7
"2011","Halton 005D","E01012426","Total",1345,646,699,1341,4,21,59.54,22.6
"2011","Halton 005E","E01012427","Total",1765,845,920,1764,1,13,72.44,24.4
"2011","Halton 006A","E01012378","Total",1498,722,776,1498,0,10,36.30,41.3
"2011","Halton 006B","E01012379","Total",1481,714,767,1452,29,7,31.49,47.0
"2011","Halton 006C","E01012380","Total",1391,644,747,1331,60,6,20.14,69.1
"2011","Halton 006D","E01012388","Total",1814,872,942,1809,5,8,37.67,48.2
"2011","Halton 006E","E01012442","Total",1621,720,901,1621,0,11,21.20,76.5
"2011","Halton 007A","E01012367","Total",1591,778,813,1591,0,3,59.30,26.8
"2011","Halton 007B","E01012370","Total",1743,847,896,1699,44,11,19.19,90.8
"2011","Halton 007C","E01012424","Total",1877,927,950,1877,0,6,49.09,38.2
"2011","Halton 007D","E01012441","Total",2301,1137,1164,2285,16,12,259.38,8.9
"2011","Halton 008A","E01012389","Total",1785,861,924,1785,0,14,48.57,36.8
"2011","Halton 008B","E01012391","Total",2130,1035,1095,2130,0,15,594.29,3.6
"2011","Halton 008C","E01012401","Total",1841,906,935,1841,0,18,578.98,3.2
"2011","Halton 008D","E01012443","Total",1597,775,822,1531,66,13,168.61,9.5
"2011","Halton 009A","E01012385","Total",1441,719,722,1441,0,21,1320.44,1.1
"2011","Halton 009B","E01012386","Total",1945,973,972,1945,0,36,291.61,6.7
"2011","Halton 009C","E01012387","Total",1115,543,572,1115,0,14,331.59,3.4
"2011","Halton 009D","E01012434","Total",1577,773,804,1539,38,18,35.64,44.2
"2011","Halton 009E","E01012435","Total",2114,1081,1033,2108,6,31,125.62,16.8
"2011","Halton 010A","E01012381","Total",1351,716,635,1351,0,6,37.63,35.9
"2011","Halton 010B","E01012382","Total",1497,724,773,1497,0,14,331.87,4.5
"2011","Halton 010C","E01012384","Total",1588,787,801,1588,0,12,43.62,36.4
"2011","Halton 010D","E01012444","Total",1139,550,589,1139,0,8,45.41,25.1
"2011","Halton 010E","E01012445","Total",1276,641,635,1276,0,3,70.34,18.1
"2011","Halton 011A","E01012398","Total",1239,607,632,1239,0,5,26.01,47.6
"2011","Halton 011B","E01012400","Total",1240,568,672,1240,0,6,17.61,70.4
"2011","Halton 011C","E01012402","Total",1586,738,848,1518,68,11,43.13,36.8
"2011","Halton 011D","E01012404","Total",1403,688,715,1403,0,10,32.05,43.8
"2011","Halton 011E","E01012405","Total",1992,983,1009,1992,0,14,37.55,53.0
"2011","Halton 012A","E01012416","Total",1792,881,911,1786,6,11,240.69,7.4
"2011","Halton 012B","E01012417","Total",1294,641,653,1294,0,5,217.90,5.9
"2011","Halton 012C","E01012428","Total",2200,1086,1114,2185,15,21,111.67,19.7
"2011","Halton 012D","E01012429","Total",1387,673,714,1387,0,10,34.36,40.4
"2011","Halton 012E","E01012430","Total",1755,889,866,1744,11,9,37.58,46.7
"2011","Halton 012F","E01012431","Total",2064,1077,987,2032,32,13,78.36,26.3
"2011","Halton 013A","E01012383","Total",1702,833,869,1702,0,12,44.36,38.4
"2011","Halton 013B","E01012396","Total",1531,769,762,1474,57,5,26.30,58.2
"2011","Halton 013C","E01012397","Total",1505,709,796,1483,22,6,38.12,39.5
"2011","Halton 013D","E01012399","Total",1408,682,726,1408,0,6,33.54,42.0
"2011","Halton 013E","E01012403","Total",1624,790,834,1624,0,16,30.22,53.7
"2011","Halton 013F","E01012408","Total",2046,964,1082,2008,38,8,72.66,28.2
"2011","Halton 014A","E01012432","Total",1409,687,722,1409,0,3,28.51,49.4
"2011","Halton 014B","E01012433","Total",1620,770,850,1620,0,7,59.19,27.4
"2011","Halton 014C","E01012436","Total",1334,631,703,1334,0,2,25.93,51.4
"2011","Halton 014D","E01012438","Total",1189,554,635,1178,11,11,26.33,45.2
"2011","Halton 014E","E01012440","Total",1373,685,688,1373,0,11,62.49,22.0
"2011","Halton 015A","E01012406","Total",1596,777,819,1596,0,9,45.70,34.9
"2011","Halton 015B","E01012407","Total",1594,766,828,1594,0,12,37.88,42.1
"2011","Halton 015C","E01012409","Total",1434,699,735,1375,59,16,54.88,26.1
"2011","Halton 015D","E01012437","Total",1354,634,720,1354,0,5,23.30,58.1
"2011","Halton 015E","E01012439","Total",1522,692,830,1520,2,9,32.61,46.7
"2011","Halton 016A","E01012371","Total",1244,595,649,1244,0,16,36.41,34.2
"2011","Halton 016B","E01012372","Total",1139,570,569,1135,4,9,54.45,20.9
"2011","Halton 016C","E01012373","Total",1290,644,646,1290,0,12,43.95,29.4
"2011","Halton 016D","E01012415","Total",1399,691,708,1399,0,13,192.84,7.3
"2011","Halton 016E","E01012418","Total",1376,660,716,1376,0,20,65.46,21.0
"2011","Warrington 001A","E01012471","Total",2289,1660,629,1225,1064,39,662.20,3.5
"2011","Warrington 001B","E01012472","Total",1823,858,965,1787,36,37,675.55,2.7
"2011","Warrington 001C","E01012476","Total",1544,757,787,1544,0,26,517.91,3.0
"2011","Warrington 001D","E01012477","Total",1559,767,792,1544,15,45,325.41,4.8
"2011","Warrington 002A","E01012473","Total",1558,730,828,1558,0,28,59.36,26.2
"2011","Warrington 002B","E01012474","Total",1427,636,791,1387,40,24,35.12,40.6
"2011","Warrington 002C","E01012475","Total",1490,742,748,1490,0,30,373.93,4.0
"2011","Warrington 002D","E01012554","Total",1960,972,988,1960,0,12,1135.25,1.7
"2011","Warrington 003A","E01012467","Total",1224,607,617,1196,28,3,52.11,23.5
"2011","Warrington 003B","E01012468","Total",2435,1196,1239,2306,129,32,783.74,3.1
"2011","Warrington 003C","E01012469","Total",1546,746,800,1455,91,15,956.60,1.6
"2011","Warrington 003D","E01012470","Total",1143,546,597,1143,0,6,45.86,24.9
"2011","Warrington 004A","E01012460","Total",1420,698,722,1418,2,10,125.07,11.4
"2011","Warrington 004B","E01012462","Total",1289,644,645,1289,0,12,97.24,13.3
"2011","Warrington 004C","E01012463","Total",1128,573,555,1128,0,24,138.29,8.2
"2011","Warrington 004D","E01012464","Total",1399,702,697,1391,8,21,84.21,16.6
"2011","Warrington 005A","E01012459","Total",1361,678,683,1348,13,8,71.03,19.2
"2011","Warrington 005B","E01012461","Total",1308,649,659,1308,0,19,200.54,6.5
"2011","Warrington 005C","E01012465","Total",1289,648,641,1289,0,13,72.55,17.8
"2011","Warrington 005D","E01012466","Total",1507,752,755,1507,0,9,22.10,68.2
"2011","Warrington 006A","E01012526","Total",1700,828,872,1700,0,6,20.47,83.0
"2011","Warrington 006B","E01012534","Total",1520,722,798,1520,0,16,21.68,70.1
"2011","Warrington 006C","E01012535","Total",1655,794,861,1655,0,3,22.68,73.0
"2011","Warrington 006D","E01012537","Total",1496,707,789,1496,0,8,26.72,56.0
"2011","Warrington 006E","E01012539","Total",1549,753,796,1547,2,12,190.23,8.1
"2011","Warrington 007A","E01012538","Total",1427,695,732,1427,0,24,50.98,28.0
"2011","Warrington 007B","E01012540","Total",1366,670,696,1366,0,10,30.83,44.3
"2011","Warrington 007C","E01012541","Total",1303,616,687,1303,0,20,53.85,24.2
"2011","Warrington 007D","E01012542","Total",1356,670,686,1356,0,17,35.39,38.3
"2011","Warrington 007E","E01012543","Total",1647,803,844,1336,311,16,41.70,39.5
"2011","Warrington 007F","E01012544","Total",1404,686,718,1401,3,5,60.71,23.1
"2011","Warrington 008A","E01012521","Total",1571,742,829,1564,7,7,26.75,58.7
"2011","Warrington 008B","E01012522","Total",1359,673,686,1359,0,5,20.90,65.0
"2011","Warrington 008C","E01012533","Total",1445,697,748,1445,0,10,17.47,82.7
"2011","Warrington 008D","E01012536","Total",1436,719,717,1436,0,8,25.93,55.4
"2011","Warrington 008E","E01012545","Total",1592,769,823,1592,0,4,38.45,41.4
"2011","Warrington 008F","E01012546","Total",1598,789,809,1598,0,10,33.06,48.3
"2011","Warrington 009A","E01012561","Total",1589,771,818,1559,30,27,88.77,17.9
"2011","Warrington 009B","E01012562","Total",1726,877,849,1726,0,34,207.46,8.3
"2011","Warrington 009C","E01012567","Total",1875,957,918,1875,0,46,166.82,11.2
"2011","Warrington 009D","E01012568","Total",2500,1248,1252,2500,0,34,112.35,22.3
"2011","Warrington 010A","E01012563","Total",1729,855,874,1729,0,50,67.84,25.5
"2011","Warrington 010B","E01012564","Total",1402,706,696,1307,95,23,72.66,19.3
"2011","Warrington 010C","E01012565","Total",2494,1206,1288,2458,36,21,63.85,39.1
"2011","Warrington 010D","E01012566","Total",2156,1066,1090,2151,5,31,40.45,53.3
"2011","Warrington 010E","E01012569","Total",1925,982,943,1925,0,44,45.07,42.7
"2011","Warrington 010F","E01012570","Total",1204,593,611,1204,0,13,49.97,24.1
"2011","Warrington 011A","E01012481","Total",1594,777,817,1594,0,2,19.50,81.7
"2011","Warrington 011B","E01012482","Total",1601,766,835,1601,0,6,27.80,57.6
"2011","Warrington 011C","E01012520","Total",1506,769,737,1465,41,9,56.05,26.9
"2011","Warrington 011D","E01012523","Total",1442,717,725,1442,0,10,32.28,44.7
"2011","Warrington 011E","E01012524","Total",1523,752,771,1523,0,11,24.90,61.2
"2011","Warrington 011F","E01012525","Total",1517,755,762,1517,0,11,23.73,63.9
"2011","Warrington 012A","E01012478","Total",1446,705,741,1446,0,16,58.44,24.7
"2011","Warrington 012B","E01012547","Total",1716,835,881,1713,3,25,56.24,30.5
"2011","Warrington 012C","E01012548","Total",1793,892,901,1793,0,22,52.81,34.0
"2011","Warrington 012D","E01012549","Total",1393,669,724,1393,0,12,39.27,35.5
"2011","Warrington 012E","E01012550","Total",1583,779,804,1583,0,12,80.84,19.6
"2011","Warrington 013A","E01012453","Total",1715,858,857,1692,23,6,76.57,22.4
"2011","Warrington 013B","E01012454","Total",2034,1047,987,2014,20,7,78.87,25.8
"2011","Warrington 013C","E01012455","Total",1934,941,993,1934,0,3,77.22,25.0
"2011","Warrington 013D","E01012457","Total",1662,825,837,1628,34,8,28.53,58.3
"2011","Warrington 014A","E01012551","Total",1560,780,780,1560,0,18,474.09,3.3
"2011","Warrington 014B","E01012552","Total",1357,644,713,1357,0,10,30.55,44.4
"2011","Warrington 014C","E01012553","Total",1354,692,662,1354,0,31,277.64,4.9
"2011","Warrington 014D","E01012555","Total",1402,695,707,1311,91,16,78.65,17.8
"2011","Warrington 014E","E01012556","Total",1483,742,741,1483,0,14,47.90,31.0
"2011","Warrington 015A","E01012491","Total",1422,705,717,1422,0,13,29.48,48.2
"2011","Warrington 015B","E01012492","Total",1444,718,726,1444,0,18,28.79,50.2
"2011","Warrington 015C","E01012493","Total",1819,878,941,1716,103,18,30.12,60.4
"2011","Warrington 015D","E01012494","Total",1654,822,832,1654,0,32,43.96,37.6
"2011","Warrington 015E","E01012500","Total",1354,661,693,1354,0,23,35.70,37.9
"2011","Warrington 016A","E01012495","Total",1713,882,831,1713,0,21,56.09,30.5
"2011","Warrington 016B","E01012496","Total",1400,674,726,1400,0,19,38.13,36.7
"2011","Warrington 016C","E01012497","Total",1271,593,678,1271,0,12,50.85,25.0
"2011","Warrington 016D","E01012498","Total",1523,729,794,1523,0,17,26.29,57.9
"2011","Warrington 016E","E01012499","Total",1908,946,962,1908,0,13,26.04,73.3
"2011","Warrington 016F","E01012501","Total",1419,708,711,1419,0,11,39.40,36.0
"2011","Warrington 017A","E01012479","Total",1618,829,789,1606,12,7,52.46,30.8
"2011","Warrington 017B","E01012480","Total",1960,1040,920,1752,208,11,57.14,34.3
"2011","Warrington 017D","E01012510","Total",1751,923,828,1751,0,14,69.40,25.2
"2011","Warrington 017E","E01012511","Total",1670,827,843,1670,0,8,57.29,29.1
"2011","Warrington 017F","E01033299","Total",2010,1006,1004,2010,0,11,27.54,73.0
"2011","Warrington 017G","E01033303","Total",1165,593,572,1165,0,5,9.29,125.4
"2011","Warrington 018B","E01012458","Total",2367,1204,1163,2356,11,18,186.73,12.7
"2011","Warrington 018C","E01012483","Total",1621,792,829,1621,0,10,26.09,62.1
"2011","Warrington 018D","E01012509","Total",1791,875,916,1791,0,10,92.11,19.4
"2011","Warrington 018E","E01012512","Total",1558,769,789,1558,0,5,31.76,49.1
"2011","Warrington 018F","E01033300","Total",1082,649,433,1047,35,8,122.61,8.8
"2011","Warrington 018G","E01033302","Total",1545,811,734,1541,4,10,179.04,8.6
"2011","Warrington 019A","E01012527","Total",1491,722,769,1491,0,17,33.52,44.5
"2011","Warrington 019B","E01012528","Total",1241,576,665,1202,39,15,38.07,32.6
"2011","Warrington 019C","E01012529","Total",1426,684,742,1426,0,16,75.71,18.8
"2011","Warrington 019D","E01012530","Total",1442,698,744,1383,59,25,1127.49,1.3
"2011","Warrington 019E","E01012531","Total",1513,703,810,1513,0,11,38.56,39.2
"2011","Warrington 019F","E01012532","Total",1430,675,755,1367,63,17,36.46,39.2
"2011","Warrington 020A","E01012504","Total",1785,908,877,1751,34,8,87.49,20.4
"2011","Warrington 020B","E01012505","Total",1400,701,699,1400,0,6,40.72,34.4
"2011","Warrington 020C","E01012506","Total",1544,768,776,1544,0,4,45.58,33.9
"2011","Warrington 020D","E01012507","Total",1845,942,903,1838,7,17,51.97,35.5
"2011","Warrington 020E","E01012508","Total",1560,770,790,1505,55,10,21.14,73.8
"2011","Warrington 021A","E01012513","Total",1980,959,1021,1962,18,46,159.74,12.4
"2011","Warrington 021B","E01012514","Total",1864,887,977,1837,27,56,111.62,16.7
"2011","Warrington 021C","E01012515","Total",1471,712,759,1471,0,24,514.38,2.9
"2011","Warrington 021D","E01012516","Total",1342,656,686,1301,41,46,61.26,21.9
"2011","Warrington 021E","E01012517","Total",2216,1092,1124,2216,0,44,231.13,9.6
"2011","Warrington 021F","E01012518","Total",2003,995,1008,2003,0,38,547.13,3.7
"2011","Warrington 021G","E01012519","Total",1474,730,744,1471,3,27,60.35,24.4
"2011","Warrington 022A","E01012485","Total",1568,765,803,1568,0,29,30.90,50.7
"2011","Warrington 022B","E01012486","Total",1483,730,753,1483,0,33,29.05,51.0
"2011","Warrington 022C","E01012487","Total",1537,743,794,1537,0,27,29.05,52.9
"2011","Warrington 022D","E01012489","Total",1898,901,997,1808,90,53,163.81,11.6
"2011","Warrington 022E","E01012490","Total",1466,705,761,1466,0,33,32.56,45.0
"2011","Warrington 023A","E01012450","Total",1403,658,745,1403,0,25,62.48,22.5
"2011","Warrington 023B","E01012451","Total",1558,752,806,1504,54,18,32.58,47.8
"2011","Warrington 023C","E01012557","Total",1574,777,797,1574,0,25,28.70,54.8
"2011","Warrington 023D","E01012558","Total",1787,906,881,1787,0,29,35.68,50.1
"2011","Warrington 023E","E01012559","Total",1554,766,788,1488,66,21,41.47,37.5
"2011","Warrington 023F","E01012560","Total",1476,709,767,1476,0,18,36.65,40.3
"2011","Warrington 024A","E01012448","Total",1579,916,663,1278,301,43,600.75,2.6
"2011","Warrington 024B","E01012488","Total",1735,849,886,1711,24,39,627.93,2.8
"2011","Warrington 024C","E01012502","Total",1633,811,822,1614,19,41,484.76,3.4
"2011","Warrington 024D","E01012503","Total",1451,717,734,1451,0,47,885.97,1.6
"2011","Warrington 025A","E01012446","Total",1429,713,716,1429,0,48,122.65,11.7
"2011","Warrington 025B","E01012447","Total",1494,733,761,1494,0,69,82.74,18.1
"2011","Warrington 025C","E01012449","Total",1403,674,729,1403,0,40,93.57,15.0
"2011","Warrington 025D","E01012452","Total",1770,868,902,1770,0,44,336.47,5.3
"2011","Allerdale 001A","E01019126","Total",1703,796,907,1630,73,13,256.76,6.6
"2011","Allerdale 001B","E01019127","Total",1565,743,822,1527,38,13,3179.03,0.5
"2011","Allerdale 001C","E01019132","Total",1803,908,895,1790,13,41,8559.85,0.2
"2011","Allerdale 001D","E01019134","Total",1523,718,805,1523,0,19,96.08,15.9
"2011","Allerdale 001E","E01019135","Total",1593,761,832,1588,5,12,134.21,11.9
"2011","Allerdale 001F","E01019136","Total",1620,794,826,1594,26,21,134.71,12.0
"2011","Allerdale 001G","E01019137","Total",1095,512,583,1038,57,10,96.82,11.3
"2011","Allerdale 002A","E01019083","Total",1832,926,906,1746,86,20,14486.68,0.1
"2011","Allerdale 002B","E01019107","Total",1608,813,795,1607,1,23,6320.43,0.3
"2011","Allerdale 002C","E01019130","Total",1683,838,845,1683,0,18,3763.63,0.4
"2011","Allerdale 002D","E01019131","Total",1940,980,960,1892,48,38,13058.02,0.1
"2011","Allerdale 003A","E01019081","Total",1884,942,942,1884,0,6,1487.46,1.3
"2011","Allerdale 003B","E01019082","Total",1496,721,775,1481,15,12,564.37,2.7
"2011","Allerdale 003C","E01019102","Total",1728,858,870,1725,3,24,5080.79,0.3
"2011","Allerdale 003D","E01019128","Total",1631,833,798,1624,7,19,5508.62,0.3
"2011","Allerdale 003E","E01019133","Total",1546,774,772,1546,0,24,4428.74,0.3
"2011","Allerdale 004A","E01019093","Total",1561,779,782,1561,0,21,418.44,3.7
"2011","Allerdale 004B","E01019094","Total",1703,829,874,1702,1,10,1391.85,1.2
"2011","Allerdale 004C","E01019096","Total",2274,1141,1133,2274,0,35,68.51,33.2
"2011","Allerdale 004D","E01019114","Total",1472,703,769,1435,37,26,102.02,14.4
"2011","Allerdale 004E","E01019115","Total",1609,826,783,1548,61,10,185.44,8.7
"2011","Allerdale 005A","E01019095","Total",1536,738,798,1492,44,8,84.71,18.1
"2011","Allerdale 005B","E01019097","Total",1803,863,940,1797,6,11,51.48,35.0
"2011","Allerdale 005C","E01019098","Total",1644,793,851,1644,0,7,865.12,1.9
"2011","Allerdale 005D","E01019099","Total",1707,859,848,1704,3,12,673.10,2.5
"2011","Allerdale 006A","E01019084","Total",1508,740,768,1508,0,22,353.38,4.3
"2011","Allerdale 006B","E01019085","Total",1550,774,776,1547,3,37,909.74,1.7
"2011","Allerdale 006C","E01019086","Total",1120,557,563,1105,15,22,2383.17,0.5
"2011","Allerdale 006D","E01019088","Total",1714,816,898,1655,59,20,96.81,17.7
"2011","Allerdale 006E","E01019091","Total",1858,917,941,1854,4,59,4115.43,0.5
"2011","Allerdale 007A","E01019078","Total",1546,781,765,1546,0,34,182.13,8.5
"2011","Allerdale 007B","E01019079","Total",1469,710,759,1469,0,32,148.55,9.9
"2011","Allerdale 007C","E01019080","Total",1809,870,939,1807,2,22,296.60,6.1
"2011","Allerdale 007D","E01019087","Total",1625,788,837,1579,46,40,100.51,16.2
"2011","Allerdale 007E","E01019090","Total",1572,796,776,1544,28,47,19069.55,0.1
"2011","Allerdale 008A","E01019116","Total",1252,643,609,1225,27,6,79.93,15.7
"2011","Allerdale 008B","E01019118","Total",1369,722,647,1369,0,12,14.07,97.3
"2011","Allerdale 008C","E01019122","Total",1415,716,699,1414,1,15,339.30,4.2
"2011","Allerdale 008D","E01019123","Total",1577,771,806,1577,0,8,517.41,3.0
"2011","Allerdale 008E","E01019124","Total",2083,1020,1063,2083,0,32,198.20,10.5
"2011","Allerdale 008F","E01019125","Total",1536,751,785,1532,4,12,680.20,2.3
"2011","Allerdale 009A","E01019111","Total",1537,765,772,1537,0,8,82.46,18.6
"2011","Allerdale 009B","E01019112","Total",1693,844,849,1693,0,7,62.08,27.3
"2011","Allerdale 009C","E01019113","Total",1749,804,945,1715,34,5,107.47,16.3
"2011","Allerdale 009D","E01019120","Total",1783,891,892,1783,0,16,112.20,15.9
"2011","Allerdale 009E","E01019121","Total",1989,1023,966,1989,0,16,30.96,64.2
"2011","Allerdale 010A","E01019108","Total",1487,678,809,1483,4,6,69.18,21.5
"2011","Allerdale 010B","E01019109","Total",1818,881,937,1818,0,14,29.82,61.0
"2011","Allerdale 010C","E01019110","Total",1673,777,896,1673,0,5,29.38,56.9
"2011","Allerdale 010D","E01019117","Total",1309,662,647,1309,0,14,28.45,46.0
"2011","Allerdale 010E","E01019119","Total",1509,730,779,1427,82,18,182.92,8.2
"2011","Allerdale 011A","E01019089","Total",1594,764,830,1572,22,16,837.58,1.9
"2011","Allerdale 011B","E01019100","Total",1660,802,858,1613,47,20,148.36,11.2
"2011","Allerdale 011C","E01019101","Total",1507,743,764,1437,70,25,1465.51,1.0
"2011","Allerdale 011D","E01019129","Total",1694,841,853,1636,58,30,345.78,4.9
"2011","Allerdale 012A","E01019092","Total",1615,812,803,1467,148,26,12794.88,0.1
"2011","Allerdale 012B","E01019103","Total",1291,607,684,1226,65,20,32.55,39.7
"2011","Allerdale 012C","E01019104","Total",1357,653,704,1271,86,19,245.87,5.5
"2011","Allerdale 012D","E01019105","Total",1127,568,559,1030,97,18,36.97,30.5
"2011","Allerdale 012E","E01019106","Total",1468,706,762,1442,26,26,7034.02,0.2
"2011","Barrow-in-Furness 001A","E01019144","Total",1458,731,727,1426,32,20,1856.41,0.8
"2011","Barrow-in-Furness 001B","E01019145","Total",2004,992,1012,2004,0,25,66.73,30.0
"2011","Barrow-in-Furness 001C","E01019146","Total",1370,689,681,1370,0,25,728.40,1.9
"2011","Barrow-in-Furness 001D","E01019147","Total",1575,773,802,1575,0,11,35.33,44.6
"2011","Barrow-in-Furness 002A","E01019148","Total",1404,701,703,1404,0,9,300.61,4.7
"2011","Barrow-in-Furness 002B","E01019149","Total",1505,748,757,1505,0,23,154.77,9.7
"2011","Barrow-in-Furness 002C","E01019150","Total",1539,760,779,1539,0,24,66.75,23.1
"2011","Barrow-in-Furness 002D","E01019151","Total",1487,718,769,1442,45,13,69.37,21.4
"2011","Barrow-in-Furness 003A","E01019152","Total",1216,597,619,1101,115,23,52.74,23.1
"2011","Barrow-in-Furness 003B","E01019153","Total",1074,528,546,1070,4,27,40.42,26.6
"2011","Barrow-in-Furness 003C","E01019154","Total",1253,605,648,1247,6,17,298.49,4.2
"2011","Barrow-in-Furness 003D","E01019155","Total",1379,638,741,1313,66,11,66.02,20.9
"2011","Barrow-in-Furness 003E","E01019162","Total",1472,727,745,1472,0,28,55.62,26.5
"2011","Barrow-in-Furness 003F","E01019163","Total",1315,667,648,1284,31,33,135.35,9.7
"2011","Barrow-in-Furness 004A","E01019156","Total",1423,727,696,1423,0,4,122.01,11.7
"2011","Barrow-in-Furness 004B","E01019159","Total",1052,531,521,1052,0,6,29.31,35.9
"2011","Barrow-in-Furness 004C","E01019164","Total",1451,708,743,1451,0,6,339.00,4.3
"2011","Barrow-in-Furness 004D","E01019165","Total",1408,734,674,1408,0,8,41.80,33.7
"2011","Barrow-in-Furness 004E","E01019166","Total",1371,682,689,1371,0,11,43.28,31.7
"2011","Barrow-in-Furness 005A","E01019167","Total",1483,704,779,1483,0,16,21.81,68.0
"2011","Barrow-in-Furness 005B","E01019168","Total",1395,687,708,1391,4,18,73.52,19.0
"2011","Barrow-in-Furness 005C","E01019169","Total",1349,662,687,1267,82,26,30.57,44.1
"2011","Barrow-in-Furness 005D","E01019170","Total",1282,630,652,1282,0,20,11.25,114.0
"2011","Barrow-in-Furness 005E","E01019171","Total",1320,677,643,1320,0,18,10.41,126.8
"2011","Barrow-in-Furness 006A","E01019161","Total",1752,849,903,1712,40,14,63.43,27.6
"2011","Barrow-in-Furness 006B","E01019176","Total",1704,838,866,1704,0,27,42.31,40.3
"2011","Barrow-in-Furness 006C","E01019177","Total",1400,699,701,1400,0,20,36.28,38.6
"2011","Barrow-in-Furness 006D","E01019178","Total",1509,741,768,1507,2,22,790.21,1.9
"2011","Barrow-in-Furness 006E","E01019179","Total",1229,605,624,1229,0,28,368.03,3.3
"2011","Barrow-in-Furness 007A","E01019140","Total",1051,516,535,1042,9,5,26.96,39.0
"2011","Barrow-in-Furness 007B","E01019160","Total",1380,665,715,1380,0,14,23.26,59.3
"2011","Barrow-in-Furness 007C","E01019172","Total",1383,690,693,1383,0,7,24.14,57.3
"2011","Barrow-in-Furness 007D","E01019173","Total",1320,662,658,1286,34,7,12.07,109.4
"2011","Barrow-in-Furness 007E","E01019174","Total",1163,570,593,1163,0,14,14.64,79.4
"2011","Barrow-in-Furness 007F","E01019175","Total",1436,706,730,1436,0,15,23.82,60.3
"2011","Barrow-in-Furness 008A","E01019141","Total",1228,631,597,1216,12,8,25.70,47.8
"2011","Barrow-in-Furness 008B","E01019142","Total",1431,695,736,1431,0,5,11.25,127.2
"2011","Barrow-in-Furness 008C","E01019143","Total",1612,812,800,1479,133,11,35.89,44.9
"2011","Barrow-in-Furness 008D","E01019157","Total",1444,734,710,1433,11,12,22.45,64.3
"2011","Barrow-in-Furness 008E","E01019158","Total",1193,579,614,1183,10,8,10.90,109.4
"2011","Barrow-in-Furness 009A","E01019180","Total",1859,893,966,1845,14,15,437.17,4.3
"2011","Barrow-in-Furness 009C","E01019182","Total",1383,666,717,1355,28,15,67.67,20.4
"2011","Barrow-in-Furness 009E","E01019184","Total",1335,671,664,1335,0,9,16.62,80.3
"2011","Barrow-in-Furness 009F","E01033160","Total",2102,1026,1076,2091,11,12,93.92,22.4
"2011","Barrow-in-Furness 010A","E01019138","Total",1262,639,623,1262,0,7,201.61,6.3
"2011","Barrow-in-Furness 010B","E01019139","Total",1354,753,601,1354,0,7,85.83,15.8
"2011","Barrow-in-Furness 010C","E01019185","Total",1410,709,701,1410,0,16,28.47,49.5
"2011","Barrow-in-Furness 010D","E01019186","Total",1280,609,671,1274,6,9,12.99,98.5
"2011","Barrow-in-Furness 010E","E01019187","Total",1282,611,671,1282,0,8,670.46,1.9
"2011","Carlisle 001A","E01019226","Total",1159,579,580,1153,6,19,4481.55,0.3
"2011","Carlisle 001B","E01019227","Total",1411,710,701,1389,22,9,40.05,35.2
"2011","Carlisle 001C","E01019228","Total",1553,805,748,1512,41,13,9579.94,0.2
"2011","Carlisle 001D","E01019229","Total",1933,967,966,1929,4,26,23183.94,0.1
"2011","Carlisle 002A","E01019200","Total",1551,773,778,1545,6,10,2464.97,0.6
"2011","Carlisle 002B","E01019201","Total",1430,658,772,1368,62,17,110.35,13.0
"2011","Carlisle 002C","E01019202","Total",1646,797,849,1646,0,11,112.09,14.7
"2011","Carlisle 002D","E01019225","Total",2002,1011,991,1978,24,46,23253.65,0.1
"2011","Carlisle 003A","E01019188","Total",1488,724,764,1488,0,17,129.04,11.5
"2011","Carlisle 003B","E01019189","Total",1545,779,766,1545,0,9,30.48,50.7
"2011","Carlisle 003C","E01019190","Total",1565,768,797,1565,0,24,161.03,9.7
"2011","Carlisle 003D","E01019191","Total",1551,739,812,1551,0,19,40.77,38.0
"2011","Carlisle 003E","E01019244","Total",1460,682,778,1460,0,19,33.79,43.2
"2011","Carlisle 004A","E01019196","Total",1793,868,925,1785,8,20,108.17,16.6
"2011","Carlisle 004B","E01019238","Total",1311,619,692,1311,0,21,307.83,4.3
"2011","Carlisle 004C","E01019240","Total",1768,911,857,1727,41,19,2216.01,0.8
"2011","Carlisle 004D","E01019241","Total",1612,790,822,1612,0,27,133.43,12.1
"2011","Carlisle 004E","E01019243","Total",1533,704,829,1418,115,33,68.33,22.4
"2011","Carlisle 004F","E01019251","Total",1740,826,914,1697,43,44,726.65,2.4
"2011","Carlisle 005A","E01019192","Total",1456,706,750,1456,0,13,45.17,32.2
"2011","Carlisle 005B","E01019195","Total",1426,664,762,1339,87,14,65.30,21.8
"2011","Carlisle 005C","E01019203","Total",2117,1041,1076,2111,6,48,5621.75,0.4
"2011","Carlisle 005D","E01019254","Total",1356,670,686,1356,0,14,35.03,38.7
"2011","Carlisle 005E","E01019255","Total",1366,675,691,1366,0,11,26.65,51.3
"2011","Carlisle 006A","E01019204","Total",1276,689,587,1215,61,12,199.26,6.4
"2011","Carlisle 006B","E01019206","Total",1470,817,653,1403,67,42,57.36,25.6
"2011","Carlisle 006C","E01019234","Total",1547,747,800,1540,7,11,14.05,110.1
"2011","Carlisle 006D","E01019235","Total",1487,717,770,1477,10,15,32.32,46.0
"2011","Carlisle 006E","E01019237","Total",1485,705,780,1380,105,18,46.18,32.2
"2011","Carlisle 006F","E01019242","Total",1329,609,720,1314,15,22,30.86,43.1
"2011","Carlisle 007A","E01019219","Total",2157,1054,1103,2157,0,47,9554.48,0.2
"2011","Carlisle 007B","E01019224","Total",2064,1024,1040,2059,5,59,2157.30,1.0
"2011","Carlisle 007C","E01019239","Total",1560,751,809,1558,2,37,5403.33,0.3
"2011","Carlisle 007D","E01019249","Total",1439,691,748,1433,6,33,1228.01,1.2
"2011","Carlisle 007E","E01019250","Total",1362,660,702,1343,19,30,2446.55,0.6
"2011","Carlisle 008A","E01019205","Total",1714,815,899,1625,89,8,34.40,49.8
"2011","Carlisle 008B","E01019207","Total",1394,682,712,1394,0,7,15.83,88.1
"2011","Carlisle 008C","E01019215","Total",1500,750,750,1498,2,14,41.47,36.2
"2011","Carlisle 008D","E01019218","Total",1575,744,831,1492,83,18,80.85,19.5
"2011","Carlisle 008E","E01019233","Total",1332,648,684,1299,33,9,36.17,36.8
"2011","Carlisle 009A","E01019193","Total",1516,704,812,1516,0,3,41.22,36.8
"2011","Carlisle 009B","E01019194","Total",2093,1026,1067,2044,49,12,42.29,49.5
"2011","Carlisle 009C","E01019230","Total",1542,737,805,1542,0,9,33.50,46.0
"2011","Carlisle 009D","E01019231","Total",1472,740,732,1472,0,2,50.14,29.4
"2011","Carlisle 009E","E01019232","Total",1479,723,756,1479,0,7,30.53,48.4
"2011","Carlisle 009F","E01019252","Total",1392,661,731,1392,0,5,25.30,55.0
"2011","Carlisle 010A","E01019209","Total",1444,734,710,1441,3,14,24.23,59.6
"2011","Carlisle 010B","E01019211","Total",1781,907,874,1779,2,11,74.95,23.8
"2011","Carlisle 010C","E01019216","Total",1583,760,823,1581,2,5,22.97,68.9
"2011","Carlisle 010D","E01019217","Total",1725,874,851,1725,0,13,87.62,19.7
"2011","Carlisle 010E","E01019220","Total",1558,788,770,1502,56,10,93.31,16.7
"2011","Carlisle 010F","E01019236","Total",1607,783,824,1586,21,11,21.05,76.3
"2011","Carlisle 011A","E01019197","Total",1989,924,1065,1989,0,15,79.41,25.0
"2011","Carlisle 011B","E01019198","Total",1350,665,685,1319,31,3,38.84,34.8
"2011","Carlisle 011C","E01019199","Total",1062,493,569,1062,0,3,16.13,65.8
"2011","Carlisle 011D","E01019221","Total",1964,943,1021,1964,0,6,41.87,46.9
"2011","Carlisle 011E","E01019222","Total",1655,778,877,1655,0,8,41.86,39.5
"2011","Carlisle 011F","E01019245","Total",1561,769,792,1556,5,13,23.22,67.2
"2011","Carlisle 012A","E01019208","Total",1526,735,791,1519,7,8,24.79,61.6
"2011","Carlisle 012B","E01019210","Total",1467,694,773,1444,23,7,21.24,69.1
"2011","Carlisle 012C","E01019246","Total",1267,621,646,1267,0,2,22.98,55.1
"2011","Carlisle 012D","E01019247","Total",1508,731,777,1471,37,4,53.57,28.2
"2011","Carlisle 012E","E01019248","Total",1140,534,606,1140,0,7,34.79,32.8
"2011","Carlisle 013A","E01019212","Total",1533,750,783,1438,95,33,4796.87,0.3
"2011","Carlisle 013B","E01019213","Total",2737,1374,1363,2689,48,28,2332.30,1.2
"2011","Carlisle 013C","E01019214","Total",1781,850,931,1776,5,30,1404.20,1.3
"2011","Carlisle 013D","E01019223","Total",1536,749,787,1536,0,17,30.31,50.7
"2011","Carlisle 013E","E01019253","Total",1793,862,931,1760,33,11,66.04,27.2
"2011","Copeland 001A","E01019268","Total",1130,548,582,1103,27,6,1112.79,1.0
"2011","Copeland 001B","E01019269","Total",1566,761,805,1557,9,15,483.52,3.2
"2011","Copeland 001C","E01019270","Total",1362,670,692,1362,0,15,141.19,9.6
"2011","Copeland 001D","E01019297","Total",1448,709,739,1394,54,24,691.02,2.1
"2011","Copeland 002A","E01019260","Total",1507,763,744,1504,3,16,75.87,19.9
"2011","Copeland 002B","E01019280","Total",1561,850,711,1510,51,8,54.22,28.8
"2011","Copeland 002C","E01019281","Total",1237,614,623,1219,18,14,58.98,21.0
"2011","Copeland 002D","E01019282","Total",1307,672,635,1287,20,18,30.44,42.9
"2011","Copeland 003A","E01019261","Total",1756,895,861,1756,0,34,158.13,11.1
"2011","Copeland 003B","E01019262","Total",1746,868,878,1700,46,22,127.15,13.7
"2011","Copeland 003C","E01019284","Total",1255,586,669,1255,0,7,40.45,31.0
"2011","Copeland 003D","E01019285","Total",1571,767,804,1541,30,18,44.20,35.5
"2011","Copeland 003E","E01019286","Total",1319,638,681,1319,0,22,181.48,7.3
"2011","Copeland 003F","E01019287","Total",1208,611,597,1208,0,15,24.16,50.0
"2011","Copeland 003G","E01019288","Total",1477,765,712,1468,9,19,41.77,35.4
"2011","Copeland 004A","E01019256","Total",1500,742,758,1500,0,19,2118.05,0.7
"2011","Copeland 004B","E01019263","Total",1138,584,554,1138,0,6,72.76,15.6
"2011","Copeland 004C","E01019264","Total",1701,853,848,1701,0,8,134.83,12.6
"2011","Copeland 004D","E01019265","Total",1281,667,614,1255,26,15,163.06,7.9
"2011","Copeland 004E","E01019266","Total",1471,748,723,1465,6,24,796.92,1.8
"2011","Copeland 004F","E01019267","Total",1345,633,712,1310,35,10,24.70,54.5
"2011","Copeland 004G","E01019276","Total",1025,533,492,1024,1,18,11585.49,0.1
"2011","Copeland 004H","E01019277","Total",1212,603,609,1212,0,5,85.90,14.1
"2011","Copeland 004I","E01019278","Total",1346,664,682,1345,1,10,756.99,1.8
"2011","Copeland 005A","E01019291","Total",1317,659,658,1317,0,13,84.81,15.5
"2011","Copeland 005B","E01019292","Total",1120,551,569,1120,0,13,74.23,15.1
"2011","Copeland 005C","E01019294","Total",1446,691,755,1446,0,8,60.99,23.7
"2011","Copeland 005D","E01019295","Total",1567,747,820,1567,0,7,28.62,54.8
"2011","Copeland 005E","E01019296","Total",1485,729,756,1379,106,8,140.13,10.6
"2011","Copeland 005F","E01019301","Total",1438,724,714,1438,0,7,89.90,16.0
"2011","Copeland 005G","E01019302","Total",1025,515,510,1025,0,7,694.01,1.5
"2011","Copeland 006A","E01019271","Total",1363,661,702,1353,10,9,403.48,3.4
"2011","Copeland 006B","E01019272","Total",1485,709,776,1485,0,5,39.91,37.2
"2011","Copeland 006C","E01019273","Total",1608,825,783,1608,0,23,411.53,3.9
"2011","Copeland 006D","E01019274","Total",1542,779,763,1542,0,9,99.89,15.4
"2011","Copeland 006E","E01019275","Total",2196,1093,1103,2168,28,30,378.19,5.8
"2011","Copeland 007A","E01019257","Total",1498,744,754,1498,0,12,810.76,1.8
"2011","Copeland 007B","E01019258","Total",1526,785,741,1525,1,42,4293.41,0.4
"2011","Copeland 007C","E01019279","Total",1396,734,662,1360,36,23,8939.04,0.2
"2011","Copeland 007D","E01019300","Total",1801,936,865,1718,83,62,1486.60,1.2
"2011","Copeland 007E","E01019303","Total",1523,752,771,1503,20,16,515.62,3.0
"2011","Copeland 007F","E01019304","Total",1300,668,632,1278,22,23,12614.09,0.1
"2011","Copeland 008A","E01019259","Total",1300,642,658,1276,24,18,8210.78,0.2
"2011","Copeland 008B","E01019283","Total",1849,1182,667,1312,537,10,523.09,3.5
"2011","Copeland 008C","E01019289","Total",1386,664,722,1386,0,14,88.84,15.6
"2011","Copeland 008D","E01019290","Total",1095,546,549,1091,4,7,117.09,9.4
"2011","Copeland 008E","E01019293","Total",1369,679,690,1336,33,27,13558.92,0.1
"2011","Copeland 008F","E01019298","Total",1514,761,753,1514,0,14,440.45,3.4
"2011","Copeland 008G","E01019299","Total",1985,956,1029,1934,51,14,65.49,30.3
"2011","Eden 001A","E01019305","Total",2088,1013,1075,2060,28,47,14948.78,0.1
"2011","Eden 001B","E01019314","Total",1273,644,629,1265,8,34,10127.76,0.1
"2011","Eden 001C","E01019320","Total",1471,756,715,1460,11,28,10991.25,0.1
"2011","Eden 001D","E01019321","Total",1562,788,774,1559,3,38,6201.26,0.3
"2011","Eden 002A","E01019315","Total",1699,843,856,1677,22,27,4909.66,0.3
"2011","Eden 002B","E01019316","Total",1494,775,719,1296,198,33,3999.44,0.4
"2011","Eden 002C","E01019322","Total",1388,683,705,1384,4,53,4886.38,0.3
"2011","Eden 002D","E01019338","Total",1497,759,738,1497,0,27,8633.76,0.2
"2011","Eden 003A","E01019327","Total",1342,633,709,1336,6,5,36.38,36.9
"2011","Eden 003B","E01019332","Total",1398,635,763,1319,79,8,63.51,22.0
"2011","Eden 003C","E01019333","Total",1134,569,565,1078,56,6,36.10,31.4
"2011","Eden 003D","E01019335","Total",1522,787,735,1515,7,11,293.21,5.2
"2011","Eden 003E","E01019336","Total",1723,860,863,1723,0,28,48.49,35.5
"2011","Eden 004A","E01019312","Total",1447,700,747,1396,51,20,1741.34,0.8
"2011","Eden 004B","E01019326","Total",1540,736,804,1540,0,31,248.27,6.2
"2011","Eden 004C","E01019328","Total",1342,631,711,1276,66,17,57.22,23.5
"2011","Eden 004D","E01019329","Total",1140,560,580,1114,26,31,2094.97,0.5
"2011","Eden 004E","E01019330","Total",1455,693,762,1413,42,34,27.13,53.6
"2011","Eden 004F","E01019331","Total",1529,779,750,1526,3,13,49.01,31.2
"2011","Eden 004G","E01019334","Total",1362,662,700,1362,0,6,109.98,12.4
"2011","Eden 005A","E01019308","Total",1432,719,713,1403,29,27,12254.68,0.1
"2011","Eden 005B","E01019311","Total",1438,691,747,1436,2,34,2966.51,0.5
"2011","Eden 005C","E01019313","Total",1374,685,689,1370,4,19,11578.30,0.1
"2011","Eden 005D","E01019339","Total",1422,725,697,1331,91,24,15291.99,0.1
"2011","Eden 006A","E01019306","Total",1293,620,673,1264,29,17,404.24,3.2
"2011","Eden 006B","E01019307","Total",1755,856,899,1716,39,33,355.19,4.9
"2011","Eden 006C","E01019310","Total",1396,712,684,1338,58,23,11338.74,0.1
"2011","Eden 006D","E01019319","Total",1563,791,772,1549,14,21,4718.63,0.3
"2011","Eden 006E","E01019323","Total",1202,600,602,1200,2,24,13248.64,0.1
"2011","Eden 006F","E01019324","Total",1300,652,648,1300,0,33,4943.46,0.3
"2011","Eden 006G","E01019337","Total",1394,711,683,1387,7,22,11008.86,0.1
"2011","Eden 007A","E01019309","Total",2293,1155,1138,2291,2,43,21027.45,0.1
"2011","Eden 007B","E01019317","Total",1319,660,659,1273,46,16,11305.87,0.1
"2011","Eden 007C","E01019318","Total",1261,606,655,1255,6,20,86.31,14.6
"2011","Eden 007D","E01019325","Total",1364,666,698,1360,4,17,11034.80,0.1
"2011","Eden 007E","E01019340","Total",1352,678,674,1344,8,33,13168.08,0.1
"2011","South Lakeland 001A","E01019374","Total",1533,746,787,1488,45,29,122.51,12.5
"2011","South Lakeland 001B","E01019375","Total",1445,722,723,1286,159,19,4066.46,0.4
"2011","South Lakeland 001C","E01019376","Total",1442,733,709,1231,211,28,8780.84,0.2
"2011","South Lakeland 001D","E01019395","Total",2074,948,1126,1797,277,39,2008.39,1.0
"2011","South Lakeland 002A","E01019387","Total",2116,1033,1083,2066,50,34,7800.21,0.3
"2011","South Lakeland 002B","E01019396","Total",2061,1022,1039,2002,59,53,204.17,10.1
"2011","South Lakeland 002C","E01019397","Total",1975,993,982,1807,168,24,541.65,3.6
"2011","South Lakeland 002D","E01019398","Total",1192,585,607,1167,25,16,20.24,58.9
"2011","South Lakeland 002E","E01019399","Total",1057,505,552,1050,7,20,145.98,7.2
"2011","South Lakeland 003A","E01019346","Total",1915,943,972,1907,8,41,4102.10,0.5
"2011","South Lakeland 003B","E01019359","Total",2056,984,1072,2056,0,30,116.48,17.7
"2011","South Lakeland 003C","E01019365","Total",2201,1113,1088,2198,3,36,241.38,9.1
"2011","South Lakeland 003D","E01019370","Total",2219,1049,1170,2212,7,24,77.82,28.5
"2011","South Lakeland 004A","E01019360","Total",2083,1047,1036,2003,80,33,136.89,15.2
"2011","South Lakeland 004B","E01019363","Total",1926,959,967,1859,67,30,67.07,28.7
"2011","South Lakeland 004C","E01019364","Total",1935,947,988,1906,29,20,27.87,69.4
"2011","South Lakeland 004D","E01019371","Total",2203,1058,1145,2188,15,31,52.77,41.7
"2011","South Lakeland 005A","E01019358","Total",1832,862,970,1803,29,26,213.22,8.6
"2011","South Lakeland 005B","E01019362","Total",1966,940,1026,1966,0,35,87.06,22.6
"2011","South Lakeland 005C","E01019366","Total",1882,927,955,1783,99,27,87.05,21.6
"2011","South Lakeland 005D","E01019394","Total",2313,1181,1132,2313,0,45,19018.31,0.1
"2011","South Lakeland 006A","E01019361","Total",1850,885,965,1805,45,33,59.08,31.3
"2011","South Lakeland 006B","E01019367","Total",2468,1220,1248,2444,24,38,199.02,12.4
"2011","South Lakeland 006C","E01019368","Total",2110,1023,1087,2110,0,28,51.77,40.8
"2011","South Lakeland 006D","E01019369","Total",1855,862,993,1829,26,40,69.37,26.7
"2011","South Lakeland 007A","E01019356","Total",1435,706,729,1381,54,23,9213.75,0.2
"2011","South Lakeland 007B","E01019381","Total",2114,1068,1046,2066,48,31,7572.68,0.3
"2011","South Lakeland 007C","E01019386","Total",1727,870,857,1673,54,35,6323.60,0.3
"2011","South Lakeland 008A","E01019344","Total",1031,514,517,1031,0,36,6939.49,0.1
"2011","South Lakeland 008B","E01019345","Total",1174,577,597,1174,0,10,3901.39,0.3
"2011","South Lakeland 008C","E01019350","Total",1617,802,815,1577,40,44,11014.56,0.1
"2011","South Lakeland 008D","E01019351","Total",1753,892,861,1753,0,42,4565.52,0.4
"2011","South Lakeland 009A","E01019372","Total",1057,478,579,1004,53,22,79.75,13.3
"2011","South Lakeland 009B","E01019373","Total",1447,650,797,1200,247,42,4714.00,0.3
"2011","South Lakeland 009C","E01019384","Total",2601,1395,1206,2151,450,57,24144.19,0.1
"2011","South Lakeland 009D","E01019385","Total",1140,541,599,1138,2,25,84.27,13.5
"2011","South Lakeland 010A","E01019348","Total",1227,612,615,1225,2,35,1267.79,1.0
"2011","South Lakeland 010B","E01019352","Total",2235,1083,1152,2208,27,54,5948.23,0.4
"2011","South Lakeland 010C","E01019377","Total",1748,845,903,1728,20,35,1901.15,0.9
"2011","South Lakeland 010D","E01019383","Total",1975,945,1030,1964,11,40,2949.53,0.7
"2011","South Lakeland 011A","E01019341","Total",1531,730,801,1523,8,25,943.53,1.6
"2011","South Lakeland 011B","E01019342","Total",1063,491,572,1020,43,9,57.49,18.5
"2011","South Lakeland 011C","E01019343","Total",1524,730,794,1433,91,20,2007.05,0.8
"2011","South Lakeland 011D","E01019347","Total",1756,853,903,1755,1,16,864.36,2.0
"2011","South Lakeland 011E","E01019382","Total",2199,1066,1133,2085,114,37,360.64,6.1
"2011","South Lakeland 012A","E01019388","Total",1924,919,1005,1749,175,24,205.45,9.4
"2011","South Lakeland 012B","E01019389","Total",2268,1108,1160,2268,0,18,366.30,6.2
"2011","South Lakeland 012C","E01019390","Total",1997,972,1025,1995,2,32,190.20,10.5
"2011","South Lakeland 012D","E01019392","Total",1833,897,936,1832,1,23,31.11,58.9
"2011","South Lakeland 013A","E01019349","Total",1831,869,962,1769,62,41,2859.34,0.6
"2011","South Lakeland 013B","E01019353","Total",1496,700,796,1494,2,27,103.06,14.5
"2011","South Lakeland 013C","E01019354","Total",1320,601,719,1277,43,22,511.15,2.6
"2011","South Lakeland 013D","E01019355","Total",1298,605,693,1230,68,11,136.21,9.5
"2011","South Lakeland 013E","E01019357","Total",1869,925,944,1843,26,22,1665.01,1.1
"2011","South Lakeland 014A","E01019378","Total",1601,769,832,1601,0,28,89.20,17.9
"2011","South Lakeland 014B","E01019379","Total",1428,683,745,1369,59,34,1479.57,1.0
"2011","South Lakeland 014C","E01019380","Total",1074,546,528,1074,0,25,2104.80,0.5
"2011","South Lakeland 014D","E01019391","Total",1717,845,872,1717,0,29,154.06,11.1
"2011","South Lakeland 014E","E01019393","Total",1939,948,991,1931,8,38,315.86,6.1
"2011","Bolton 001A","E01004768","Total",1601,805,796,1601,0,33,391.26,4.1
"2011","Bolton 001B","E01004803","Total",1635,816,819,1635,0,23,245.57,6.7
"2011","Bolton 001C","E01004804","Total",1452,727,725,1452,0,31,46.92,30.9
"2011","Bolton 001D","E01004807","Total",1451,725,726,1446,5,26,31.46,46.1
"2011","Bolton 001E","E01004808","Total",1643,809,834,1643,0,26,74.68,22.0
"2011","Bolton 002A","E01004788","Total",1392,661,731,1392,0,29,74.78,18.6
"2011","Bolton 002B","E01004790","Total",1432,701,731,1432,0,26,53.48,26.8
"2011","Bolton 002C","E01004805","Total",1633,804,829,1633,0,30,98.42,16.6
"2011","Bolton 002D","E01004806","Total",1515,739,776,1515,0,19,63.32,23.9
"2011","Bolton 002E","E01004810","Total",1597,769,828,1594,3,26,79.78,20.0
"2011","Bolton 003A","E01004769","Total",1534,750,784,1534,0,21,40.45,37.9
"2011","Bolton 003B","E01004770","Total",1465,703,762,1465,0,11,44.24,33.1
"2011","Bolton 003C","E01004771","Total",1641,813,828,1641,0,25,45.27,36.2
"2011","Bolton 003D","E01004773","Total",1962,1018,944,1942,20,22,26.62,73.7
"2011","Bolton 003E","E01004809","Total",1763,820,943,1763,0,16,35.72,49.4
"2011","Bolton 004A","E01004777","Total",1601,755,846,1533,68,9,34.37,46.6
"2011","Bolton 004B","E01004881","Total",1437,650,787,1362,75,12,20.85,68.9
"2011","Bolton 004C","E01004888","Total",1322,675,647,1322,0,22,37.56,35.2
"2011","Bolton 004D","E01004889","Total",1433,667,766,1433,0,22,32.74,43.8
"2011","Bolton 004E","E01004890","Total",1402,669,733,1402,0,6,30.82,45.5
"2011","Bolton 005A","E01004766","Total",1592,795,797,1592,0,13,51.53,30.9
"2011","Bolton 005B","E01004767","Total",1678,815,863,1675,3,15,52.14,32.2
"2011","Bolton 005C","E01004772","Total",1731,821,910,1731,0,11,32.52,53.2
"2011","Bolton 005D","E01004774","Total",1675,809,866,1667,8,15,31.10,53.9
"2011","Bolton 005E","E01004824","Total",1731,896,835,1706,25,42,27.84,62.2
"2011","Bolton 006A","E01004784","Total",1261,628,633,1261,0,12,24.12,52.3
"2011","Bolton 006B","E01004785","Total",1423,680,743,1423,0,15,57.85,24.6
"2011","Bolton 006C","E01004786","Total",1453,687,766,1453,0,13,87.58,16.6
"2011","Bolton 006D","E01004789","Total",1406,686,720,1406,0,28,566.82,2.5
"2011","Bolton 006E","E01004791","Total",1234,570,664,1234,0,12,39.82,31.0
"2011","Bolton 006F","E01004792","Total",1465,711,754,1465,0,23,63.81,23.0
"2011","Bolton 007A","E01004779","Total",1557,769,788,1557,0,17,29.75,52.3
"2011","Bolton 007B","E01004781","Total",1816,897,919,1816,0,22,273.24,6.6
"2011","Bolton 007C","E01004882","Total",1362,672,690,1362,0,9,23.42,58.2
"2011","Bolton 007D","E01004883","Total",1431,718,713,1431,0,15,48.28,29.6
"2011","Bolton 007E","E01004884","Total",1470,734,736,1470,0,23,569.25,2.6
"2011","Bolton 008A","E01004864","Total",1550,758,792,1550,0,20,21.75,71.3
"2011","Bolton 008B","E01004867","Total",1517,784,733,1517,0,14,18.23,83.2
"2011","Bolton 008C","E01004921","Total",1561,753,808,1561,0,16,23.09,67.6
"2011","Bolton 008D","E01004924","Total",1538,764,774,1538,0,33,611.46,2.5
"2011","Bolton 008E","E01004925","Total",1516,721,795,1496,20,11,21.16,71.6
"2011","Bolton 009A","E01004778","Total",1186,600,586,1159,27,9,43.78,27.1
"2011","Bolton 009B","E01004780","Total",1987,981,1006,1970,17,27,624.14,3.2
"2011","Bolton 009C","E01004782","Total",1118,524,594,1118,0,7,60.86,18.4
"2011","Bolton 009D","E01004783","Total",1490,749,741,1490,0,16,154.26,9.7
"2011","Bolton 010A","E01004802","Total",1809,882,927,1809,0,11,34.91,51.8
"2011","Bolton 010B","E01004926","Total",1302,570,732,1302,0,10,22.21,58.6
"2011","Bolton 010C","E01004927","Total",2056,1001,1055,2056,0,15,67.69,30.4
"2011","Bolton 010D","E01004929","Total",1975,978,997,1975,0,17,56.97,34.7
"2011","Bolton 011A","E01004820","Total",1601,808,793,1601,0,10,15.58,102.8
"2011","Bolton 011B","E01004825","Total",1641,864,777,1641,0,13,16.18,101.4
"2011","Bolton 011C","E01004826","Total",1586,773,813,1586,0,8,18.05,87.9
"2011","Bolton 011D","E01004865","Total",1345,646,699,1345,0,7,25.84,52.1
"2011","Bolton 011E","E01004866","Total",1741,851,890,1741,0,10,38.44,45.3
"2011","Bolton 012A","E01004840","Total",1652,823,829,1624,28,27,418.11,4.0
"2011","Bolton 012B","E01004841","Total",1720,844,876,1720,0,11,39.91,43.1
"2011","Bolton 012C","E01004842","Total",1702,806,896,1702,0,34,33.22,51.2
"2011","Bolton 012D","E01004919","Total",1505,745,760,1505,0,23,39.94,37.7
"2011","Bolton 012E","E01004920","Total",1584,734,850,1557,27,11,46.36,34.2
"2011","Bolton 013A","E01004787","Total",1608,780,828,1608,0,4,30.04,53.5
"2011","Bolton 013B","E01004793","Total",1617,770,847,1542,75,8,30.92,52.3
"2011","Bolton 013C","E01004794","Total",1775,840,935,1775,0,14,39.78,44.6
"2011","Bolton 013D","E01004795","Total",1498,751,747,1387,111,10,40.90,36.6
"2011","Bolton 013E","E01004797","Total",1371,634,737,1371,0,5,31.96,42.9
"2011","Bolton 014A","E01004775","Total",1512,756,756,1424,88,24,744.12,2.0
"2011","Bolton 014B","E01004885","Total",1366,669,697,1366,0,37,195.76,7.0
"2011","Bolton 014C","E01004886","Total",1383,671,712,1381,2,17,23.74,58.3
"2011","Bolton 014D","E01004887","Total",1415,695,720,1415,0,19,66.63,21.2
"2011","Bolton 015A","E01004868","Total",1679,836,843,1679,0,14,18.93,88.7
"2011","Bolton 015B","E01004869","Total",1674,822,852,1674,0,5,26.11,64.1
"2011","Bolton 015C","E01004870","Total",1889,1029,860,1834,55,10,31.67,59.6
"2011","Bolton 015D","E01004871","Total",1629,857,772,1629,0,10,20.08,81.1
"2011","Bolton 015E","E01004922","Total",1742,866,876,1742,0,20,28.47,61.2
"2011","Bolton 016B","E01004822","Total",1679,822,857,1679,0,12,31.29,53.7
"2011","Bolton 016C","E01004823","Total",1732,865,867,1718,14,11,31.67,54.7
"2011","Bolton 016D","E01004848","Total",1693,923,770,1366,327,14,87.23,19.4
"2011","Bolton 016E","E01033217","Total",1037,565,472,1034,3,2,80.41,12.9
"2011","Bolton 016F","E01033220","Total",1294,728,566,1294,0,4,92.08,14.1
"2011","Bolton 017A","E01004818","Total",1589,837,752,1536,53,13,24.26,65.5
"2011","Bolton 017B","E01004819","Total",1513,777,736,1298,215,18,35.33,42.8
"2011","Bolton 017C","E01004928","Total",1408,683,725,1404,4,10,18.33,76.8
"2011","Bolton 017D","E01004930","Total",1517,736,781,1517,0,6,44.76,33.9
"2011","Bolton 017E","E01004931","Total",1584,767,817,1584,0,10,34.25,46.2
"2011","Bolton 017F","E01004932","Total",1534,755,779,1534,0,5,52.90,29.0
"2011","Bolton 018A","E01004834","Total",1614,870,744,1476,138,14,13.10,123.2
"2011","Bolton 018B","E01004838","Total",1672,817,855,1640,32,13,80.66,20.7
"2011","Bolton 018C","E01004843","Total",1517,715,802,1495,22,38,34.88,43.5
"2011","Bolton 018D","E01004845","Total",1714,852,862,1714,0,47,50.90,33.7
"2011","Bolton 018E","E01004923","Total",1584,814,770,1578,6,19,16.83,94.1
"2011","Bolton 019A","E01004796","Total",1494,741,753,1494,0,16,51.05,29.3
"2011","Bolton 019B","E01004798","Total",1652,790,862,1652,0,7,53.94,30.6
"2011","Bolton 019C","E01004799","Total",1317,649,668,1317,0,13,28.14,46.8
"2011","Bolton 019D","E01004800","Total",1303,644,659,1303,0,24,24.04,54.2
"2011","Bolton 019E","E01004801","Total",1635,756,879,1635,0,11,52.38,31.2
"2011","Bolton 019F","E01004917","Total",2044,978,1066,2044,0,11,173.89,11.8
"2011","Bolton 020A","E01004835","Total",1488,768,720,1488,0,21,40.83,36.4
"2011","Bolton 020B","E01004836","Total",1491,712,779,1463,28,18,60.11,24.8
"2011","Bolton 020C","E01004837","Total",1632,813,819,1632,0,47,127.09,12.8
"2011","Bolton 020D","E01004844","Total",1581,781,800,1581,0,58,87.64,18.0
"2011","Bolton 020E","E01004897","Total",1085,554,531,1085,0,13,77.20,14.1
"2011","Bolton 021A","E01004827","Total",1615,820,795,1615,0,13,15.98,101.1
"2011","Bolton 021B","E01004849","Total",1731,878,853,1731,0,15,29.41,58.9
"2011","Bolton 021C","E01004850","Total",1743,956,787,1743,0,7,18.84,92.5
"2011","Bolton 021D","E01004851","Total",1552,790,762,1552,0,15,21.56,72.0
"2011","Bolton 021E","E01004853","Total",1599,831,768,1599,0,13,10.40,153.8
"2011","Bolton 022A","E01004811","Total",1557,773,784,1557,0,5,43.61,35.7
"2011","Bolton 022B","E01004812","Total",1848,958,890,1848,0,26,80.59,22.9
"2011","Bolton 022C","E01004813","Total",1392,701,691,1357,35,10,19.05,73.1
"2011","Bolton 022D","E01004815","Total",1578,801,777,1578,0,15,23.80,66.3
"2011","Bolton 022E","E01004817","Total",1562,823,739,1520,42,14,84.72,18.4
"2011","Bolton 023A","E01004828","Total",1800,910,890,1800,0,7,14.32,125.7
"2011","Bolton 023B","E01004829","Total",1371,693,678,1371,0,12,20.32,67.5
"2011","Bolton 023C","E01004832","Total",1532,761,771,1532,0,5,16.37,93.6
"2011","Bolton 023D","E01004854","Total",1531,783,748,1507,24,12,13.55,113.0
"2011","Bolton 023E","E01004878","Total",1475,774,701,1475,0,14,23.25,63.4
"2011","Bolton 024A","E01004911","Total",1566,780,786,1566,0,9,31.11,50.3
"2011","Bolton 024B","E01004912","Total",1448,700,748,1448,0,11,58.04,24.9
"2011","Bolton 024C","E01004913","Total",1960,982,978,1960,0,10,42.85,45.7
"2011","Bolton 024D","E01004914","Total",1194,576,618,1194,0,8,46.57,25.6
"2011","Bolton 024E","E01004915","Total",1340,675,665,1330,10,15,50.32,26.6
"2011","Bolton 024F","E01004916","Total",1460,671,789,1460,0,11,43.17,33.8
"2011","Bolton 024G","E01004918","Total",1303,664,639,1303,0,6,21.20,61.5
"2011","Bolton 025A","E01004846","Total",1272,630,642,1272,0,7,12.14,104.8
"2011","Bolton 025B","E01004847","Total",2004,959,1045,1931,73,18,23.97,83.6
"2011","Bolton 025C","E01004852","Total",1612,808,804,1612,0,21,19.46,82.8
"2011","Bolton 025D","E01004877","Total",1792,899,893,1792,0,8,54.27,33.0
"2011","Bolton 025E","E01004879","Total",1460,683,777,1460,0,5,17.78,82.1
"2011","Bolton 026A","E01004830","Total",1551,761,790,1551,0,6,24.97,62.1
"2011","Bolton 026B","E01004831","Total",1630,814,816,1630,0,18,39.30,41.5
"2011","Bolton 026C","E01004833","Total",1530,736,794,1530,0,11,551.15,2.8
"2011","Bolton 026D","E01004839","Total",1978,960,1018,1973,5,9,35.33,56.0
"2011","Bolton 027A","E01004814","Total",1456,732,724,1456,0,11,80.37,18.1
"2011","Bolton 027B","E01004855","Total",1483,709,774,1483,0,7,79.61,18.6
"2011","Bolton 027C","E01004856","Total",1422,732,690,1422,0,2,39.76,35.8
"2011","Bolton 027D","E01004857","Total",1506,742,764,1506,0,5,37.79,39.9
"2011","Bolton 028A","E01004891","Total",1594,783,811,1592,2,19,108.77,14.7
"2011","Bolton 028B","E01004893","Total",1532,780,752,1532,0,32,99.91,15.3
"2011","Bolton 028C","E01004894","Total",1840,904,936,1840,0,21,49.94,36.8
"2011","Bolton 028E","E01004901","Total",1812,919,893,1812,0,41,35.44,51.1
"2011","Bolton 028F","E01033218","Total",1581,784,797,1581,0,9,70.15,22.5
"2011","Bolton 028G","E01033219","Total",1496,755,741,1496,0,26,134.46,11.1
"2011","Bolton 029A","E01004816","Total",1588,776,812,1588,0,15,24.02,66.1
"2011","Bolton 029B","E01004872","Total",1560,754,806,1560,0,5,24.45,63.8
"2011","Bolton 029C","E01004873","Total",1762,854,908,1762,0,13,24.62,71.6
"2011","Bolton 029D","E01004875","Total",1590,778,812,1590,0,14,52.98,30.0
"2011","Bolton 029E","E01004880","Total",1333,669,664,1324,9,4,46.98,28.4
"2011","Bolton 030A","E01004892","Total",1531,720,811,1531,0,20,345.78,4.4
"2011","Bolton 030B","E01004896","Total",1360,664,696,1321,39,22,48.05,28.3
"2011","Bolton 030C","E01004899","Total",1539,757,782,1539,0,18,149.57,10.3
"2011","Bolton 030D","E01004900","Total",1599,784,815,1599,0,12,25.46,62.8
"2011","Bolton 031A","E01004776","Total",1802,890,912,1802,0,12,535.51,3.4
"2011","Bolton 031B","E01004895","Total",1325,621,704,1325,0,9,26.44,50.1
"2011","Bolton 031C","E01004936","Total",2029,1004,1025,2029,0,26,60.31,33.6
"2011","Bolton 031D","E01004938","Total",1493,734,759,1493,0,8,28.92,51.6
"2011","Bolton 031E","E01004939","Total",1519,760,759,1519,0,9,68.09,22.3
"2011","Bolton 032A","E01004858","Total",1600,802,798,1580,20,13,32.01,50.0
"2011","Bolton 032B","E01004859","Total",1463,664,799,1345,118,3,34.04,43.0
"2011","Bolton 032C","E01004860","Total",1487,713,774,1487,0,10,29.46,50.5
"2011","Bolton 032D","E01004902","Total",1679,835,844,1679,0,10,43.97,38.2
"2011","Bolton 032E","E01004906","Total",1684,847,837,1652,32,10,62.44,27.0
"2011","Bolton 033A","E01004861","Total",1663,806,857,1663,0,7,49.50,33.6
"2011","Bolton 033B","E01004862","Total",1374,655,719,1374,0,9,27.74,49.5
"2011","Bolton 033C","E01004863","Total",1536,748,788,1536,0,4,28.59,53.7
"2011","Bolton 033D","E01004874","Total",1804,879,925,1782,22,10,31.30,57.6
"2011","Bolton 033E","E01004876","Total",1866,910,956,1866,0,11,39.17,47.6
"2011","Bolton 034A","E01004903","Total",1470,713,757,1470,0,15,53.39,27.5
"2011","Bolton 034B","E01004904","Total",1623,810,813,1623,0,12,193.70,8.4
"2011","Bolton 034C","E01004905","Total",1601,785,816,1601,0,13,34.39,46.6
"2011","Bolton 034D","E01004907","Total",1301,616,685,1301,0,8,32.32,40.3
"2011","Bolton 034E","E01004908","Total",1347,649,698,1347,0,6,200.48,6.7
"2011","Bolton 034F","E01004909","Total",1411,682,729,1411,0,7,35.50,39.7
"2011","Bolton 034G","E01004910","Total",2096,1040,1056,2096,0,18,108.43,19.3
"2011","Bolton 035A","E01004933","Total",1329,673,656,1329,0,18,76.51,17.4
"2011","Bolton 035B","E01004934","Total",1518,762,756,1517,1,30,108.10,14.0
"2011","Bolton 035C","E01004935","Total",1770,839,931,1770,0,20,47.17,37.5
"2011","Bolton 035D","E01004937","Total",1524,758,766,1524,0,27,208.02,7.3
"2011","Bolton 035E","E01004940","Total",1463,708,755,1463,0,18,25.51,57.4
"2011","Bury 001A","E01005014","Total",1462,735,727,1462,0,7,59.91,24.4
"2011","Bury 001B","E01005015","Total",1523,710,813,1520,3,12,200.41,7.6
"2011","Bury 001C","E01005016","Total",1517,745,772,1517,0,22,37.91,40.0
"2011","Bury 001D","E01005017","Total",1733,859,874,1733,0,23,118.31,14.6
"2011","Bury 001E","E01005018","Total",1503,733,770,1503,0,23,44.11,34.1
"2011","Bury 001F","E01005021","Total",1229,728,501,997,232,39,673.87,1.8
"2011","Bury 002A","E01005019","Total",1502,709,793,1502,0,26,50.92,29.5
"2011","Bury 002B","E01005023","Total",1309,605,704,1277,32,21,39.22,33.4
"2011","Bury 002C","E01005046","Total",1435,695,740,1435,0,26,48.34,29.7
"2011","Bury 002D","E01005048","Total",1687,821,866,1687,0,54,81.99,20.6
"2011","Bury 003A","E01005020","Total",1465,731,734,1465,0,57,47.81,30.6
"2011","Bury 003B","E01005022","Total",1597,796,801,1594,3,41,308.36,5.2
"2011","Bury 003C","E01005047","Total",1475,702,773,1387,88,33,655.66,2.2
"2011","Bury 003D","E01005049","Total",1695,843,852,1690,5,36,139.54,12.1
"2011","Bury 003E","E01005051","Total",1574,739,835,1502,72,33,63.23,24.9
"2011","Bury 004A","E01004976","Total",1547,738,809,1547,0,19,32.82,47.1
"2011","Bury 004B","E01004977","Total",1721,816,905,1619,102,24,43.82,39.3
"2011","Bury 004C","E01004978","Total",1688,843,845,1661,27,20,35.42,47.7
"2011","Bury 004D","E01004981","Total",1455,698,757,1417,38,20,261.10,5.6
"2011","Bury 004E","E01004982","Total",1449,727,722,1449,0,19,133.76,10.8
"2011","Bury 005A","E01004961","Total",1545,735,810,1545,0,23,36.82,42.0
"2011","Bury 005B","E01004965","Total",1227,605,622,1225,2,28,92.09,13.3
"2011","Bury 005C","E01004966","Total",1777,845,932,1771,6,10,64.89,27.4
"2011","Bury 005D","E01004967","Total",1284,634,650,1284,0,27,38.17,33.6
"2011","Bury 006A","E01004963","Total",1472,721,751,1472,0,23,54.75,26.9
"2011","Bury 006B","E01004968","Total",1576,771,805,1553,23,24,30.01,52.5
"2011","Bury 006C","E01005050","Total",2041,1003,1038,2041,0,19,57.49,35.5
"2011","Bury 006D","E01005052","Total",1464,730,734,1464,0,22,23.78,61.6
"2011","Bury 006E","E01005053","Total",1530,759,771,1502,28,15,72.46,21.1
"2011","Bury 007A","E01004954","Total",1464,713,751,1417,47,12,128.93,11.4
"2011","Bury 007B","E01004955","Total",1348,683,665,1333,15,5,42.28,31.9
"2011","Bury 007C","E01004956","Total",1534,766,768,1498,36,9,151.25,10.1
"2011","Bury 007D","E01004957","Total",1748,831,917,1748,0,13,69.86,25.0
"2011","Bury 007E","E01004960","Total",1514,742,772,1499,15,8,38.07,39.8
"2011","Bury 008A","E01004958","Total",1400,738,662,1375,25,17,25.40,55.1
"2011","Bury 008B","E01004959","Total",1658,816,842,1658,0,8,22.03,75.3
"2011","Bury 008C","E01004979","Total",1544,808,736,1505,39,7,67.99,22.7
"2011","Bury 008D","E01004980","Total",1286,650,636,1286,0,6,19.51,65.9
"2011","Bury 008E","E01005024","Total",1447,709,738,1403,44,9,76.30,19.0
"2011","Bury 008F","E01005026","Total",1629,815,814,1612,17,15,23.48,69.4
"2011","Bury 009A","E01004947","Total",1420,686,734,1396,24,8,20.33,69.8
"2011","Bury 009B","E01004948","Total",1864,922,942,1723,141,11,94.94,19.6
"2011","Bury 009C","E01004962","Total",1670,828,842,1651,19,18,29.70,56.2
"2011","Bury 009D","E01004964","Total",1833,894,939,1782,51,7,40.03,45.8
"2011","Bury 010A","E01004949","Total",1470,730,740,1470,0,20,42.07,34.9
"2011","Bury 010B","E01004950","Total",1510,726,784,1510,0,36,136.52,11.1
"2011","Bury 010C","E01004951","Total",1579,761,818,1537,42,27,29.05,54.4
"2011","Bury 010D","E01004952","Total",1379,674,705,1379,0,38,34.77,39.7
"2011","Bury 010E","E01004953","Total",1492,711,781,1492,0,24,48.31,30.9
"2011","Bury 011A","E01005025","Total",1489,759,730,1479,10,26,85.50,17.4
"2011","Bury 011B","E01005027","Total",1771,908,863,1734,37,21,68.71,25.8
"2011","Bury 011C","E01005028","Total",1863,938,925,1863,0,8,28.87,64.5
"2011","Bury 011D","E01005029","Total",1851,887,964,1822,29,19,24.95,74.2
"2011","Bury 012A","E01005000","Total",1555,772,783,1527,28,26,113.77,13.7
"2011","Bury 012B","E01005001","Total",1339,661,678,1339,0,28,23.83,56.2
"2011","Bury 012C","E01005005","Total",1404,674,730,1373,31,20,347.89,4.0
"2011","Bury 012D","E01005006","Total",1519,728,791,1519,0,29,177.27,8.6
"2011","Bury 013A","E01005030","Total",1590,786,804,1590,0,10,38.75,41.0
"2011","Bury 013B","E01005054","Total",1498,728,770,1498,0,19,342.10,4.4
"2011","Bury 013C","E01005059","Total",1707,840,867,1707,0,26,59.98,28.5
"2011","Bury 013D","E01005060","Total",1669,806,863,1668,1,25,91.96,18.1
"2011","Bury 014A","E01004997","Total",1556,763,793,1482,74,7,27.83,55.9
"2011","Bury 014B","E01004998","Total",1464,700,764,1431,33,11,50.54,29.0
"2011","Bury 014C","E01004999","Total",1480,738,742,1480,0,15,196.03,7.5
"2011","Bury 014D","E01005002","Total",1590,755,835,1590,0,26,24.50,64.9
"2011","Bury 014E","E01005003","Total",1462,727,735,1462,0,9,15.67,93.3
"2011","Bury 015A","E01004991","Total",1414,704,710,1414,0,9,70.19,20.1
"2011","Bury 015B","E01004992","Total",1481,728,753,1476,5,9,75.98,19.5
"2011","Bury 015C","E01004993","Total",1411,657,754,1411,0,14,53.90,26.2
"2011","Bury 015D","E01004994","Total",1307,652,655,1302,5,8,68.83,19.0
"2011","Bury 016A","E01004990","Total",1517,767,750,1515,2,10,27.67,54.8
"2011","Bury 016B","E01004996","Total",1444,703,741,1427,17,3,24.11,59.9
"2011","Bury 016C","E01005004","Total",1458,718,740,1458,0,3,29.53,49.4
"2011","Bury 016D","E01005008","Total",1866,911,955,1855,11,7,43.44,43.0
"2011","Bury 016E","E01005009","Total",1481,729,752,1481,0,12,50.08,29.6
"2011","Bury 017A","E01004945","Total",1558,751,807,1548,10,33,382.04,4.1
"2011","Bury 017B","E01005055","Total",1493,739,754,1493,0,19,38.19,39.1
"2011","Bury 017C","E01005056","Total",1256,634,622,1256,0,17,42.48,29.6
"2011","Bury 017D","E01005057","Total",1560,752,808,1560,0,24,58.56,26.6
"2011","Bury 017E","E01005058","Total",1333,665,668,1333,0,26,26.68,50.0
"2011","Bury 018A","E01004995","Total",1543,751,792,1543,0,16,103.86,14.9
"2011","Bury 018B","E01005010","Total",1621,769,852,1621,0,10,253.97,6.4
"2011","Bury 018C","E01005012","Total",1711,845,866,1711,0,14,73.13,23.4
"2011","Bury 018D","E01005013","Total",2378,1183,1195,2377,1,28,50.55,47.0
"2011","Bury 019A","E01004984","Total",1367,645,722,1367,0,27,25.07,54.5
"2011","Bury 019B","E01004985","Total",1439,712,727,1439,0,49,371.65,3.9
"2011","Bury 019C","E01004989","Total",1457,726,731,1427,30,32,37.85,38.5
"2011","Bury 019D","E01005007","Total",1470,661,809,1414,56,18,59.29,24.8
"2011","Bury 019E","E01005011","Total",1385,681,704,1385,0,24,56.32,24.6
"2011","Bury 020A","E01004983","Total",1291,628,663,1291,0,21,34.31,37.6
"2011","Bury 020B","E01004986","Total",1638,768,870,1638,0,13,91.76,17.9
"2011","Bury 020C","E01004987","Total",1201,559,642,1200,1,6,27.47,43.7
"2011","Bury 020D","E01004988","Total",1438,665,773,1438,0,22,43.95,32.7
"2011","Bury 021A","E01004941","Total",1783,844,939,1783,0,13,49.89,35.7
"2011","Bury 021B","E01004942","Total",1521,704,817,1521,0,14,22.36,68.0
"2011","Bury 021C","E01004943","Total",1631,803,828,1631,0,25,30.37,53.7
"2011","Bury 021D","E01004944","Total",1615,786,829,1615,0,24,23.92,67.5
"2011","Bury 021E","E01004946","Total",1624,743,881,1624,0,5,38.76,41.9
"2011","Bury 022A","E01004969","Total",1472,765,707,1399,73,11,261.01,5.6
"2011","Bury 022B","E01004970","Total",1572,770,802,1572,0,30,56.65,27.7
"2011","Bury 022C","E01004971","Total",1519,776,743,1519,0,19,24.64,61.6
"2011","Bury 022D","E01005034","Total",1457,695,762,1397,60,28,64.55,22.6
"2011","Bury 023A","E01004972","Total",1485,709,776,1485,0,16,19.27,77.1
"2011","Bury 023B","E01004973","Total",1525,762,763,1524,1,11,21.09,72.3
"2011","Bury 023C","E01004975","Total",1521,717,804,1519,2,12,21.74,70.0
"2011","Bury 023D","E01005039","Total",1486,714,772,1486,0,9,27.64,53.8
"2011","Bury 023E","E01005045","Total",1599,784,815,1599,0,23,31.39,50.9
"2011","Bury 024A","E01004974","Total",1427,718,709,1422,5,27,28.48,50.1
"2011","Bury 024B","E01005033","Total",1528,767,761,1522,6,25,47.78,32.0
"2011","Bury 024C","E01005036","Total",1816,938,878,1816,0,29,41.32,43.9
"2011","Bury 024D","E01005037","Total",1422,712,710,1407,15,20,27.89,51.0
"2011","Bury 025A","E01005031","Total",1463,693,770,1463,0,14,37.65,38.9
"2011","Bury 025B","E01005032","Total",1256,539,717,1037,219,8,83.33,15.1
"2011","Bury 025C","E01005035","Total",1402,675,727,1402,0,8,208.42,6.7
"2011","Bury 025D","E01005038","Total",1347,654,693,1347,0,27,25.13,53.6
"2011","Bury 026A","E01005040","Total",1812,918,894,1806,6,19,25.39,71.4
"2011","Bury 026B","E01005041","Total",1614,799,815,1609,5,52,33.14,48.7
"2011","Bury 026C","E01005042","Total",1902,920,982,1834,68,63,33.21,57.3
"2011","Bury 026D","E01005043","Total",1872,896,976,1872,0,56,22.22,84.2
"2011","Bury 026E","E01005044","Total",1793,935,858,1775,18,41,14.40,124.5
"2011","Manchester 001A","E01005098","Total",1522,712,810,1522,0,6,33.56,45.4
"2011","Manchester 001B","E01005099","Total",1819,811,1008,1789,30,4,64.17,28.3
"2011","Manchester 001C","E01005100","Total",1588,722,866,1588,0,11,81.34,19.5
"2011","Manchester 001D","E01005102","Total",1358,647,711,1358,0,2,18.10,75.0
"2011","Manchester 001E","E01005103","Total",1640,771,869,1640,0,3,44.83,36.6
"2011","Manchester 002A","E01005101","Total",1704,792,912,1704,0,2,40.94,41.6
"2011","Manchester 002B","E01005135","Total",1621,772,849,1621,0,5,29.09,55.7
"2011","Manchester 002C","E01005136","Total",1506,709,797,1470,36,9,34.81,43.3
"2011","Manchester 002D","E01005138","Total",1755,879,876,1755,0,10,45.82,38.3
"2011","Manchester 002E","E01005140","Total",2804,1394,1410,2759,45,12,96.71,29.0
"2011","Manchester 003B","E01005139","Total",1726,847,879,1726,0,9,35.55,48.6
"2011","Manchester 003C","E01005141","Total",1738,832,906,1738,0,9,67.52,25.7
"2011","Manchester 003D","E01005251","Total",1594,760,834,1589,5,16,29.93,53.3
"2011","Manchester 003E","E01005252","Total",1834,862,972,1825,9,7,26.62,68.9
"2011","Manchester 003F","E01033685","Total",1561,781,780,1561,0,5,32.97,47.3
"2011","Manchester 003G","E01033687","Total",1417,749,668,1417,0,3,41.78,33.9
"2011","Manchester 004A","E01005104","Total",1789,892,897,1789,0,9,53.15,33.7
"2011","Manchester 004B","E01005160","Total",1769,892,877,1769,0,20,340.71,5.2
"2011","Manchester 004C","E01005161","Total",1554,750,804,1554,0,8,28.17,55.2
"2011","Manchester 004D","E01005162","Total",1710,856,854,1694,16,21,28.77,59.4
"2011","Manchester 004E","E01005163","Total",1651,857,794,1649,2,13,24.04,68.7
"2011","Manchester 005A","E01005247","Total",1454,690,764,1438,16,8,24.01,60.6
"2011","Manchester 005B","E01005248","Total",1369,633,736,1369,0,17,34.93,39.2
"2011","Manchester 005C","E01005249","Total",1846,930,916,1759,87,9,73.00,25.3
"2011","Manchester 005D","E01005250","Total",1781,805,976,1771,10,15,31.99,55.7
"2011","Manchester 005E","E01005253","Total",1585,755,830,1585,0,5,27.32,58.0
"2011","Manchester 005F","E01005254","Total",1598,796,802,1598,0,13,24.30,65.8
"2011","Manchester 006A","E01005164","Total",1571,876,695,1565,6,11,62.05,25.3
"2011","Manchester 006B","E01005205","Total",1987,960,1027,1978,9,10,46.38,42.8
"2011","Manchester 006C","E01005206","Total",1693,886,807,1614,79,8,33.66,50.3
"2011","Manchester 006D","E01005207","Total",1915,951,964,1915,0,13,25.16,76.1
"2011","Manchester 007A","E01005223","Total",1234,620,614,1234,0,15,19.55,63.1
"2011","Manchester 007B","E01005224","Total",1819,897,922,1819,0,18,28.82,63.1
"2011","Manchester 007C","E01005225","Total",1847,924,923,1842,5,11,25.92,71.3
"2011","Manchester 007D","E01005226","Total",1599,761,838,1568,31,5,21.63,73.9
"2011","Manchester 007E","E01005229","Total",1539,745,794,1512,27,13,39.78,38.7
"2011","Manchester 008A","E01005145","Total",2711,1452,1259,2660,51,12,19.15,141.6
"2011","Manchester 008B","E01005146","Total",2361,1162,1199,2335,26,12,60.33,39.1
"2011","Manchester 008C","E01005149","Total",1743,914,829,1739,4,11,14.59,119.5
"2011","Manchester 008D","E01005165","Total",2109,1108,1001,2055,54,12,37.68,56.0
"2011","Manchester 008E","E01005166","Total",1862,957,905,1842,20,15,27.52,67.7
"2011","Manchester 008F","E01005167","Total",1985,1025,960,1957,28,12,42.76,46.4
"2011","Manchester 009A","E01005202","Total",1778,852,926,1758,20,11,81.51,21.8
"2011","Manchester 009B","E01005203","Total",1905,997,908,1896,9,4,64.32,29.6
"2011","Manchester 009D","E01005227","Total",1685,834,851,1665,20,7,18.35,91.8
"2011","Manchester 009E","E01005228","Total",1691,819,872,1691,0,19,39.39,42.9
"2011","Manchester 009F","E01033678","Total",1574,794,780,1574,0,11,35.94,43.8
"2011","Manchester 009G","E01033679","Total",1409,739,670,1366,43,2,33.88,41.6
"2011","Manchester 011A","E01005256","Total",1995,993,1002,1947,48,12,79.95,25.0
"2011","Manchester 011B","E01005257","Total",1798,846,952,1798,0,11,172.84,10.4
"2011","Manchester 011C","E01005258","Total",1707,844,863,1636,71,3,29.84,57.2
"2011","Manchester 011D","E01005259","Total",1602,739,863,1602,0,12,23.97,66.8
"2011","Manchester 011E","E01005260","Total",1499,754,745,1451,48,11,35.98,41.7
"2011","Manchester 012A","E01005093","Total",1724,826,898,1685,39,9,31.09,55.5
"2011","Manchester 012B","E01005094","Total",1463,689,774,1463,0,7,41.03,35.7
"2011","Manchester 012C","E01005097","Total",1731,804,927,1731,0,6,52.11,33.2
"2011","Manchester 012D","E01005255","Total",1609,826,783,1609,0,7,33.01,48.7
"2011","Manchester 012E","E01005261","Total",1642,761,881,1631,11,11,25.04,65.6
"2011","Manchester 013B","E01005129","Total",1461,760,701,1461,0,14,43.04,33.9
"2011","Manchester 013C","E01005132","Total",1480,706,774,1480,0,10,39.85,37.1
"2011","Manchester 013D","E01005133","Total",1275,685,590,1207,68,3,32.92,38.7
"2011","Manchester 013E","E01033663","Total",1183,735,448,1183,0,1,21.84,54.2
"2011","Manchester 013F","E01033684","Total",1203,721,482,1203,0,1,4.83,249.1
"2011","Manchester 013G","E01033688","Total",1505,740,765,1494,11,7,92.36,16.3
"2011","Manchester 015A","E01005092","Total",1629,810,819,1612,17,7,25.91,62.9
"2011","Manchester 015C","E01005105","Total",1960,1000,960,1947,13,9,56.33,34.8
"2011","Manchester 015D","E01005106","Total",1877,931,946,1877,0,5,102.98,18.2
"2011","Manchester 015E","E01005107","Total",1803,911,892,1803,0,10,72.19,25.0
"2011","Manchester 015F","E01033668","Total",1136,582,554,1136,0,3,31.14,36.5
"2011","Manchester 015G","E01033669","Total",1397,692,705,1397,0,7,80.08,17.4
"2011","Manchester 017A","E01005108","Total",2630,1259,1371,2630,0,19,74.52,35.3
"2011","Manchester 017D","E01005189","Total",1691,819,872,1654,37,5,37.48,45.1
"2011","Manchester 017E","E01005190","Total",2017,1014,1003,2017,0,8,22.17,91.0
"2011","Manchester 017F","E01033666","Total",2664,1323,1341,2606,58,23,58.74,45.4
"2011","Manchester 018A","E01005061","Total",1648,853,795,1648,0,12,86.24,19.1
"2011","Manchester 018B","E01005062","Total",2893,1449,1444,1924,969,44,58.73,49.3
"2011","Manchester 018C","E01005063","Total",1486,740,746,1466,20,7,28.45,52.2
"2011","Manchester 018D","E01005065","Total",2231,1178,1053,2159,72,7,65.94,33.8
"2011","Manchester 018E","E01005066","Total",1700,952,748,981,719,25,19.15,88.8
"2011","Manchester 019A","E01005208","Total",2338,1252,1086,2336,2,14,46.19,50.6
"2011","Manchester 019B","E01005209","Total",2699,1353,1346,1794,905,35,79.40,34.0
"2011","Manchester 019C","E01005210","Total",3244,1572,1672,1273,1971,31,21.74,149.2
"2011","Manchester 019D","E01005214","Total",2279,1303,976,2279,0,13,23.98,95.0
"2011","Manchester 020A","E01005067","Total",1362,678,684,1362,0,6,39.68,34.3
"2011","Manchester 020B","E01005186","Total",2376,1177,1199,2265,111,31,73.53,32.3
"2011","Manchester 020C","E01005232","Total",1867,966,901,1851,16,17,88.94,21.0
"2011","Manchester 020D","E01005235","Total",1760,857,903,1760,0,9,31.50,55.9
"2011","Manchester 020E","E01005239","Total",1762,874,888,1756,6,12,26.83,65.7
"2011","Manchester 021A","E01005187","Total",1926,968,958,1926,0,12,15.19,126.8
"2011","Manchester 021B","E01005188","Total",1714,840,874,1693,21,9,67.63,25.3
"2011","Manchester 021C","E01005191","Total",1657,842,815,1657,0,11,14.80,112.0
"2011","Manchester 021D","E01005192","Total",1584,814,770,1584,0,9,65.52,24.2
"2011","Manchester 021E","E01005193","Total",1798,892,906,1798,0,11,29.12,61.7
"2011","Manchester 022B","E01005230","Total",2069,1127,942,2006,63,13,20.10,102.9
"2011","Manchester 022C","E01005231","Total",2626,1303,1323,1749,877,21,17.07,153.8
"2011","Manchester 022D","E01005236","Total",2061,1126,935,2054,7,18,14.04,146.8
"2011","Manchester 022E","E01005237","Total",1994,1091,903,1956,38,14,16.16,123.4
"2011","Manchester 022F","E01033652","Total",1618,805,813,992,626,21,28.25,57.3
"2011","Manchester 022G","E01033657","Total",1557,773,784,1018,539,9,17.41,89.4
"2011","Manchester 023A","E01005195","Total",1986,924,1062,1981,5,6,43.10,46.1
"2011","Manchester 023B","E01005196","Total",2376,1152,1224,2376,0,12,48.13,49.4
"2011","Manchester 023C","E01005197","Total",1566,828,738,1552,14,4,29.28,53.5
"2011","Manchester 023D","E01005198","Total",1570,771,799,1570,0,18,28.31,55.5
"2011","Manchester 023E","E01005201","Total",2016,1021,995,2016,0,12,22.85,88.2
"2011","Manchester 024A","E01005240","Total",2655,1334,1321,2655,0,22,49.62,53.5
"2011","Manchester 024B","E01005243","Total",2463,1146,1317,2463,0,22,31.06,79.3
"2011","Manchester 024C","E01005245","Total",2410,1181,1229,2410,0,15,31.35,76.9
"2011","Manchester 024D","E01005246","Total",2139,938,1201,2139,0,7,14.13,151.4
"2011","Manchester 025A","E01005241","Total",2428,1243,1185,2428,0,11,19.90,122.0
"2011","Manchester 025B","E01005242","Total",2603,1370,1233,2603,0,11,18.43,141.2
"2011","Manchester 025C","E01005244","Total",2938,1557,1381,2621,317,15,18.90,155.4
"2011","Manchester 025D","E01005285","Total",1299,675,624,1279,20,7,11.58,112.2
"2011","Manchester 025E","E01005288","Total",1728,1007,721,1723,5,12,18.61,92.9
"2011","Manchester 026A","E01005280","Total",1919,966,953,1919,0,22,28.66,67.0
"2011","Manchester 026B","E01005281","Total",2239,1062,1177,1015,1224,24,45.52,49.2
"2011","Manchester 026C","E01005284","Total",3436,1642,1794,1807,1629,56,29.66,115.8
"2011","Manchester 026D","E01005286","Total",2170,1219,951,1985,185,32,28.88,75.1
"2011","Manchester 026E","E01005287","Total",2131,1097,1034,2076,55,9,21.44,99.4
"2011","Manchester 027A","E01005194","Total",2589,1397,1192,2585,4,19,24.78,104.5
"2011","Manchester 027B","E01005199","Total",2273,1151,1122,2273,0,17,13.65,166.5
"2011","Manchester 027C","E01005200","Total",1831,919,912,1815,16,10,53.51,34.2
"2011","Manchester 027D","E01005233","Total",2403,1272,1131,2371,32,12,10.34,232.4
"2011","Manchester 027E","E01005234","Total",2046,1054,992,2046,0,3,20.07,101.9
"2011","Manchester 027F","E01005238","Total",2109,1073,1036,2109,0,20,20.75,101.6
"2011","Manchester 028A","E01005297","Total",2449,1223,1226,2400,49,11,32.69,74.9
"2011","Manchester 028B","E01005298","Total",1835,922,913,1835,0,11,18.13,101.2
"2011","Manchester 028C","E01005302","Total",1846,985,861,1771,75,17,26.78,68.9
"2011","Manchester 028E","E01033680","Total",1211,686,525,1196,15,4,16.32,74.2
"2011","Manchester 028F","E01033686","Total",1265,671,594,1224,41,9,15.04,84.1
"2011","Manchester 029A","E01005150","Total",1870,1047,823,1812,58,4,24.53,76.2
"2011","Manchester 029B","E01005151","Total",1485,747,738,1426,59,21,19.03,78.0
"2011","Manchester 029C","E01005152","Total",1453,721,732,1453,0,22,18.84,77.1
"2011","Manchester 029D","E01005159","Total",1585,780,805,1585,0,18,24.60,64.4
"2011","Manchester 029E","E01005296","Total",1704,866,838,1688,16,19,22.45,75.9
"2011","Manchester 029F","E01005299","Total",1591,785,806,1591,0,18,23.56,67.5
"2011","Manchester 030A","E01005178","Total",1968,1002,966,1968,0,11,21.21,92.8
"2011","Manchester 030B","E01005179","Total",2235,1138,1097,2168,67,24,31.63,70.7
"2011","Manchester 030C","E01005180","Total",1847,899,948,1847,0,9,51.65,35.8
"2011","Manchester 030D","E01005181","Total",2140,1066,1074,2040,100,27,40.68,52.6
"2011","Manchester 030E","E01005182","Total",1610,760,850,1494,116,16,20.33,79.2
"2011","Manchester 030F","E01005183","Total",1779,827,952,1779,0,7,28.48,62.5
"2011","Manchester 031A","E01005219","Total",2073,1112,961,2043,30,17,24.58,84.3
"2011","Manchester 031B","E01005220","Total",1849,943,906,1836,13,7,24.91,74.2
"2011","Manchester 031C","E01005221","Total",2248,1199,1049,2243,5,21,26.40,85.2
"2011","Manchester 031D","E01005222","Total",2102,1029,1073,2077,25,14,42.24,49.8
"2011","Manchester 032A","E01005184","Total",2121,1017,1104,2102,19,23,42.04,50.5
"2011","Manchester 032B","E01005185","Total",4024,1957,2067,1692,2332,70,23.36,172.3
"2011","Manchester 032C","E01005271","Total",2101,1072,1029,2091,10,12,18.29,114.9
"2011","Manchester 032D","E01005282","Total",1852,941,911,1852,0,26,36.64,50.5
"2011","Manchester 032E","E01005283","Total",1481,745,736,1449,32,18,15.53,95.4
"2011","Manchester 033A","E01005154","Total",1581,760,821,1581,0,16,15.24,103.7
"2011","Manchester 033B","E01005156","Total",1496,729,767,1496,0,11,26.88,55.7
"2011","Manchester 033C","E01005158","Total",1511,725,786,1511,0,14,34.14,44.3
"2011","Manchester 033D","E01005300","Total",1561,737,824,1561,0,25,27.37,57.0
"2011","Manchester 033E","E01005301","Total",1601,788,813,1596,5,25,25.90,61.8
"2011","Manchester 034A","E01005118","Total",1507,712,795,1507,0,17,22.00,68.5
"2011","Manchester 034B","E01005120","Total",1849,890,959,1849,0,15,22.36,82.7
"2011","Manchester 034C","E01005215","Total",2004,998,1006,2004,0,6,34.79,57.6
"2011","Manchester 034D","E01005216","Total",1526,738,788,1526,0,11,31.81,48.0
"2011","Manchester 034E","E01005217","Total",1905,923,982,1895,10,28,31.85,59.8
"2011","Manchester 034F","E01005218","Total",1683,887,796,1681,2,15,22.34,75.3
"2011","Manchester 035A","E01005270","Total",1747,840,907,1747,0,11,21.63,80.8
"2011","Manchester 035B","E01005272","Total",1802,813,989,1781,21,10,47.96,37.6
"2011","Manchester 035C","E01005273","Total",1558,815,743,1558,0,19,14.55,107.1
"2011","Manchester 035D","E01005278","Total",1839,892,947,1839,0,15,23.23,79.2
"2011","Manchester 035E","E01005279","Total",2036,999,1037,2036,0,16,62.70,32.5
"2011","Manchester 036A","E01005305","Total",1795,974,821,1795,0,23,32.81,54.7
"2011","Manchester 036B","E01005309","Total",2297,1107,1190,2274,23,5,21.03,109.2
"2011","Manchester 036C","E01005310","Total",1860,842,1018,1860,0,25,15.53,119.8
"2011","Manchester 036D","E01005311","Total",1769,903,866,1769,0,10,20.99,84.3
"2011","Manchester 036E","E01005312","Total",1811,923,888,1811,0,23,12.22,148.2
"2011","Manchester 037A","E01005082","Total",1548,720,828,1548,0,10,77.47,20.0
"2011","Manchester 037B","E01005153","Total",1663,781,882,1663,0,14,17.52,94.9
"2011","Manchester 037C","E01005155","Total",1411,676,735,1411,0,13,37.61,37.5
"2011","Manchester 037D","E01005157","Total",1591,749,842,1591,0,32,89.11,17.9
"2011","Manchester 038A","E01005274","Total",1766,877,889,1766,0,13,25.33,69.7
"2011","Manchester 038B","E01005275","Total",1695,879,816,1695,0,14,15.11,112.2
"2011","Manchester 038C","E01005276","Total",1602,816,786,1529,73,17,20.13,79.6
"2011","Manchester 038D","E01005277","Total",1729,919,810,1716,13,21,28.24,61.2
"2011","Manchester 039A","E01005076","Total",1483,767,716,1434,49,5,16.18,91.7
"2011","Manchester 039C","E01005081","Total",1770,824,946,1770,0,11,41.93,42.2
"2011","Manchester 039D","E01005083","Total",1710,910,800,1710,0,9,36.49,46.9
"2011","Manchester 039E","E01033670","Total",1252,632,620,1252,0,1,25.26,49.6
"2011","Manchester 039F","E01033671","Total",1709,887,822,1647,62,5,22.44,76.2
"2011","Manchester 040A","E01005125","Total",1596,771,825,1596,0,15,22.91,69.7
"2011","Manchester 040B","E01005304","Total",1810,983,827,1797,13,13,20.99,86.2
"2011","Manchester 040C","E01005306","Total",1546,792,754,1546,0,41,33.21,46.6
"2011","Manchester 040D","E01005307","Total",1971,1044,927,1971,0,15,27.23,72.4
"2011","Manchester 040E","E01005308","Total",1697,833,864,1690,7,10,33.39,50.8
"2011","Manchester 041A","E01005119","Total",1531,727,804,1531,0,9,28.91,53.0
"2011","Manchester 041B","E01005121","Total",1594,745,849,1594,0,9,26.14,61.0
"2011","Manchester 041C","E01005122","Total",1681,787,894,1681,0,13,34.46,48.8
"2011","Manchester 041D","E01005123","Total",1701,809,892,1701,0,14,22.36,76.1
"2011","Manchester 041E","E01005124","Total",1734,781,953,1734,0,10,23.89,72.6
"2011","Manchester 042A","E01005077","Total",1558,730,828,1558,0,9,42.62,36.6
"2011","Manchester 042B","E01005078","Total",1453,745,708,1401,52,18,36.65,39.6
"2011","Manchester 042C","E01005079","Total",1565,748,817,1513,52,33,43.89,35.7
"2011","Manchester 042D","E01005084","Total",2018,973,1045,2018,0,14,86.99,23.2
"2011","Manchester 043A","E01005172","Total",1600,787,813,1589,11,23,30.94,51.7
"2011","Manchester 043B","E01005173","Total",1547,790,757,1508,39,21,82.04,18.9
"2011","Manchester 043C","E01005174","Total",1570,753,817,1570,0,39,20.66,76.0
"2011","Manchester 043D","E01005175","Total",1605,801,804,1605,0,20,23.47,68.4
"2011","Manchester 043E","E01005176","Total",1806,903,903,1799,7,7,27.46,65.8
"2011","Manchester 043F","E01005177","Total",1339,629,710,1339,0,23,18.54,72.2
"2011","Manchester 044A","E01005115","Total",1874,935,939,1874,0,16,34.55,54.2
"2011","Manchester 044B","E01005262","Total",1841,897,944,1841,0,7,27.53,66.9
"2011","Manchester 044C","E01005264","Total",1535,720,815,1480,55,14,41.67,36.8
"2011","Manchester 044D","E01005265","Total",1684,813,871,1684,0,8,30.16,55.8
"2011","Manchester 044E","E01005266","Total",1957,940,1017,1943,14,10,32.23,60.7
"2011","Manchester 045A","E01005126","Total",2034,1004,1030,2034,0,18,29.08,69.9
"2011","Manchester 045B","E01005168","Total",1388,679,709,1382,6,39,34.45,40.3
"2011","Manchester 045C","E01005169","Total",1367,662,705,1208,159,38,74.53,18.3
"2011","Manchester 045D","E01005170","Total",1531,761,770,1531,0,16,70.66,21.7
"2011","Manchester 045E","E01005171","Total",1697,854,843,1697,0,14,53.55,31.7
"2011","Manchester 046A","E01005263","Total",1633,843,790,1604,29,7,116.85,14.0
"2011","Manchester 046B","E01005267","Total",1551,760,791,1546,5,11,117.72,13.2
"2011","Manchester 046C","E01005268","Total",2018,979,1039,2018,0,19,82.38,24.5
"2011","Manchester 046D","E01005269","Total",1484,715,769,1482,2,24,59.50,24.9
"2011","Manchester 047A","E01005069","Total",1447,696,751,1447,0,9,34.53,41.9
"2011","Manchester 047B","E01005111","Total",1405,644,761,1405,0,19,25.95,54.1
"2011","Manchester 047C","E01005113","Total",1573,797,776,1573,0,1,25.36,62.0
"2011","Manchester 047D","E01005114","Total",1768,845,923,1748,20,34,53.26,33.2
"2011","Manchester 047E","E01005116","Total",1964,924,1040,1964,0,10,43.08,45.6
"2011","Manchester 048A","E01005071","Total",1592,771,821,1592,0,8,32.33,49.2
"2011","Manchester 048B","E01005072","Total",1703,837,866,1682,21,8,28.76,59.2
"2011","Manchester 048C","E01005073","Total",1492,754,738,1492,0,6,41.82,35.7
"2011","Manchester 048D","E01005112","Total",1660,807,853,1660,0,7,76.57,21.7
"2011","Manchester 048E","E01005117","Total",2059,1041,1018,2059,0,8,99.29,20.7
"2011","Manchester 049A","E01005085","Total",1567,751,816,1565,2,3,29.36,53.4
"2011","Manchester 049B","E01005086","Total",1811,885,926,1805,6,9,24.78,73.1
"2011","Manchester 049C","E01005089","Total",1920,891,1029,1839,81,5,29.13,65.9
"2011","Manchester 049D","E01005289","Total",1450,710,740,1442,8,3,22.79,63.6
"2011","Manchester 049E","E01005295","Total",2459,1213,1246,2357,102,6,90.10,27.3
"2011","Manchester 050A","E01005087","Total",2083,970,1113,2083,0,8,29.61,70.3
"2011","Manchester 050B","E01005088","Total",1708,768,940,1708,0,3,35.37,48.3
"2011","Manchester 050C","E01005090","Total",1597,746,851,1597,0,3,32.82,48.7
"2011","Manchester 050D","E01005091","Total",2159,1037,1122,2159,0,12,27.36,78.9
"2011","Manchester 050E","E01005291","Total",1454,676,778,1454,0,7,40.71,35.7
"2011","Manchester 051A","E01005068","Total",1578,745,833,1566,12,10,32.35,48.8
"2011","Manchester 051B","E01005070","Total",1682,808,874,1628,54,9,80.68,20.8
"2011","Manchester 051C","E01005074","Total",1522,736,786,1522,0,3,45.57,33.4
"2011","Manchester 051D","E01005075","Total",1390,647,743,1378,12,1,81.63,17.0
"2011","Manchester 051E","E01005319","Total",2131,1010,1121,2131,0,9,46.69,45.6
"2011","Manchester 052A","E01005290","Total",1544,763,781,1544,0,5,33.44,46.2
"2011","Manchester 052B","E01005292","Total",1479,692,787,1479,0,2,30.74,48.1
"2011","Manchester 052C","E01005293","Total",1229,592,637,1229,0,10,24.61,49.9
"2011","Manchester 052D","E01005294","Total",1496,739,757,1496,0,10,43.71,34.2
"2011","Manchester 052E","E01005317","Total",1647,804,843,1646,1,5,196.36,8.4
"2011","Manchester 053A","E01005313","Total",1496,717,779,1496,0,5,28.34,52.8
"2011","Manchester 053B","E01005314","Total",1575,747,828,1575,0,4,29.69,53.0
"2011","Manchester 053C","E01005315","Total",1503,720,783,1503,0,5,36.41,41.3
"2011","Manchester 053D","E01005316","Total",1606,796,810,1606,0,7,687.23,2.3
"2011","Manchester 053E","E01005318","Total",1874,889,985,1808,66,5,62.04,30.2
"2011","Manchester 054A","E01005130","Total",1481,779,702,1444,37,9,34.38,43.1
"2011","Manchester 054B","E01033651","Total",1152,657,495,1152,0,14,29.74,38.7
"2011","Manchester 054C","E01033658","Total",1303,712,591,1093,210,16,61.11,21.3
"2011","Manchester 054D","E01033664","Total",1119,602,517,1042,77,4,25.91,43.2
"2011","Manchester 054E","E01033667","Total",1006,589,417,994,12,6,13.28,75.8
"2011","Manchester 055A","E01005128","Total",1710,898,812,1300,410,19,13.65,125.3
"2011","Manchester 055B","E01033653","Total",1670,964,706,1664,6,8,31.23,53.5
"2011","Manchester 055C","E01033654","Total",2956,1502,1454,1126,1830,44,27.79,106.4
"2011","Manchester 055D","E01033659","Total",1336,782,554,1336,0,2,18.11,73.8
"2011","Manchester 055E","E01033661","Total",1155,710,445,1155,0,4,55.76,20.7
"2011","Manchester 056A","E01005143","Total",2602,1368,1234,2592,10,20,17.55,148.3
"2011","Manchester 056B","E01033655","Total",1197,683,514,1197,0,3,11.54,103.7
"2011","Manchester 056C","E01033665","Total",1212,704,508,1212,0,11,70.41,17.2
"2011","Manchester 056D","E01033676","Total",1668,824,844,1668,0,14,72.42,23.0
"2011","Manchester 057A","E01005212","Total",2110,1074,1036,1256,854,47,27.81,75.9
"2011","Manchester 057B","E01033656","Total",3490,1873,1617,1390,2100,46,20.96,166.5
"2011","Manchester 057C","E01033662","Total",1335,828,507,1332,3,11,14.50,92.1
"2011","Manchester 058A","E01005142","Total",1912,948,964,1912,0,10,27.36,69.9
"2011","Manchester 058B","E01005147","Total",2538,1236,1302,2538,0,21,55.90,45.4
"2011","Manchester 058C","E01033674","Total",2206,1535,671,1398,808,12,72.55,30.4
"2011","Manchester 058D","E01033675","Total",2064,993,1071,2058,6,19,24.65,83.7
"2011","Manchester 059A","E01005213","Total",2189,1192,997,2189,0,10,25.59,85.5
"2011","Manchester 059B","E01033660","Total",1168,679,489,1168,0,2,9.67,120.8
"2011","Manchester 059C","E01033672","Total",1291,690,601,1291,0,11,23.20,55.6
"2011","Manchester 059D","E01033673","Total",1101,658,443,1101,0,6,6.44,171.0
"2011","Manchester 060A","E01033677","Total",1170,694,476,1170,0,12,25.91,45.2
"2011","Manchester 060B","E01033681","Total",1373,796,577,1372,1,6,34.31,40.0
"2011","Manchester 060C","E01033682","Total",1261,741,520,1261,0,5,16.96,74.4
"2011","Manchester 060D","E01033683","Total",1259,756,503,1259,0,14,19.79,63.6
"2011","Oldham 001A","E01005357","Total",1424,698,726,1424,0,20,135.90,10.5
"2011","Oldham 001B","E01005358","Total",1643,762,881,1643,0,5,26.21,62.7
"2011","Oldham 001C","E01005359","Total",1594,791,803,1594,0,16,115.58,13.8
"2011","Oldham 001D","E01005360","Total",1402,669,733,1402,0,12,94.28,14.9
"2011","Oldham 002A","E01005441","Total",1592,756,836,1592,0,10,71.45,22.3
"2011","Oldham 002B","E01005442","Total",1408,681,727,1408,0,15,36.98,38.1
"2011","Oldham 002C","E01005444","Total",1504,702,802,1504,0,12,20.48,73.4
"2011","Oldham 002D","E01005445","Total",1537,742,795,1537,0,22,23.19,66.3
"2011","Oldham 003A","E01005361","Total",1696,824,872,1696,0,24,59.35,28.6
"2011","Oldham 003B","E01005443","Total",1396,680,716,1396,0,40,443.98,3.1
"2011","Oldham 003C","E01005446","Total",1393,680,713,1393,0,28,42.05,33.1
"2011","Oldham 003D","E01005447","Total",1630,762,868,1507,123,6,72.58,22.5
"2011","Oldham 004A","E01005390","Total",1515,734,781,1515,0,8,25.63,59.1
"2011","Oldham 004B","E01005394","Total",1540,741,799,1540,0,26,188.67,8.2
"2011","Oldham 004C","E01005395","Total",1439,711,728,1439,0,19,33.18,43.4
"2011","Oldham 004D","E01005396","Total",1482,733,749,1474,8,20,43.35,34.2
"2011","Oldham 005A","E01005355","Total",1511,737,774,1511,0,9,22.91,66.0
"2011","Oldham 005B","E01005356","Total",1335,638,697,1335,0,36,33.83,39.5
"2011","Oldham 005C","E01005399","Total",1589,796,793,1589,0,20,32.54,48.8
"2011","Oldham 005D","E01005403","Total",1679,852,827,1660,19,17,74.00,22.7
"2011","Oldham 006A","E01005410","Total",1550,784,766,1550,0,38,1297.91,1.2
"2011","Oldham 006B","E01005411","Total",1548,736,812,1548,0,37,174.85,8.9
"2011","Oldham 006C","E01005414","Total",1295,669,626,1295,0,24,1849.16,0.7
"2011","Oldham 006D","E01005415","Total",1148,548,600,1148,0,17,104.98,10.9
"2011","Oldham 007C","E01005452","Total",1372,678,694,1372,0,26,99.03,13.9
"2011","Oldham 007D","E01005453","Total",1320,643,677,1320,0,24,72.21,18.3
"2011","Oldham 007E","E01032558","Total",1447,667,780,1447,0,6,52.15,27.7
"2011","Oldham 007F","E01032559","Total",2800,1376,1424,2725,75,22,167.99,16.7
"2011","Oldham 008A","E01005391","Total",1593,806,787,1593,0,19,144.00,11.1
"2011","Oldham 008B","E01005392","Total",1481,706,775,1481,0,4,30.54,48.5
"2011","Oldham 008C","E01005393","Total",1271,607,664,1231,40,13,38.32,33.2
"2011","Oldham 008D","E01005401","Total",1652,804,848,1652,0,26,44.57,37.1
"2011","Oldham 009A","E01005397","Total",1459,709,750,1443,16,14,123.20,11.8
"2011","Oldham 009B","E01005398","Total",1548,724,824,1482,66,13,53.51,28.9
"2011","Oldham 009C","E01005400","Total",1503,741,762,1503,0,8,38.71,38.8
"2011","Oldham 009D","E01005402","Total",1533,737,796,1506,27,11,36.07,42.5
"2011","Oldham 010A","E01005335","Total",1289,630,659,1289,0,23,34.84,37.0
"2011","Oldham 010B","E01005337","Total",1963,978,985,1963,0,19,24.56,79.9
"2011","Oldham 010C","E01005339","Total",1463,738,725,1463,0,28,168.64,8.7
"2011","Oldham 010D","E01005340","Total",1435,673,762,1435,0,5,33.40,43.0
"2011","Oldham 011A","E01005421","Total",1709,801,908,1621,88,14,50.39,33.9
"2011","Oldham 011B","E01005422","Total",1503,691,812,1503,0,8,44.44,33.8
"2011","Oldham 011E","E01032920","Total",1870,962,908,1870,0,9,52.84,35.4
"2011","Oldham 012A","E01005448","Total",1472,733,739,1458,14,9,25.77,57.1
"2011","Oldham 012B","E01005449","Total",1218,573,645,1218,0,8,46.47,26.2
"2011","Oldham 012C","E01005454","Total",1449,712,737,1423,26,22,50.87,28.5
"2011","Oldham 012D","E01005455","Total",1586,822,764,1564,22,18,16.50,96.1
"2011","Oldham 012E","E01005456","Total",1589,780,809,1589,0,10,23.23,68.4
"2011","Oldham 013A","E01005407","Total",1706,866,840,1706,0,48,324.48,5.3
"2011","Oldham 013B","E01005412","Total",1690,853,837,1690,0,36,155.98,10.8
"2011","Oldham 013C","E01005416","Total",1385,695,690,1357,28,27,412.29,3.4
"2011","Oldham 013D","E01005417","Total",1463,698,765,1424,39,18,238.44,6.1
"2011","Oldham 014A","E01005348","Total",1654,814,840,1654,0,9,19.43,85.1
"2011","Oldham 014B","E01005350","Total",2011,1091,920,1972,39,6,49.80,40.4
"2011","Oldham 014C","E01005432","Total",1499,737,762,1497,2,12,50.96,29.4
"2011","Oldham 014D","E01005433","Total",1515,700,815,1515,0,13,57.99,26.1
"2011","Oldham 015A","E01005329","Total",1526,774,752,1526,0,20,30.55,50.0
"2011","Oldham 015B","E01005330","Total",1562,778,784,1562,0,24,257.86,6.1
"2011","Oldham 015C","E01005333","Total",1274,655,619,1274,0,23,24.21,52.6
"2011","Oldham 015D","E01005336","Total",1576,787,789,1576,0,13,37.55,42.0
"2011","Oldham 016A","E01005349","Total",2424,1205,1219,2424,0,23,24.58,98.6
"2011","Oldham 016B","E01005351","Total",1986,976,1010,1986,0,12,24.54,80.9
"2011","Oldham 016C","E01005352","Total",1449,734,715,1433,16,5,18.08,80.1
"2011","Oldham 016D","E01005353","Total",1913,1014,899,1913,0,10,38.12,50.2
"2011","Oldham 016E","E01005354","Total",1764,885,879,1743,21,18,52.61,33.5
"2011","Oldham 017A","E01005327","Total",1932,917,1015,1798,134,11,46.72,41.4
"2011","Oldham 017B","E01005328","Total",1369,703,666,1369,0,11,49.67,27.6
"2011","Oldham 017C","E01005331","Total",1544,775,769,1544,0,6,22.76,67.8
"2011","Oldham 017D","E01005334","Total",1514,749,765,1514,0,19,29.57,51.2
"2011","Oldham 017E","E01005338","Total",1791,848,943,1791,0,6,42.06,42.6
"2011","Oldham 018A","E01005387","Total",1431,714,717,1431,0,20,25.90,55.3
"2011","Oldham 018B","E01005388","Total",1354,640,714,1321,33,14,28.12,48.2
"2011","Oldham 018C","E01005389","Total",1661,818,843,1619,42,19,59.21,28.1
"2011","Oldham 018D","E01005418","Total",1510,752,758,1510,0,21,27.61,54.7
"2011","Oldham 019A","E01005428","Total",1736,892,844,1736,0,13,27.79,62.5
"2011","Oldham 019B","E01005431","Total",1720,829,891,1663,57,7,43.93,39.2
"2011","Oldham 019C","E01005450","Total",1670,811,859,1670,0,7,17.86,93.5
"2011","Oldham 019D","E01005451","Total",1336,670,666,1336,0,8,32.00,41.8
"2011","Oldham 020C","E01005408","Total",1771,878,893,1771,0,30,99.35,17.8
"2011","Oldham 020D","E01005409","Total",1658,804,854,1658,0,44,2568.32,0.6
"2011","Oldham 020E","E01032922","Total",2477,1205,1272,2477,0,49,85.18,29.1
"2011","Oldham 021A","E01005406","Total",1414,702,712,1414,0,43,147.91,9.6
"2011","Oldham 021B","E01005413","Total",1665,815,850,1665,0,35,56.99,29.2
"2011","Oldham 021C","E01005419","Total",1502,706,796,1502,0,24,24.67,60.9
"2011","Oldham 021D","E01005420","Total",1678,782,896,1653,25,19,45.19,37.1
"2011","Oldham 022A","E01005321","Total",1609,815,794,1576,33,6,76.68,21.0
"2011","Oldham 022B","E01005326","Total",3008,1448,1560,2788,220,19,22.31,134.8
"2011","Oldham 022C","E01005427","Total",2021,989,1032,2021,0,10,29.05,69.6
"2011","Oldham 022D","E01005429","Total",1818,915,903,1818,0,12,25.19,72.2
"2011","Oldham 022E","E01005430","Total",2394,1180,1214,2394,0,15,26.68,89.7
"2011","Oldham 024A","E01005320","Total",1913,956,957,1884,29,11,22.36,85.6
"2011","Oldham 024B","E01005434","Total",1340,739,601,1340,0,13,62.41,21.5
"2011","Oldham 024C","E01005437","Total",1908,950,958,1908,0,11,13.35,142.9
"2011","Oldham 024D","E01005459","Total",1358,636,722,1358,0,2,33.55,40.5
"2011","Oldham 026A","E01005383","Total",1968,942,1026,1968,0,20,47.28,41.6
"2011","Oldham 026D","E01005386","Total",1388,656,732,1388,0,7,205.85,6.7
"2011","Oldham 026E","E01032556","Total",1439,724,715,1439,0,7,40.66,35.4
"2011","Oldham 026F","E01032557","Total",1654,759,895,1628,26,4,37.02,44.7
"2011","Oldham 027A","E01005342","Total",1336,642,694,1336,0,6,25.69,52.0
"2011","Oldham 027B","E01005343","Total",1393,660,733,1393,0,9,14.27,97.6
"2011","Oldham 027C","E01005344","Total",1499,709,790,1499,0,7,26.40,56.8
"2011","Oldham 027D","E01005381","Total",1511,729,782,1497,14,15,31.84,47.5
"2011","Oldham 028A","E01005332","Total",2295,1093,1202,2295,0,22,57.72,39.8
"2011","Oldham 028B","E01005341","Total",1459,747,712,1443,16,4,25.52,57.2
"2011","Oldham 028C","E01005345","Total",1506,760,746,1506,0,11,63.64,23.7
"2011","Oldham 028D","E01005346","Total",1433,705,728,1401,32,17,38.37,37.3
"2011","Oldham 028E","E01005347","Total",1345,679,666,1345,0,11,57.90,23.2
"2011","Oldham 029A","E01005322","Total",1267,598,669,1267,0,7,21.40,59.2
"2011","Oldham 029B","E01005323","Total",1397,705,692,1397,0,6,27.89,50.1
"2011","Oldham 029C","E01005324","Total",1469,668,801,1423,46,5,52.30,28.1
"2011","Oldham 029D","E01005325","Total",1001,473,528,1001,0,10,33.75,29.7
"2011","Oldham 029E","E01005438","Total",2331,1188,1143,2331,0,8,68.85,33.9
"2011","Oldham 030A","E01005377","Total",1327,629,698,1327,0,2,23.02,57.6
"2011","Oldham 030B","E01005379","Total",1272,547,725,1272,0,3,17.53,72.6
"2011","Oldham 030C","E01005380","Total",1509,707,802,1509,0,22,59.42,25.4
"2011","Oldham 030D","E01005382","Total",1453,718,735,1453,0,13,28.51,51.0
"2011","Oldham 030E","E01005439","Total",1519,737,782,1519,0,12,29.48,51.5
"2011","Oldham 031A","E01005362","Total",1462,715,747,1460,2,10,29.59,49.4
"2011","Oldham 031B","E01005364","Total",1674,817,857,1674,0,6,24.33,68.8
"2011","Oldham 031C","E01005368","Total",1542,731,811,1542,0,11,26.28,58.7
"2011","Oldham 031D","E01005376","Total",1288,604,684,1288,0,3,43.80,29.4
"2011","Oldham 031E","E01005378","Total",1494,733,761,1494,0,3,49.18,30.4
"2011","Oldham 032A","E01005363","Total",1539,757,782,1539,0,9,30.38,50.7
"2011","Oldham 032B","E01005369","Total",1494,698,796,1419,75,3,53.08,28.1
"2011","Oldham 032C","E01005370","Total",1437,692,745,1437,0,9,40.80,35.2
"2011","Oldham 032D","E01005371","Total",1331,652,679,1309,22,10,34.26,38.8
"2011","Oldham 033A","E01005365","Total",1456,729,727,1456,0,14,102.97,14.1
"2011","Oldham 033B","E01005366","Total",1514,686,828,1475,39,5,30.47,49.7
"2011","Oldham 033C","E01005367","Total",1474,716,758,1474,0,22,190.31,7.7
"2011","Oldham 033D","E01005440","Total",1334,638,696,1334,0,4,161.03,8.3
"2011","Oldham 034A","E01005372","Total",1191,578,613,1191,0,10,20.32,58.6
"2011","Oldham 034B","E01005373","Total",1201,581,620,1201,0,7,18.90,63.5
"2011","Oldham 034C","E01005374","Total",1443,701,742,1443,0,7,20.66,69.8
"2011","Oldham 034D","E01005375","Total",1469,718,751,1469,0,12,46.42,31.6
"2011","Oldham 035A","E01005435","Total",1913,981,932,1913,0,10,16.79,113.9
"2011","Oldham 035B","E01005436","Total",1699,807,892,1657,42,15,22.28,76.3
"2011","Oldham 035C","E01005460","Total",2356,1163,1193,2356,0,6,21.91,107.5
"2011","Oldham 035D","E01005461","Total",2385,1177,1208,2334,51,15,23.53,101.4
"2011","Oldham 035E","E01005462","Total",1856,948,908,1845,11,17,30.18,61.5
"2011","Oldham 035F","E01005463","Total",1122,582,540,1122,0,6,14.96,75.0
"2011","Oldham 035G","E01032921","Total",2578,1359,1219,2469,109,14,44.60,57.8
"2011","Rochdale 001A","E01005518","Total",1425,722,703,1408,17,24,782.38,1.8
"2011","Rochdale 001B","E01005520","Total",1758,850,908,1758,0,18,157.79,11.1
"2011","Rochdale 001C","E01005522","Total",1344,631,713,1324,20,5,26.99,49.8
"2011","Rochdale 001D","E01005523","Total",1936,956,980,1916,20,10,56.95,34.0
"2011","Rochdale 002A","E01005519","Total",1558,790,768,1558,0,14,117.32,13.3
"2011","Rochdale 002B","E01005594","Total",1455,713,742,1455,0,26,424.95,3.4
"2011","Rochdale 002C","E01005597","Total",1600,771,829,1600,0,17,711.50,2.2
"2011","Rochdale 002D","E01005598","Total",1562,769,793,1562,0,9,44.72,34.9
"2011","Rochdale 003A","E01005516","Total",1413,674,739,1378,35,17,27.58,51.2
"2011","Rochdale 003B","E01005517","Total",1506,718,788,1465,41,12,59.34,25.4
"2011","Rochdale 003C","E01005521","Total",1427,676,751,1363,64,13,1611.78,0.9
"2011","Rochdale 003D","E01005596","Total",1925,970,955,1907,18,15,135.92,14.2
"2011","Rochdale 004A","E01005578","Total",1444,720,724,1420,24,14,36.77,39.3
"2011","Rochdale 004B","E01005579","Total",1674,818,856,1674,0,1,36.33,46.1
"2011","Rochdale 004C","E01005586","Total",1523,747,776,1521,2,8,33.29,45.7
"2011","Rochdale 004D","E01005593","Total",1546,733,813,1546,0,13,32.34,47.8
"2011","Rochdale 004E","E01005595","Total",1420,679,741,1378,42,3,22.12,64.2
"2011","Rochdale 005A","E01005489","Total",1189,572,617,1189,0,25,52.66,22.6
"2011","Rochdale 005B","E01005490","Total",1513,925,588,1113,400,11,86.16,17.6
"2011","Rochdale 005C","E01005491","Total",1469,711,758,1469,0,14,50.62,29.0
"2011","Rochdale 005D","E01005493","Total",1608,774,834,1608,0,46,63.48,25.3
"2011","Rochdale 005E","E01005494","Total",1750,830,920,1750,0,19,38.00,46.1
"2011","Rochdale 005F","E01005495","Total",1660,762,898,1624,36,11,63.61,26.1
"2011","Rochdale 006A","E01005488","Total",1593,788,805,1593,0,28,326.76,4.9
"2011","Rochdale 006B","E01005492","Total",1557,760,797,1557,0,37,66.45,23.4
"2011","Rochdale 006C","E01005499","Total",1483,741,742,1483,0,16,1958.19,0.8
"2011","Rochdale 006D","E01005571","Total",1565,766,799,1565,0,31,442.82,3.5
"2011","Rochdale 007A","E01005570","Total",1275,608,667,1237,38,27,77.42,16.5
"2011","Rochdale 007B","E01005572","Total",1647,808,839,1645,2,39,34.67,47.5
"2011","Rochdale 007C","E01005573","Total",1502,746,756,1484,18,45,61.02,24.6
"2011","Rochdale 007D","E01005574","Total",1677,845,832,1676,1,43,99.94,16.8
"2011","Rochdale 007E","E01005587","Total",1467,709,758,1467,0,47,38.14,38.5
"2011","Rochdale 007F","E01005588","Total",1377,627,750,1374,3,11,39.71,34.7
"2011","Rochdale 008A","E01005580","Total",1580,771,809,1575,5,15,41.88,37.7
"2011","Rochdale 008B","E01005581","Total",1588,793,795,1580,8,2,29.65,53.6
"2011","Rochdale 008D","E01005583","Total",1689,844,845,1689,0,7,23.56,71.7
"2011","Rochdale 008F","E01005585","Total",1419,733,686,1419,0,12,49.92,28.4
"2011","Rochdale 008G","E01033258","Total",2981,1527,1454,2981,0,13,38.81,76.8
"2011","Rochdale 009A","E01005496","Total",1354,673,681,1351,3,8,30.94,43.8
"2011","Rochdale 009B","E01005589","Total",1522,749,773,1522,0,14,25.79,59.0
"2011","Rochdale 009C","E01005590","Total",1652,806,846,1636,16,20,51.09,32.3
"2011","Rochdale 009D","E01005591","Total",1426,641,785,1391,35,12,28.64,49.8
"2011","Rochdale 009E","E01005592","Total",1610,763,847,1551,59,12,68.39,23.5
"2011","Rochdale 010A","E01005472","Total",1547,744,803,1547,0,9,54.14,28.6
"2011","Rochdale 010B","E01005473","Total",1513,753,760,1510,3,16,27.15,55.7
"2011","Rochdale 010C","E01005482","Total",2056,1203,853,1955,101,4,85.77,24.0
"2011","Rochdale 010D","E01005483","Total",1882,1006,876,1818,64,10,18.34,102.6
"2011","Rochdale 010E","E01005484","Total",2119,1122,997,2106,13,9,58.26,36.4
"2011","Rochdale 010F","E01005486","Total",1606,787,819,1605,1,11,16.77,95.8
"2011","Rochdale 010G","E01005487","Total",1717,838,879,1705,12,15,37.71,45.5
"2011","Rochdale 011A","E01005474","Total",1290,618,672,1209,81,12,95.37,13.5
"2011","Rochdale 011B","E01005575","Total",1636,799,837,1636,0,41,45.44,36.0
"2011","Rochdale 011C","E01005576","Total",1517,762,755,1517,0,51,67.30,22.5
"2011","Rochdale 011D","E01005577","Total",1482,715,767,1482,0,39,68.94,21.5
"2011","Rochdale 012A","E01005469","Total",1804,881,923,1804,0,13,30.11,59.9
"2011","Rochdale 012B","E01005563","Total",1811,898,913,1809,2,19,44.19,41.0
"2011","Rochdale 012C","E01005565","Total",1564,768,796,1563,1,16,29.70,52.7
"2011","Rochdale 012D","E01005566","Total",2148,989,1159,2134,14,17,62.10,34.6
"2011","Rochdale 012E","E01005568","Total",1674,855,819,1635,39,6,19.51,85.8
"2011","Rochdale 012F","E01005569","Total",1635,808,827,1635,0,12,31.42,52.0
"2011","Rochdale 013A","E01005556","Total",1539,777,762,1539,0,20,46.45,33.1
"2011","Rochdale 013B","E01005559","Total",1586,780,806,1566,20,6,67.70,23.4
"2011","Rochdale 013C","E01005560","Total",1551,746,805,1539,12,14,126.36,12.3
"2011","Rochdale 013D","E01005567","Total",1459,711,748,1459,0,9,131.17,11.1
"2011","Rochdale 014A","E01005555","Total",1366,695,671,1366,0,12,350.34,3.9
"2011","Rochdale 014B","E01005557","Total",1212,584,628,1209,3,9,28.05,43.2
"2011","Rochdale 014C","E01005558","Total",1644,809,835,1643,1,14,31.74,51.8
"2011","Rochdale 014D","E01005561","Total",1362,652,710,1334,28,22,1190.82,1.1
"2011","Rochdale 014E","E01005562","Total",1525,738,787,1525,0,17,69.81,21.8
"2011","Rochdale 015A","E01005470","Total",1772,890,882,1721,51,10,13.55,130.8
"2011","Rochdale 015B","E01005471","Total",1606,772,834,1606,0,16,40.27,39.9
"2011","Rochdale 015C","E01005475","Total",1665,837,828,1665,0,7,29.54,56.4
"2011","Rochdale 015D","E01005485","Total",2151,1094,1057,2111,40,16,24.29,88.6
"2011","Rochdale 015E","E01005564","Total",1938,965,973,1938,0,16,44.08,44.0
"2011","Rochdale 016A","E01005464","Total",1752,856,896,1752,0,6,36.57,47.9
"2011","Rochdale 016B","E01005465","Total",1716,835,881,1716,0,21,55.83,30.7
"2011","Rochdale 016C","E01005466","Total",2313,1146,1167,2304,9,16,59.60,38.8
"2011","Rochdale 016D","E01005467","Total",1722,789,933,1722,0,5,116.41,14.8
"2011","Rochdale 016E","E01005468","Total",1544,757,787,1535,9,39,197.49,7.8
"2011","Rochdale 017A","E01005476","Total",1637,824,813,1630,7,8,125.69,13.0
"2011","Rochdale 017B","E01005477","Total",1676,802,874,1669,7,9,44.68,37.5
"2011","Rochdale 017C","E01005478","Total",1591,750,841,1591,0,14,183.13,8.7
"2011","Rochdale 017D","E01005479","Total",1761,840,921,1733,28,17,136.07,12.9
"2011","Rochdale 017E","E01005480","Total",1624,755,869,1593,31,14,59.33,27.4
"2011","Rochdale 017F","E01005481","Total",1727,785,942,1590,137,15,39.75,43.4
"2011","Rochdale 018A","E01005497","Total",1577,760,817,1577,0,6,44.95,35.1
"2011","Rochdale 018B","E01005501","Total",1567,775,792,1560,7,6,58.86,26.6
"2011","Rochdale 018C","E01005502","Total",1534,733,801,1534,0,10,19.62,78.2
"2011","Rochdale 018D","E01005504","Total",1508,720,788,1508,0,11,29.66,50.8
"2011","Rochdale 018E","E01005505","Total",1707,798,909,1707,0,10,68.86,24.8
"2011","Rochdale 018F","E01005509","Total",1790,936,854,1788,2,7,21.28,84.1
"2011","Rochdale 019A","E01005510","Total",1148,560,588,1148,0,12,22.50,51.0
"2011","Rochdale 019B","E01005511","Total",1246,619,627,1232,14,16,78.60,15.9
"2011","Rochdale 019C","E01005512","Total",1545,788,757,1491,54,6,22.66,68.2
"2011","Rochdale 019D","E01005513","Total",1336,615,721,1332,4,9,26.96,49.6
"2011","Rochdale 019E","E01005514","Total",1510,739,771,1510,0,12,257.38,5.9
"2011","Rochdale 019F","E01005515","Total",1705,766,939,1705,0,8,73.10,23.3
"2011","Rochdale 020A","E01005498","Total",1464,704,760,1461,3,19,80.57,18.2
"2011","Rochdale 020B","E01005500","Total",1608,765,843,1544,64,23,182.60,8.8
"2011","Rochdale 020C","E01005503","Total",1310,669,641,1310,0,37,35.91,36.5
"2011","Rochdale 020D","E01005506","Total",1592,786,806,1508,84,19,25.88,61.5
"2011","Rochdale 020E","E01005507","Total",1574,734,840,1574,0,8,92.68,17.0
"2011","Rochdale 020F","E01005508","Total",1866,914,952,1861,5,35,435.75,4.3
"2011","Rochdale 021A","E01005524","Total",1489,723,766,1489,0,23,29.86,49.9
"2011","Rochdale 021B","E01005525","Total",1602,800,802,1602,0,13,48.91,32.8
"2011","Rochdale 021C","E01005526","Total",1584,773,811,1584,0,16,242.08,6.5
"2011","Rochdale 021D","E01005528","Total",1499,730,769,1495,4,11,30.46,49.2
"2011","Rochdale 021E","E01005536","Total",1603,753,850,1599,4,12,33.21,48.3
"2011","Rochdale 021F","E01005543","Total",1321,628,693,1260,61,18,311.55,4.2
"2011","Rochdale 022A","E01005527","Total",1498,708,790,1447,51,4,43.04,34.8
"2011","Rochdale 022B","E01005529","Total",1610,744,866,1610,0,7,24.93,64.6
"2011","Rochdale 022C","E01005551","Total",1726,804,922,1726,0,4,29.90,57.7
"2011","Rochdale 022D","E01005552","Total",1990,946,1044,1990,0,5,35.00,56.9
"2011","Rochdale 022E","E01005553","Total",1831,874,957,1831,0,8,28.78,63.6
"2011","Rochdale 022F","E01005554","Total",1343,659,684,1343,0,11,313.87,4.3
"2011","Rochdale 023A","E01005534","Total",1493,743,750,1488,5,15,28.96,51.6
"2011","Rochdale 023B","E01005535","Total",1580,805,775,1556,24,6,29.82,53.0
"2011","Rochdale 023C","E01005537","Total",1363,714,649,1363,0,18,25.59,53.3
"2011","Rochdale 023D","E01005538","Total",1509,710,799,1504,5,7,23.40,64.5
"2011","Rochdale 023E","E01005540","Total",1334,654,680,1328,6,9,47.47,28.1
"2011","Rochdale 023F","E01005541","Total",1621,801,820,1621,0,12,25.94,62.5
"2011","Rochdale 023G","E01005542","Total",1326,638,688,1303,23,5,32.16,41.2
"2011","Rochdale 024A","E01005533","Total",1640,800,840,1636,4,15,37.75,43.4
"2011","Rochdale 024B","E01005539","Total",1354,693,661,1301,53,12,46.82,28.9
"2011","Rochdale 024C","E01005546","Total",1237,596,641,1237,0,12,121.73,10.2
"2011","Rochdale 024D","E01005547","Total",1450,708,742,1434,16,11,48.10,30.1
"2011","Rochdale 024E","E01005548","Total",1284,656,628,1251,33,11,66.92,19.2
"2011","Rochdale 025A","E01005530","Total",1437,688,749,1437,0,17,41.00,35.0
"2011","Rochdale 025B","E01005531","Total",1165,560,605,1165,0,9,41.99,27.7
"2011","Rochdale 025C","E01005532","Total",1435,669,766,1435,0,9,30.41,47.2
"2011","Rochdale 025D","E01005544","Total",1470,713,757,1470,0,21,39.20,37.5
"2011","Rochdale 025E","E01005545","Total",1227,594,633,1227,0,27,34.01,36.1
"2011","Rochdale 025F","E01005549","Total",1562,746,816,1562,0,30,55.73,28.0
"2011","Rochdale 025G","E01005550","Total",1420,687,733,1420,0,15,34.33,41.4
"2011","Salford 001A","E01005659","Total",1444,715,729,1422,22,12,58.52,24.7
"2011","Salford 001B","E01005660","Total",1470,701,769,1470,0,4,32.48,45.3
"2011","Salford 001C","E01005663","Total",1376,681,695,1376,0,9,40.48,34.0
"2011","Salford 001D","E01005664","Total",1487,696,791,1487,0,3,35.15,42.3
"2011","Salford 001E","E01005665","Total",1470,682,788,1470,0,6,38.23,38.5
"2011","Salford 002A","E01005703","Total",1544,789,755,1544,0,7,32.82,47.0
"2011","Salford 002B","E01005704","Total",1405,688,717,1404,1,7,22.93,61.3
"2011","Salford 002C","E01005706","Total",1494,686,808,1456,38,5,27.38,54.6
"2011","Salford 002D","E01005708","Total",1491,722,769,1491,0,6,37.58,39.7
"2011","Salford 003A","E01005702","Total",2127,1027,1100,2127,0,17,71.96,29.6
"2011","Salford 003B","E01005705","Total",1868,892,976,1861,7,12,191.75,9.7
"2011","Salford 003C","E01005707","Total",1718,865,853,1718,0,5,62.41,27.5
"2011","Salford 004A","E01005661","Total",1789,868,921,1781,8,9,69.62,25.7
"2011","Salford 004B","E01005662","Total",1519,704,815,1519,0,7,87.64,17.3
"2011","Salford 004C","E01005709","Total",1391,661,730,1391,0,15,25.09,55.4
"2011","Salford 004D","E01005710","Total",1509,708,801,1508,1,17,75.48,20.0
"2011","Salford 005A","E01005670","Total",1663,785,878,1663,0,5,40.32,41.2
"2011","Salford 005B","E01005672","Total",1369,652,717,1369,0,7,23.74,57.7
"2011","Salford 005C","E01005676","Total",1276,620,656,1276,0,12,65.40,19.5
"2011","Salford 005D","E01005677","Total",1540,750,790,1540,0,10,125.21,12.3
"2011","Salford 006A","E01005686","Total",1439,713,726,1439,0,7,31.68,45.4
"2011","Salford 006B","E01005688","Total",1591,807,784,1591,0,5,30.51,52.1
"2011","Salford 006C","E01005691","Total",1472,748,724,1472,0,6,69.59,21.2
"2011","Salford 006D","E01005692","Total",1306,640,666,1280,26,8,34.35,38.0
"2011","Salford 007A","E01005711","Total",1505,751,754,1505,0,12,75.60,19.9
"2011","Salford 007B","E01005712","Total",1620,794,826,1593,27,13,29.91,54.2
"2011","Salford 007C","E01005713","Total",1415,653,762,1415,0,19,39.82,35.5
"2011","Salford 007D","E01005714","Total",1438,681,757,1438,0,8,78.57,18.3
"2011","Salford 007E","E01005715","Total",1652,822,830,1649,3,28,50.82,32.5
"2011","Salford 007F","E01005718","Total",1680,849,831,1673,7,15,35.76,47.0
"2011","Salford 008A","E01005673","Total",1437,711,726,1436,1,7,94.07,15.3
"2011","Salford 008B","E01005675","Total",2564,1720,844,1708,856,12,211.36,12.1
"2011","Salford 008C","E01005678","Total",1519,741,778,1519,0,2,92.91,16.3
"2011","Salford 008D","E01005679","Total",1594,769,825,1594,0,6,37.78,42.2
"2011","Salford 009A","E01005687","Total",1752,860,892,1752,0,10,95.16,18.4
"2011","Salford 009B","E01005689","Total",1438,679,759,1438,0,2,27.80,51.7
"2011","Salford 009C","E01005690","Total",1555,757,798,1555,0,12,34.62,44.9
"2011","Salford 009D","E01005693","Total",1402,659,743,1402,0,5,34.42,40.7
"2011","Salford 010A","E01005646","Total",1577,770,807,1577,0,88,24.77,63.7
"2011","Salford 010B","E01005649","Total",1717,856,861,1676,41,58,36.79,46.7
"2011","Salford 010C","E01005650","Total",1582,839,743,1518,64,67,43.67,36.2
"2011","Salford 010D","E01005651","Total",2121,1010,1111,2028,93,128,22.67,93.6
"2011","Salford 011A","E01005647","Total",1621,739,882,1459,162,34,27.46,59.0
"2011","Salford 011B","E01005648","Total",1817,924,893,1783,34,20,78.87,23.0
"2011","Salford 011C","E01005652","Total",1398,660,738,1398,0,10,26.84,52.1
"2011","Salford 011D","E01005653","Total",1518,696,822,1518,0,6,71.08,21.4
"2011","Salford 012A","E01005671","Total",1503,736,767,1501,2,5,49.08,30.6
"2011","Salford 012B","E01005674","Total",1446,694,752,1374,72,13,31.94,45.3
"2011","Salford 012C","E01005694","Total",1741,836,905,1741,0,10,86.10,20.2
"2011","Salford 012D","E01005696","Total",1521,734,787,1521,0,12,41.34,36.8
"2011","Salford 012E","E01005698","Total",1657,799,858,1657,0,14,28.15,58.9
"2011","Salford 012F","E01005700","Total",1538,746,792,1497,41,10,29.66,51.9
"2011","Salford 013A","E01005716","Total",1770,893,877,1770,0,39,46.31,38.2
"2011","Salford 013B","E01005717","Total",1568,778,790,1568,0,30,38.16,41.1
"2011","Salford 013C","E01005734","Total",1357,644,713,1324,33,20,35.80,37.9
"2011","Salford 013D","E01005735","Total",1393,701,692,1393,0,23,24.51,56.8
"2011","Salford 013E","E01005736","Total",1420,711,709,1420,0,18,26.37,53.8
"2011","Salford 013F","E01005737","Total",1507,746,761,1507,0,27,877.56,1.7
"2011","Salford 013G","E01005739","Total",1531,736,795,1531,0,20,67.42,22.7
"2011","Salford 014A","E01005695","Total",1578,783,795,1578,0,31,98.90,16.0
"2011","Salford 014B","E01005697","Total",1563,766,797,1563,0,18,31.28,50.0
"2011","Salford 014C","E01005738","Total",1766,876,890,1725,41,18,323.43,5.5
"2011","Salford 014D","E01005740","Total",1556,755,801,1556,0,22,64.57,24.1
"2011","Salford 014E","E01005741","Total",1642,785,857,1635,7,38,80.26,20.5
"2011","Salford 014F","E01005742","Total",1587,759,828,1587,0,15,36.65,43.3
"2011","Salford 015A","E01005625","Total",1329,626,703,1329,0,3,27.18,48.9
"2011","Salford 015B","E01005627","Total",1178,569,609,1178,0,6,17.32,68.0
"2011","Salford 015C","E01005699","Total",1494,734,760,1494,0,15,23.11,64.6
"2011","Salford 015D","E01005701","Total",1593,777,816,1566,27,20,39.54,40.3
"2011","Salford 016A","E01005609","Total",1787,874,913,1750,37,5,35.33,50.6
"2011","Salford 016B","E01005611","Total",1942,992,950,1930,12,11,41.90,46.3
"2011","Salford 016C","E01005612","Total",2038,1043,995,2038,0,11,29.35,69.4
"2011","Salford 016D","E01005613","Total",2280,1211,1069,2254,26,20,29.30,77.8
"2011","Salford 016E","E01005614","Total",1940,957,983,1940,0,52,16.41,118.2
"2011","Salford 016F","E01005615","Total",1958,998,960,1746,212,5,22.53,86.9
"2011","Salford 017A","E01005624","Total",1669,791,878,1669,0,4,28.97,57.6
"2011","Salford 017B","E01005680","Total",1425,735,690,1356,69,12,93.60,15.2
"2011","Salford 017C","E01005683","Total",1600,741,859,1590,10,4,57.97,27.6
"2011","Salford 017F","E01032919","Total",3668,1949,1719,2178,1490,72,105.72,34.7
"2011","Salford 018A","E01005622","Total",1452,684,768,1428,24,9,16.28,89.2
"2011","Salford 018B","E01005623","Total",1261,635,626,1255,6,18,22.81,55.3
"2011","Salford 018C","E01005626","Total",1311,640,671,1245,66,16,35.48,37.0
"2011","Salford 018D","E01005628","Total",1616,835,781,1544,72,7,27.10,59.6
"2011","Salford 019A","E01005725","Total",1378,648,730,1378,0,9,20.33,67.8
"2011","Salford 019B","E01005726","Total",1500,714,786,1500,0,5,44.08,34.0
"2011","Salford 019C","E01005727","Total",1337,664,673,1337,0,9,17.42,76.8
"2011","Salford 019D","E01005728","Total",1353,663,690,1351,2,10,29.45,45.9
"2011","Salford 019E","E01005733","Total",1370,657,713,1370,0,11,41.20,33.3
"2011","Salford 020A","E01005631","Total",1509,842,667,1479,30,4,27.87,54.1
"2011","Salford 020B","E01005632","Total",2112,1043,1069,2092,20,6,55.24,38.2
"2011","Salford 020C","E01005633","Total",1393,679,714,1393,0,12,35.77,38.9
"2011","Salford 020D","E01005634","Total",1472,722,750,1472,0,26,30.21,48.7
"2011","Salford 020E","E01005635","Total",1577,788,789,1476,101,22,35.95,43.9
"2011","Salford 020F","E01005636","Total",1553,771,782,1533,20,35,44.93,34.6
"2011","Salford 020G","E01005637","Total",1314,646,668,1314,0,16,32.55,40.4
"2011","Salford 021A","E01005629","Total",1311,637,674,1306,5,17,26.13,50.2
"2011","Salford 021B","E01005630","Total",1495,699,796,1469,26,17,22.73,65.8
"2011","Salford 021C","E01005719","Total",1741,878,863,1725,16,12,70.29,24.8
"2011","Salford 021D","E01005720","Total",2384,1177,1207,2372,12,9,101.32,23.5
"2011","Salford 021E","E01005722","Total",1778,845,933,1762,16,3,37.04,48.0
"2011","Salford 021F","E01005723","Total",1469,685,784,1469,0,3,64.14,22.9
"2011","Salford 021G","E01005724","Total",1479,715,764,1418,61,13,31.13,47.5
"2011","Salford 022D","E01005610","Total",1261,622,639,1056,205,6,67.10,18.8
"2011","Salford 022E","E01032684","Total",1809,1012,797,1302,507,34,22.84,79.2
"2011","Salford 022F","E01032687","Total",1285,740,545,1284,1,8,23.84,53.9
"2011","Salford 022G","E01032906","Total",1243,764,479,1207,36,3,33.64,37.0
"2011","Salford 022H","E01032907","Total",1185,678,507,1185,0,3,101.46,11.7
"2011","Salford 022I","E01032909","Total",1325,732,593,1325,0,2,14.26,92.9
"2011","Salford 022J","E01032911","Total",1154,619,535,1154,0,5,26.29,43.9
"2011","Salford 022K","E01033330","Total",1396,837,559,1379,17,6,37.23,37.5
"2011","Salford 023A","E01005654","Total",1420,727,693,1420,0,4,18.22,77.9
"2011","Salford 023B","E01005656","Total",1497,735,762,1497,0,13,14.82,101.0
"2011","Salford 023C","E01005657","Total",1446,751,695,1442,4,5,17.49,82.7
"2011","Salford 023D","E01005721","Total",1436,775,661,1436,0,5,40.70,35.3
"2011","Salford 024A","E01005655","Total",1368,717,651,1341,27,10,24.29,56.3
"2011","Salford 024B","E01005658","Total",1415,662,753,1415,0,4,28.07,50.4
"2011","Salford 024C","E01005681","Total",1580,839,741,947,633,19,22.24,71.0
"2011","Salford 024D","E01005682","Total",1515,904,611,1515,0,1,16.66,90.9
"2011","Salford 025A","E01005729","Total",1308,690,618,1288,20,2,18.96,69.0
"2011","Salford 025B","E01005730","Total",1646,798,848,1623,23,5,43.16,38.1
"2011","Salford 025C","E01005731","Total",1594,774,820,1594,0,13,36.16,44.1
"2011","Salford 025D","E01005732","Total",1142,557,585,1142,0,3,199.87,5.7
"2011","Salford 026A","E01005599","Total",1610,847,763,1610,0,4,47.52,33.9
"2011","Salford 026B","E01005600","Total",1467,732,735,1467,0,10,30.52,48.1
"2011","Salford 026C","E01005601","Total",1574,766,808,1480,94,7,19.90,79.1
"2011","Salford 026D","E01005602","Total",1352,671,681,1352,0,5,21.92,61.7
"2011","Salford 027A","E01005603","Total",1580,767,813,1580,0,7,23.59,67.0
"2011","Salford 027B","E01005604","Total",1523,726,797,1523,0,12,40.86,37.3
"2011","Salford 027C","E01005605","Total",1383,700,683,1368,15,7,107.51,12.9
"2011","Salford 027D","E01005638","Total",1558,765,793,1530,28,7,28.23,55.2
"2011","Salford 028B","E01005667","Total",1828,889,939,1828,0,4,37.38,48.9
"2011","Salford 028E","E01032685","Total",1494,859,635,1494,0,4,62.95,23.7
"2011","Salford 028F","E01032686","Total",1396,826,570,1396,0,6,36.79,37.9
"2011","Salford 028G","E01032912","Total",1481,755,726,1481,0,8,62.43,23.7
"2011","Salford 028H","E01032914","Total",1602,895,707,1602,0,10,51.21,31.3
"2011","Salford 028I","E01032915","Total",1547,751,796,1547,0,5,25.67,60.3
"2011","Salford 028J","E01032917","Total",1056,626,430,1056,0,1,31.90,33.1
"2011","Salford 029A","E01005639","Total",1566,736,830,1566,0,6,20.41,76.7
"2011","Salford 029B","E01005640","Total",1456,703,753,1456,0,15,234.93,6.2
"2011","Salford 029C","E01005641","Total",1423,686,737,1410,13,11,24.21,58.8
"2011","Salford 029D","E01005642","Total",1227,602,625,1227,0,8,31.89,38.5
"2011","Salford 029E","E01005643","Total",1404,666,738,1387,17,9,475.02,3.0
"2011","Salford 029F","E01005644","Total",1583,790,793,1583,0,4,33.68,47.0
"2011","Salford 029G","E01005645","Total",1445,716,729,1445,0,16,47.60,30.4
"2011","Salford 030A","E01005616","Total",1461,710,751,1461,0,9,39.13,37.3
"2011","Salford 030B","E01005617","Total",1536,735,801,1536,0,9,143.33,10.7
"2011","Salford 030C","E01005618","Total",1485,680,805,1485,0,6,151.60,9.8
"2011","Salford 030D","E01005619","Total",1298,654,644,1298,0,6,50.47,25.7
"2011","Salford 030E","E01005620","Total",2531,1277,1254,2531,0,15,93.44,27.1
"2011","Salford 030F","E01005621","Total",1652,837,815,1652,0,8,881.39,1.9
"2011","Stockport 001A","E01005886","Total",1496,717,779,1496,0,20,17.79,84.1
"2011","Stockport 001B","E01005888","Total",1522,707,815,1522,0,7,18.73,81.3
"2011","Stockport 001C","E01005889","Total",1472,680,792,1472,0,5,27.47,53.6
"2011","Stockport 001D","E01005891","Total",1293,634,659,1293,0,18,28.92,44.7
"2011","Stockport 001E","E01005894","Total",1405,689,716,1405,0,7,15.29,91.9
"2011","Stockport 002A","E01005887","Total",1498,703,795,1498,0,4,34.03,44.0
"2011","Stockport 002B","E01005890","Total",1478,706,772,1478,0,9,37.87,39.0
"2011","Stockport 002C","E01005893","Total",1697,864,833,1697,0,13,25.96,65.4
"2011","Stockport 002D","E01005896","Total",1666,852,814,1666,0,9,25.73,64.7
"2011","Stockport 002E","E01005919","Total",1602,728,874,1576,26,13,44.96,35.6
"2011","Stockport 003A","E01005862","Total",1561,773,788,1561,0,27,24.58,63.5
"2011","Stockport 003B","E01005892","Total",1311,661,650,1311,0,7,77.89,16.8
"2011","Stockport 003C","E01005895","Total",1150,535,615,1150,0,12,39.24,29.3
"2011","Stockport 003D","E01005920","Total",1562,769,793,1562,0,20,31.06,50.3
"2011","Stockport 003E","E01005921","Total",1392,652,740,1392,0,3,29.91,46.5
"2011","Stockport 003F","E01005922","Total",1406,669,737,1406,0,9,22.76,61.8
"2011","Stockport 004A","E01005753","Total",1671,756,915,1633,38,6,30.14,55.4
"2011","Stockport 004B","E01005754","Total",1791,931,860,1791,0,5,44.81,40.0
"2011","Stockport 004C","E01005755","Total",1635,802,833,1635,0,9,60.38,27.1
"2011","Stockport 004D","E01005756","Total",1589,789,800,1548,41,3,61.51,25.8
"2011","Stockport 005A","E01005745","Total",1433,726,707,1433,0,19,80.58,17.8
"2011","Stockport 005B","E01005746","Total",1418,706,712,1394,24,6,28.77,49.3
"2011","Stockport 005C","E01005747","Total",1454,727,727,1454,0,23,33.13,43.9
"2011","Stockport 005D","E01005748","Total",1536,774,762,1531,5,11,45.80,33.5
"2011","Stockport 006A","E01005863","Total",1744,871,873,1714,30,42,34.66,50.3
"2011","Stockport 006B","E01005864","Total",1481,748,733,1388,93,31,28.70,51.6
"2011","Stockport 006C","E01005866","Total",1713,915,798,1694,19,25,28.85,59.4
"2011","Stockport 006D","E01005869","Total",1508,715,793,1508,0,17,49.97,30.2
"2011","Stockport 007A","E01005914","Total",1426,731,695,1426,0,14,43.09,33.1
"2011","Stockport 007B","E01005915","Total",1489,740,749,1488,1,14,65.29,22.8
"2011","Stockport 007C","E01005916","Total",1565,787,778,1537,28,7,38.90,40.2
"2011","Stockport 007D","E01005917","Total",1619,798,821,1616,3,6,50.83,31.9
"2011","Stockport 008A","E01005859","Total",1459,728,731,1376,83,29,23.47,62.2
"2011","Stockport 008B","E01005865","Total",1471,733,738,1471,0,32,81.95,17.9
"2011","Stockport 008C","E01005867","Total",1458,698,760,1409,49,50,34.16,42.7
"2011","Stockport 008D","E01005868","Total",1498,745,753,1498,0,25,46.82,32.0
"2011","Stockport 009A","E01005743","Total",1353,667,686,1353,0,9,43.03,31.4
"2011","Stockport 009B","E01005744","Total",1438,687,751,1351,87,5,261.74,5.5
"2011","Stockport 009C","E01005749","Total",1647,807,840,1647,0,10,31.62,52.1
"2011","Stockport 009D","E01005750","Total",1697,820,877,1696,1,23,72.82,23.3
"2011","Stockport 009E","E01005751","Total",1314,661,653,1314,0,7,23.19,56.7
"2011","Stockport 010A","E01005897","Total",1495,739,756,1495,0,10,77.87,19.2
"2011","Stockport 010B","E01005898","Total",1603,770,833,1599,4,11,443.81,3.6
"2011","Stockport 010C","E01005900","Total",1549,751,798,1549,0,21,60.30,25.7
"2011","Stockport 010D","E01005903","Total",1438,716,722,1430,8,25,117.40,12.2
"2011","Stockport 010E","E01005904","Total",1462,713,749,1462,0,21,35.46,41.2
"2011","Stockport 011A","E01005853","Total",1570,754,816,1570,0,18,43.89,35.8
"2011","Stockport 011B","E01005856","Total",1619,795,824,1613,6,25,55.74,29.0
"2011","Stockport 011C","E01005860","Total",1488,692,796,1488,0,21,30.53,48.7
"2011","Stockport 011D","E01005861","Total",1548,738,810,1548,0,24,48.34,32.0
"2011","Stockport 012A","E01005752","Total",1477,734,743,1477,0,14,30.46,48.5
"2011","Stockport 012B","E01005899","Total",1616,752,864,1576,40,15,78.70,20.5
"2011","Stockport 012C","E01005901","Total",1398,695,703,1394,4,12,175.95,7.9
"2011","Stockport 012D","E01005902","Total",1618,767,851,1618,0,6,67.52,24.0
"2011","Stockport 012E","E01005905","Total",1436,701,735,1393,43,11,19.36,74.2
"2011","Stockport 013A","E01005852","Total",1552,747,805,1552,0,19,67.51,23.0
"2011","Stockport 013B","E01005854","Total",1626,789,837,1623,3,31,24.24,67.1
"2011","Stockport 013C","E01005855","Total",1504,769,735,1504,0,24,33.61,44.7
"2011","Stockport 013D","E01005857","Total",1549,767,782,1549,0,22,43.68,35.5
"2011","Stockport 013E","E01005858","Total",1575,752,823,1549,26,16,39.89,39.5
"2011","Stockport 014A","E01005757","Total",1607,818,789,1607,0,9,93.30,17.2
"2011","Stockport 014B","E01005758","Total",1851,1008,843,1775,76,10,103.99,17.8
"2011","Stockport 014C","E01005766","Total",1452,760,692,1450,2,13,29.94,48.5
"2011","Stockport 014D","E01005918","Total",1511,861,650,1431,80,12,33.04,45.7
"2011","Stockport 015A","E01005870","Total",1399,694,705,1364,35,12,68.45,20.4
"2011","Stockport 015B","E01005871","Total",1337,654,683,1337,0,13,24.63,54.3
"2011","Stockport 015C","E01005873","Total",1489,729,760,1489,0,18,38.44,38.7
"2011","Stockport 015D","E01005875","Total",1559,756,803,1559,0,16,24.46,63.7
"2011","Stockport 016A","E01005764","Total",1642,796,846,1616,26,9,29.44,55.8
"2011","Stockport 016B","E01005816","Total",1600,763,837,1600,0,3,12.17,131.5
"2011","Stockport 016C","E01005817","Total",1345,654,691,1343,2,5,26.34,51.1
"2011","Stockport 016D","E01005822","Total",1507,798,709,1505,2,4,48.89,30.8
"2011","Stockport 017A","E01005880","Total",1488,718,770,1488,0,26,444.83,3.3
"2011","Stockport 017B","E01005881","Total",1278,634,644,1278,0,35,82.53,15.5
"2011","Stockport 017C","E01005883","Total",1536,767,769,1536,0,23,131.89,11.6
"2011","Stockport 017D","E01005908","Total",1494,722,772,1475,19,33,998.95,1.5
"2011","Stockport 018A","E01005765","Total",1393,657,736,1383,10,6,23.81,58.5
"2011","Stockport 018B","E01005818","Total",1422,672,750,1422,0,10,25.83,55.1
"2011","Stockport 018C","E01005819","Total",1547,786,761,1547,0,11,60.03,25.8
"2011","Stockport 018D","E01005820","Total",1455,672,783,1402,53,8,21.87,66.5
"2011","Stockport 018E","E01005821","Total",1489,736,753,1489,0,14,44.23,33.7
"2011","Stockport 018F","E01005823","Total",1632,811,821,1632,0,8,23.54,69.3
"2011","Stockport 019A","E01005825","Total",1516,759,757,1502,14,16,31.35,48.4
"2011","Stockport 019B","E01005872","Total",1712,843,869,1699,13,3,26.87,63.7
"2011","Stockport 019C","E01005874","Total",1672,874,798,1672,0,4,48.77,34.3
"2011","Stockport 019D","E01005876","Total",1481,746,735,1479,2,12,21.14,70.1
"2011","Stockport 019E","E01005877","Total",1402,686,716,1401,1,7,39.25,35.7
"2011","Stockport 020A","E01005878","Total",1435,675,760,1435,0,9,90.35,15.9
"2011","Stockport 020B","E01005879","Total",1308,621,687,1302,6,20,21.87,59.8
"2011","Stockport 020C","E01005882","Total",1380,660,720,1258,122,32,111.66,12.4
"2011","Stockport 020D","E01005884","Total",1494,712,782,1494,0,30,105.13,14.2
"2011","Stockport 020E","E01005885","Total",1386,630,756,1303,83,18,45.38,30.5
"2011","Stockport 021A","E01005832","Total",1472,744,728,1472,0,20,56.97,25.8
"2011","Stockport 021B","E01005833","Total",1046,507,539,1026,20,12,38.97,26.8
"2011","Stockport 021C","E01005835","Total",1397,695,702,1393,4,21,165.15,8.5
"2011","Stockport 021D","E01005837","Total",1588,772,816,1588,0,14,44.26,35.9
"2011","Stockport 021E","E01005843","Total",1510,768,742,1510,0,21,32.57,46.4
"2011","Stockport 022A","E01005769","Total",1335,603,732,1335,0,3,135.86,9.8
"2011","Stockport 022B","E01005778","Total",1469,706,763,1469,0,15,32.65,45.0
"2011","Stockport 022C","E01005779","Total",1419,684,735,1419,0,13,26.95,52.7
"2011","Stockport 022D","E01005780","Total",1466,720,746,1466,0,7,29.75,49.3
"2011","Stockport 022E","E01005781","Total",1533,724,809,1533,0,3,46.07,33.3
"2011","Stockport 023A","E01005759","Total",1679,845,834,1670,9,10,31.74,52.9
"2011","Stockport 023B","E01005760","Total",1857,928,929,1857,0,11,22.31,83.2
"2011","Stockport 023C","E01005797","Total",1370,684,686,1350,20,8,18.86,72.6
"2011","Stockport 023D","E01005800","Total",1627,776,851,1627,0,35,34.95,46.6
"2011","Stockport 023E","E01005804","Total",1201,549,652,1089,112,11,24.21,49.6
"2011","Stockport 024A","E01005824","Total",1474,734,740,1474,0,11,24.08,61.2
"2011","Stockport 024B","E01005826","Total",1450,658,792,1411,39,9,26.32,55.1
"2011","Stockport 024C","E01005827","Total",1406,695,711,1390,16,14,32.43,43.4
"2011","Stockport 024D","E01005828","Total",1288,624,664,1285,3,3,21.73,59.3
"2011","Stockport 024E","E01005829","Total",1283,608,675,1272,11,7,50.48,25.4
"2011","Stockport 025A","E01005768","Total",1632,782,850,1609,23,31,84.09,19.4
"2011","Stockport 025B","E01005770","Total",1429,682,747,1429,0,25,32.10,44.5
"2011","Stockport 025C","E01005771","Total",1383,662,721,1376,7,18,39.66,34.9
"2011","Stockport 025D","E01005775","Total",1566,738,828,1527,39,16,43.76,35.8
"2011","Stockport 026A","E01005761","Total",1404,736,668,1402,2,4,38.12,36.8
"2011","Stockport 026B","E01005762","Total",1588,736,852,1588,0,14,49.17,32.3
"2011","Stockport 026C","E01005763","Total",1696,828,868,1646,50,6,30.46,55.7
"2011","Stockport 026D","E01005799","Total",1804,885,919,1804,0,17,33.32,54.1
"2011","Stockport 027A","E01005798","Total",1587,761,826,1494,93,25,38.75,41.0
"2011","Stockport 027B","E01005801","Total",1497,755,742,1446,51,19,78.07,19.2
"2011","Stockport 027C","E01005802","Total",1535,778,757,1529,6,36,31.66,48.5
"2011","Stockport 027D","E01005803","Total",1488,730,758,1488,0,40,41.05,36.2
"2011","Stockport 027E","E01005830","Total",1476,718,758,1473,3,7,30.20,48.9
"2011","Stockport 027F","E01005831","Total",1546,754,792,1539,7,14,25.81,59.9
"2011","Stockport 028A","E01005767","Total",1492,729,763,1476,16,25,71.99,20.7
"2011","Stockport 028B","E01005772","Total",1466,726,740,1466,0,23,44.06,33.3
"2011","Stockport 028C","E01005773","Total",1523,708,815,1523,0,43,51.63,29.5
"2011","Stockport 028D","E01005774","Total",1400,671,729,1387,13,12,62.58,22.4
"2011","Stockport 028E","E01005776","Total",1571,775,796,1571,0,35,46.37,33.9
"2011","Stockport 029A","E01005909","Total",1552,748,804,1552,0,34,177.82,8.7
"2011","Stockport 029B","E01005910","Total",1533,711,822,1533,0,13,36.64,41.8
"2011","Stockport 029C","E01005911","Total",1353,635,718,1280,73,11,36.14,37.4
"2011","Stockport 029D","E01005912","Total",1366,691,675,1366,0,10,346.21,3.9
"2011","Stockport 030A","E01005782","Total",1218,574,644,1218,0,15,39.63,30.7
"2011","Stockport 030B","E01005783","Total",1541,727,814,1541,0,14,33.51,46.0
"2011","Stockport 030C","E01005784","Total",1427,693,734,1393,34,26,106.97,13.3
"2011","Stockport 030D","E01005785","Total",1535,768,767,1535,0,30,30.86,49.7
"2011","Stockport 030E","E01005786","Total",1589,809,780,1589,0,33,45.10,35.2
"2011","Stockport 031A","E01005834","Total",1505,734,771,1505,0,21,31.25,48.2
"2011","Stockport 031B","E01005836","Total",1837,894,943,1830,7,17,58.48,31.4
"2011","Stockport 031C","E01005838","Total",1707,811,896,1707,0,11,35.21,48.5
"2011","Stockport 031D","E01005840","Total",1532,749,783,1525,7,19,52.06,29.4
"2011","Stockport 032A","E01005927","Total",1352,654,698,1352,0,43,39.53,34.2
"2011","Stockport 032B","E01005928","Total",1572,756,816,1572,0,22,94.02,16.7
"2011","Stockport 032C","E01005929","Total",1376,679,697,1349,27,47,86.99,15.8
"2011","Stockport 032D","E01005930","Total",1560,753,807,1560,0,48,98.29,15.9
"2011","Stockport 033A","E01005806","Total",1215,581,634,1215,0,6,73.85,16.5
"2011","Stockport 033B","E01005813","Total",1441,699,742,1441,0,48,48.55,29.7
"2011","Stockport 033C","E01005814","Total",1329,664,665,1326,3,31,39.86,33.3
"2011","Stockport 033D","E01005815","Total",1470,700,770,1470,0,26,33.74,43.6
"2011","Stockport 034A","E01005777","Total",1486,701,785,1486,0,10,54.38,27.3
"2011","Stockport 034B","E01005787","Total",1299,664,635,1299,0,61,46.50,27.9
"2011","Stockport 034C","E01005788","Total",1528,735,793,1521,7,31,45.15,33.8
"2011","Stockport 034D","E01005790","Total",1223,588,635,1219,4,22,30.38,40.3
"2011","Stockport 035A","E01005805","Total",1573,749,824,1538,35,34,28.63,54.9
"2011","Stockport 035B","E01005807","Total",1576,776,800,1562,14,36,67.03,23.5
"2011","Stockport 035C","E01005839","Total",1316,663,653,1316,0,28,36.81,35.8
"2011","Stockport 035D","E01005841","Total",1538,737,801,1520,18,17,49.19,31.3
"2011","Stockport 036A","E01005844","Total",1490,714,776,1430,60,13,83.15,17.9
"2011","Stockport 036B","E01005845","Total",1621,796,825,1621,0,22,36.88,44.0
"2011","Stockport 036C","E01005849","Total",1571,779,792,1571,0,27,59.59,26.4
"2011","Stockport 036D","E01005851","Total",1524,755,769,1524,0,27,53.52,28.5
"2011","Stockport 037A","E01005808","Total",1366,663,703,1366,0,39,38.14,35.8
"2011","Stockport 037B","E01005809","Total",1263,631,632,1263,0,43,139.18,9.1
"2011","Stockport 037C","E01005810","Total",1573,735,838,1475,98,37,60.85,25.9
"2011","Stockport 037D","E01005811","Total",1402,687,715,1402,0,43,37.12,37.8
"2011","Stockport 037E","E01005812","Total",1289,627,662,1289,0,39,65.39,19.7
"2011","Stockport 038A","E01005842","Total",1620,806,814,1620,0,22,345.02,4.7
"2011","Stockport 038B","E01005906","Total",1462,690,772,1438,24,22,95.31,15.3
"2011","Stockport 038C","E01005907","Total",1293,632,661,1276,17,17,88.07,14.7
"2011","Stockport 038D","E01005913","Total",1441,703,738,1441,0,17,147.03,9.8
"2011","Stockport 039A","E01005789","Total",1560,771,789,1559,1,26,42.72,36.5
"2011","Stockport 039B","E01005791","Total",1543,744,799,1543,0,46,36.97,41.7
"2011","Stockport 039C","E01005793","Total",1423,673,750,1423,0,27,93.65,15.2
"2011","Stockport 039D","E01005795","Total",1292,631,661,1290,2,29,40.20,32.1
"2011","Stockport 039E","E01005796","Total",1260,621,639,1260,0,30,41.61,30.3
"2011","Stockport 040A","E01005846","Total",1659,837,822,1659,0,17,38.88,42.7
"2011","Stockport 040B","E01005847","Total",1553,765,788,1553,0,16,21.34,72.8
"2011","Stockport 040C","E01005848","Total",1839,899,940,1773,66,34,117.03,15.7
"2011","Stockport 040D","E01005850","Total",1759,852,907,1759,0,13,65.80,26.7
"2011","Stockport 041A","E01005792","Total",1464,721,743,1462,2,45,39.25,37.3
"2011","Stockport 041B","E01005794","Total",1241,597,644,1241,0,36,28.04,44.3
"2011","Stockport 041C","E01005923","Total",1549,756,793,1532,17,39,71.25,21.7
"2011","Stockport 041D","E01005931","Total",1445,681,764,1445,0,37,37.02,39.0
"2011","Stockport 042A","E01005924","Total",1343,646,697,1308,35,30,39.29,34.2
"2011","Stockport 042B","E01005925","Total",1418,655,763,1377,41,34,57.33,24.7
"2011","Stockport 042C","E01005926","Total",1265,621,644,1249,16,31,575.93,2.2
"2011","Stockport 042D","E01005932","Total",1385,677,708,1385,0,36,65.65,21.1
"2011","Tameside 001A","E01006053","Total",1864,907,957,1864,0,29,147.07,12.7
"2011","Tameside 001B","E01006054","Total",1623,776,847,1582,41,12,134.42,12.1
"2011","Tameside 001C","E01006055","Total",1387,670,717,1387,0,17,52.65,26.3
"2011","Tameside 001D","E01006057","Total",1533,741,792,1514,19,14,35.32,43.4
"2011","Tameside 001E","E01006058","Total",1911,976,935,1887,24,10,52.47,36.4
"2011","Tameside 001F","E01006059","Total",1413,689,724,1413,0,14,87.62,16.1
"2011","Tameside 002A","E01005938","Total",1638,825,813,1638,0,22,452.66,3.6
"2011","Tameside 002B","E01005939","Total",1305,633,672,1305,0,26,30.93,42.2
"2011","Tameside 002C","E01005940","Total",1494,737,757,1494,0,29,58.98,25.3
"2011","Tameside 002D","E01005955","Total",1710,849,861,1710,0,23,36.85,46.4
"2011","Tameside 003A","E01006056","Total",1190,586,604,1190,0,6,356.34,3.3
"2011","Tameside 003B","E01006061","Total",2383,1172,1211,2383,0,23,171.49,13.9
"2011","Tameside 003C","E01006062","Total",2114,1047,1067,2114,0,16,73.98,28.6
"2011","Tameside 003D","E01006063","Total",1463,723,740,1463,0,9,127.44,11.5
"2011","Tameside 004A","E01005936","Total",1487,751,736,1487,0,16,36.21,41.1
"2011","Tameside 004B","E01005937","Total",1516,722,794,1516,0,10,53.61,28.3
"2011","Tameside 004C","E01005945","Total",1974,936,1038,1931,43,8,26.99,73.1
"2011","Tameside 004D","E01005946","Total",1653,824,829,1605,48,13,20.59,80.3
"2011","Tameside 004E","E01005947","Total",1581,788,793,1581,0,4,14.76,107.1
"2011","Tameside 005A","E01005954","Total",1499,726,773,1458,41,7,42.18,35.5
"2011","Tameside 005B","E01005956","Total",1422,681,741,1387,35,25,109.02,13.0
"2011","Tameside 005C","E01005957","Total",1459,739,720,1449,10,9,22.80,64.0
"2011","Tameside 005D","E01005958","Total",1456,693,763,1456,0,7,24.74,58.9
"2011","Tameside 005E","E01005959","Total",1705,818,887,1705,0,21,35.98,47.4
"2011","Tameside 006A","E01005933","Total",1467,721,746,1467,0,10,25.26,58.1
"2011","Tameside 006B","E01005934","Total",1479,708,771,1479,0,20,28.56,51.8
"2011","Tameside 006C","E01005935","Total",1475,695,780,1433,42,2,27.25,54.1
"2011","Tameside 006D","E01005949","Total",1557,759,798,1530,27,6,28.41,54.8
"2011","Tameside 006E","E01005960","Total",1637,816,821,1602,35,15,21.75,75.3
"2011","Tameside 007A","E01005941","Total",1650,883,767,1612,38,12,28.33,58.2
"2011","Tameside 007B","E01005942","Total",1649,817,832,1649,0,15,30.34,54.4
"2011","Tameside 007C","E01005943","Total",1793,890,903,1777,16,17,56.91,31.5
"2011","Tameside 007D","E01005944","Total",1467,763,704,1402,65,18,57.99,25.3
"2011","Tameside 008A","E01006060","Total",1396,718,678,1396,0,4,41.09,34.0
"2011","Tameside 008B","E01006064","Total",1578,784,794,1551,27,4,40.05,39.4
"2011","Tameside 008C","E01006065","Total",1357,627,730,1357,0,7,25.27,53.7
"2011","Tameside 008D","E01006066","Total",1403,677,726,1331,72,11,33.22,42.2
"2011","Tameside 009A","E01006067","Total",1842,928,914,1839,3,27,39.02,47.2
"2011","Tameside 009B","E01006068","Total",1594,787,807,1549,45,8,31.49,50.6
"2011","Tameside 009C","E01006069","Total",1667,769,898,1667,0,9,65.38,25.5
"2011","Tameside 009D","E01006073","Total",1752,822,930,1685,67,11,1366.90,1.3
"2011","Tameside 010A","E01005993","Total",1411,681,730,1411,0,9,38.10,37.0
"2011","Tameside 010B","E01005995","Total",1421,696,725,1421,0,20,96.01,14.8
"2011","Tameside 010C","E01005996","Total",1939,947,992,1939,0,17,31.66,61.2
"2011","Tameside 010D","E01005997","Total",1459,717,742,1459,0,7,30.74,47.5
"2011","Tameside 010E","E01006000","Total",1543,759,784,1510,33,22,31.58,48.9
"2011","Tameside 011A","E01005994","Total",1449,689,760,1449,0,4,37.49,38.7
"2011","Tameside 011B","E01005999","Total",1857,901,956,1857,0,6,34.39,54.0
"2011","Tameside 011C","E01006002","Total",1368,638,730,1368,0,20,23.81,57.5
"2011","Tameside 011D","E01006004","Total",1544,746,798,1544,0,12,21.64,71.3
"2011","Tameside 011E","E01006005","Total",1351,626,725,1307,44,8,29.49,45.8
"2011","Tameside 011F","E01006007","Total",1508,735,773,1508,0,16,45.96,32.8
"2011","Tameside 012A","E01005998","Total",1703,834,869,1703,0,10,37.12,45.9
"2011","Tameside 012B","E01006001","Total",1559,771,788,1559,0,9,15.81,98.6
"2011","Tameside 012C","E01006003","Total",1450,715,735,1450,0,13,17.91,81.0
"2011","Tameside 012D","E01006006","Total",1472,727,745,1472,0,20,38.77,38.0
"2011","Tameside 013A","E01005948","Total",1769,993,776,1769,0,8,97.16,18.2
"2011","Tameside 013B","E01005950","Total",1923,926,997,1923,0,10,76.98,25.0
"2011","Tameside 013C","E01005951","Total",1585,766,819,1579,6,5,103.75,15.3
"2011","Tameside 013D","E01005952","Total",2163,1247,916,2150,13,5,45.15,47.9
"2011","Tameside 013E","E01005953","Total",2043,1005,1038,2020,23,6,24.20,84.4
"2011","Tameside 014A","E01005961","Total",1423,692,731,1373,50,17,202.80,7.0
"2011","Tameside 014B","E01005962","Total",1457,706,751,1457,0,19,31.12,46.8
"2011","Tameside 014C","E01005968","Total",1446,693,753,1446,0,9,38.26,37.8
"2011","Tameside 014D","E01005969","Total",1381,679,702,1381,0,17,31.88,43.3
"2011","Tameside 015A","E01006022","Total",1619,825,794,1616,3,15,52.94,30.6
"2011","Tameside 015B","E01006023","Total",1545,822,723,1545,0,13,75.22,20.5
"2011","Tameside 015C","E01006070","Total",1437,706,731,1422,15,19,29.49,48.7
"2011","Tameside 015D","E01006071","Total",1586,814,772,1586,0,40,202.79,7.8
"2011","Tameside 015E","E01006072","Total",1685,848,837,1685,0,33,108.65,15.5
"2011","Tameside 016A","E01006009","Total",1364,673,691,1348,16,6,44.68,30.5
"2011","Tameside 016B","E01006017","Total",1416,727,689,1416,0,12,67.61,20.9
"2011","Tameside 016C","E01006018","Total",1366,675,691,1366,0,13,31.19,43.8
"2011","Tameside 016D","E01006021","Total",1365,657,708,1365,0,6,20.49,66.6
"2011","Tameside 017A","E01006008","Total",1455,715,740,1455,0,14,139.05,10.5
"2011","Tameside 017B","E01006010","Total",1381,655,726,1381,0,4,20.16,68.5
"2011","Tameside 017C","E01006012","Total",1839,893,946,1791,48,13,32.45,56.7
"2011","Tameside 017D","E01006015","Total",1419,695,724,1415,4,11,21.65,65.5
"2011","Tameside 017E","E01006016","Total",1754,926,828,1737,17,5,49.48,35.4
"2011","Tameside 018A","E01006011","Total",1634,808,826,1634,0,5,29.54,55.3
"2011","Tameside 018B","E01006013","Total",1281,624,657,1281,0,10,29.87,42.9
"2011","Tameside 018C","E01006014","Total",1302,633,669,1302,0,9,24.41,53.3
"2011","Tameside 018D","E01006019","Total",1509,763,746,1476,33,8,25.11,60.1
"2011","Tameside 018E","E01006020","Total",1563,748,815,1496,67,7,56.45,27.7
"2011","Tameside 019A","E01005963","Total",1222,597,625,1222,0,7,32.34,37.8
"2011","Tameside 019B","E01005964","Total",1538,730,808,1516,22,12,25.78,59.7
"2011","Tameside 019C","E01005965","Total",1430,695,735,1394,36,4,58.84,24.3
"2011","Tameside 019D","E01005966","Total",1355,682,673,1355,0,22,28.14,48.2
"2011","Tameside 019E","E01005967","Total",1381,693,688,1381,0,6,26.74,51.6
"2011","Tameside 020A","E01006031","Total",1496,715,781,1496,0,4,81.64,18.3
"2011","Tameside 020B","E01006032","Total",1330,650,680,1330,0,12,27.30,48.7
"2011","Tameside 020C","E01006033","Total",1360,691,669,1360,0,7,22.52,60.4
"2011","Tameside 020D","E01006034","Total",2143,1047,1096,2143,0,15,42.23,50.7
"2011","Tameside 020E","E01006035","Total",1976,999,977,1970,6,11,66.90,29.5
"2011","Tameside 020F","E01006036","Total",1953,970,983,1953,0,12,55.17,35.4
"2011","Tameside 021A","E01005970","Total",1464,747,717,1464,0,22,37.49,39.1
"2011","Tameside 021B","E01005972","Total",1680,822,858,1680,0,16,26.28,63.9
"2011","Tameside 021C","E01005974","Total",1563,763,800,1563,0,10,49.80,31.4
"2011","Tameside 021D","E01005975","Total",1562,738,824,1562,0,15,30.02,52.0
"2011","Tameside 022A","E01006024","Total",1809,898,911,1809,0,29,231.92,7.8
"2011","Tameside 022B","E01006026","Total",1569,762,807,1569,0,15,32.19,48.7
"2011","Tameside 022C","E01006037","Total",1498,727,771,1498,0,15,91.87,16.3
"2011","Tameside 022D","E01006038","Total",1638,777,861,1594,44,9,36.91,44.4
"2011","Tameside 023A","E01006047","Total",1341,657,684,1341,0,17,59.75,22.4
"2011","Tameside 023B","E01006048","Total",1498,726,772,1484,14,18,115.39,13.0
"2011","Tameside 023C","E01006049","Total",1537,766,771,1525,12,15,345.96,4.4
"2011","Tameside 023D","E01006051","Total",1645,817,828,1645,0,24,296.77,5.5
"2011","Tameside 024A","E01005985","Total",1533,736,797,1530,3,17,87.71,17.5
"2011","Tameside 024B","E01005987","Total",1547,738,809,1547,0,9,38.02,40.7
"2011","Tameside 024C","E01005988","Total",1601,773,828,1601,0,13,24.54,65.2
"2011","Tameside 024D","E01005990","Total",1344,662,682,1344,0,12,25.94,51.8
"2011","Tameside 024E","E01005991","Total",1466,720,746,1466,0,12,67.00,21.9
"2011","Tameside 025A","E01005971","Total",1406,703,703,1406,0,8,39.28,35.8
"2011","Tameside 025B","E01005986","Total",1246,594,652,1246,0,12,27.40,45.5
"2011","Tameside 025C","E01005989","Total",1220,576,644,1220,0,9,187.80,6.5
"2011","Tameside 025D","E01005992","Total",1317,608,709,1289,28,4,51.08,25.8
"2011","Tameside 026A","E01005973","Total",1426,714,712,1426,0,17,61.90,23.0
"2011","Tameside 026B","E01005976","Total",1523,723,800,1512,11,11,22.86,66.6
"2011","Tameside 026C","E01005977","Total",1497,706,791,1481,16,9,21.51,69.6
"2011","Tameside 026D","E01005978","Total",1377,660,717,1377,0,5,27.88,49.4
"2011","Tameside 027A","E01006025","Total",1418,661,757,1418,0,6,136.90,10.4
"2011","Tameside 027B","E01006027","Total",1409,700,709,1409,0,10,64.50,21.8
"2011","Tameside 027C","E01006050","Total",1707,824,883,1707,0,8,44.10,38.7
"2011","Tameside 027D","E01006052","Total",1537,768,769,1537,0,5,105.53,14.6
"2011","Tameside 028A","E01006028","Total",1762,872,890,1762,0,7,39.06,45.1
"2011","Tameside 028B","E01006029","Total",1837,882,955,1836,1,15,22.21,82.7
"2011","Tameside 028C","E01006030","Total",1836,904,932,1756,80,8,47.79,38.4
"2011","Tameside 028D","E01006039","Total",1406,672,734,1370,36,5,37.28,37.7
"2011","Tameside 028E","E01006040","Total",1699,859,840,1618,81,7,65.98,25.8
"2011","Tameside 028F","E01006041","Total",1597,803,794,1597,0,5,21.46,74.4
"2011","Tameside 029A","E01005979","Total",1612,791,821,1612,0,13,42.97,37.5
"2011","Tameside 029B","E01005980","Total",1485,698,787,1432,53,5,26.23,56.6
"2011","Tameside 029C","E01005981","Total",1529,682,847,1529,0,5,31.97,47.8
"2011","Tameside 029D","E01005982","Total",1347,644,703,1347,0,11,57.55,23.4
"2011","Tameside 029E","E01005983","Total",1616,783,833,1616,0,17,50.33,32.1
"2011","Tameside 029F","E01005984","Total",1517,787,730,1517,0,14,42.86,35.4
"2011","Tameside 030A","E01006042","Total",1638,784,854,1638,0,13,40.03,40.9
"2011","Tameside 030B","E01006043","Total",1466,686,780,1466,0,10,27.32,53.7
"2011","Tameside 030C","E01006044","Total",1383,676,707,1350,33,15,105.87,13.1
"2011","Tameside 030D","E01006045","Total",1264,614,650,1264,0,23,382.08,3.3
"2011","Tameside 030E","E01006046","Total",1481,709,772,1439,42,14,24.92,59.4
"2011","Trafford 001A","E01006109","Total",1448,856,592,1427,21,5,19.11,75.8
"2011","Trafford 001B","E01006110","Total",1775,826,949,1775,0,12,12.20,145.5
"2011","Trafford 001C","E01006111","Total",1720,818,902,1720,0,23,11.06,155.5
"2011","Trafford 001D","E01006112","Total",1713,839,874,1704,9,19,19.45,88.1
"2011","Trafford 001E","E01006185","Total",1968,1015,953,1966,2,13,56.33,34.9
"2011","Trafford 001F","E01006188","Total",1553,781,772,1553,0,4,60.37,25.7
"2011","Trafford 002A","E01006116","Total",1350,650,700,1350,0,14,25.50,52.9
"2011","Trafford 002B","E01006117","Total",1672,826,846,1672,0,25,34.65,48.3
"2011","Trafford 002C","E01006118","Total",1453,689,764,1428,25,14,37.44,38.8
"2011","Trafford 002D","E01006119","Total",1608,785,823,1608,0,15,25.94,62.0
"2011","Trafford 002E","E01006121","Total",1549,739,810,1540,9,11,547.00,2.8
"2011","Trafford 003A","E01006141","Total",1604,820,784,1604,0,21,29.55,54.3
"2011","Trafford 003B","E01006186","Total",1903,970,933,1900,3,20,73.31,26.0
"2011","Trafford 003C","E01006187","Total",2535,1268,1267,2528,7,12,80.86,31.4
"2011","Trafford 003D","E01006189","Total",2235,1110,1125,2235,0,19,29.21,76.5
"2011","Trafford 004A","E01006113","Total",1524,750,774,1524,0,26,16.90,90.2
"2011","Trafford 004B","E01006114","Total",1662,809,853,1651,11,18,22.89,72.6
"2011","Trafford 004C","E01006115","Total",1584,765,819,1583,1,11,19.17,82.6
"2011","Trafford 004D","E01006145","Total",1797,873,924,1781,16,14,66.75,26.9
"2011","Trafford 004E","E01006146","Total",1894,930,964,1894,0,24,35.03,54.1
"2011","Trafford 005A","E01006122","Total",1553,760,793,1553,0,13,81.71,19.0
"2011","Trafford 005B","E01006123","Total",1695,814,881,1669,26,25,130.36,13.0
"2011","Trafford 005C","E01006124","Total",1473,721,752,1473,0,28,56.22,26.2
"2011","Trafford 005D","E01006128","Total",1767,893,874,1739,28,26,29.97,59.0
"2011","Trafford 005E","E01006131","Total",1566,786,780,1566,0,25,60.73,25.8
"2011","Trafford 006A","E01006155","Total",1606,793,813,1606,0,13,24.64,65.2
"2011","Trafford 006B","E01006157","Total",1557,757,800,1557,0,10,297.26,5.2
"2011","Trafford 006C","E01006159","Total",1804,824,980,1804,0,7,30.87,58.4
"2011","Trafford 006D","E01006182","Total",1532,699,833,1532,0,22,24.68,62.1
"2011","Trafford 006E","E01006183","Total",1650,824,826,1650,0,22,22.64,72.9
"2011","Trafford 007A","E01006125","Total",1484,723,761,1484,0,14,56.13,26.4
"2011","Trafford 007B","E01006126","Total",1665,787,878,1665,0,7,45.19,36.8
"2011","Trafford 007C","E01006127","Total",1616,797,819,1616,0,10,84.34,19.2
"2011","Trafford 007D","E01006130","Total",1777,879,898,1777,0,26,28.45,62.5
"2011","Trafford 007E","E01006132","Total",1566,755,811,1566,0,13,130.78,12.0
"2011","Trafford 008A","E01006156","Total",1593,739,854,1593,0,16,35.43,45.0
"2011","Trafford 008B","E01006158","Total",1648,811,837,1645,3,18,91.22,18.1
"2011","Trafford 008C","E01006179","Total",1732,901,831,1717,15,19,67.66,25.6
"2011","Trafford 008D","E01006184","Total",1676,810,866,1674,2,13,147.00,11.4
"2011","Trafford 009A","E01006198","Total",1554,721,833,1476,78,14,29.93,51.9
"2011","Trafford 009B","E01006199","Total",1570,745,825,1570,0,7,23.97,65.5
"2011","Trafford 009C","E01006200","Total",1445,667,778,1364,81,5,166.27,8.7
"2011","Trafford 009D","E01006201","Total",1495,754,741,1486,9,13,24.71,60.5
"2011","Trafford 009E","E01006202","Total",1358,707,651,1356,2,17,21.80,62.3
"2011","Trafford 010A","E01006120","Total",1430,698,732,1409,21,22,25.40,56.3
"2011","Trafford 010B","E01006129","Total",1367,637,730,1329,38,20,46.83,29.2
"2011","Trafford 010C","E01006133","Total",1454,700,754,1434,20,12,67.21,21.6
"2011","Trafford 010D","E01006197","Total",1530,738,792,1526,4,24,26.31,58.2
"2011","Trafford 010E","E01006203","Total",1415,685,730,1362,53,25,25.76,54.9
"2011","Trafford 011A","E01006142","Total",1659,804,855,1659,0,29,64.58,25.7
"2011","Trafford 011B","E01006143","Total",1659,839,820,1659,0,22,56.15,29.5
"2011","Trafford 011C","E01006144","Total",1444,707,737,1444,0,12,66.12,21.8
"2011","Trafford 011D","E01006180","Total",1838,915,923,1827,11,4,33.00,55.7
"2011","Trafford 011E","E01006181","Total",1666,831,835,1651,15,17,24.91,66.9
"2011","Trafford 012A","E01006147","Total",1415,723,692,1415,0,27,21.60,65.5
"2011","Trafford 012B","E01006149","Total",1485,721,764,1485,0,16,23.86,62.2
"2011","Trafford 012C","E01006150","Total",1542,772,770,1534,8,25,33.39,46.2
"2011","Trafford 012D","E01006154","Total",1501,766,735,1501,0,15,37.68,39.8
"2011","Trafford 012E","E01006165","Total",1918,930,988,1914,4,15,83.67,22.9
"2011","Trafford 013A","E01006166","Total",1567,770,797,1567,0,17,32.06,48.9
"2011","Trafford 013B","E01006169","Total",1634,800,834,1634,0,23,31.96,51.1
"2011","Trafford 013C","E01006170","Total",1550,744,806,1550,0,17,141.45,11.0
"2011","Trafford 013D","E01006171","Total",1796,862,934,1796,0,5,27.21,66.0
"2011","Trafford 014A","E01006098","Total",1289,634,655,1260,29,31,25.42,50.7
"2011","Trafford 014B","E01006099","Total",1352,678,674,1352,0,20,31.31,43.2
"2011","Trafford 014C","E01006164","Total",1650,810,840,1650,0,19,102.54,16.1
"2011","Trafford 014D","E01006174","Total",1738,877,861,1738,0,28,28.80,60.3
"2011","Trafford 014E","E01006178","Total",1821,914,907,1821,0,18,38.24,47.6
"2011","Trafford 015A","E01006097","Total",1768,895,873,1733,35,26,43.42,40.7
"2011","Trafford 015B","E01006160","Total",1753,887,866,1753,0,13,41.76,42.0
"2011","Trafford 015C","E01006161","Total",1958,969,989,1909,49,22,44.33,44.2
"2011","Trafford 015D","E01006162","Total",1615,801,814,1615,0,29,32.17,50.2
"2011","Trafford 015E","E01006163","Total",1788,890,898,1788,0,29,25.87,69.1
"2011","Trafford 016A","E01006148","Total",1632,806,826,1575,57,56,35.39,46.1
"2011","Trafford 016B","E01006151","Total",1508,749,759,1479,29,41,42.44,35.5
"2011","Trafford 016C","E01006152","Total",1636,795,841,1636,0,50,56.32,29.0
"2011","Trafford 016D","E01006153","Total",1568,741,827,1568,0,40,31.16,50.3
"2011","Trafford 016E","E01006172","Total",1530,743,787,1524,6,27,34.07,44.9
"2011","Trafford 017A","E01006104","Total",1689,832,857,1654,35,6,55.07,30.7
"2011","Trafford 017B","E01006105","Total",1933,929,1004,1933,0,9,67.08,28.8
"2011","Trafford 017C","E01006106","Total",1485,687,798,1485,0,13,55.90,26.6
"2011","Trafford 017D","E01006107","Total",1618,765,853,1618,0,12,998.09,1.6
"2011","Trafford 017E","E01006108","Total",1670,763,907,1670,0,10,26.24,63.6
"2011","Trafford 018A","E01006102","Total",1368,635,733,1368,0,16,25.07,54.6
"2011","Trafford 018B","E01006173","Total",1516,737,779,1516,0,26,22.09,68.6
"2011","Trafford 018C","E01006175","Total",1613,750,863,1613,0,7,26.15,61.7
"2011","Trafford 018D","E01006176","Total",1789,884,905,1789,0,25,138.40,12.9
"2011","Trafford 018E","E01006177","Total",1645,798,847,1645,0,13,23.61,69.7
"2011","Trafford 019A","E01006091","Total",2287,1133,1154,2287,0,20,69.31,33.0
"2011","Trafford 019B","E01006092","Total",1355,632,723,1355,0,10,56.96,23.8
"2011","Trafford 019C","E01006095","Total",1629,827,802,1629,0,19,112.57,14.5
"2011","Trafford 019D","E01006167","Total",1633,782,851,1632,1,8,26.57,61.5
"2011","Trafford 019E","E01006168","Total",1919,893,1026,1919,0,14,34.87,55.0
"2011","Trafford 020A","E01006090","Total",1964,1015,949,1964,0,25,40.61,48.4
"2011","Trafford 020B","E01006094","Total",1486,719,767,1486,0,30,25.66,57.9
"2011","Trafford 020C","E01006096","Total",1532,749,783,1532,0,19,36.10,42.4
"2011","Trafford 020D","E01006100","Total",1517,766,751,1501,16,44,27.41,55.3
"2011","Trafford 020E","E01006103","Total",1618,818,800,1618,0,33,25.93,62.4
"2011","Trafford 021A","E01006101","Total",1522,773,749,1522,0,41,44.28,34.4
"2011","Trafford 021B","E01006190","Total",1693,831,862,1664,29,32,37.67,44.9
"2011","Trafford 021C","E01006195","Total",1771,888,883,1771,0,28,27.71,63.9
"2011","Trafford 021D","E01006196","Total",1784,903,881,1784,0,48,26.68,66.9
"2011","Trafford 021E","E01006210","Total",1656,850,806,1656,0,33,36.16,45.8
"2011","Trafford 022A","E01006204","Total",1610,750,860,1610,0,36,37.84,42.5
"2011","Trafford 022B","E01006206","Total",1884,895,989,1859,25,17,31.26,60.3
"2011","Trafford 022C","E01006207","Total",1617,780,837,1611,6,13,27.09,59.7
"2011","Trafford 022D","E01006208","Total",1627,758,869,1627,0,26,43.97,37.0
"2011","Trafford 022E","E01006211","Total",1530,732,798,1530,0,13,39.48,38.8
"2011","Trafford 023A","E01006093","Total",1596,786,810,1580,16,26,24.83,64.3
"2011","Trafford 023B","E01006191","Total",1658,800,858,1658,0,42,36.39,45.6
"2011","Trafford 023C","E01006192","Total",1534,735,799,1534,0,31,86.19,17.8
"2011","Trafford 023D","E01006205","Total",1388,697,691,1388,0,31,25.39,54.7
"2011","Trafford 023E","E01006209","Total",1577,777,800,1577,0,30,75.61,20.9
"2011","Trafford 024A","E01006078","Total",1851,937,914,1843,8,25,30.73,60.2
"2011","Trafford 024B","E01006080","Total",1808,885,923,1782,26,31,30.84,58.6
"2011","Trafford 024C","E01006089","Total",1497,763,734,1497,0,11,46.75,32.0
"2011","Trafford 024D","E01006193","Total",1519,757,762,1513,6,35,30.75,49.4
"2011","Trafford 024E","E01006194","Total",2333,1162,1171,2333,0,36,49.69,47.0
"2011","Trafford 025A","E01006074","Total",1574,733,841,1496,78,15,113.49,13.9
"2011","Trafford 025B","E01006075","Total",1940,960,980,1908,32,38,74.87,25.9
"2011","Trafford 025C","E01006076","Total",1623,782,841,1548,75,26,63.42,25.6
"2011","Trafford 025D","E01006079","Total",1995,1017,978,1991,4,49,63.66,31.3
"2011","Trafford 025E","E01006087","Total",1513,754,759,1513,0,47,1871.51,0.8
"2011","Trafford 026A","E01006083","Total",1397,687,710,1397,0,87,49.16,28.4
"2011","Trafford 026B","E01006084","Total",1708,838,870,1708,0,75,45.46,37.6
"2011","Trafford 026C","E01006088","Total",1575,771,804,1575,0,45,21.67,72.7
"2011","Trafford 026D","E01006139","Total",1717,830,887,1717,0,38,29.01,59.2
"2011","Trafford 026E","E01006140","Total",1685,828,857,1685,0,37,63.91,26.4
"2011","Trafford 027A","E01006077","Total",1591,812,779,1591,0,31,26.42,60.2
"2011","Trafford 027B","E01006081","Total",1391,689,702,1369,22,67,136.51,10.2
"2011","Trafford 027C","E01006082","Total",1607,780,827,1602,5,59,88.32,18.2
"2011","Trafford 027D","E01006085","Total",1574,719,855,1495,79,42,41.82,37.6
"2011","Trafford 027E","E01006086","Total",1668,802,866,1622,46,40,107.60,15.5
"2011","Trafford 028A","E01006134","Total",1527,755,772,1527,0,78,117.49,13.0
"2011","Trafford 028B","E01006135","Total",1636,764,872,1571,65,59,90.51,18.1
"2011","Trafford 028C","E01006136","Total",1551,732,819,1551,0,68,126.77,12.2
"2011","Trafford 028D","E01006137","Total",1433,693,740,1433,0,51,136.88,10.5
"2011","Trafford 028E","E01006138","Total",1747,823,924,1747,0,40,235.18,7.4
"2011","Wigan 001A","E01006315","Total",1237,608,629,1223,14,21,255.98,4.8
"2011","Wigan 001B","E01006316","Total",1486,743,743,1486,0,20,134.34,11.1
"2011","Wigan 001C","E01006317","Total",1523,745,778,1523,0,14,59.07,25.8
"2011","Wigan 001D","E01006319","Total",1439,706,733,1439,0,27,38.30,37.6
"2011","Wigan 002A","E01006229","Total",1527,746,781,1498,29,26,259.87,5.9
"2011","Wigan 002B","E01006230","Total",1417,696,721,1417,0,34,101.69,13.9
"2011","Wigan 002C","E01006233","Total",1497,737,760,1456,41,37,87.83,17.0
"2011","Wigan 002D","E01006237","Total",1576,791,785,1576,0,30,130.42,12.1
"2011","Wigan 002E","E01006238","Total",1530,727,803,1530,0,11,25.10,61.0
"2011","Wigan 003A","E01006259","Total",1321,666,655,1321,0,11,91.82,14.4
"2011","Wigan 003B","E01006312","Total",1481,738,743,1481,0,21,51.21,28.9
"2011","Wigan 003C","E01006313","Total",1067,528,539,1067,0,2,88.60,12.0
"2011","Wigan 003D","E01006314","Total",1679,814,865,1679,0,21,241.79,6.9
"2011","Wigan 003E","E01006318","Total",1446,729,717,1446,0,17,69.03,20.9
"2011","Wigan 003F","E01006320","Total",1378,702,676,1378,0,8,160.34,8.6
"2011","Wigan 003G","E01006321","Total",1710,858,852,1710,0,27,43.17,39.6
"2011","Wigan 004A","E01006231","Total",1477,738,739,1477,0,32,609.65,2.4
"2011","Wigan 004B","E01006232","Total",1855,874,981,1809,46,29,682.43,2.7
"2011","Wigan 004C","E01006234","Total",1230,621,609,1230,0,9,62.59,19.7
"2011","Wigan 004D","E01006235","Total",1524,746,778,1524,0,16,61.89,24.6
"2011","Wigan 005A","E01006253","Total",1544,747,797,1544,0,12,34.15,45.2
"2011","Wigan 005B","E01006254","Total",1657,782,875,1657,0,4,101.62,16.3
"2011","Wigan 005C","E01006255","Total",1505,744,761,1498,7,12,26.36,57.1
"2011","Wigan 005D","E01006256","Total",1439,747,692,1437,2,2,36.40,39.5
"2011","Wigan 005E","E01006260","Total",1530,735,795,1530,0,4,48.17,31.8
"2011","Wigan 006A","E01006370","Total",1598,878,720,1591,7,20,49.13,32.5
"2011","Wigan 006B","E01006372","Total",1675,795,880,1613,62,45,79.50,21.1
"2011","Wigan 006C","E01006373","Total",1503,745,758,1503,0,23,27.19,55.3
"2011","Wigan 006D","E01006374","Total",1549,747,802,1549,0,19,37.66,41.1
"2011","Wigan 006E","E01006390","Total",1539,762,777,1539,0,17,41.09,37.5
"2011","Wigan 007A","E01006236","Total",1480,734,746,1480,0,16,450.72,3.3
"2011","Wigan 007B","E01006388","Total",1691,856,835,1670,21,15,45.04,37.5
"2011","Wigan 007C","E01006389","Total",1400,687,713,1400,0,11,26.37,53.1
"2011","Wigan 007D","E01006391","Total",1587,799,788,1587,0,11,56.37,28.2
"2011","Wigan 008A","E01006257","Total",1307,655,652,1292,15,5,14.29,91.5
"2011","Wigan 008B","E01006258","Total",1684,812,872,1636,48,9,27.91,60.3
"2011","Wigan 008C","E01006369","Total",1696,900,796,1694,2,12,68.69,24.7
"2011","Wigan 008D","E01006371","Total",1543,782,761,1543,0,22,26.52,58.2
"2011","Wigan 008E","E01006375","Total",1602,813,789,1602,0,28,32.77,48.9
"2011","Wigan 009A","E01006306","Total",1546,827,719,1546,0,4,22.01,70.2
"2011","Wigan 009B","E01006307","Total",1432,736,696,1432,0,5,41.43,34.6
"2011","Wigan 009C","E01006386","Total",1534,824,710,1534,0,5,23.54,65.2
"2011","Wigan 009D","E01006387","Total",1319,650,669,1268,51,3,19.27,68.4
"2011","Wigan 009E","E01006392","Total",1499,766,733,1499,0,4,24.81,60.4
"2011","Wigan 010A","E01006350","Total",1823,902,921,1823,0,7,67.21,27.1
"2011","Wigan 010B","E01006351","Total",2092,1015,1077,2092,0,9,28.88,72.4
"2011","Wigan 010C","E01006357","Total",1727,810,917,1672,55,2,68.73,25.1
"2011","Wigan 010D","E01006360","Total",1675,834,841,1675,0,4,49.18,34.1
"2011","Wigan 010E","E01006361","Total",1616,825,791,1616,0,2,124.83,12.9
"2011","Wigan 011A","E01006356","Total",1472,735,737,1472,0,9,27.03,54.5
"2011","Wigan 011B","E01006396","Total",1472,713,759,1429,43,10,246.19,6.0
"2011","Wigan 011C","E01006397","Total",1135,560,575,1112,23,2,14.77,76.8
"2011","Wigan 011D","E01006398","Total",1086,547,539,1086,0,5,22.14,49.1
"2011","Wigan 011E","E01006399","Total",1538,766,772,1538,0,10,53.00,29.0
"2011","Wigan 012A","E01006305","Total",1783,874,909,1783,0,14,31.40,56.8
"2011","Wigan 012B","E01006308","Total",1640,796,844,1600,40,8,102.94,15.9
"2011","Wigan 012C","E01006309","Total",1602,839,763,1565,37,0,54.32,29.5
"2011","Wigan 012D","E01006310","Total",1513,764,749,1513,0,9,251.35,6.0
"2011","Wigan 012E","E01006311","Total",1593,783,810,1593,0,4,85.76,18.6
"2011","Wigan 013A","E01006269","Total",1605,810,795,1603,2,14,63.05,25.5
"2011","Wigan 013B","E01006271","Total",1785,880,905,1754,31,18,90.08,19.8
"2011","Wigan 013C","E01006272","Total",1653,816,837,1558,95,4,169.18,9.8
"2011","Wigan 013D","E01006273","Total",1533,723,810,1533,0,10,72.54,21.1
"2011","Wigan 013E","E01006276","Total",2274,1129,1145,2274,0,17,64.99,35.0
"2011","Wigan 014A","E01006353","Total",1543,794,749,1543,0,11,29.67,52.0
"2011","Wigan 014B","E01006354","Total",1584,805,779,1502,82,8,19.87,79.7
"2011","Wigan 014C","E01006355","Total",1531,746,785,1531,0,12,22.03,69.5
"2011","Wigan 014D","E01006358","Total",1750,868,882,1704,46,4,60.15,29.1
"2011","Wigan 014E","E01006359","Total",1514,752,762,1514,0,8,35.61,42.5
"2011","Wigan 015A","E01006349","Total",1762,886,876,1762,0,3,133.50,13.2
"2011","Wigan 015B","E01006352","Total",1666,843,823,1619,47,2,56.29,29.6
"2011","Wigan 015C","E01006404","Total",1660,811,849,1617,43,5,53.69,30.9
"2011","Wigan 015D","E01006405","Total",1381,651,730,1344,37,15,42.43,32.5
"2011","Wigan 015E","E01006411","Total",1630,848,782,1630,0,3,51.12,31.9
"2011","Wigan 016A","E01006270","Total",1495,740,755,1495,0,4,27.63,54.1
"2011","Wigan 016B","E01006274","Total",1511,719,792,1511,0,1,20.03,75.4
"2011","Wigan 016C","E01006275","Total",1529,744,785,1529,0,7,27.42,55.8
"2011","Wigan 016D","E01006277","Total",1802,905,897,1802,0,22,64.96,27.7
"2011","Wigan 016E","E01006286","Total",1509,753,756,1467,42,5,39.25,38.4
"2011","Wigan 017A","E01006239","Total",1965,1023,942,1965,0,7,42.79,45.9
"2011","Wigan 017B","E01006240","Total",1601,793,808,1601,0,7,27.90,57.4
"2011","Wigan 017C","E01006241","Total",2001,1016,985,1946,55,13,107.78,18.6
"2011","Wigan 017D","E01006287","Total",1217,590,627,1217,0,18,21.01,57.9
"2011","Wigan 017E","E01006289","Total",1746,902,844,1746,0,6,29.14,59.9
"2011","Wigan 018A","E01006362","Total",1782,899,883,1782,0,12,170.38,10.5
"2011","Wigan 018B","E01006363","Total",1542,741,801,1542,0,10,41.38,37.3
"2011","Wigan 018C","E01006364","Total",1811,856,955,1811,0,18,112.70,16.1
"2011","Wigan 018D","E01006365","Total",2206,1070,1136,2206,0,36,55.80,39.5
"2011","Wigan 018E","E01006366","Total",1681,867,814,1681,0,22,132.45,12.7
"2011","Wigan 018F","E01006367","Total",1577,777,800,1577,0,17,56.29,28.0
"2011","Wigan 018G","E01006368","Total",1641,789,852,1641,0,13,504.52,3.3
"2011","Wigan 019A","E01006278","Total",1574,757,817,1574,0,13,54.73,28.8
"2011","Wigan 019B","E01006279","Total",1593,781,812,1579,14,11,34.05,46.8
"2011","Wigan 019C","E01006280","Total",1428,688,740,1405,23,11,40.12,35.6
"2011","Wigan 019D","E01006281","Total",1764,889,875,1764,0,16,57.61,30.6
"2011","Wigan 019E","E01006285","Total",1838,906,932,1838,0,18,70.41,26.1
"2011","Wigan 020A","E01006406","Total",1460,721,739,1460,0,6,43.37,33.7
"2011","Wigan 020B","E01006407","Total",1507,755,752,1507,0,15,114.04,13.2
"2011","Wigan 020C","E01006408","Total",1544,764,780,1544,0,11,34.21,45.1
"2011","Wigan 020D","E01006409","Total",1388,679,709,1388,0,6,21.40,64.9
"2011","Wigan 020E","E01006410","Total",1403,717,686,1403,0,22,62.87,22.3
"2011","Wigan 021A","E01006393","Total",1490,760,730,1490,0,9,27.66,53.9
"2011","Wigan 021B","E01006394","Total",1561,755,806,1561,0,10,59.28,26.3
"2011","Wigan 021C","E01006395","Total",2502,1263,1239,2502,0,21,154.57,16.2
"2011","Wigan 021D","E01006400","Total",1345,642,703,1345,0,16,56.94,23.6
"2011","Wigan 021E","E01006401","Total",1463,718,745,1463,0,15,251.93,5.8
"2011","Wigan 021F","E01006402","Total",1198,597,601,1198,0,13,22.83,52.5
"2011","Wigan 021G","E01006403","Total",1705,859,846,1705,0,8,47.09,36.2
"2011","Wigan 022A","E01006290","Total",1375,686,689,1375,0,17,50.43,27.3
"2011","Wigan 022B","E01006291","Total",1470,740,730,1470,0,6,27.21,54.0
"2011","Wigan 022C","E01006292","Total",1568,761,807,1530,38,14,50.49,31.1
"2011","Wigan 022D","E01006293","Total",1579,791,788,1538,41,24,94.46,16.7
"2011","Wigan 023A","E01006242","Total",1643,816,827,1625,18,6,79.60,20.6
"2011","Wigan 023B","E01006243","Total",2045,1044,1001,2045,0,14,119.12,17.2
"2011","Wigan 023C","E01006244","Total",1564,769,795,1560,4,3,97.19,16.1
"2011","Wigan 023D","E01006245","Total",2417,1222,1195,2417,0,23,198.39,12.2
"2011","Wigan 024A","E01006213","Total",1627,815,812,1627,0,12,184.44,8.8
"2011","Wigan 024B","E01006215","Total",1675,842,833,1602,73,5,343.81,4.9
"2011","Wigan 024C","E01006217","Total",2334,1146,1188,2334,0,9,62.59,37.3
"2011","Wigan 024D","E01006218","Total",2055,1027,1028,2055,0,10,41.83,49.1
"2011","Wigan 024E","E01006219","Total",1297,637,660,1297,0,6,24.24,53.5
"2011","Wigan 025A","E01006288","Total",1803,864,939,1803,0,11,143.93,12.5
"2011","Wigan 025B","E01006294","Total",1963,973,990,1963,0,12,31.51,62.3
"2011","Wigan 025C","E01006295","Total",1593,810,783,1593,0,9,33.50,47.6
"2011","Wigan 025D","E01006377","Total",1624,787,837,1614,10,20,70.63,23.0
"2011","Wigan 025E","E01006378","Total",1334,679,655,1334,0,18,90.56,14.7
"2011","Wigan 026A","E01006212","Total",1395,713,682,1388,7,4,105.20,13.3
"2011","Wigan 026B","E01006214","Total",1375,672,703,1375,0,4,181.56,7.6
"2011","Wigan 026C","E01006216","Total",2191,1111,1080,2191,0,9,80.47,27.2
"2011","Wigan 026D","E01006322","Total",1539,782,757,1539,0,7,236.96,6.5
"2011","Wigan 026E","E01006329","Total",1290,765,525,1078,212,4,196.20,6.6
"2011","Wigan 027A","E01006282","Total",1701,860,841,1661,40,15,70.98,24.0
"2011","Wigan 027B","E01006283","Total",1535,788,747,1535,0,4,76.47,20.1
"2011","Wigan 027C","E01006284","Total",1520,764,756,1520,0,14,30.11,50.5
"2011","Wigan 027D","E01006336","Total",1630,765,865,1593,37,14,52.23,31.2
"2011","Wigan 027E","E01006337","Total",1507,731,776,1507,0,11,41.73,36.1
"2011","Wigan 028A","E01006376","Total",1642,835,807,1642,0,11,65.17,25.2
"2011","Wigan 028B","E01006381","Total",1920,985,935,1920,0,23,75.45,25.4
"2011","Wigan 028C","E01006382","Total",1410,719,691,1410,0,15,24.76,56.9
"2011","Wigan 028D","E01006383","Total",1660,834,826,1660,0,12,27.11,61.2
"2011","Wigan 028E","E01006384","Total",1394,711,683,1394,0,20,25.73,54.2
"2011","Wigan 029A","E01006250","Total",1532,773,759,1532,0,15,73.85,20.7
"2011","Wigan 029B","E01006251","Total",1462,727,735,1462,0,19,1368.50,1.1
"2011","Wigan 029C","E01006379","Total",1551,756,795,1551,0,9,193.72,8.0
"2011","Wigan 029D","E01006380","Total",1655,781,874,1655,0,6,108.88,15.2
"2011","Wigan 029E","E01006385","Total",1489,728,761,1489,0,26,33.06,45.0
"2011","Wigan 030A","E01006328","Total",1432,754,678,1432,0,6,27.23,52.6
"2011","Wigan 030B","E01006333","Total",1810,892,918,1789,21,15,39.27,46.1
"2011","Wigan 030C","E01006334","Total",1716,861,855,1716,0,8,31.42,54.6
"2011","Wigan 030D","E01006338","Total",1588,795,793,1588,0,8,20.89,76.0
"2011","Wigan 031A","E01006248","Total",1564,831,733,1564,0,7,110.32,14.2
"2011","Wigan 031B","E01006249","Total",1578,776,802,1578,0,14,122.69,12.9
"2011","Wigan 031C","E01006330","Total",1629,811,818,1629,0,22,36.72,44.4
"2011","Wigan 031D","E01006331","Total",1596,796,800,1596,0,23,59.66,26.8
"2011","Wigan 031E","E01006332","Total",2077,1024,1053,1862,215,13,41.30,50.3
"2011","Wigan 032A","E01006262","Total",1531,780,751,1531,0,8,244.36,6.3
"2011","Wigan 032B","E01006263","Total",1547,777,770,1547,0,26,54.43,28.4
"2011","Wigan 032C","E01006266","Total",1392,685,707,1392,0,10,40.93,34.0
"2011","Wigan 032D","E01006267","Total",1637,803,834,1637,0,11,27.01,60.6
"2011","Wigan 032E","E01006268","Total",1762,877,885,1762,0,13,58.92,29.9
"2011","Wigan 033A","E01006323","Total",1502,739,763,1502,0,3,67.97,22.1
"2011","Wigan 033B","E01006324","Total",1325,653,672,1325,0,13,25.18,52.6
"2011","Wigan 033C","E01006325","Total",1608,811,797,1608,0,8,42.36,38.0
"2011","Wigan 033D","E01006326","Total",1439,725,714,1430,9,8,17.33,83.0
"2011","Wigan 033E","E01006327","Total",1482,718,764,1458,24,8,299.18,5.0
"2011","Wigan 034A","E01006246","Total",1566,788,778,1566,0,11,79.22,19.8
"2011","Wigan 034B","E01006247","Total",1330,651,679,1330,0,19,48.05,27.7
"2011","Wigan 034C","E01006252","Total",1464,698,766,1464,0,12,25.32,57.8
"2011","Wigan 034D","E01006297","Total",1631,757,874,1631,0,6,120.28,13.6
"2011","Wigan 034E","E01006335","Total",1672,829,843,1672,0,10,18.80,88.9
"2011","Wigan 035A","E01006220","Total",1845,900,945,1797,48,10,327.51,5.6
"2011","Wigan 035B","E01006221","Total",1645,819,826,1645,0,16,41.57,39.6
"2011","Wigan 035C","E01006222","Total",1577,786,791,1577,0,13,65.06,24.2
"2011","Wigan 035D","E01006224","Total",1577,805,772,1577,0,16,37.94,41.6
"2011","Wigan 035E","E01006226","Total",1754,904,850,1754,0,8,58.03,30.2
"2011","Wigan 036A","E01006223","Total",1610,812,798,1568,42,22,36.80,43.8
"2011","Wigan 036B","E01006225","Total",1514,736,778,1486,28,17,56.35,26.9
"2011","Wigan 036C","E01006261","Total",1536,733,803,1502,34,8,27.41,56.0
"2011","Wigan 036D","E01006264","Total",1356,685,671,1356,0,24,35.51,38.2
"2011","Wigan 036E","E01006265","Total",1432,700,732,1432,0,20,36.24,39.5
"2011","Wigan 037A","E01006296","Total",1533,736,797,1533,0,9,49.94,30.7
"2011","Wigan 037B","E01006298","Total",1405,665,740,1405,0,6,22.77,61.7
"2011","Wigan 037C","E01006299","Total",1888,951,937,1888,0,24,141.42,13.4
"2011","Wigan 037D","E01006300","Total",1347,659,688,1347,0,29,37.54,35.9
"2011","Wigan 037E","E01006301","Total",1362,651,711,1362,0,23,135.32,10.1
"2011","Wigan 038A","E01006227","Total",1554,757,797,1554,0,8,33.44,46.5
"2011","Wigan 038B","E01006228","Total",1731,896,835,1731,0,13,82.02,21.1
"2011","Wigan 038C","E01006342","Total",1567,778,789,1567,0,9,47.21,33.2
"2011","Wigan 038D","E01006344","Total",1487,695,792,1450,37,13,26.01,57.2
"2011","Wigan 038E","E01006346","Total",2134,1076,1058,2134,0,19,93.07,22.9
"2011","Wigan 039A","E01006339","Total",1370,662,708,1370,0,13,47.66,28.7
"2011","Wigan 039B","E01006340","Total",1457,721,736,1457,0,7,319.67,4.6
"2011","Wigan 039C","E01006343","Total",1758,860,898,1758,0,25,35.07,50.1
"2011","Wigan 039D","E01006345","Total",1583,766,817,1559,24,13,30.75,51.5
"2011","Wigan 039E","E01006348","Total",1607,793,814,1574,33,27,474.77,3.4
"2011","Wigan 040A","E01006302","Total",1603,814,789,1603,0,22,98.04,16.4
"2011","Wigan 040B","E01006303","Total",1394,695,699,1394,0,12,247.06,5.6
"2011","Wigan 040C","E01006304","Total",1481,725,756,1481,0,12,173.55,8.5
"2011","Wigan 040D","E01006341","Total",1644,820,824,1644,0,12,50.94,32.3
"2011","Wigan 040E","E01006347","Total",1580,760,820,1580,0,19,36.97,42.7
"2011","Burnley 001A","E01024859","Total",1529,751,778,1489,40,11,25.06,61.0
"2011","Burnley 001B","E01024861","Total",1309,628,681,1309,0,31,24.42,53.6
"2011","Burnley 001C","E01024862","Total",1573,782,791,1573,0,20,34.33,45.8
"2011","Burnley 001D","E01024891","Total",1617,757,860,1601,16,16,38.30,42.2
"2011","Burnley 001E","E01024892","Total",1428,658,770,1428,0,8,66.68,21.4
"2011","Burnley 001F","E01024894","Total",1376,670,706,1376,0,8,22.17,62.1
"2011","Burnley 002A","E01024893","Total",1483,722,761,1483,0,6,38.75,38.3
"2011","Burnley 002B","E01024896","Total",1326,644,682,1326,0,12,39.63,33.5
"2011","Burnley 002C","E01024897","Total",1426,690,736,1303,123,14,42.62,33.5
"2011","Burnley 002D","E01024898","Total",1562,783,779,1562,0,1,21.04,74.2
"2011","Burnley 003A","E01024856","Total",1613,819,794,1587,26,12,12.00,134.4
"2011","Burnley 003B","E01024875","Total",1405,744,661,1405,0,13,10.17,138.2
"2011","Burnley 003C","E01024876","Total",1367,702,665,1361,6,22,16.97,80.6
"2011","Burnley 003D","E01024877","Total",1574,849,725,1555,19,24,73.37,21.5
"2011","Burnley 003E","E01024878","Total",1609,822,787,1609,0,10,162.54,9.9
"2011","Burnley 003F","E01024895","Total",1377,727,650,1377,0,10,18.67,73.8
"2011","Burnley 004A","E01024883","Total",1506,698,808,1490,16,12,70.92,21.2
"2011","Burnley 004B","E01024884","Total",1585,747,838,1544,41,13,53.00,29.9
"2011","Burnley 004C","E01024885","Total",1665,844,821,1665,0,19,37.47,44.4
"2011","Burnley 004D","E01024886","Total",1392,706,686,1392,0,9,15.45,90.1
"2011","Burnley 004E","E01024889","Total",1289,637,652,1241,48,19,175.46,7.3
"2011","Burnley 004F","E01024890","Total",1470,710,760,1470,0,10,57.40,25.6
"2011","Burnley 005A","E01024879","Total",1318,624,694,1302,16,9,38.29,34.4
"2011","Burnley 005B","E01024880","Total",1435,695,740,1383,52,18,38.63,37.1
"2011","Burnley 005C","E01024912","Total",1397,675,722,1368,29,28,277.62,5.0
"2011","Burnley 005D","E01024913","Total",1372,696,676,1372,0,25,27.76,49.4
"2011","Burnley 005E","E01024914","Total",1484,736,748,1484,0,25,182.02,8.2
"2011","Burnley 006A","E01024881","Total",1425,713,712,1422,3,8,21.99,64.8
"2011","Burnley 006B","E01024882","Total",1473,701,772,1473,0,7,25.23,58.4
"2011","Burnley 006C","E01024902","Total",1523,725,798,1491,32,12,42.64,35.7
"2011","Burnley 006D","E01024911","Total",1760,880,880,1760,0,13,40.34,43.6
"2011","Burnley 007A","E01024855","Total",1428,683,745,1404,24,8,27.94,51.1
"2011","Burnley 007B","E01024857","Total",1522,724,798,1456,66,9,90.60,16.8
"2011","Burnley 007C","E01024858","Total",1338,671,667,1320,18,14,28.99,46.2
"2011","Burnley 007D","E01024864","Total",1587,777,810,1587,0,11,16.73,94.9
"2011","Burnley 008A","E01024863","Total",1471,721,750,1471,0,8,55.94,26.3
"2011","Burnley 008B","E01024865","Total",1434,720,714,1427,7,10,25.40,56.5
"2011","Burnley 008C","E01024866","Total",1761,842,919,1761,0,25,96.67,18.2
"2011","Burnley 008D","E01024867","Total",1420,681,739,1420,0,18,99.49,14.3
"2011","Burnley 009A","E01024860","Total",1243,632,611,1243,0,14,1637.52,0.8
"2011","Burnley 009B","E01024868","Total",1221,612,609,1206,15,7,1327.51,0.9
"2011","Burnley 009C","E01024869","Total",1414,698,716,1414,0,23,650.74,2.2
"2011","Burnley 009D","E01024870","Total",1146,558,588,1146,0,20,2100.50,0.5
"2011","Burnley 010A","E01024872","Total",1357,633,724,1357,0,12,28.72,47.2
"2011","Burnley 010B","E01024899","Total",1644,798,846,1644,0,6,83.15,19.8
"2011","Burnley 010C","E01024900","Total",1603,778,825,1589,14,14,56.81,28.2
"2011","Burnley 010D","E01024907","Total",1227,612,615,1221,6,8,30.59,40.1
"2011","Burnley 010E","E01024908","Total",1039,499,540,1034,5,1,24.23,42.9
"2011","Burnley 010F","E01024909","Total",1538,806,732,1474,64,8,73.53,20.9
"2011","Burnley 011A","E01024874","Total",1052,526,526,1041,11,23,993.36,1.1
"2011","Burnley 011B","E01024887","Total",1500,747,753,1500,0,14,236.49,6.3
"2011","Burnley 011C","E01024888","Total",1670,841,829,1630,40,22,1230.33,1.4
"2011","Burnley 011D","E01024901","Total",1815,878,937,1815,0,21,55.61,32.6
"2011","Burnley 014D","E01024871","Total",1333,653,680,1260,73,20,40.28,33.1
"2011","Burnley 014E","E01024873","Total",1380,677,703,1380,0,14,26.91,51.3
"2011","Burnley 014F","E01024903","Total",1260,600,660,1260,0,13,24.37,51.7
"2011","Burnley 014A","E01024904","Total",1746,817,929,1660,86,42,156.47,11.2
"2011","Burnley 014G","E01024905","Total",1246,618,628,1220,26,20,22.12,56.3
"2011","Burnley 014B","E01024906","Total",1530,764,766,1530,0,7,44.46,34.4
"2011","Burnley 014C","E01024910","Total",1466,693,773,1446,20,5,33.63,43.6
"2011","Chorley 001A","E01024951","Total",1205,606,599,1205,0,8,24.18,49.8
"2011","Chorley 001B","E01024952","Total",1300,663,637,1166,134,10,45.65,28.5
"2011","Chorley 001C","E01024953","Total",1396,698,698,1368,28,11,32.64,42.8
"2011","Chorley 001D","E01024954","Total",1399,702,697,1399,0,10,48.59,28.8
"2011","Chorley 002A","E01024921","Total",2123,1015,1108,2062,61,37,2619.39,0.8
"2011","Chorley 002B","E01024978","Total",1341,671,670,1341,0,20,600.61,2.2
"2011","Chorley 002C","E01024979","Total",1382,665,717,1382,0,31,754.37,1.8
"2011","Chorley 002D","E01024980","Total",1388,675,713,1388,0,39,325.72,4.3
"2011","Chorley 003A","E01024946","Total",1241,596,645,1241,0,20,67.15,18.5
"2011","Chorley 003B","E01024947","Total",1348,688,660,1348,0,24,41.48,32.5
"2011","Chorley 003C","E01024955","Total",1475,749,726,1437,38,21,114.82,12.8
"2011","Chorley 003D","E01024956","Total",1444,701,743,1433,11,22,116.37,12.4
"2011","Chorley 003E","E01024957","Total",1441,692,749,1407,34,22,225.01,6.4
"2011","Chorley 003F","E01024958","Total",1371,684,687,1371,0,9,24.12,56.8
"2011","Chorley 004A","E01024948","Total",1456,739,717,1456,0,15,57.94,25.1
"2011","Chorley 004B","E01024949","Total",2295,1128,1167,2261,34,20,233.08,9.8
"2011","Chorley 004C","E01024950","Total",1357,694,663,1356,1,30,63.69,21.3
"2011","Chorley 004D","E01024977","Total",2239,1098,1141,2239,0,40,1921.08,1.2
"2011","Chorley 005A","E01024967","Total",1302,634,668,1302,0,18,336.31,3.9
"2011","Chorley 005B","E01024968","Total",1891,936,955,1887,4,28,62.46,30.3
"2011","Chorley 005C","E01024969","Total",1364,631,733,1360,4,16,54.89,24.8
"2011","Chorley 005D","E01024970","Total",1370,697,673,1370,0,17,56.91,24.1
"2011","Chorley 005E","E01024971","Total",1296,619,677,1239,57,23,307.66,4.2
"2011","Chorley 005F","E01024972","Total",1264,629,635,1264,0,24,65.91,19.2
"2011","Chorley 006A","E01024929","Total",1345,665,680,1285,60,6,27.33,49.2
"2011","Chorley 006B","E01024930","Total",1438,733,705,1438,0,5,33.40,43.1
"2011","Chorley 006C","E01024931","Total",1487,705,782,1465,22,5,25.93,57.3
"2011","Chorley 006D","E01024932","Total",1025,512,513,1025,0,22,191.08,5.4
"2011","Chorley 006E","E01024933","Total",1356,663,693,1356,0,12,72.08,18.8
"2011","Chorley 006F","E01024937","Total",1488,722,766,1465,23,37,111.29,13.4
"2011","Chorley 007A","E01024964","Total",1462,721,741,1462,0,28,751.93,1.9
"2011","Chorley 007B","E01024974","Total",1547,758,789,1547,0,35,1846.06,0.8
"2011","Chorley 007C","E01024975","Total",3156,2497,659,1274,1882,21,824.17,3.8
"2011","Chorley 007D","E01024976","Total",1555,755,800,1510,45,16,61.09,25.5
"2011","Chorley 008A","E01024919","Total",2572,1269,1303,2513,59,26,314.50,8.2
"2011","Chorley 008B","E01024920","Total",1939,960,979,1934,5,30,64.22,30.2
"2011","Chorley 008C","E01024934","Total",1509,716,793,1438,71,25,79.56,19.0
"2011","Chorley 008D","E01024935","Total",1418,672,746,1418,0,12,117.51,12.1
"2011","Chorley 009A","E01024925","Total",1708,814,894,1708,0,9,32.74,52.2
"2011","Chorley 009B","E01024926","Total",1921,926,995,1916,5,9,223.36,8.6
"2011","Chorley 009C","E01024927","Total",1667,804,863,1667,0,13,27.73,60.1
"2011","Chorley 009D","E01024928","Total",1527,735,792,1501,26,15,26.16,58.4
"2011","Chorley 010A","E01024936","Total",1546,798,748,1540,6,10,23.53,65.7
"2011","Chorley 010B","E01024938","Total",1624,827,797,1624,0,19,36.13,44.9
"2011","Chorley 010C","E01024939","Total",1744,857,887,1744,0,25,251.18,6.9
"2011","Chorley 010D","E01024940","Total",1699,904,795,1694,5,13,49.23,34.5
"2011","Chorley 010E","E01024941","Total",1568,783,785,1568,0,11,29.31,53.5
"2011","Chorley 011A","E01024923","Total",1234,628,606,1229,5,20,1158.00,1.1
"2011","Chorley 011B","E01024924","Total",1412,725,687,1407,5,11,371.99,3.8
"2011","Chorley 011C","E01024963","Total",1515,733,782,1515,0,16,70.92,21.4
"2011","Chorley 011D","E01024965","Total",1400,691,709,1398,2,29,920.63,1.5
"2011","Chorley 011E","E01024966","Total",1588,783,805,1588,0,19,285.17,5.6
"2011","Chorley 012A","E01024942","Total",1629,795,834,1625,4,3,26.30,61.9
"2011","Chorley 012B","E01024943","Total",2293,1108,1185,2289,4,12,113.02,20.3
"2011","Chorley 012C","E01024944","Total",1786,870,916,1786,0,23,97.42,18.3
"2011","Chorley 012D","E01024945","Total",2889,1425,1464,2842,47,21,53.25,54.3
"2011","Chorley 013A","E01024922","Total",1450,698,752,1450,0,18,303.20,4.8
"2011","Chorley 013B","E01024959","Total",1740,865,875,1700,40,8,52.64,33.1
"2011","Chorley 013C","E01024960","Total",1623,799,824,1623,0,11,51.27,31.7
"2011","Chorley 013D","E01024961","Total",1602,785,817,1573,29,15,493.16,3.2
"2011","Chorley 013E","E01024962","Total",1544,752,792,1500,44,15,71.16,21.7
"2011","Chorley 014A","E01024915","Total",2181,1061,1120,2181,0,19,58.23,37.5
"2011","Chorley 014B","E01024916","Total",1673,831,842,1643,30,12,289.10,5.8
"2011","Chorley 014C","E01024917","Total",1723,861,862,1723,0,10,67.81,25.4
"2011","Chorley 014D","E01024918","Total",1749,845,904,1746,3,31,511.26,3.4
"2011","Chorley 014E","E01024973","Total",2135,1047,1088,2085,50,32,1865.61,1.1
"2011","Fylde 001A","E01024993","Total",1479,707,772,1478,1,34,890.03,1.7
"2011","Fylde 001B","E01025026","Total",1328,667,661,1277,51,25,1884.48,0.7
"2011","Fylde 001C","E01025027","Total",1778,871,907,1749,29,32,1693.41,1.0
"2011","Fylde 001D","E01025028","Total",1368,660,708,1368,0,37,69.55,19.7
"2011","Fylde 001E","E01025031","Total",1205,603,602,1205,0,17,2077.47,0.6
"2011","Fylde 002A","E01025007","Total",1288,636,652,1247,41,35,126.50,10.2
"2011","Fylde 002B","E01025008","Total",1151,564,587,1151,0,8,36.18,31.8
"2011","Fylde 002C","E01025009","Total",1451,708,743,1450,1,17,56.82,25.5
"2011","Fylde 002D","E01025011","Total",1471,694,777,1412,59,9,21.08,69.8
"2011","Fylde 002E","E01025012","Total",1975,955,1020,1975,0,27,721.92,2.7
"2011","Fylde 002F","E01025013","Total",1609,755,854,1609,0,13,43.19,37.3
"2011","Fylde 002G","E01025019","Total",1373,655,718,1373,0,40,442.83,3.1
"2011","Fylde 003A","E01024998","Total",1799,822,977,1784,15,20,716.18,2.5
"2011","Fylde 003B","E01025010","Total",1833,1169,664,1271,562,14,156.74,11.7
"2011","Fylde 003C","E01025014","Total",1683,856,827,1680,3,26,3069.04,0.5
"2011","Fylde 003D","E01025015","Total",1544,752,792,1544,0,22,279.32,5.5
"2011","Fylde 004A","E01025004","Total",1326,632,694,1322,4,14,35.15,37.7
"2011","Fylde 004B","E01025006","Total",1313,651,662,1313,0,8,98.22,13.4
"2011","Fylde 004C","E01025023","Total",1332,634,698,1332,0,20,44.06,30.2
"2011","Fylde 004D","E01025024","Total",1312,619,693,1256,56,14,314.15,4.2
"2011","Fylde 004E","E01025025","Total",1533,742,791,1533,0,26,25.08,61.1
"2011","Fylde 005A","E01025001","Total",1560,701,859,1560,0,12,245.36,6.4
"2011","Fylde 005B","E01025002","Total",1465,695,770,1463,2,16,27.81,52.7
"2011","Fylde 005C","E01025005","Total",1434,677,757,1429,5,16,44.50,32.2
"2011","Fylde 005D","E01025016","Total",2366,1147,1219,2360,6,68,257.19,9.2
"2011","Fylde 005E","E01025018","Total",1232,586,646,1232,0,20,69.84,17.6
"2011","Fylde 006A","E01024984","Total",1438,692,746,1420,18,22,43.02,33.4
"2011","Fylde 006B","E01024985","Total",1391,676,715,1373,18,33,31.32,44.4
"2011","Fylde 006C","E01024986","Total",1530,790,740,1456,74,19,82.51,18.5
"2011","Fylde 006D","E01024987","Total",1273,665,608,1267,6,13,23.81,53.5
"2011","Fylde 006E","E01024988","Total",1598,804,794,1453,145,21,48.38,33.0
"2011","Fylde 006F","E01024989","Total",1491,731,760,1463,28,22,33.56,44.4
"2011","Fylde 006G","E01024996","Total",1234,611,623,1149,85,27,19.03,64.8
"2011","Fylde 007A","E01024997","Total",1424,686,738,1375,49,17,133.76,10.6
"2011","Fylde 007B","E01024999","Total",1514,724,790,1514,0,13,155.26,9.8
"2011","Fylde 007C","E01025000","Total",1282,628,654,1282,0,18,123.90,10.3
"2011","Fylde 007D","E01025029","Total",1949,969,980,1949,0,23,1185.93,1.6
"2011","Fylde 007E","E01025030","Total",1647,793,854,1643,4,22,183.21,9.0
"2011","Fylde 008A","E01024981","Total",1332,656,676,1318,14,35,63.90,20.8
"2011","Fylde 008B","E01024982","Total",1379,650,729,1173,206,22,60.44,22.8
"2011","Fylde 008C","E01024983","Total",1459,703,756,1459,0,39,29.35,49.7
"2011","Fylde 008D","E01024994","Total",1587,766,821,1554,33,39,60.99,26.0
"2011","Fylde 008E","E01024995","Total",1419,668,751,1372,47,22,80.29,17.7
"2011","Fylde 008F","E01025003","Total",1638,785,853,1631,7,25,96.55,17.0
"2011","Fylde 008G","E01025017","Total",1418,619,799,1418,0,11,29.30,48.4
"2011","Fylde 009A","E01024990","Total",1586,745,841,1542,44,13,54.50,29.1
"2011","Fylde 009B","E01024991","Total",1014,454,560,908,106,19,78.29,13.0
"2011","Fylde 009C","E01024992","Total",1346,606,740,1346,0,16,155.40,8.7
"2011","Fylde 009D","E01025020","Total",1293,615,678,1290,3,30,185.45,7.0
"2011","Fylde 009E","E01025021","Total",1436,711,725,1436,0,31,88.58,16.2
"2011","Fylde 009F","E01025022","Total",1871,876,995,1871,0,18,76.03,24.6
"2011","Hyndburn 001A","E01025060","Total",1466,720,746,1462,4,3,10.29,142.5
"2011","Hyndburn 001B","E01025061","Total",1449,681,768,1448,1,16,219.13,6.6
"2011","Hyndburn 001C","E01025062","Total",1571,787,784,1562,9,14,46.67,33.7
"2011","Hyndburn 001D","E01025063","Total",1506,761,745,1506,0,15,67.38,22.4
"2011","Hyndburn 001E","E01025064","Total",1579,770,809,1565,14,21,706.63,2.2
"2011","Hyndburn 001F","E01025065","Total",1637,826,811,1617,20,5,26.58,61.6
"2011","Hyndburn 001G","E01025066","Total",1592,779,813,1592,0,31,145.20,11.0
"2011","Hyndburn 002A","E01025032","Total",1455,690,765,1408,47,10,179.51,8.1
"2011","Hyndburn 002B","E01025033","Total",2299,1147,1152,2282,17,30,586.97,3.9
"2011","Hyndburn 002C","E01025034","Total",1683,861,822,1682,1,18,66.48,25.3
"2011","Hyndburn 002D","E01025048","Total",1583,792,791,1583,0,22,37.97,41.7
"2011","Hyndburn 002E","E01025049","Total",1612,784,828,1598,14,12,24.32,66.3
"2011","Hyndburn 002F","E01025050","Total",1530,742,788,1459,71,16,134.37,11.4
"2011","Hyndburn 002G","E01025053","Total",1552,748,804,1547,5,14,156.93,9.9
"2011","Hyndburn 003A","E01025070","Total",1162,583,579,1162,0,7,44.84,25.9
"2011","Hyndburn 003B","E01025071","Total",1381,685,696,1381,0,12,70.27,19.7
"2011","Hyndburn 003C","E01025072","Total",1381,693,688,1381,0,2,124.60,11.1
"2011","Hyndburn 003D","E01025073","Total",1289,639,650,1287,2,16,40.28,32.0
"2011","Hyndburn 003E","E01025074","Total",1412,696,716,1412,0,16,827.98,1.7
"2011","Hyndburn 004A","E01025051","Total",1384,709,675,1336,48,17,115.77,12.0
"2011","Hyndburn 004B","E01025052","Total",1482,729,753,1482,0,23,140.22,10.6
"2011","Hyndburn 004C","E01025057","Total",1591,780,811,1571,20,7,27.09,58.7
"2011","Hyndburn 004D","E01025058","Total",1381,625,756,1351,30,7,30.86,44.8
"2011","Hyndburn 004E","E01025059","Total",1480,665,815,1435,45,7,54.29,27.3
"2011","Hyndburn 004F","E01025067","Total",1525,785,740,1491,34,7,16.08,94.8
"2011","Hyndburn 004G","E01025068","Total",1512,754,758,1512,0,10,19.52,77.5
"2011","Hyndburn 004H","E01025069","Total",1481,754,727,1481,0,7,11.41,129.8
"2011","Hyndburn 005A","E01025044","Total",1236,595,641,1236,0,7,62.57,19.8
"2011","Hyndburn 005B","E01025045","Total",1281,595,686,1281,0,7,27.95,45.8
"2011","Hyndburn 005C","E01025046","Total",1230,615,615,1218,12,3,108.90,11.3
"2011","Hyndburn 005D","E01025081","Total",1651,825,826,1651,0,22,124.04,13.3
"2011","Hyndburn 006A","E01025041","Total",1708,861,847,1708,0,9,50.13,34.1
"2011","Hyndburn 006B","E01025042","Total",2197,1096,1101,2197,0,10,16.05,136.9
"2011","Hyndburn 006E","E01025082","Total",1715,836,879,1715,0,7,36.82,46.6
"2011","Hyndburn 006F","E01025083","Total",2003,946,1057,1945,58,5,31.17,64.3
"2011","Hyndburn 006G","E01025084","Total",1634,835,799,1611,23,16,60.53,27.0
"2011","Hyndburn 006H","E01033231","Total",2869,1422,1447,2858,11,22,42.47,67.6
"2011","Hyndburn 007A","E01025055","Total",1506,768,738,1485,21,10,20.13,74.8
"2011","Hyndburn 007B","E01025075","Total",1677,836,841,1677,0,7,43.17,38.8
"2011","Hyndburn 007C","E01025076","Total",1367,646,721,1367,0,20,32.79,41.7
"2011","Hyndburn 007D","E01025077","Total",1372,657,715,1334,38,11,49.10,27.9
"2011","Hyndburn 007E","E01025078","Total",1528,789,739,1516,12,9,23.56,64.9
"2011","Hyndburn 008A","E01025035","Total",1483,764,719,1483,0,18,320.47,4.6
"2011","Hyndburn 008B","E01025036","Total",1505,804,701,1488,17,13,42.98,35.0
"2011","Hyndburn 008C","E01025037","Total",1436,690,746,1405,31,12,56.66,25.3
"2011","Hyndburn 008D","E01025038","Total",1358,653,705,1358,0,13,31.15,43.6
"2011","Hyndburn 008E","E01025039","Total",1212,618,594,1212,0,19,343.25,3.5
"2011","Hyndburn 008F","E01025040","Total",1472,745,727,1467,5,24,72.03,20.4
"2011","Hyndburn 009A","E01025054","Total",1714,867,847,1714,0,10,1043.03,1.6
"2011","Hyndburn 009B","E01025056","Total",1341,674,667,1341,0,10,53.70,25.0
"2011","Hyndburn 009C","E01025079","Total",1666,854,812,1666,0,10,32.56,51.2
"2011","Hyndburn 009D","E01025080","Total",1598,801,797,1562,36,13,642.47,2.5
"2011","Lancaster 001A","E01025088","Total",1121,559,562,1121,0,12,76.27,14.7
"2011","Lancaster 001B","E01025096","Total",1598,778,820,1598,0,15,125.68,12.7
"2011","Lancaster 001C","E01025097","Total",1488,733,755,1488,0,8,68.01,21.9
"2011","Lancaster 001D","E01025098","Total",1353,637,716,1266,87,25,339.48,4.0
"2011","Lancaster 001E","E01025148","Total",2035,976,1059,1991,44,35,2745.77,0.7
"2011","Lancaster 001F","E01025168","Total",1094,525,569,1094,0,7,110.49,9.9
"2011","Lancaster 001G","E01025169","Total",1266,583,683,1248,18,16,1619.94,0.8
"2011","Lancaster 002A","E01025130","Total",2123,1027,1096,2118,5,35,4149.70,0.5
"2011","Lancaster 002B","E01025132","Total",1488,765,723,1423,65,40,13470.67,0.1
"2011","Lancaster 002C","E01025166","Total",1180,563,617,1167,13,26,2456.83,0.5
"2011","Lancaster 002D","E01025167","Total",1218,636,582,1172,46,24,6432.19,0.2
"2011","Lancaster 003A","E01025089","Total",1395,657,738,1383,12,19,258.37,5.4
"2011","Lancaster 003B","E01025090","Total",1739,848,891,1731,8,25,313.91,5.5
"2011","Lancaster 003C","E01025158","Total",1433,666,767,1359,74,21,53.35,26.9
"2011","Lancaster 003D","E01025159","Total",1431,667,764,1363,68,28,792.68,1.8
"2011","Lancaster 003E","E01025160","Total",1255,605,650,1255,0,25,115.55,10.9
"2011","Lancaster 004A","E01025085","Total",1392,657,735,1327,65,13,35.36,39.4
"2011","Lancaster 004B","E01025086","Total",1370,617,753,1324,46,18,65.88,20.8
"2011","Lancaster 004C","E01025087","Total",1305,545,760,1187,118,8,43.51,30.0
"2011","Lancaster 004D","E01025161","Total",1123,512,611,1123,0,12,32.10,35.0
"2011","Lancaster 005A","E01025108","Total",1232,596,636,1199,33,18,303.05,4.1
"2011","Lancaster 005B","E01025109","Total",1045,488,557,1045,0,26,1281.47,0.8
"2011","Lancaster 005C","E01025131","Total",1533,748,785,1533,0,26,3017.09,0.5
"2011","Lancaster 005D","E01025133","Total",1421,681,740,1421,0,20,182.01,7.8
"2011","Lancaster 006A","E01025112","Total",1654,800,854,1629,25,13,29.34,56.4
"2011","Lancaster 006B","E01025136","Total",1565,730,835,1565,0,4,23.63,66.2
"2011","Lancaster 006C","E01025138","Total",1463,713,750,1460,3,2,26.65,54.9
"2011","Lancaster 006D","E01025139","Total",1636,860,776,1633,3,7,40.59,40.3
"2011","Lancaster 006E","E01025140","Total",1495,731,764,1294,201,9,23.69,63.1
"2011","Lancaster 008A","E01025111","Total",1807,857,950,1760,47,16,33.87,53.4
"2011","Lancaster 008B","E01025113","Total",1519,747,772,1519,0,10,26.25,57.9
"2011","Lancaster 008C","E01025118","Total",1115,537,578,1110,5,11,20.91,53.3
"2011","Lancaster 008D","E01025119","Total",1348,644,704,1292,56,12,34.60,39.0
"2011","Lancaster 009A","E01025110","Total",1419,739,680,1371,48,8,18.84,75.3
"2011","Lancaster 009B","E01025116","Total",1401,668,733,1319,82,11,23.95,58.5
"2011","Lancaster 009C","E01025117","Total",1406,757,649,1406,0,13,9.97,141.0
"2011","Lancaster 009D","E01025120","Total",1405,690,715,1389,16,7,13.15,106.8
"2011","Lancaster 010A","E01025170","Total",1679,780,899,1679,0,11,33.52,50.1
"2011","Lancaster 010B","E01025171","Total",1710,797,913,1710,0,10,101.41,16.9
"2011","Lancaster 010C","E01025172","Total",1536,708,828,1509,27,18,121.80,12.6
"2011","Lancaster 010D","E01025173","Total",1640,769,871,1640,0,6,48.06,34.1
"2011","Lancaster 011A","E01025149","Total",2134,1052,1082,2127,7,18,38.55,55.4
"2011","Lancaster 011B","E01025150","Total",1485,686,799,1485,0,18,21.08,70.4
"2011","Lancaster 011C","E01025151","Total",1538,757,781,1538,0,14,51.40,29.9
"2011","Lancaster 011D","E01025152","Total",1511,726,785,1511,0,17,31.48,48.0
"2011","Lancaster 011E","E01025154","Total",1339,630,709,1339,0,7,21.37,62.7
"2011","Lancaster 013A","E01025091","Total",1473,712,761,1473,0,16,30.35,48.5
"2011","Lancaster 013B","E01025092","Total",1212,548,664,1177,35,6,55.63,21.8
"2011","Lancaster 013C","E01025095","Total",1461,857,604,1137,324,28,222.41,6.6
"2011","Lancaster 013D","E01025126","Total",1923,955,968,1905,18,43,116.09,16.6
"2011","Lancaster 014A","E01025093","Total",1705,820,885,1623,82,27,29.71,57.4
"2011","Lancaster 014B","E01025094","Total",1418,772,646,1197,221,20,14.33,99.0
"2011","Lancaster 014C","E01025099","Total",1497,794,703,1476,21,24,38.84,38.5
"2011","Lancaster 014E","E01033071","Total",1207,648,559,1113,94,7,35.73,33.8
"2011","Lancaster 014F","E01033073","Total",1719,857,862,1462,257,21,36.37,47.3
"2011","Lancaster 015A","E01025125","Total",1356,576,780,995,361,28,14.10,96.2
"2011","Lancaster 015B","E01025128","Total",1314,643,671,1313,1,4,17.50,75.1
"2011","Lancaster 015C","E01025129","Total",1244,596,648,1244,0,21,8.56,145.3
"2011","Lancaster 015D","E01025147","Total",1453,713,740,1432,21,14,25.31,57.4
"2011","Lancaster 016A","E01025114","Total",1507,726,781,1492,15,20,44.68,33.7
"2011","Lancaster 016B","E01025115","Total",1570,745,825,1570,0,6,36.08,43.5
"2011","Lancaster 016C","E01025121","Total",1725,837,888,1725,0,21,154.36,11.2
"2011","Lancaster 016D","E01025122","Total",1716,822,894,1711,5,13,84.29,20.4
"2011","Lancaster 016E","E01025123","Total",2313,1132,1181,2306,7,19,73.45,31.5
"2011","Lancaster 016F","E01025124","Total",1510,732,778,1510,0,15,35.78,42.2
"2011","Lancaster 016I","E01033072","Total",2414,1188,1226,2377,37,22,2362.50,1.0
"2011","Lancaster 017A","E01025100","Total",1542,762,780,1450,92,21,170.48,9.0
"2011","Lancaster 017B","E01025101","Total",1413,694,719,1413,0,16,20.24,69.8
"2011","Lancaster 017C","E01025102","Total",1461,661,800,1435,26,20,44.19,33.1
"2011","Lancaster 017D","E01025103","Total",1337,655,682,1337,0,43,124.92,10.7
"2011","Lancaster 017E","E01025144","Total",2045,844,1201,1665,380,57,48.87,41.8
"2011","Lancaster 017F","E01025146","Total",2041,994,1047,1988,53,64,422.14,4.8
"2011","Lancaster 018A","E01025127","Total",1376,667,709,1376,0,13,40.05,34.4
"2011","Lancaster 018B","E01025141","Total",1443,700,743,1443,0,26,38.79,37.2
"2011","Lancaster 018C","E01025143","Total",1448,675,773,1423,25,15,29.38,49.3
"2011","Lancaster 018D","E01025145","Total",1472,655,817,1472,0,20,15.95,92.3
"2011","Lancaster 019A","E01025105","Total",6137,2972,3165,1332,4805,120,9301.74,0.7
"2011","Lancaster 019B","E01025106","Total",2458,1170,1288,1704,754,32,134.44,18.3
"2011","Lancaster 019C","E01025107","Total",1643,837,806,1637,6,26,4447.36,0.4
"2011","Lancaster 019D","E01025142","Total",1452,694,758,1435,17,29,61.81,23.5
"2011","Lancaster 020A","E01025137","Total",1464,717,747,1446,18,14,29.23,50.1
"2011","Lancaster 020F","E01025153","Total",1245,623,622,1245,0,6,33.43,37.2
"2011","Lancaster 020G","E01025155","Total",1258,625,633,1258,0,17,41.66,30.2
"2011","Lancaster 020H","E01025156","Total",1175,550,625,1175,0,15,18.25,64.4
"2011","Lancaster 020I","E01025157","Total",1153,530,623,1153,0,6,70.34,16.4
"2011","Lancaster 020B","E01025162","Total",1348,625,723,1348,0,14,34.51,39.1
"2011","Lancaster 020C","E01025163","Total",1384,662,722,1384,0,22,54.73,25.3
"2011","Lancaster 020D","E01025164","Total",1400,651,749,1355,45,20,40.15,34.9
"2011","Lancaster 020E","E01025165","Total",1500,758,742,1500,0,26,43.44,34.5
"2011","Pendle 001A","E01025191","Total",1254,619,635,1254,0,9,108.79,11.5
"2011","Pendle 001B","E01025192","Total",1438,723,715,1394,44,18,46.60,30.9
"2011","Pendle 001C","E01025193","Total",1358,650,708,1358,0,18,242.30,5.6
"2011","Pendle 001D","E01025194","Total",1395,687,708,1395,0,11,14.73,94.7
"2011","Pendle 002A","E01025195","Total",1210,604,606,1210,0,14,149.49,8.1
"2011","Pendle 002B","E01025196","Total",1599,832,767,1577,22,12,23.82,67.1
"2011","Pendle 002C","E01025197","Total",1341,662,679,1341,0,11,1636.24,0.8
"2011","Pendle 002D","E01025198","Total",1401,670,731,1386,15,11,68.11,20.6
"2011","Pendle 003A","E01025199","Total",1678,828,850,1678,0,25,999.70,1.7
"2011","Pendle 003B","E01025200","Total",1524,747,777,1522,2,10,392.57,3.9
"2011","Pendle 003C","E01025201","Total",1599,782,817,1599,0,15,46.03,34.7
"2011","Pendle 003D","E01025202","Total",1382,682,700,1381,1,18,680.68,2.0
"2011","Pendle 004A","E01025205","Total",1381,677,704,1381,0,11,14.06,98.2
"2011","Pendle 004B","E01025206","Total",1173,555,618,1173,0,6,106.20,11.0
"2011","Pendle 004C","E01025207","Total",1265,627,638,1265,0,5,27.00,46.9
"2011","Pendle 004D","E01025208","Total",1270,604,666,1203,67,9,20.09,63.2
"2011","Pendle 005A","E01025220","Total",1594,750,844,1594,0,8,26.74,59.6
"2011","Pendle 005B","E01025221","Total",1351,655,696,1351,0,16,104.16,13.0
"2011","Pendle 005C","E01025222","Total",1468,709,759,1454,14,22,227.10,6.5
"2011","Pendle 005D","E01025223","Total",1414,691,723,1351,63,4,25.31,55.9
"2011","Pendle 006A","E01025178","Total",1815,877,938,1795,20,31,1800.39,1.0
"2011","Pendle 006B","E01025179","Total",1570,764,806,1570,0,17,152.30,10.3
"2011","Pendle 006C","E01025180","Total",1877,926,951,1876,1,18,2430.56,0.8
"2011","Pendle 006D","E01025203","Total",1683,850,833,1683,0,22,691.95,2.4
"2011","Pendle 007A","E01025226","Total",1579,814,765,1574,5,12,72.95,21.6
"2011","Pendle 007B","E01025227","Total",2011,995,1016,2002,9,17,61.17,32.9
"2011","Pendle 007C","E01025228","Total",1590,789,801,1577,13,10,243.75,6.5
"2011","Pendle 008A","E01025174","Total",1461,703,758,1439,22,24,155.65,9.4
"2011","Pendle 008B","E01025175","Total",1580,781,799,1539,41,19,180.08,8.8
"2011","Pendle 008C","E01025176","Total",2002,952,1050,2002,0,24,74.41,26.9
"2011","Pendle 008D","E01025177","Total",1800,879,921,1782,18,40,866.58,2.1
"2011","Pendle 008E","E01025204","Total",1642,800,842,1640,2,32,2836.05,0.6
"2011","Pendle 008F","E01025211","Total",1459,716,743,1459,0,21,400.16,3.6
"2011","Pendle 009A","E01025181","Total",1565,717,848,1565,0,6,46.29,33.8
"2011","Pendle 009B","E01025182","Total",1630,821,809,1627,3,11,68.94,23.6
"2011","Pendle 009C","E01025183","Total",1646,817,829,1626,20,12,28.87,57.0
"2011","Pendle 009D","E01025184","Total",1648,818,830,1648,0,18,17.58,93.7
"2011","Pendle 010A","E01025188","Total",2013,1001,1012,2013,0,9,23.11,87.1
"2011","Pendle 010B","E01025189","Total",1679,823,856,1679,0,15,30.92,54.3
"2011","Pendle 010C","E01025210","Total",1803,888,915,1796,7,12,49.99,36.1
"2011","Pendle 010D","E01025217","Total",1536,768,768,1508,28,11,13.53,113.5
"2011","Pendle 010E","E01025218","Total",1261,642,619,1249,12,8,12.17,103.6
"2011","Pendle 010F","E01025219","Total",1160,589,571,1160,0,8,11.38,101.9
"2011","Pendle 011A","E01025224","Total",2165,1071,1094,2165,0,23,24.50,88.4
"2011","Pendle 011B","E01025225","Total",1683,810,873,1683,0,16,44.51,37.8
"2011","Pendle 011C","E01025229","Total",2222,1108,1114,2222,0,32,50.63,43.9
"2011","Pendle 011D","E01025230","Total",1632,825,807,1632,0,19,32.91,49.6
"2011","Pendle 012A","E01025187","Total",1424,692,732,1424,0,19,48.03,29.6
"2011","Pendle 012B","E01025190","Total",1689,809,880,1661,28,20,80.29,21.0
"2011","Pendle 012C","E01025209","Total",1686,826,860,1686,0,21,391.65,4.3
"2011","Pendle 012D","E01025216","Total",2117,1017,1100,2036,81,15,295.09,7.2
"2011","Pendle 013A","E01025185","Total",1929,954,975,1886,43,14,89.06,21.7
"2011","Pendle 013B","E01025186","Total",1509,797,712,1509,0,6,47.82,31.6
"2011","Pendle 013C","E01025212","Total",1402,691,711,1402,0,22,42.99,32.6
"2011","Pendle 013D","E01025213","Total",1122,557,565,1122,0,21,418.54,2.7
"2011","Pendle 013E","E01025214","Total",1379,677,702,1361,18,28,122.30,11.3
"2011","Pendle 013F","E01025215","Total",1388,694,694,1381,7,13,19.55,71.0
"2011","Preston 001A","E01025278","Total",2543,1259,1284,2517,26,50,1301.43,2.0
"2011","Preston 001B","E01025279","Total",1945,948,997,1914,31,44,4344.85,0.4
"2011","Preston 001C","E01025282","Total",1398,674,724,1367,31,21,315.46,4.4
"2011","Preston 002A","E01025257","Total",1346,671,675,1346,0,46,134.97,10.0
"2011","Preston 002B","E01025277","Total",1722,840,882,1722,0,38,548.80,3.1
"2011","Preston 002C","E01025280","Total",1804,884,920,1785,19,34,1583.49,1.1
"2011","Preston 002D","E01025281","Total",1500,726,774,1500,0,41,1525.10,1.0
"2011","Preston 003A","E01025256","Total",1503,698,805,1503,0,31,37.34,40.3
"2011","Preston 003B","E01025258","Total",1490,718,772,1490,0,25,47.18,31.6
"2011","Preston 003C","E01025259","Total",2065,1002,1063,2065,0,33,69.08,29.9
"2011","Preston 003D","E01025299","Total",1441,699,742,1441,0,25,30.98,46.5
"2011","Preston 003E","E01025301","Total",1128,556,572,1128,0,17,17.74,63.6
"2011","Preston 003F","E01025302","Total",1238,602,636,1213,25,15,24.80,49.9
"2011","Preston 004A","E01025253","Total",1773,891,882,1773,0,44,98.73,18.0
"2011","Preston 004B","E01025254","Total",1216,593,623,1154,62,17,48.33,25.2
"2011","Preston 004C","E01025255","Total",1597,803,794,1595,2,29,107.99,14.8
"2011","Preston 004D","E01025300","Total",1133,538,595,1027,106,13,79.09,14.3
"2011","Preston 004E","E01025303","Total",1339,652,687,1339,0,15,99.16,13.5
"2011","Preston 005A","E01025260","Total",1490,723,767,1449,41,12,56.19,26.5
"2011","Preston 005B","E01025262","Total",1510,753,757,1510,0,18,31.97,47.2
"2011","Preston 005C","E01025263","Total",1500,692,808,1417,83,6,27.14,55.3
"2011","Preston 005D","E01025264","Total",1451,709,742,1451,0,22,37.15,39.1
"2011","Preston 006A","E01025239","Total",1393,659,734,1393,0,18,36.45,38.2
"2011","Preston 006B","E01025241","Total",1605,783,822,1585,20,35,38.88,41.3
"2011","Preston 006C","E01025242","Total",1612,774,838,1565,47,26,67.65,23.8
"2011","Preston 006D","E01025243","Total",1966,1016,950,1924,42,43,69.77,28.2
"2011","Preston 006E","E01025251","Total",1494,731,763,1494,0,20,64.15,23.3
"2011","Preston 007A","E01025234","Total",1461,720,741,1416,45,3,80.34,18.2
"2011","Preston 007B","E01025235","Total",1647,812,835,1647,0,5,38.17,43.1
"2011","Preston 007C","E01025237","Total",1488,716,772,1488,0,4,33.78,44.0
"2011","Preston 007D","E01025238","Total",1562,726,836,1556,6,12,22.30,70.0
"2011","Preston 007E","E01025245","Total",2663,1286,1377,2663,0,25,60.89,43.7
"2011","Preston 007F","E01025252","Total",1423,675,748,1339,84,9,39.16,36.3
"2011","Preston 008A","E01025233","Total",1406,688,718,1363,43,23,52.88,26.6
"2011","Preston 008B","E01025240","Total",1591,781,810,1545,46,25,28.80,55.2
"2011","Preston 008C","E01025261","Total",1418,679,739,1378,40,14,51.32,27.6
"2011","Preston 008D","E01025266","Total",1262,620,642,1262,0,12,25.66,49.2
"2011","Preston 008E","E01025309","Total",1160,586,574,1160,0,10,23.33,49.7
"2011","Preston 009A","E01025236","Total",1455,689,766,1450,5,9,26.23,55.5
"2011","Preston 009B","E01025283","Total",1685,825,860,1685,0,9,30.64,55.0
"2011","Preston 009C","E01025284","Total",1761,880,881,1709,52,9,61.49,28.6
"2011","Preston 009D","E01025285","Total",1428,726,702,1428,0,14,25.13,56.8
"2011","Preston 009E","E01025286","Total",1706,861,845,1706,0,18,442.12,3.9
"2011","Preston 009F","E01025287","Total",1968,997,971,1961,7,2,42.24,46.6
"2011","Preston 010A","E01025270","Total",1593,809,784,1592,1,22,384.90,4.1
"2011","Preston 010B","E01025272","Total",1585,799,786,1584,1,30,355.87,4.5
"2011","Preston 010C","E01025273","Total",1420,720,700,1420,0,34,43.38,32.7
"2011","Preston 010D","E01025288","Total",1599,862,737,1567,32,10,159.42,10.0
"2011","Preston 011A","E01025246","Total",1750,911,839,1750,0,0,20.54,85.2
"2011","Preston 011B","E01025274","Total",1907,1015,892,1857,50,16,13.90,137.2
"2011","Preston 011C","E01025275","Total",1609,768,841,1546,63,11,78.29,20.6
"2011","Preston 011D","E01025294","Total",1827,947,880,1809,18,9,14.67,124.5
"2011","Preston 012A","E01025276","Total",1695,862,833,1695,0,18,18.37,92.3
"2011","Preston 012B","E01025308","Total",1717,819,898,1717,0,15,16.46,104.3
"2011","Preston 012C","E01025310","Total",1516,752,764,1497,19,5,20.54,73.8
"2011","Preston 012D","E01025311","Total",1346,626,720,1346,0,10,16.39,82.1
"2011","Preston 012E","E01025312","Total",1641,852,789,1640,1,15,28.94,56.7
"2011","Preston 012F","E01025313","Total",1948,970,978,1242,706,39,29.74,65.5
"2011","Preston 012G","E01025314","Total",2670,1290,1380,1631,1039,31,66.46,40.2
"2011","Preston 013A","E01025231","Total",1448,680,768,1373,75,16,42.58,34.0
"2011","Preston 013B","E01025232","Total",1605,857,748,1602,3,13,18.21,88.1
"2011","Preston 013C","E01025265","Total",1490,739,751,1490,0,12,41.95,35.5
"2011","Preston 013D","E01025267","Total",1446,702,744,1446,0,8,39.36,36.7
"2011","Preston 013E","E01025268","Total",1664,841,823,1664,0,5,25.61,65.0
"2011","Preston 013F","E01025269","Total",1638,787,851,1638,0,6,53.76,30.5
"2011","Preston 013G","E01025271","Total",1559,754,805,1557,2,17,35.60,43.8
"2011","Preston 014A","E01025295","Total",2559,1644,915,1986,573,9,43.11,59.4
"2011","Preston 014B","E01025296","Total",1950,974,976,1950,0,8,32.26,60.4
"2011","Preston 014C","E01025297","Total",2057,1037,1020,2057,0,8,25.66,80.2
"2011","Preston 014D","E01025298","Total",1621,805,816,1621,0,13,19.28,84.1
"2011","Preston 015A","E01025244","Total",1690,879,811,1690,0,13,8.42,200.7
"2011","Preston 015B","E01025292","Total",3172,1603,1569,1371,1801,50,38.97,81.4
"2011","Preston 015C","E01025293","Total",2030,1055,975,2030,0,29,35.38,57.4
"2011","Preston 016A","E01025247","Total",1728,892,836,1728,0,6,44.04,39.2
"2011","Preston 016B","E01025248","Total",1328,623,705,1328,0,8,28.58,46.5
"2011","Preston 016C","E01025249","Total",1016,512,504,976,40,6,69.25,14.7
"2011","Preston 016D","E01025250","Total",1712,866,846,1712,0,2,148.15,11.6
"2011","Preston 016E","E01025304","Total",1845,922,923,1845,0,9,46.24,39.9
"2011","Preston 016F","E01025305","Total",1641,816,825,1641,0,10,18.57,88.4
"2011","Preston 017A","E01025289","Total",1680,883,797,1665,15,19,30.04,55.9
"2011","Preston 017B","E01025290","Total",1707,911,796,1675,32,12,26.59,64.2
"2011","Preston 017C","E01025291","Total",1365,694,671,1365,0,17,22.39,61.0
"2011","Preston 017D","E01025306","Total",1795,1041,754,1762,33,17,58.73,30.6
"2011","Preston 017F","E01033223","Total",1235,717,518,833,402,10,42.27,29.2
"2011","Preston 017G","E01033224","Total",1029,582,447,995,34,2,25.24,40.8
"2011","Preston 017H","E01033226","Total",1083,605,478,1076,7,6,12.94,83.7
"2011","Ribble Valley 001A","E01025315","Total",1737,905,832,1400,337,53,4882.67,0.4
"2011","Ribble Valley 001B","E01025320","Total",1325,661,664,1320,5,34,12438.05,0.1
"2011","Ribble Valley 001C","E01025331","Total",1405,713,692,1380,25,32,6547.96,0.2
"2011","Ribble Valley 001D","E01025348","Total",1517,740,777,1517,0,18,1513.55,1.0
"2011","Ribble Valley 001E","E01025349","Total",1416,693,723,1389,27,48,2862.16,0.5
"2011","Ribble Valley 002A","E01025334","Total",1559,747,812,1528,31,28,113.52,13.7
"2011","Ribble Valley 002B","E01025344","Total",1397,638,759,1367,30,25,74.28,18.8
"2011","Ribble Valley 002C","E01025345","Total",1449,731,718,1432,17,35,234.34,6.2
"2011","Ribble Valley 002D","E01025346","Total",1502,745,757,1502,0,17,164.74,9.1
"2011","Ribble Valley 002E","E01025347","Total",1633,813,820,1617,16,36,122.62,13.3
"2011","Ribble Valley 003A","E01025329","Total",1431,709,722,1426,5,14,86.98,16.5
"2011","Ribble Valley 003B","E01025330","Total",1342,647,695,1286,56,6,50.23,26.7
"2011","Ribble Valley 003C","E01025335","Total",1377,637,740,1373,4,17,27.61,49.9
"2011","Ribble Valley 003D","E01025338","Total",1592,812,780,1562,30,13,35.71,44.6
"2011","Ribble Valley 003E","E01025339","Total",1483,711,772,1483,0,19,53.99,27.5
"2011","Ribble Valley 004A","E01025322","Total",1356,682,674,1345,11,27,12143.66,0.1
"2011","Ribble Valley 004B","E01025326","Total",1477,691,786,1423,54,18,1352.05,1.1
"2011","Ribble Valley 004C","E01025327","Total",1320,630,690,1316,4,27,415.76,3.2
"2011","Ribble Valley 004D","E01025342","Total",1598,811,787,1590,8,35,927.26,1.7
"2011","Ribble Valley 005A","E01025321","Total",1316,628,688,1262,54,14,1643.23,0.8
"2011","Ribble Valley 005B","E01025340","Total",1402,677,725,1402,0,30,566.24,2.5
"2011","Ribble Valley 005C","E01025341","Total",1171,568,603,1171,0,28,496.43,2.4
"2011","Ribble Valley 005D","E01025343","Total",1422,703,719,1422,0,18,991.85,1.4
"2011","Ribble Valley 005E","E01025354","Total",1316,637,679,1316,0,31,2421.75,0.5
"2011","Ribble Valley 006A","E01025316","Total",1480,713,767,1480,0,38,664.50,2.2
"2011","Ribble Valley 006B","E01025317","Total",1163,567,596,1150,13,13,552.93,2.1
"2011","Ribble Valley 006C","E01025325","Total",1518,729,789,1518,0,12,31.54,48.1
"2011","Ribble Valley 006D","E01025328","Total",1231,577,654,1188,43,12,38.06,32.3
"2011","Ribble Valley 007A","E01025318","Total",1060,518,542,1060,0,15,85.64,12.4
"2011","Ribble Valley 007B","E01025319","Total",2094,1038,1056,2082,12,51,710.46,2.9
"2011","Ribble Valley 007C","E01025333","Total",1212,591,621,1212,0,20,640.58,1.9
"2011","Ribble Valley 007D","E01025350","Total",1289,615,674,1263,26,24,489.85,2.6
"2011","Ribble Valley 007E","E01025351","Total",2606,1325,1281,2424,182,58,1143.01,2.3
"2011","Ribble Valley 008A","E01025323","Total",1132,557,575,1132,0,28,1515.67,0.7
"2011","Ribble Valley 008B","E01025324","Total",1501,713,788,1383,118,28,349.41,4.3
"2011","Ribble Valley 008C","E01025332","Total",1049,524,525,1049,0,27,77.19,13.6
"2011","Ribble Valley 008D","E01025336","Total",1121,540,581,1121,0,31,815.91,1.4
"2011","Ribble Valley 008E","E01025337","Total",1551,752,799,1551,0,28,628.96,2.5
"2011","Ribble Valley 008F","E01025352","Total",1492,769,723,1432,60,38,174.62,8.5
"2011","Ribble Valley 008G","E01025353","Total",1090,516,574,1077,13,34,231.14,4.7
"2011","Rossendale 001A","E01025355","Total",2248,1097,1151,2209,39,47,288.55,7.8
"2011","Rossendale 001B","E01025361","Total",2062,980,1082,2035,27,30,182.47,11.3
"2011","Rossendale 001C","E01025362","Total",1971,978,993,1971,0,40,668.28,2.9
"2011","Rossendale 001D","E01025393","Total",1430,709,721,1417,13,21,1329.13,1.1
"2011","Rossendale 002A","E01025363","Total",1363,632,731,1265,98,18,44.59,30.6
"2011","Rossendale 002B","E01025364","Total",1310,648,662,1310,0,27,43.64,30.0
"2011","Rossendale 002C","E01025366","Total",1557,765,792,1557,0,22,31.54,49.4
"2011","Rossendale 002D","E01025395","Total",1565,777,788,1565,0,11,977.17,1.6
"2011","Rossendale 002E","E01025396","Total",1375,667,708,1375,0,6,57.25,24.0
"2011","Rossendale 002F","E01025397","Total",1688,855,833,1662,26,17,416.06,4.1
"2011","Rossendale 002G","E01025398","Total",1406,697,709,1406,0,11,19.81,71.0
"2011","Rossendale 003A","E01025367","Total",1776,888,888,1752,24,36,867.69,2.0
"2011","Rossendale 003B","E01025368","Total",1596,785,811,1562,34,7,85.93,18.6
"2011","Rossendale 003C","E01025369","Total",1230,584,646,1208,22,17,41.79,29.4
"2011","Rossendale 003D","E01025381","Total",1473,701,772,1473,0,7,210.65,7.0
"2011","Rossendale 003E","E01025382","Total",1722,862,860,1722,0,11,35.94,47.9
"2011","Rossendale 003F","E01025383","Total",2310,1166,1144,2309,1,21,204.19,11.3
"2011","Rossendale 004A","E01025356","Total",1508,752,756,1449,59,13,36.02,41.9
"2011","Rossendale 004C","E01025373","Total",1561,763,798,1561,0,38,161.07,9.7
"2011","Rossendale 004D","E01025385","Total",1250,591,659,1250,0,3,34.36,36.4
"2011","Rossendale 004F","E01025387","Total",1320,673,647,1320,0,28,125.79,10.5
"2011","Rossendale 004G","E01033281","Total",2612,1307,1305,2598,14,40,311.11,8.4
"2011","Rossendale 007A","E01025377","Total",1413,709,704,1413,0,31,650.08,2.2
"2011","Rossendale 007B","E01025378","Total",1500,756,744,1500,0,25,1176.66,1.3
"2011","Rossendale 007C","E01025379","Total",1406,628,778,1280,126,5,24.61,57.1
"2011","Rossendale 007D","E01025380","Total",1486,726,760,1486,0,29,36.62,40.6
"2011","Rossendale 008A","E01025357","Total",1320,640,680,1302,18,23,145.98,9.0
"2011","Rossendale 008B","E01025358","Total",2200,1059,1141,2181,19,56,1881.48,1.2
"2011","Rossendale 008C","E01025365","Total",1496,709,787,1488,8,21,136.24,11.0
"2011","Rossendale 008D","E01025384","Total",1247,600,647,1193,54,13,234.41,5.3
"2011","Rossendale 009A","E01025359","Total",1634,824,810,1627,7,24,977.62,1.7
"2011","Rossendale 009B","E01025360","Total",1952,968,984,1952,0,22,133.64,14.6
"2011","Rossendale 009C","E01025375","Total",1672,831,841,1660,12,28,260.00,6.4
"2011","Rossendale 009D","E01025376","Total",2242,1085,1157,2227,15,10,442.67,5.1
"2011","Rossendale 010F","E01025370","Total",1203,608,595,1173,30,13,116.70,10.3
"2011","Rossendale 010A","E01025371","Total",1400,677,723,1400,0,8,51.90,27.0
"2011","Rossendale 010B","E01025374","Total",1477,739,738,1418,59,15,69.51,21.2
"2011","Rossendale 010G","E01025388","Total",1465,737,728,1462,3,9,343.47,4.3
"2011","Rossendale 010H","E01025389","Total",1232,585,647,1232,0,11,230.82,5.3
"2011","Rossendale 010I","E01025390","Total",1092,517,575,1092,0,6,222.35,4.9
"2011","Rossendale 010C","E01025391","Total",1491,724,767,1491,0,7,69.89,21.3
"2011","Rossendale 010D","E01025392","Total",1203,617,586,1191,12,10,349.08,3.4
"2011","Rossendale 010E","E01025394","Total",1518,751,767,1518,0,14,78.06,19.4
"2011","South Ribble 001A","E01025424","Total",1261,606,655,1261,0,22,340.99,3.7
"2011","South Ribble 001B","E01025425","Total",1357,675,682,1312,45,27,56.33,24.1
"2011","South Ribble 001C","E01025426","Total",1245,610,635,1234,11,29,55.48,22.4
"2011","South Ribble 001D","E01025466","Total",1491,726,765,1491,0,27,28.00,53.2
"2011","South Ribble 002A","E01025413","Total",1801,862,939,1774,27,20,134.60,13.4
"2011","South Ribble 002B","E01025414","Total",1571,788,783,1571,0,24,156.27,10.1
"2011","South Ribble 002C","E01025456","Total",1206,585,621,1158,48,16,2009.95,0.6
"2011","South Ribble 002D","E01025458","Total",1476,725,751,1476,0,15,276.30,5.3
"2011","South Ribble 003A","E01025408","Total",1447,695,752,1447,0,26,108.66,13.3
"2011","South Ribble 003B","E01025409","Total",1322,643,679,1322,0,14,36.49,36.2
"2011","South Ribble 003C","E01025410","Total",1394,678,716,1394,0,42,49.62,28.1
"2011","South Ribble 003D","E01025467","Total",2013,953,1060,2009,4,28,51.50,39.1
"2011","South Ribble 004A","E01025403","Total",2021,1009,1012,2021,0,20,58.05,34.8
"2011","South Ribble 004B","E01025457","Total",1397,691,706,1393,4,14,174.72,8.0
"2011","South Ribble 004C","E01025463","Total",1377,668,709,1339,38,20,49.86,27.6
"2011","South Ribble 004D","E01025464","Total",1297,653,644,1297,0,27,149.85,8.7
"2011","South Ribble 004E","E01025465","Total",1118,554,564,1118,0,4,33.37,33.5
"2011","South Ribble 005A","E01025411","Total",2054,996,1058,2054,0,16,47.41,43.3
"2011","South Ribble 005B","E01025448","Total",1608,806,802,1608,0,6,62.77,25.6
"2011","South Ribble 005C","E01025449","Total",1002,493,509,1002,0,23,29.84,33.6
"2011","South Ribble 005D","E01025450","Total",1036,492,544,1030,6,13,56.37,18.4
"2011","South Ribble 006A","E01025412","Total",1478,729,749,1478,0,13,115.21,12.8
"2011","South Ribble 006B","E01025427","Total",1438,728,710,1438,0,15,32.15,44.7
"2011","South Ribble 006C","E01025428","Total",1554,730,824,1479,75,19,27.24,57.0
"2011","South Ribble 006D","E01025429","Total",1347,630,717,1347,0,4,26.27,51.3
"2011","South Ribble 007A","E01025404","Total",1209,599,610,1209,0,9,30.69,39.4
"2011","South Ribble 007B","E01025405","Total",1211,582,629,1142,69,5,50.21,24.1
"2011","South Ribble 007C","E01025406","Total",1223,596,627,1223,0,18,35.83,34.1
"2011","South Ribble 007D","E01025407","Total",1950,928,1022,1950,0,12,30.27,64.4
"2011","South Ribble 008A","E01025399","Total",1579,737,842,1579,0,14,26.60,59.4
"2011","South Ribble 008B","E01025400","Total",1845,865,980,1804,41,17,205.93,9.0
"2011","South Ribble 008C","E01025401","Total",1472,733,739,1472,0,7,134.46,10.9
"2011","South Ribble 008D","E01025402","Total",1435,710,725,1435,0,12,75.68,19.0
"2011","South Ribble 009A","E01025442","Total",1075,544,531,1075,0,5,31.64,34.0
"2011","South Ribble 009B","E01025443","Total",1371,661,710,1337,34,8,46.74,29.3
"2011","South Ribble 009C","E01025444","Total",1316,644,672,1316,0,6,24.21,54.4
"2011","South Ribble 009D","E01025461","Total",1941,973,968,1941,0,31,79.18,24.5
"2011","South Ribble 009E","E01025462","Total",1729,881,848,1702,27,6,69.76,24.8
"2011","South Ribble 010A","E01025439","Total",1388,647,741,1358,30,17,267.84,5.2
"2011","South Ribble 010B","E01025453","Total",1665,818,847,1630,35,33,304.06,5.5
"2011","South Ribble 010C","E01025454","Total",1279,645,634,1279,0,42,103.09,12.4
"2011","South Ribble 010D","E01025455","Total",1458,706,752,1458,0,17,384.82,3.8
"2011","South Ribble 011A","E01025436","Total",2277,1137,1140,2277,0,35,976.03,2.3
"2011","South Ribble 011B","E01025437","Total",1790,903,887,1790,0,26,298.06,6.0
"2011","South Ribble 011C","E01025438","Total",1319,651,668,1267,52,22,516.68,2.6
"2011","South Ribble 011D","E01025440","Total",1412,687,725,1412,0,17,852.67,1.7
"2011","South Ribble 011E","E01025441","Total",1408,664,744,1408,0,46,68.72,20.5
"2011","South Ribble 012A","E01025417","Total",1424,679,745,1413,11,10,289.50,4.9
"2011","South Ribble 012B","E01025418","Total",1399,675,724,1399,0,7,22.98,60.9
"2011","South Ribble 012C","E01025419","Total",1598,766,832,1576,22,9,149.25,10.7
"2011","South Ribble 012D","E01025420","Total",2756,1413,1343,2748,8,36,470.28,5.9
"2011","South Ribble 013A","E01025421","Total",2307,1153,1154,2304,3,16,58.68,39.3
"2011","South Ribble 013B","E01025422","Total",1340,634,706,1340,0,12,42.03,31.9
"2011","South Ribble 013C","E01025431","Total",1744,871,873,1738,6,17,34.07,51.2
"2011","South Ribble 013D","E01025433","Total",1820,893,927,1803,17,25,39.20,46.4
"2011","South Ribble 014A","E01025416","Total",1549,771,778,1511,38,20,107.34,14.4
"2011","South Ribble 014B","E01025451","Total",1976,975,1001,1970,6,32,102.16,19.3
"2011","South Ribble 014C","E01025452","Total",1703,854,849,1703,0,11,309.14,5.5
"2011","South Ribble 015A","E01025415","Total",2051,1023,1028,2051,0,12,43.49,47.2
"2011","South Ribble 015B","E01025423","Total",1353,646,707,1353,0,8,22.61,59.8
"2011","South Ribble 015C","E01025435","Total",1517,730,787,1469,48,17,111.67,13.6
"2011","South Ribble 015D","E01025446","Total",1517,724,793,1481,36,25,49.93,30.4
"2011","South Ribble 016A","E01025430","Total",1996,975,1021,1993,3,18,39.92,50.0
"2011","South Ribble 016C","E01025434","Total",1962,975,987,1962,0,41,85.03,23.1
"2011","South Ribble 016D","E01032928","Total",1929,952,977,1929,0,19,183.50,10.5
"2011","South Ribble 016E","E01032929","Total",1084,515,569,1084,0,3,30.91,35.1
"2011","South Ribble 017A","E01025445","Total",1443,700,743,1443,0,8,97.05,14.9
"2011","South Ribble 017B","E01025447","Total",1196,542,654,1186,10,9,15.45,77.4
"2011","South Ribble 017C","E01025459","Total",1678,838,840,1646,32,12,46.80,35.9
"2011","South Ribble 017D","E01025460","Total",2052,1004,1048,2006,46,17,164.11,12.5
"2011","West Lancashire 001A","E01025496","Total",1204,611,593,1204,0,8,334.81,3.6
"2011","West Lancashire 001B","E01025497","Total",1548,751,797,1548,0,31,1453.08,1.1
"2011","West Lancashire 001C","E01025498","Total",1289,622,667,1265,24,8,74.87,17.2
"2011","West Lancashire 001D","E01025530","Total",1437,729,708,1437,0,24,152.30,9.4
"2011","West Lancashire 001E","E01025532","Total",1534,785,749,1534,0,17,92.63,16.6
"2011","West Lancashire 001F","E01025533","Total",1571,766,805,1571,0,9,593.94,2.6
"2011","West Lancashire 002A","E01025507","Total",1525,759,766,1525,0,12,1059.17,1.4
"2011","West Lancashire 002B","E01025508","Total",1423,710,713,1394,29,15,1747.08,0.8
"2011","West Lancashire 002C","E01025509","Total",1198,574,624,1198,0,15,271.55,4.4
"2011","West Lancashire 002D","E01025513","Total",2049,1028,1021,2018,31,39,1262.85,1.6
"2011","West Lancashire 002E","E01025531","Total",1110,548,562,1110,0,16,1400.40,0.8
"2011","West Lancashire 003A","E01025474","Total",1126,555,571,1126,0,17,2999.98,0.4
"2011","West Lancashire 003B","E01025495","Total",2057,999,1058,2024,33,27,2801.35,0.7
"2011","West Lancashire 003C","E01025514","Total",2263,1132,1131,2263,0,21,2212.02,1.0
"2011","West Lancashire 003D","E01025515","Total",1602,813,789,1547,55,18,1777.45,0.9
"2011","West Lancashire 004A","E01025483","Total",2208,1077,1131,2180,28,17,45.67,48.3
"2011","West Lancashire 004B","E01025484","Total",1964,967,997,1936,28,27,313.05,6.3
"2011","West Lancashire 004C","E01025485","Total",1700,836,864,1700,0,27,351.22,4.8
"2011","West Lancashire 004D","E01025486","Total",1664,822,842,1664,0,16,79.33,21.0
"2011","West Lancashire 004E","E01025487","Total",1646,806,840,1593,53,14,426.39,3.9
"2011","West Lancashire 005A","E01025510","Total",1365,648,717,1292,73,27,1019.04,1.3
"2011","West Lancashire 005B","E01025511","Total",1147,546,601,1147,0,28,770.63,1.5
"2011","West Lancashire 005C","E01025512","Total",1272,607,665,1270,2,12,66.21,19.2
"2011","West Lancashire 005D","E01025538","Total",1531,744,787,1529,2,30,1071.22,1.4
"2011","West Lancashire 005E","E01025539","Total",1355,640,715,1323,32,19,236.27,5.7
"2011","West Lancashire 006A","E01025499","Total",1359,650,709,1359,0,21,117.92,11.5
"2011","West Lancashire 006B","E01025501","Total",1113,520,593,1113,0,6,71.56,15.6
"2011","West Lancashire 006C","E01025502","Total",1620,772,848,1611,9,20,44.66,36.3
"2011","West Lancashire 006D","E01025516","Total",1502,728,774,1502,0,23,28.52,52.7
"2011","West Lancashire 006E","E01025517","Total",1538,768,770,1511,27,23,196.09,7.8
"2011","West Lancashire 006F","E01025519","Total",1249,611,638,1187,62,15,125.39,10.0
"2011","West Lancashire 007A","E01025488","Total",1961,896,1065,1822,139,48,76.01,25.8
"2011","West Lancashire 007B","E01025489","Total",1337,639,698,1304,33,19,52.33,25.5
"2011","West Lancashire 007C","E01025490","Total",1804,784,1020,1276,528,40,102.39,17.6
"2011","West Lancashire 007D","E01025500","Total",1425,675,750,1425,0,19,55.52,25.7
"2011","West Lancashire 007E","E01025518","Total",1434,668,766,1434,0,14,34.60,41.4
"2011","West Lancashire 008A","E01025479","Total",1988,968,1020,1988,0,31,3725.12,0.5
"2011","West Lancashire 008B","E01025491","Total",1618,782,836,1341,277,36,701.69,2.3
"2011","West Lancashire 008C","E01025506","Total",1970,975,995,1965,5,45,2083.66,0.9
"2011","West Lancashire 009A","E01025468","Total",1714,840,874,1714,0,26,79.66,21.5
"2011","West Lancashire 009B","E01025469","Total",1567,758,809,1567,0,18,48.78,32.1
"2011","West Lancashire 009C","E01025470","Total",1502,750,752,1502,0,22,115.15,13.0
"2011","West Lancashire 009D","E01025522","Total",1144,563,581,1144,0,16,146.12,7.8
"2011","West Lancashire 010A","E01025471","Total",1527,738,789,1527,0,14,25.54,59.8
"2011","West Lancashire 010B","E01025480","Total",1443,657,786,1368,75,5,30.85,46.8
"2011","West Lancashire 010C","E01025481","Total",1451,714,737,1451,0,3,62.19,23.3
"2011","West Lancashire 010D","E01025482","Total",1456,710,746,1452,4,9,41.63,35.0
"2011","West Lancashire 010E","E01025520","Total",1230,608,622,1194,36,3,17.54,70.1
"2011","West Lancashire 010F","E01025521","Total",1687,818,869,1687,0,9,139.38,12.1
"2011","West Lancashire 011A","E01025523","Total",1653,808,845,1594,59,8,263.97,6.3
"2011","West Lancashire 011B","E01025524","Total",1484,746,738,1478,6,19,23.97,61.9
"2011","West Lancashire 011C","E01025525","Total",1625,793,832,1625,0,13,37.72,43.1
"2011","West Lancashire 011D","E01025526","Total",1696,813,883,1696,0,9,47.77,35.5
"2011","West Lancashire 012A","E01025472","Total",1424,696,728,1402,22,22,492.93,2.9
"2011","West Lancashire 012B","E01025473","Total",1454,689,765,1366,88,32,364.81,4.0
"2011","West Lancashire 012C","E01025475","Total",1467,729,738,1467,0,28,89.30,16.4
"2011","West Lancashire 012D","E01025476","Total",1318,617,701,1244,74,29,65.23,20.2
"2011","West Lancashire 012E","E01025477","Total",1214,582,632,1198,16,25,526.90,2.3
"2011","West Lancashire 012F","E01025478","Total",1191,585,606,1191,0,35,118.23,10.1
"2011","West Lancashire 013A","E01025492","Total",1286,619,667,1283,3,15,37.75,34.1
"2011","West Lancashire 013B","E01025527","Total",1390,682,708,1390,0,11,41.54,33.5
"2011","West Lancashire 013C","E01025528","Total",1767,915,852,1767,0,18,37.71,46.9
"2011","West Lancashire 013D","E01025529","Total",1823,916,907,1770,53,8,145.18,12.6
"2011","West Lancashire 014A","E01025493","Total",1635,799,836,1635,0,7,32.16,50.8
"2011","West Lancashire 014B","E01025494","Total",1546,765,781,1542,4,7,37.77,40.9
"2011","West Lancashire 014C","E01025503","Total",1369,651,718,1369,0,5,28.75,47.6
"2011","West Lancashire 014D","E01025504","Total",1115,512,603,1107,8,8,20.65,54.0
"2011","West Lancashire 014E","E01025505","Total",1425,696,729,1425,0,6,33.60,42.4
"2011","West Lancashire 015A","E01025534","Total",1750,845,905,1726,24,19,133.87,13.1
"2011","West Lancashire 015B","E01025535","Total",1417,709,708,1415,2,17,679.04,2.1
"2011","West Lancashire 015C","E01025536","Total",1524,712,812,1524,0,9,26.58,57.3
"2011","West Lancashire 015D","E01025537","Total",1484,733,751,1484,0,21,137.43,10.8
"2011","West Lancashire 015E","E01025540","Total",1201,561,640,1149,52,15,521.29,2.3
"2011","Wyre 001A","E01025573","Total",1389,686,703,1389,0,13,24.36,57.0
"2011","Wyre 001B","E01025574","Total",1533,712,821,1533,0,8,38.53,39.8
"2011","Wyre 001C","E01025581","Total",1391,686,705,1370,21,17,22.63,61.5
"2011","Wyre 001D","E01025582","Total",1255,648,607,1250,5,12,26.08,48.1
"2011","Wyre 001E","E01025583","Total",1289,647,642,1289,0,6,11.13,115.8
"2011","Wyre 001F","E01025584","Total",1483,808,675,1453,30,7,38.45,38.6
"2011","Wyre 002A","E01025605","Total",1432,676,756,1359,73,17,70.32,20.4
"2011","Wyre 002B","E01025606","Total",1258,598,660,1258,0,9,16.56,76.0
"2011","Wyre 002C","E01025607","Total",1573,776,797,1564,9,13,32.15,48.9
"2011","Wyre 002D","E01025608","Total",1643,782,861,1606,37,12,26.76,61.4
"2011","Wyre 003A","E01025590","Total",1576,748,828,1506,70,12,22.14,71.2
"2011","Wyre 003B","E01025591","Total",1552,751,801,1552,0,6,47.83,32.4
"2011","Wyre 003C","E01025592","Total",1494,700,794,1494,0,6,41.77,35.8
"2011","Wyre 003D","E01025593","Total",1759,883,876,1446,313,21,111.14,15.8
"2011","Wyre 004A","E01025563","Total",1134,549,585,1009,125,16,494.78,2.3
"2011","Wyre 004B","E01025564","Total",1610,779,831,1610,0,13,110.28,14.6
"2011","Wyre 004C","E01025565","Total",1486,733,753,1484,2,20,985.68,1.5
"2011","Wyre 004D","E01025586","Total",1568,765,803,1568,0,18,106.15,14.8
"2011","Wyre 004E","E01025587","Total",1510,732,778,1497,13,17,234.18,6.4
"2011","Wyre 004F","E01025588","Total",1372,644,728,1314,58,10,131.17,10.5
"2011","Wyre 004G","E01025589","Total",1241,618,623,1241,0,9,987.40,1.3
"2011","Wyre 005A","E01025557","Total",1551,734,817,1551,0,20,131.83,11.8
"2011","Wyre 005B","E01025575","Total",1089,504,585,1089,0,2,315.35,3.5
"2011","Wyre 005C","E01025578","Total",1533,731,802,1533,0,11,29.52,51.9
"2011","Wyre 005D","E01025579","Total",1394,672,722,1394,0,5,14.70,94.8
"2011","Wyre 005E","E01025580","Total",1296,648,648,1246,50,19,90.56,14.3
"2011","Wyre 006A","E01025547","Total",1934,1025,909,1613,321,58,2971.38,0.7
"2011","Wyre 006B","E01025549","Total",2148,1048,1100,2078,70,41,2006.49,1.1
"2011","Wyre 006C","E01025609","Total",2035,1010,1025,1979,56,43,5574.47,0.4
"2011","Wyre 007A","E01025548","Total",1522,739,783,1522,0,9,557.68,2.7
"2011","Wyre 007B","E01025553","Total",2594,1283,1311,2581,13,42,913.34,2.8
"2011","Wyre 007C","E01025558","Total",1707,802,905,1691,16,32,78.29,21.8
"2011","Wyre 007D","E01025559","Total",1834,885,949,1811,23,19,921.00,2.0
"2011","Wyre 007E","E01025560","Total",1311,620,691,1311,0,18,47.26,27.7
"2011","Wyre 008A","E01025554","Total",1514,720,794,1514,0,4,30.02,50.4
"2011","Wyre 008B","E01025556","Total",1516,716,800,1501,15,9,46.28,32.8
"2011","Wyre 008C","E01025570","Total",1262,626,636,1148,114,14,29.21,43.2
"2011","Wyre 008D","E01025571","Total",1413,725,688,1390,23,9,26.89,52.5
"2011","Wyre 008E","E01025572","Total",1350,652,698,1332,18,8,31.72,42.6
"2011","Wyre 008F","E01025604","Total",1504,721,783,1504,0,25,29.61,50.8
"2011","Wyre 009A","E01025561","Total",1471,727,744,1471,0,29,1454.12,1.0
"2011","Wyre 009B","E01025562","Total",2110,1014,1096,2098,12,29,3742.17,0.6
"2011","Wyre 009C","E01025585","Total",2293,1156,1137,2253,40,30,3544.87,0.6
"2011","Wyre 010A","E01025542","Total",1678,800,878,1648,30,21,37.38,44.9
"2011","Wyre 010B","E01025555","Total",1359,662,697,1359,0,16,34.32,39.6
"2011","Wyre 010C","E01025601","Total",1395,647,748,1395,0,26,47.42,29.4
"2011","Wyre 010D","E01025602","Total",1550,764,786,1550,0,25,61.15,25.3
"2011","Wyre 010E","E01025603","Total",1502,711,791,1502,0,18,42.28,35.5
"2011","Wyre 011A","E01025541","Total",1695,820,875,1684,11,12,127.63,13.3
"2011","Wyre 011B","E01025543","Total",1763,830,933,1751,12,25,127.97,13.8
"2011","Wyre 011C","E01025544","Total",1540,743,797,1540,0,9,29.88,51.5
"2011","Wyre 011D","E01025576","Total",2327,1097,1230,2306,21,30,95.67,24.3
"2011","Wyre 011E","E01025577","Total",1432,695,737,1432,0,8,22.04,65.0
"2011","Wyre 012A","E01025550","Total",1486,732,754,1486,0,21,63.06,23.6
"2011","Wyre 012B","E01025552","Total",1283,631,652,1283,0,24,99.07,13.0
"2011","Wyre 012C","E01025594","Total",1517,693,824,1496,21,19,49.48,30.7
"2011","Wyre 012D","E01025595","Total",1442,696,746,1442,0,27,139.81,10.3
"2011","Wyre 012E","E01025596","Total",2057,1020,1037,2057,0,30,190.20,10.8
"2011","Wyre 012F","E01025597","Total",1096,512,584,1096,0,15,22.03,49.8
"2011","Wyre 013A","E01025545","Total",1878,875,1003,1749,129,34,211.24,8.9
"2011","Wyre 013B","E01025546","Total",1485,684,801,1456,29,29,37.58,39.5
"2011","Wyre 013C","E01025551","Total",1292,627,665,1292,0,18,22.83,56.6
"2011","Wyre 013D","E01025567","Total",1520,704,816,1520,0,24,66.05,23.0
"2011","Wyre 013E","E01025598","Total",1452,711,741,1448,4,15,85.56,17.0
"2011","Wyre 014A","E01025566","Total",1986,966,1020,1986,0,59,193.98,10.2
"2011","Wyre 014B","E01025568","Total",1717,822,895,1717,0,19,76.52,22.4
"2011","Wyre 014C","E01025569","Total",1846,873,973,1846,0,19,101.40,18.2
"2011","Wyre 014D","E01025599","Total",991,484,507,988,3,21,61.98,16.0
"2011","Wyre 014E","E01025600","Total",1531,747,784,1531,0,23,42.65,35.9
"2011","Knowsley 001A","E01006448","Total",1677,714,963,1677,0,2,135.03,12.4
"2011","Knowsley 001B","E01006492","Total",1358,658,700,1358,0,1,19.81,68.6
"2011","Knowsley 001C","E01006493","Total",1115,479,636,1115,0,0,42.81,26.0
"2011","Knowsley 001D","E01006494","Total",1429,583,846,1423,6,3,47.75,29.9
"2011","Knowsley 001E","E01006495","Total",1872,893,979,1872,0,5,57.56,32.5
"2011","Knowsley 002A","E01006454","Total",1222,595,627,1222,0,7,24.68,49.5
"2011","Knowsley 002B","E01006456","Total",1595,814,781,1595,0,9,40.20,39.7
"2011","Knowsley 002C","E01006457","Total",1188,557,631,1188,0,3,44.02,27.0
"2011","Knowsley 002D","E01006458","Total",1413,654,759,1413,0,6,32.52,43.5
"2011","Knowsley 002E","E01006490","Total",2757,1296,1461,2757,0,10,36.76,75.0
"2011","Knowsley 002F","E01006491","Total",1970,967,1003,1970,0,11,36.41,54.1
"2011","Knowsley 003A","E01006415","Total",2101,1008,1093,2101,0,10,152.92,13.7
"2011","Knowsley 003B","E01006417","Total",1310,680,630,1310,0,5,26.81,48.9
"2011","Knowsley 003C","E01006436","Total",1466,703,763,1466,0,0,24.19,60.6
"2011","Knowsley 003D","E01006437","Total",1369,635,734,1369,0,5,54.77,25.0
"2011","Knowsley 003E","E01006447","Total",1357,654,703,1307,50,3,24.56,55.3
"2011","Knowsley 004A","E01006455","Total",1694,740,954,1655,39,6,41.60,40.7
"2011","Knowsley 004B","E01006506","Total",1351,672,679,1317,34,5,14.83,91.1
"2011","Knowsley 004C","E01006507","Total",1428,659,769,1428,0,0,22.44,63.6
"2011","Knowsley 004D","E01006508","Total",1394,668,726,1394,0,4,116.82,11.9
"2011","Knowsley 004E","E01006509","Total",1640,761,879,1640,0,11,50.05,32.8
"2011","Knowsley 004F","E01006510","Total",1199,578,621,1199,0,3,27.85,43.1
"2011","Knowsley 005A","E01006416","Total",1451,651,800,1451,0,5,146.03,9.9
"2011","Knowsley 005B","E01006418","Total",1357,637,720,1357,0,1,45.85,29.6
"2011","Knowsley 005C","E01006434","Total",1521,696,825,1521,0,3,30.72,49.5
"2011","Knowsley 005D","E01006435","Total",1556,730,826,1556,0,6,24.51,63.5
"2011","Knowsley 005E","E01006438","Total",1200,580,620,1200,0,20,208.32,5.8
"2011","Knowsley 005F","E01006439","Total",1613,798,815,1613,0,12,1316.50,1.2
"2011","Knowsley 005G","E01006446","Total",1364,629,735,1362,2,7,616.45,2.2
"2011","Knowsley 006A","E01006412","Total",1457,669,788,1457,0,3,25.76,56.6
"2011","Knowsley 006B","E01006413","Total",1419,729,690,1419,0,1,44.33,32.0
"2011","Knowsley 006C","E01006414","Total",1366,628,738,1366,0,6,27.36,49.9
"2011","Knowsley 006D","E01006441","Total",2402,1168,1234,2358,44,19,88.36,27.2
"2011","Knowsley 007A","E01006460","Total",1576,742,834,1576,0,8,26.42,59.7
"2011","Knowsley 007B","E01006461","Total",1590,763,827,1590,0,10,30.98,51.3
"2011","Knowsley 007C","E01006463","Total",1868,947,921,1824,44,17,49.11,38.0
"2011","Knowsley 007D","E01006464","Total",1617,807,810,1574,43,8,135.85,11.9
"2011","Knowsley 007E","E01006466","Total",1549,714,835,1549,0,13,31.74,48.8
"2011","Knowsley 008A","E01006453","Total",1223,557,666,1223,0,2,16.16,75.7
"2011","Knowsley 008B","E01006467","Total",1275,572,703,1275,0,5,29.09,43.8
"2011","Knowsley 008E","E01006470","Total",1375,655,720,1375,0,1,25.11,54.8
"2011","Knowsley 008F","E01033228","Total",1907,869,1038,1907,0,10,51.71,36.9
"2011","Knowsley 009A","E01006459","Total",1612,785,827,1592,20,16,29.18,55.2
"2011","Knowsley 009B","E01006462","Total",1514,736,778,1514,0,8,27.68,54.7
"2011","Knowsley 009C","E01006496","Total",1377,647,730,1375,2,5,40.19,34.3
"2011","Knowsley 009D","E01006498","Total",1574,782,792,1527,47,22,30.81,51.1
"2011","Knowsley 009E","E01006499","Total",1591,755,836,1591,0,14,45.08,35.3
"2011","Knowsley 010A","E01006440","Total",1454,676,778,1454,0,3,229.51,6.3
"2011","Knowsley 010B","E01006442","Total",1272,625,647,1272,0,4,26.79,47.5
"2011","Knowsley 010C","E01006443","Total",1395,660,735,1371,24,6,26.76,52.1
"2011","Knowsley 010D","E01006444","Total",1383,626,757,1318,65,5,23.10,59.9
"2011","Knowsley 010E","E01006445","Total",1329,602,727,1329,0,4,19.35,68.7
"2011","Knowsley 011A","E01006465","Total",1686,828,858,1686,0,20,109.41,15.4
"2011","Knowsley 011B","E01006482","Total",1530,688,842,1530,0,13,33.26,46.0
"2011","Knowsley 011C","E01006483","Total",1341,647,694,1341,0,7,19.20,69.8
"2011","Knowsley 011D","E01006484","Total",1376,649,727,1376,0,4,25.36,54.3
"2011","Knowsley 012A","E01006449","Total",1504,714,790,1464,40,6,28.73,52.3
"2011","Knowsley 012B","E01006450","Total",1422,656,766,1422,0,6,35.92,39.6
"2011","Knowsley 012C","E01006451","Total",1481,702,779,1476,5,5,24.40,60.7
"2011","Knowsley 012D","E01006452","Total",1528,720,808,1528,0,7,20.13,75.9
"2011","Knowsley 013A","E01006497","Total",1073,502,571,1073,0,8,56.63,18.9
"2011","Knowsley 013B","E01006500","Total",1109,523,586,1109,0,6,18.85,58.8
"2011","Knowsley 013C","E01006501","Total",1431,711,720,1431,0,6,65.48,21.9
"2011","Knowsley 013D","E01006504","Total",1376,678,698,1376,0,8,18.34,75.0
"2011","Knowsley 013E","E01006505","Total",1750,832,918,1750,0,2,40.06,43.7
"2011","Knowsley 014A","E01006472","Total",1565,753,812,1565,0,25,56.46,27.7
"2011","Knowsley 014B","E01006485","Total",1544,755,789,1544,0,4,34.19,45.2
"2011","Knowsley 014C","E01006486","Total",1172,569,603,1172,0,13,15.63,75.0
"2011","Knowsley 014D","E01006487","Total",1529,719,810,1529,0,5,19.97,76.6
"2011","Knowsley 014E","E01006488","Total",1753,825,928,1715,38,14,40.40,43.4
"2011","Knowsley 014F","E01006489","Total",1434,691,743,1434,0,10,17.15,83.6
"2011","Knowsley 015A","E01006477","Total",1386,651,735,1372,14,4,46.53,29.8
"2011","Knowsley 015B","E01006478","Total",1361,632,729,1345,16,6,77.04,17.7
"2011","Knowsley 015C","E01006479","Total",1395,651,744,1395,0,8,23.80,58.6
"2011","Knowsley 015D","E01006480","Total",1369,635,734,1369,0,8,23.68,57.8
"2011","Knowsley 015E","E01006481","Total",1346,630,716,1329,17,3,64.61,20.8
"2011","Knowsley 016A","E01006471","Total",1487,683,804,1487,0,14,80.13,18.6
"2011","Knowsley 016B","E01006473","Total",1248,585,663,1248,0,13,150.96,8.3
"2011","Knowsley 016C","E01006474","Total",1483,680,803,1446,37,14,44.14,33.6
"2011","Knowsley 016D","E01006475","Total",1526,721,805,1380,146,12,35.68,42.8
"2011","Knowsley 016E","E01006476","Total",1428,708,720,1428,0,15,28.25,50.5
"2011","Knowsley 017A","E01006420","Total",2066,997,1069,2066,0,22,1083.69,1.9
"2011","Knowsley 017B","E01006424","Total",2070,1009,1061,2066,4,22,359.84,5.8
"2011","Knowsley 017C","E01006502","Total",1739,856,883,1739,0,5,227.52,7.6
"2011","Knowsley 017D","E01006503","Total",1243,613,630,1243,0,14,466.10,2.7
"2011","Knowsley 018A","E01006421","Total",1210,589,621,1210,0,10,21.83,55.4
"2011","Knowsley 018B","E01006425","Total",1362,661,701,1362,0,13,171.54,7.9
"2011","Knowsley 018C","E01006430","Total",1332,607,725,1213,119,3,27.51,48.4
"2011","Knowsley 018D","E01006433","Total",1439,686,753,1398,41,6,34.13,42.2
"2011","Knowsley 019A","E01006419","Total",1492,729,763,1492,0,5,45.29,32.9
"2011","Knowsley 019B","E01006422","Total",1269,624,645,1269,0,14,27.47,46.2
"2011","Knowsley 019C","E01006423","Total",1426,725,701,1426,0,7,23.74,60.1
"2011","Knowsley 019D","E01006427","Total",1450,689,761,1450,0,7,34.07,42.6
"2011","Knowsley 020A","E01006426","Total",1230,592,638,1230,0,3,33.63,36.6
"2011","Knowsley 020B","E01006428","Total",1511,748,763,1511,0,7,96.51,15.7
"2011","Knowsley 020C","E01006429","Total",1131,515,616,1127,4,2,115.16,9.8
"2011","Knowsley 020D","E01006431","Total",1672,811,861,1670,2,13,50.79,32.9
"2011","Knowsley 020E","E01006432","Total",1526,737,789,1526,0,9,30.52,50.0
"2011","Liverpool 001A","E01006651","Total",1642,800,842,1642,0,10,29.93,54.9
"2011","Liverpool 001B","E01006653","Total",1520,733,787,1520,0,3,42.68,35.6
"2011","Liverpool 001C","E01006655","Total",1758,836,922,1733,25,7,38.81,45.3
"2011","Liverpool 001D","E01006658","Total",1300,604,696,1300,0,4,17.19,75.6
"2011","Liverpool 001E","E01006660","Total",1433,682,751,1433,0,4,98.06,14.6
"2011","Liverpool 002A","E01006652","Total",1505,752,753,1505,0,2,23.81,63.2
"2011","Liverpool 002B","E01006656","Total",1493,734,759,1493,0,7,25.69,58.1
"2011","Liverpool 002C","E01006657","Total",1211,576,635,1211,0,4,13.12,92.3
"2011","Liverpool 002D","E01006780","Total",1465,705,760,1465,0,8,18.03,81.3
"2011","Liverpool 002E","E01006783","Total",1548,759,789,1548,0,6,25.11,61.6
"2011","Liverpool 003A","E01006781","Total",1470,708,762,1469,1,13,17.00,86.5
"2011","Liverpool 003B","E01006782","Total",1560,777,783,1541,19,5,14.56,107.1
"2011","Liverpool 003C","E01006784","Total",1347,685,662,1344,3,7,11.38,118.4
"2011","Liverpool 003D","E01006785","Total",1769,875,894,1769,0,8,50.25,35.2
"2011","Liverpool 003E","E01006786","Total",1820,937,883,1820,0,9,30.81,59.1
"2011","Liverpool 004A","E01006661","Total",1663,751,912,1663,0,6,33.10,50.2
"2011","Liverpool 004B","E01006662","Total",1775,780,995,1633,142,3,89.27,19.9
"2011","Liverpool 004C","E01006663","Total",1153,561,592,1153,0,1,112.79,10.2
"2011","Liverpool 004D","E01006664","Total",1795,847,948,1795,0,7,31.57,56.9
"2011","Liverpool 004E","E01006669","Total",1470,722,748,1470,0,5,22.49,65.4
"2011","Liverpool 005A","E01006654","Total",1513,713,800,1455,58,10,63.68,23.8
"2011","Liverpool 005B","E01006659","Total",1765,1241,524,1070,695,6,161.04,11.0
"2011","Liverpool 005C","E01006734","Total",1412,667,745,1412,0,4,17.00,83.1
"2011","Liverpool 005D","E01006735","Total",1309,612,697,1309,0,4,18.01,72.7
"2011","Liverpool 005E","E01006736","Total",1460,683,777,1460,0,7,26.52,55.1
"2011","Liverpool 005F","E01006737","Total",1435,664,771,1435,0,7,18.07,79.4
"2011","Liverpool 006A","E01006787","Total",2330,1673,657,1534,796,1,35.25,66.1
"2011","Liverpool 006B","E01006788","Total",1825,902,923,1825,0,7,16.87,108.2
"2011","Liverpool 006C","E01006790","Total",1587,747,840,1587,0,1,24.12,65.8
"2011","Liverpool 006D","E01006791","Total",1674,884,790,1674,0,1,29.91,56.0
"2011","Liverpool 007A","E01006665","Total",1555,768,787,1555,0,13,70.47,22.1
"2011","Liverpool 007B","E01006666","Total",1504,723,781,1504,0,19,23.46,64.1
"2011","Liverpool 007C","E01006667","Total",1453,700,753,1413,40,7,53.83,27.0
"2011","Liverpool 007D","E01006668","Total",1534,726,808,1534,0,10,23.38,65.6
"2011","Liverpool 007E","E01006670","Total",1526,728,798,1520,6,11,65.00,23.5
"2011","Liverpool 008A","E01006607","Total",1531,718,813,1529,2,5,20.22,75.7
"2011","Liverpool 008B","E01006612","Total",1495,728,767,1495,0,2,28.57,52.3
"2011","Liverpool 008C","E01006729","Total",1400,641,759,1400,0,2,17.01,82.3
"2011","Liverpool 008F","E01032510","Total",1809,879,930,1809,0,5,36.04,50.2
"2011","Liverpool 008G","E01032511","Total",1378,676,702,1378,0,4,64.85,21.2
"2011","Liverpool 009A","E01006608","Total",1215,604,611,1213,2,4,29.87,40.7
"2011","Liverpool 009B","E01006609","Total",1283,609,674,1283,0,4,12.99,98.8
"2011","Liverpool 009C","E01006610","Total",1397,647,750,1395,2,3,17.72,78.8
"2011","Liverpool 009D","E01006613","Total",1360,655,705,1360,0,6,60.43,22.5
"2011","Liverpool 009E","E01006705","Total",1409,724,685,1409,0,5,13.40,105.1
"2011","Liverpool 010A","E01006598","Total",1361,617,744,1361,0,7,21.62,63.0
"2011","Liverpool 010B","E01006599","Total",1121,489,632,1121,0,1,20.12,55.7
"2011","Liverpool 010E","E01006672","Total",1955,911,1044,1955,0,16,36.59,53.4
"2011","Liverpool 010F","E01033759","Total",1147,532,615,1147,0,5,49.09,23.4
"2011","Liverpool 011A","E01006600","Total",1407,638,769,1407,0,12,24.51,57.4
"2011","Liverpool 011B","E01006603","Total",1410,671,739,1386,24,3,27.01,52.2
"2011","Liverpool 011C","E01006730","Total",1326,618,708,1323,3,6,22.95,57.8
"2011","Liverpool 011D","E01006731","Total",1196,554,642,1196,0,0,17.26,69.3
"2011","Liverpool 011E","E01006732","Total",1643,676,967,1643,0,3,18.39,89.3
"2011","Liverpool 012A","E01006611","Total",1291,646,645,1291,0,4,8.61,149.9
"2011","Liverpool 012B","E01006614","Total",1322,635,687,1322,0,1,7.94,166.5
"2011","Liverpool 012C","E01006615","Total",1302,611,691,1302,0,6,15.02,86.7
"2011","Liverpool 012D","E01006698","Total",1716,826,890,1716,0,7,13.51,127.0
"2011","Liverpool 012E","E01006700","Total",1438,705,733,1410,28,8,14.63,98.3
"2011","Liverpool 013A","E01006623","Total",1462,724,738,1462,0,19,47.10,31.0
"2011","Liverpool 013B","E01006624","Total",1556,756,800,1551,5,10,40.82,38.1
"2011","Liverpool 013C","E01006627","Total",1378,654,724,1378,0,9,111.73,12.3
"2011","Liverpool 013D","E01006671","Total",1355,634,721,1349,6,17,90.51,15.0
"2011","Liverpool 014A","E01006699","Total",1594,817,777,1581,13,1,19.64,81.2
"2011","Liverpool 014B","E01006701","Total",1380,693,687,1380,0,6,25.01,55.2
"2011","Liverpool 014C","E01006702","Total",1618,783,835,1596,22,15,19.55,82.8
"2011","Liverpool 014D","E01006703","Total",1561,835,726,1527,34,5,25.73,60.7
"2011","Liverpool 014E","E01006778","Total",2205,1094,1111,2205,0,12,150.32,14.7
"2011","Liverpool 015A","E01006541","Total",1593,786,807,1593,0,8,68.19,23.4
"2011","Liverpool 015B","E01006543","Total",1247,598,649,1247,0,3,14.88,83.8
"2011","Liverpool 015C","E01006544","Total",1658,742,916,1658,0,6,14.94,111.0
"2011","Liverpool 015D","E01006616","Total",1428,696,732,1428,0,5,26.79,53.3
"2011","Liverpool 015E","E01006762","Total",1692,789,903,1692,0,9,26.63,63.5
"2011","Liverpool 016A","E01006604","Total",1367,642,725,1367,0,10,31.42,43.5
"2011","Liverpool 016B","E01006605","Total",1531,740,791,1531,0,5,28.25,54.2
"2011","Liverpool 016C","E01006618","Total",1639,765,874,1639,0,6,28.44,57.6
"2011","Liverpool 016D","E01006625","Total",1416,675,741,1416,0,12,21.95,64.5
"2011","Liverpool 016E","E01006626","Total",1448,676,772,1448,0,3,25.43,56.9
"2011","Liverpool 017A","E01006637","Total",1596,701,895,1596,0,4,23.12,69.0
"2011","Liverpool 017B","E01006638","Total",1219,532,687,1219,0,2,22.09,55.2
"2011","Liverpool 017C","E01006639","Total",1509,687,822,1509,0,5,40.59,37.2
"2011","Liverpool 017D","E01006644","Total",2040,987,1053,2040,0,10,38.14,53.5
"2011","Liverpool 017E","E01006645","Total",1424,671,753,1424,0,4,31.86,44.7
"2011","Liverpool 018A","E01006542","Total",1397,698,699,1297,100,4,54.06,25.8
"2011","Liverpool 018B","E01006558","Total",1357,670,687,1357,0,5,10.60,128.0
"2011","Liverpool 018E","E01006562","Total",1514,709,805,1514,0,8,13.29,113.9
"2011","Liverpool 018F","E01033747","Total",1043,484,559,1035,8,0,25.23,41.3
"2011","Liverpool 019A","E01006545","Total",1512,708,804,1512,0,6,9.37,161.4
"2011","Liverpool 019B","E01006546","Total",1319,666,653,1319,0,2,11.08,119.0
"2011","Liverpool 019C","E01006547","Total",1490,769,721,1490,0,4,15.31,97.3
"2011","Liverpool 019D","E01006548","Total",1675,825,850,1580,95,7,13.25,126.4
"2011","Liverpool 019E","E01006766","Total",1266,614,652,1265,1,9,12.81,98.8
"2011","Liverpool 019F","E01006767","Total",1787,898,889,1784,3,4,25.85,69.1
"2011","Liverpool 020A","E01006606","Total",1521,729,792,1521,0,7,45.21,33.6
"2011","Liverpool 020B","E01006761","Total",1644,864,780,1583,61,5,36.69,44.8
"2011","Liverpool 020C","E01006763","Total",1471,737,734,1471,0,2,12.00,122.6
"2011","Liverpool 020D","E01006764","Total",1522,771,751,1522,0,3,14.85,102.5
"2011","Liverpool 020E","E01006765","Total",1468,693,775,1468,0,3,15.76,93.1
"2011","Liverpool 020F","E01006768","Total",1359,741,618,1347,12,14,27.82,48.8
"2011","Liverpool 021A","E01006617","Total",1421,667,754,1421,0,3,37.40,38.0
"2011","Liverpool 021B","E01006619","Total",1599,753,846,1599,0,13,38.34,41.7
"2011","Liverpool 021C","E01006620","Total",1417,670,747,1409,8,14,23.03,61.5
"2011","Liverpool 021D","E01006621","Total",1468,717,751,1468,0,24,65.01,22.6
"2011","Liverpool 021E","E01006622","Total",1519,751,768,1519,0,20,21.60,70.3
"2011","Liverpool 021F","E01006640","Total",1880,886,994,1880,0,22,61.71,30.5
"2011","Liverpool 022B","E01006776","Total",1677,813,864,1646,31,2,218.27,7.7
"2011","Liverpool 022D","E01006779","Total",1968,893,1075,1934,34,5,41.44,47.5
"2011","Liverpool 022E","E01033764","Total",2202,1130,1072,2191,11,5,82.69,26.6
"2011","Liverpool 023A","E01006560","Total",1860,965,895,1860,0,10,38.81,47.9
"2011","Liverpool 023B","E01006564","Total",1721,837,884,1721,0,5,30.35,56.7
"2011","Liverpool 023C","E01006646","Total",1899,993,906,1881,18,2,69.03,27.5
"2011","Liverpool 023D","E01006648","Total",2175,1148,1027,2175,0,5,66.46,32.7
"2011","Liverpool 024A","E01006540","Total",1509,776,733,1485,24,0,17.25,87.5
"2011","Liverpool 024B","E01006563","Total",1744,857,887,1740,4,3,28.52,61.2
"2011","Liverpool 024C","E01006647","Total",1422,652,770,1422,0,7,34.42,41.3
"2011","Liverpool 024D","E01006693","Total",1511,783,728,1508,3,4,30.89,48.9
"2011","Liverpool 025A","E01006572","Total",1207,528,679,1207,0,6,13.82,87.3
"2011","Liverpool 025B","E01006574","Total",1388,661,727,1388,0,5,20.06,69.2
"2011","Liverpool 025C","E01006641","Total",1740,816,924,1640,100,1,18.53,93.9
"2011","Liverpool 025D","E01006642","Total",1290,572,718,1290,0,5,18.60,69.4
"2011","Liverpool 025E","E01006643","Total",1822,831,991,1822,0,6,21.92,83.1
"2011","Liverpool 026A","E01006567","Total",1655,862,793,1622,33,16,59.09,28.0
"2011","Liverpool 026B","E01006568","Total",1617,745,872,1491,126,5,32.94,49.1
"2011","Liverpool 026C","E01006570","Total",1479,722,757,1463,16,15,43.92,33.7
"2011","Liverpool 026D","E01006571","Total",1470,689,781,1438,32,5,40.33,36.4
"2011","Liverpool 027A","E01006711","Total",1538,761,777,1500,38,11,62.76,24.5
"2011","Liverpool 027D","E01006717","Total",1436,719,717,1436,0,10,15.64,91.8
"2011","Liverpool 027E","E01006718","Total",1587,796,791,1584,3,13,15.27,103.9
"2011","Liverpool 027F","E01006719","Total",1535,744,791,1535,0,8,17.71,86.7
"2011","Liverpool 027G","E01032508","Total",1723,837,886,1723,0,12,31.68,54.4
"2011","Liverpool 027H","E01032509","Total",1434,671,763,1432,2,6,20.38,70.4
"2011","Liverpool 028A","E01006690","Total",1492,782,710,1457,35,14,79.90,18.7
"2011","Liverpool 028B","E01006692","Total",2180,1102,1078,2180,0,15,53.50,40.7
"2011","Liverpool 028C","E01006695","Total",1821,1045,776,1814,7,11,16.14,112.8
"2011","Liverpool 028D","E01006759","Total",1095,571,524,1052,43,11,59.94,18.3
"2011","Liverpool 028E","E01006760","Total",1611,999,612,1548,63,3,22.97,70.1
"2011","Liverpool 029A","E01006565","Total",1549,705,844,1549,0,7,21.57,71.8
"2011","Liverpool 029B","E01006569","Total",1429,672,757,1372,57,11,34.90,40.9
"2011","Liverpool 029C","E01006573","Total",1501,715,786,1501,0,15,14.33,104.7
"2011","Liverpool 029D","E01006712","Total",1339,615,724,1303,36,5,11.84,113.1
"2011","Liverpool 029E","E01006713","Total",1377,645,732,1375,2,4,9.95,138.4
"2011","Liverpool 030A","E01006691","Total",1503,787,716,1488,15,12,18.92,79.4
"2011","Liverpool 030B","E01006694","Total",1864,949,915,1864,0,6,13.15,141.7
"2011","Liverpool 030C","E01006696","Total",1744,856,888,1744,0,9,20.77,84.0
"2011","Liverpool 030D","E01006697","Total",1845,958,887,1843,2,3,12.79,144.3
"2011","Liverpool 030E","E01006746","Total",1513,735,778,1506,7,7,21.79,69.4
"2011","Liverpool 031A","E01006512","Total",1880,1070,810,1420,460,21,28.41,66.2
"2011","Liverpool 031B","E01006747","Total",3552,1636,1916,1655,1897,72,50.21,70.7
"2011","Liverpool 031C","E01006748","Total",1936,1034,902,1936,0,11,16.17,119.7
"2011","Liverpool 031F","E01006751","Total",2572,1229,1343,2043,529,28,47.69,53.9
"2011","Liverpool 031G","E01033763","Total",1527,823,704,1471,56,9,31.98,47.7
"2011","Liverpool 032A","E01006566","Total",1506,730,776,1431,75,9,18.38,81.9
"2011","Liverpool 032B","E01006585","Total",1354,654,700,1354,0,3,23.58,57.4
"2011","Liverpool 032C","E01006586","Total",1899,935,964,1875,24,15,36.75,51.7
"2011","Liverpool 032D","E01006587","Total",1624,828,796,1619,5,10,28.52,56.9
"2011","Liverpool 032E","E01006716","Total",1589,773,816,1454,135,2,27.78,57.2
"2011","Liverpool 034A","E01006575","Total",1294,607,687,1289,5,10,25.64,50.5
"2011","Liverpool 034B","E01006576","Total",1693,803,890,1691,2,15,33.04,51.2
"2011","Liverpool 034C","E01006577","Total",1503,727,776,1503,0,16,37.73,39.8
"2011","Liverpool 034D","E01006579","Total",1643,796,847,1643,0,13,27.28,60.2
"2011","Liverpool 034E","E01006584","Total",1393,689,704,1393,0,10,29.37,47.4
"2011","Liverpool 035A","E01006720","Total",2108,1074,1034,2108,0,12,53.47,39.4
"2011","Liverpool 035B","E01006725","Total",1537,786,751,1537,0,9,26.66,57.7
"2011","Liverpool 035C","E01006726","Total",1565,758,807,1565,0,6,9.07,172.5
"2011","Liverpool 035D","E01006727","Total",1441,749,692,1438,3,11,9.65,149.3
"2011","Liverpool 035E","E01006728","Total",1623,785,838,1620,3,3,10.91,148.8
"2011","Liverpool 035F","E01006752","Total",1012,545,467,1012,0,1,19.91,50.8
"2011","Liverpool 036A","E01006578","Total",1380,657,723,1380,0,5,21.62,63.8
"2011","Liverpool 036B","E01006580","Total",1335,650,685,1331,4,24,37.80,35.3
"2011","Liverpool 036C","E01006581","Total",1559,738,821,1559,0,30,23.56,66.2
"2011","Liverpool 036D","E01006773","Total",1379,694,685,1378,1,9,23.47,58.8
"2011","Liverpool 036E","E01006774","Total",1445,699,746,1445,0,10,24.54,58.9
"2011","Liverpool 037A","E01006514","Total",2108,1177,931,1758,350,29,26.23,80.4
"2011","Liverpool 037B","E01006515","Total",1208,595,613,1208,0,10,36.51,33.1
"2011","Liverpool 037D","E01006673","Total",1937,1009,928,1925,12,8,29.13,66.5
"2011","Liverpool 037E","E01033757","Total",1025,593,432,1015,10,15,7.48,137.0
"2011","Liverpool 037F","E01033768","Total",1223,744,479,1219,4,1,10.57,115.7
"2011","Liverpool 038A","E01006550","Total",1595,776,819,1595,0,13,10.34,154.3
"2011","Liverpool 038B","E01006557","Total",2054,1024,1030,2051,3,16,17.59,116.8
"2011","Liverpool 038C","E01006721","Total",1655,805,850,1655,0,11,19.41,85.3
"2011","Liverpool 038D","E01006722","Total",1793,937,856,1793,0,28,10.30,174.1
"2011","Liverpool 038E","E01006723","Total",1875,966,909,1862,13,10,12.40,151.2
"2011","Liverpool 038F","E01006724","Total",1790,910,880,1783,7,23,28.09,63.7
"2011","Liverpool 039A","E01006552","Total",2029,1101,928,2027,2,8,15.67,129.5
"2011","Liverpool 039B","E01006556","Total",2011,1087,924,2010,1,19,23.33,86.2
"2011","Liverpool 039C","E01006674","Total",1885,953,932,1885,0,11,20.66,91.2
"2011","Liverpool 039D","E01006679","Total",2232,1104,1128,2184,48,13,34.73,64.3
"2011","Liverpool 040A","E01006709","Total",1438,739,699,1438,0,5,24.13,59.6
"2011","Liverpool 040B","E01006769","Total",1270,630,640,1270,0,5,30.85,41.2
"2011","Liverpool 040C","E01006770","Total",1002,459,543,1002,0,2,22.88,43.8
"2011","Liverpool 040D","E01006771","Total",1425,630,795,1425,0,3,49.88,28.6
"2011","Liverpool 040E","E01006772","Total",1091,520,571,1081,10,9,30.40,35.9
"2011","Liverpool 040F","E01006775","Total",1319,593,726,1302,17,4,25.86,51.0
"2011","Liverpool 041A","E01006582","Total",1642,799,843,1630,12,28,48.26,34.0
"2011","Liverpool 041B","E01006589","Total",1518,728,790,1512,6,20,28.42,53.4
"2011","Liverpool 041C","E01006591","Total",1633,806,827,1633,0,27,18.63,87.7
"2011","Liverpool 041D","E01006592","Total",1565,721,844,1541,24,50,37.63,41.6
"2011","Liverpool 041E","E01006597","Total",1667,772,895,1639,28,34,29.57,56.4
"2011","Liverpool 042A","E01006553","Total",1880,919,961,1880,0,17,16.74,112.3
"2011","Liverpool 042C","E01006588","Total",1569,769,800,1521,48,12,36.27,43.3
"2011","Liverpool 042D","E01006590","Total",1642,858,784,1637,5,15,26.67,61.6
"2011","Liverpool 042E","E01006593","Total",1541,758,783,1541,0,16,18.17,84.8
"2011","Liverpool 042F","E01033749","Total",1153,609,544,1151,2,11,20.27,56.9
"2011","Liverpool 042G","E01033766","Total",1075,558,517,1072,3,6,6.29,170.9
"2011","Liverpool 043A","E01006520","Total",1706,937,769,1685,21,0,26.16,65.2
"2011","Liverpool 043B","E01006549","Total",1662,998,664,1559,103,6,22.69,73.2
"2011","Liverpool 043C","E01006675","Total",1824,1054,770,1682,142,8,48.76,37.4
"2011","Liverpool 043D","E01006677","Total",1040,451,589,993,47,3,12.90,80.6
"2011","Liverpool 044A","E01006518","Total",1696,843,853,1630,66,8,23.39,72.5
"2011","Liverpool 044B","E01006630","Total",1338,609,729,1338,0,0,32.98,40.6
"2011","Liverpool 044C","E01006632","Total",1842,928,914,1842,0,11,20.31,90.7
"2011","Liverpool 044D","E01006676","Total",1753,861,892,1753,0,6,14.88,117.8
"2011","Liverpool 044E","E01006678","Total",2127,1122,1005,2126,1,8,33.43,63.6
"2011","Liverpool 045A","E01006706","Total",1346,623,723,1346,0,2,59.00,22.8
"2011","Liverpool 045B","E01006707","Total",1323,598,725,1294,29,2,62.87,21.0
"2011","Liverpool 045C","E01006708","Total",1805,837,968,1757,48,10,118.61,15.2
"2011","Liverpool 045D","E01006710","Total",1496,683,813,1490,6,8,22.82,65.6
"2011","Liverpool 046A","E01006792","Total",1368,668,700,1364,4,29,56.81,24.1
"2011","Liverpool 046B","E01006794","Total",1593,764,829,1590,3,16,45.54,35.0
"2011","Liverpool 046C","E01006800","Total",1401,707,694,1401,0,10,39.40,35.6
"2011","Liverpool 046D","E01006801","Total",1355,639,716,1344,11,12,32.45,41.8
"2011","Liverpool 047A","E01006532","Total",1557,783,774,1554,3,31,93.74,16.6
"2011","Liverpool 047B","E01006539","Total",1437,711,726,1403,34,39,85.53,16.8
"2011","Liverpool 047C","E01006583","Total",1758,742,1016,1255,503,53,74.43,23.6
"2011","Liverpool 047D","E01006594","Total",1410,667,743,1405,5,31,29.77,47.4
"2011","Liverpool 047E","E01006796","Total",1591,789,802,1586,5,46,62.27,25.6
"2011","Liverpool 048A","E01006522","Total",1731,995,736,1670,61,2,47.05,36.8
"2011","Liverpool 048B","E01006524","Total",2431,1121,1310,1079,1352,41,47.01,51.7
"2011","Liverpool 048C","E01006526","Total",1404,677,727,1301,103,8,49.63,28.3
"2011","Liverpool 048D","E01006529","Total",1304,640,664,1304,0,15,10.02,130.1
"2011","Liverpool 048E","E01006551","Total",1581,794,787,1134,447,15,56.10,28.2
"2011","Liverpool 048F","E01006554","Total",1692,871,821,1670,22,27,14.99,112.9
"2011","Liverpool 049A","E01006525","Total",1209,601,608,1209,0,21,42.07,28.7
"2011","Liverpool 049B","E01006595","Total",1745,805,940,1745,0,17,19.41,89.9
"2011","Liverpool 049C","E01006596","Total",1451,706,745,1451,0,27,24.22,59.9
"2011","Liverpool 049D","E01006689","Total",1651,793,858,1651,0,22,42.74,38.6
"2011","Liverpool 050B","E01006633","Total",1432,696,736,1432,0,2,21.19,67.6
"2011","Liverpool 050F","E01032505","Total",1317,623,694,1315,2,9,48.05,27.4
"2011","Liverpool 050G","E01032506","Total",1403,736,667,1344,59,2,14.74,95.2
"2011","Liverpool 050H","E01032507","Total",1539,735,804,1539,0,5,9.24,166.6
"2011","Liverpool 050I","E01033748","Total",1277,705,572,1276,1,4,48.36,26.4
"2011","Liverpool 050J","E01033767","Total",1067,511,556,1067,0,4,7.58,140.8
"2011","Liverpool 051A","E01006793","Total",1494,726,768,1494,0,14,28.37,52.7
"2011","Liverpool 051B","E01006795","Total",1407,687,720,1407,0,22,33.51,42.0
"2011","Liverpool 051C","E01006797","Total",1499,730,769,1499,0,8,22.13,67.7
"2011","Liverpool 051D","E01006798","Total",1410,685,725,1410,0,18,28.03,50.3
"2011","Liverpool 051E","E01006799","Total",1821,880,941,1796,25,9,25.88,70.4
"2011","Liverpool 052A","E01006521","Total",1660,836,824,1619,41,6,60.60,27.4
"2011","Liverpool 052B","E01006523","Total",1508,751,757,1473,35,7,16.37,92.1
"2011","Liverpool 052C","E01006528","Total",1461,755,706,1434,27,19,70.35,20.8
"2011","Liverpool 052D","E01006628","Total",1874,871,1003,1518,356,30,55.94,33.5
"2011","Liverpool 052E","E01006629","Total",1255,595,660,1242,13,9,25.36,49.5
"2011","Liverpool 053A","E01006527","Total",1454,683,771,1373,81,14,33.35,43.6
"2011","Liverpool 053B","E01006680","Total",1569,784,785,1569,0,14,44.54,35.2
"2011","Liverpool 053C","E01006682","Total",1310,643,667,1310,0,25,21.61,60.6
"2011","Liverpool 053D","E01006683","Total",1510,718,792,1507,3,23,25.91,58.3
"2011","Liverpool 053E","E01006686","Total",1433,696,737,1429,4,18,19.14,74.9
"2011","Liverpool 054A","E01006534","Total",1542,753,789,1542,0,17,32.14,48.0
"2011","Liverpool 054B","E01006535","Total",1639,766,873,1550,89,16,181.63,9.0
"2011","Liverpool 054C","E01006536","Total",1848,874,974,1848,0,7,66.50,27.8
"2011","Liverpool 054D","E01006681","Total",1585,789,796,1585,0,18,35.16,45.1
"2011","Liverpool 055A","E01006530","Total",1431,674,757,1428,3,15,23.54,60.8
"2011","Liverpool 055B","E01006531","Total",1458,686,772,1455,3,15,43.21,33.7
"2011","Liverpool 055C","E01006533","Total",1408,680,728,1355,53,18,92.15,15.3
"2011","Liverpool 055D","E01006537","Total",2257,1093,1164,2257,0,18,107.56,21.0
"2011","Liverpool 055E","E01006538","Total",1318,639,679,1318,0,11,42.34,31.1
"2011","Liverpool 056A","E01006519","Total",1286,628,658,1286,0,34,50.79,25.3
"2011","Liverpool 056B","E01006684","Total",2138,1048,1090,2113,25,28,62.84,34.0
"2011","Liverpool 056C","E01006685","Total",1484,689,795,1426,58,18,29.11,51.0
"2011","Liverpool 056D","E01006687","Total",1952,1031,921,1896,56,41,85.59,22.8
"2011","Liverpool 056E","E01006688","Total",1524,744,780,1520,4,14,25.09,60.7
"2011","Liverpool 057A","E01006740","Total",1280,679,601,1280,0,7,91.93,13.9
"2011","Liverpool 057B","E01006742","Total",1394,693,701,1394,0,8,31.83,43.8
"2011","Liverpool 057C","E01006744","Total",1482,720,762,1482,0,11,14.40,102.9
"2011","Liverpool 057D","E01006745","Total",1879,958,921,1854,25,6,38.70,48.6
"2011","Liverpool 058A","E01006738","Total",1501,669,832,1501,0,3,15.87,94.6
"2011","Liverpool 058B","E01006739","Total",1769,840,929,1738,31,4,543.01,3.3
"2011","Liverpool 058C","E01006741","Total",1815,877,938,1815,0,3,157.09,11.6
"2011","Liverpool 058D","E01006743","Total",2175,1066,1109,2175,0,4,173.65,12.5
"2011","Liverpool 059A","E01006753","Total",1557,716,841,1557,0,2,29.38,53.0
"2011","Liverpool 059B","E01006754","Total",1627,778,849,1627,0,6,47.04,34.6
"2011","Liverpool 059C","E01006755","Total",1587,721,866,1552,35,10,51.05,31.1
"2011","Liverpool 059D","E01006756","Total",1820,835,985,1820,0,4,33.09,55.0
"2011","Liverpool 059E","E01006757","Total",1491,695,796,1491,0,3,28.55,52.2
"2011","Liverpool 059F","E01006758","Total",1527,701,826,1527,0,6,24.29,62.9
"2011","Liverpool 060A","E01006513","Total",2941,1461,1480,1691,1250,56,55.92,52.6
"2011","Liverpool 060B","E01033758","Total",1730,883,847,703,1027,47,25.42,68.1
"2011","Liverpool 060C","E01033760","Total",2115,1042,1073,856,1259,40,37.18,56.9
"2011","Liverpool 060D","E01033761","Total",1372,843,529,1340,32,5,12.49,109.8
"2011","Liverpool 060E","E01033762","Total",1791,943,848,722,1069,47,16.72,107.1
"2011","Liverpool 061A","E01033750","Total",1448,895,553,1448,0,3,49.36,29.3
"2011","Liverpool 061B","E01033754","Total",1452,784,668,1448,4,8,32.33,44.9
"2011","Liverpool 061C","E01033756","Total",1185,737,448,1136,49,13,46.64,25.4
"2011","Liverpool 061D","E01033765","Total",1351,656,695,1351,0,9,34.34,39.3
"2011","Liverpool 062A","E01033751","Total",1873,1044,829,1039,834,43,59.75,31.3
"2011","Liverpool 062B","E01033752","Total",1196,740,456,1195,1,3,38.54,31.0
"2011","Liverpool 062C","E01033753","Total",1051,690,361,1051,0,2,23.09,45.5
"2011","Liverpool 062D","E01033755","Total",1082,643,439,1082,0,5,9.01,120.1
"2011","Sefton 001A","E01006946","Total",1397,649,748,1397,0,18,101.99,13.7
"2011","Sefton 001B","E01007028","Total",1355,660,695,1355,0,7,30.52,44.4
"2011","Sefton 001C","E01007029","Total",1248,548,700,1248,0,11,39.86,31.3
"2011","Sefton 001D","E01007030","Total",1539,716,823,1539,0,10,38.00,40.5
"2011","Sefton 001E","E01007036","Total",1212,579,633,1212,0,7,339.60,3.6
"2011","Sefton 002A","E01006947","Total",1427,680,747,1427,0,21,35.21,40.5
"2011","Sefton 002B","E01007031","Total",1446,675,771,1446,0,20,93.71,15.4
"2011","Sefton 002C","E01007032","Total",1324,611,713,1324,0,13,41.18,32.2
"2011","Sefton 002D","E01007033","Total",1491,693,798,1491,0,18,28.83,51.7
"2011","Sefton 002E","E01007035","Total",1454,672,782,1383,71,23,127.30,11.4
"2011","Sefton 003A","E01006944","Total",1672,734,938,1456,216,5,37.67,44.4
"2011","Sefton 003B","E01006948","Total",1315,585,730,1277,38,16,43.17,30.5
"2011","Sefton 003C","E01006949","Total",1456,675,781,1427,29,22,50.70,28.7
"2011","Sefton 003D","E01006951","Total",1489,686,803,1404,85,24,48.05,31.0
"2011","Sefton 003E","E01007034","Total",1356,616,740,1315,41,23,29.72,45.6
"2011","Sefton 004A","E01006945","Total",1605,756,849,1456,149,14,29.09,55.2
"2011","Sefton 004B","E01006950","Total",1516,748,768,1340,176,5,460.41,3.3
"2011","Sefton 004C","E01006968","Total",1772,867,905,1668,104,9,75.07,23.6
"2011","Sefton 004D","E01006969","Total",1467,748,719,1409,58,7,31.61,46.4
"2011","Sefton 004F","E01033094","Total",988,502,486,927,61,2,11.23,88.0
"2011","Sefton 004G","E01033097","Total",1050,527,523,1038,12,8,16.59,63.3
"2011","Sefton 005A","E01007055","Total",1484,725,759,1484,0,8,33.84,43.9
"2011","Sefton 005B","E01007056","Total",1616,791,825,1616,0,13,27.63,58.5
"2011","Sefton 005C","E01007057","Total",1528,726,802,1528,0,13,60.51,25.3
"2011","Sefton 005D","E01007062","Total",1434,707,727,1434,0,30,26.50,54.1
"2011","Sefton 005E","E01007063","Total",1580,750,830,1580,0,15,23.79,66.4
"2011","Sefton 006A","E01007058","Total",1437,744,693,1425,12,17,27.77,51.7
"2011","Sefton 006B","E01007059","Total",1516,736,780,1516,0,15,28.01,54.1
"2011","Sefton 006C","E01007060","Total",1475,721,754,1389,86,16,93.92,15.7
"2011","Sefton 006D","E01007061","Total",1494,750,744,1494,0,21,22.11,67.6
"2011","Sefton 006E","E01007064","Total",1288,628,660,1227,61,33,29.44,43.8
"2011","Sefton 007A","E01006934","Total",1529,741,788,1529,0,20,30.75,49.7
"2011","Sefton 007B","E01006970","Total",1630,802,828,1589,41,15,28.69,56.8
"2011","Sefton 007C","E01006994","Total",1620,790,830,1593,27,18,29.52,54.9
"2011","Sefton 007D","E01006996","Total",1615,830,785,1514,101,23,32.18,50.2
"2011","Sefton 007E","E01006998","Total",1664,808,856,1659,5,11,24.53,67.8
"2011","Sefton 008A","E01006995","Total",1334,646,688,1297,37,22,32.58,40.9
"2011","Sefton 008B","E01006997","Total",1511,729,782,1511,0,14,48.09,31.4
"2011","Sefton 008C","E01006999","Total",1621,773,848,1602,19,17,76.82,21.1
"2011","Sefton 008D","E01007000","Total",1290,617,673,1286,4,15,29.93,43.1
"2011","Sefton 008E","E01007001","Total",1618,768,850,1588,30,12,66.42,24.4
"2011","Sefton 008F","E01007002","Total",1330,639,691,1330,0,12,86.57,15.4
"2011","Sefton 009A","E01006928","Total",1466,722,744,1466,0,32,39.74,36.9
"2011","Sefton 009B","E01006935","Total",1694,823,871,1679,15,31,33.00,51.3
"2011","Sefton 009C","E01006971","Total",1597,766,831,1488,109,25,329.51,4.8
"2011","Sefton 009D","E01006972","Total",1625,693,932,1542,83,18,39.91,40.7
"2011","Sefton 009E","E01006973","Total",1616,720,896,1388,228,33,95.12,17.0
"2011","Sefton 009F","E01006974","Total",1588,739,849,1542,46,47,322.43,4.9
"2011","Sefton 010A","E01006929","Total",1552,756,796,1550,2,24,34.19,45.4
"2011","Sefton 010B","E01006930","Total",1460,699,761,1460,0,16,25.88,56.4
"2011","Sefton 010C","E01006931","Total",1533,700,833,1530,3,15,32.19,47.6
"2011","Sefton 010D","E01006932","Total",1505,727,778,1502,3,44,47.43,31.7
"2011","Sefton 010E","E01006933","Total",1450,706,744,1445,5,17,33.08,43.8
"2011","Sefton 011A","E01006920","Total",1624,761,863,1620,4,17,40.74,39.9
"2011","Sefton 011B","E01006924","Total",1458,669,789,1453,5,15,36.78,39.6
"2011","Sefton 011C","E01006925","Total",1532,729,803,1508,24,17,62.18,24.6
"2011","Sefton 011D","E01006927","Total",1677,812,865,1677,0,22,82.73,20.3
"2011","Sefton 012A","E01006921","Total",1305,611,694,1305,0,19,39.50,33.0
"2011","Sefton 012B","E01006922","Total",1419,695,724,1417,2,21,391.24,3.6
"2011","Sefton 012C","E01006923","Total",1472,692,780,1472,0,12,83.92,17.5
"2011","Sefton 012D","E01006926","Total",1615,789,826,1615,0,44,83.24,19.4
"2011","Sefton 013A","E01006985","Total",1457,690,767,1455,2,40,120.45,12.1
"2011","Sefton 013B","E01006986","Total",1281,614,667,1202,79,20,250.59,5.1
"2011","Sefton 013C","E01006987","Total",1253,608,645,1251,2,31,772.86,1.6
"2011","Sefton 013D","E01006989","Total",1337,641,696,1294,43,38,152.47,8.8
"2011","Sefton 013E","E01006990","Total",1236,604,632,1236,0,38,35.55,34.8
"2011","Sefton 014A","E01006988","Total",1372,614,758,1341,31,16,83.67,16.4
"2011","Sefton 014B","E01007079","Total",1586,774,812,1573,13,40,62.90,25.2
"2011","Sefton 014C","E01007080","Total",1438,669,769,1414,24,28,32.35,44.5
"2011","Sefton 014D","E01007081","Total",1491,700,791,1491,0,31,52.76,28.3
"2011","Sefton 015A","E01006991","Total",1496,736,760,1496,0,32,79.39,18.8
"2011","Sefton 015B","E01006992","Total",1125,529,596,1063,62,28,33.18,33.9
"2011","Sefton 015C","E01006993","Total",1498,720,778,1498,0,24,337.68,4.4
"2011","Sefton 015D","E01007078","Total",1545,751,794,1537,8,24,41.16,37.5
"2011","Sefton 016A","E01007075","Total",1370,623,747,1370,0,14,77.90,17.6
"2011","Sefton 016B","E01007076","Total",1414,677,737,1381,33,22,1191.05,1.2
"2011","Sefton 016C","E01007077","Total",1512,730,782,1512,0,16,29.97,50.5
"2011","Sefton 016D","E01007082","Total",1434,700,734,1434,0,26,33.02,43.4
"2011","Sefton 017A","E01007067","Total",1393,661,732,1367,26,19,472.63,2.9
"2011","Sefton 017B","E01007068","Total",1272,613,659,1272,0,14,57.39,22.2
"2011","Sefton 017C","E01007069","Total",1445,661,784,1442,3,13,33.33,43.4
"2011","Sefton 017D","E01007070","Total",1471,732,739,1471,0,15,90.53,16.2
"2011","Sefton 017E","E01007101","Total",1440,700,740,1440,0,25,24.65,58.4
"2011","Sefton 018C","E01007095","Total",1583,754,829,1583,0,8,37.06,42.7
"2011","Sefton 018D","E01007096","Total",1332,619,713,1332,0,14,18.86,70.6
"2011","Sefton 018E","E01007100","Total",1391,664,727,1391,0,13,79.60,17.5
"2011","Sefton 018F","E01033096","Total",2531,1269,1262,2405,126,29,107.59,23.5
"2011","Sefton 019A","E01007074","Total",1506,704,802,1500,6,16,35.32,42.6
"2011","Sefton 019B","E01007097","Total",1529,742,787,1529,0,11,33.19,46.1
"2011","Sefton 019C","E01007098","Total",1418,695,723,1418,0,15,181.69,7.8
"2011","Sefton 019D","E01007099","Total",1511,674,837,1415,96,15,97.88,15.4
"2011","Sefton 020A","E01007065","Total",1338,664,674,1338,0,16,22.07,60.6
"2011","Sefton 020B","E01007066","Total",1560,751,809,1560,0,11,26.07,59.8
"2011","Sefton 020C","E01007071","Total",1256,607,649,1254,2,7,101.01,12.4
"2011","Sefton 020D","E01007072","Total",1440,676,764,1417,23,8,42.38,34.0
"2011","Sefton 020E","E01007073","Total",1336,645,691,1333,3,15,47.56,28.1
"2011","Sefton 021A","E01007020","Total",1419,682,737,1419,0,22,25.43,55.8
"2011","Sefton 021B","E01007022","Total",1420,715,705,1420,0,17,453.82,3.1
"2011","Sefton 021C","E01007023","Total",1345,623,722,1311,34,15,63.41,21.2
"2011","Sefton 021D","E01007027","Total",2063,1016,1047,2063,0,47,287.85,7.2
"2011","Sefton 021E","E01007037","Total",1506,707,799,1506,0,17,139.46,10.8
"2011","Sefton 021F","E01007038","Total",1488,715,773,1488,0,17,711.40,2.1
"2011","Sefton 022A","E01006936","Total",1502,702,800,1479,23,28,111.54,13.5
"2011","Sefton 022B","E01006937","Total",1306,633,673,1306,0,33,28.83,45.3
"2011","Sefton 022C","E01006938","Total",1237,594,643,1199,38,31,198.00,6.2
"2011","Sefton 022D","E01006939","Total",1479,682,797,1479,0,23,22.36,66.1
"2011","Sefton 022E","E01006940","Total",1434,671,763,1372,62,45,42.05,34.1
"2011","Sefton 022F","E01006943","Total",1229,578,651,1229,0,38,28.61,43.0
"2011","Sefton 023A","E01007083","Total",1187,555,632,1187,0,8,22.28,53.3
"2011","Sefton 023B","E01007085","Total",1353,613,740,1353,0,11,21.83,62.0
"2011","Sefton 023C","E01007086","Total",1274,577,697,1121,153,5,24.97,51.0
"2011","Sefton 023D","E01007091","Total",1285,585,700,1285,0,4,32.22,39.9
"2011","Sefton 023E","E01007092","Total",1106,511,595,1079,27,6,23.99,46.1
"2011","Sefton 024A","E01006979","Total",1453,694,759,1453,0,6,80.93,18.0
"2011","Sefton 024B","E01006980","Total",1473,711,762,1473,0,16,21.86,67.4
"2011","Sefton 024C","E01007024","Total",1174,520,654,1076,98,6,19.12,61.4
"2011","Sefton 024D","E01007026","Total",1145,526,619,1145,0,12,21.43,53.4
"2011","Sefton 024E","E01007089","Total",1378,632,746,1329,49,10,22.09,62.4
"2011","Sefton 025A","E01007021","Total",1304,629,675,1304,0,26,23.26,56.1
"2011","Sefton 025B","E01007025","Total",1339,654,685,1339,0,27,28.11,47.6
"2011","Sefton 025C","E01007105","Total",1628,763,865,1628,0,22,34.52,47.2
"2011","Sefton 025D","E01007106","Total",1477,697,780,1477,0,16,23.29,63.4
"2011","Sefton 025E","E01007107","Total",1357,632,725,1302,55,21,20.40,66.5
"2011","Sefton 025F","E01007108","Total",1571,770,801,1571,0,20,25.40,61.9
"2011","Sefton 026A","E01007039","Total",1268,621,647,1268,0,7,37.73,33.6
"2011","Sefton 026B","E01007040","Total",2225,1247,978,1882,343,13,817.62,2.7
"2011","Sefton 026C","E01007042","Total",1275,604,671,1275,0,15,59.94,21.3
"2011","Sefton 026D","E01007044","Total",1367,643,724,1367,0,7,27.26,50.1
"2011","Sefton 026E","E01007045","Total",1236,602,634,1236,0,7,73.68,16.8
"2011","Sefton 027A","E01007041","Total",1403,668,735,1403,0,7,164.50,8.5
"2011","Sefton 027B","E01007043","Total",1408,682,726,1408,0,8,32.06,43.9
"2011","Sefton 027C","E01007046","Total",1593,775,818,1593,0,6,45.70,34.9
"2011","Sefton 027D","E01007053","Total",1408,671,737,1408,0,8,48.82,28.8
"2011","Sefton 027E","E01007084","Total",1385,673,712,1385,0,14,33.27,41.6
"2011","Sefton 028A","E01006941","Total",1632,746,886,1607,25,31,29.09,56.1
"2011","Sefton 028B","E01006942","Total",1461,713,748,1461,0,7,22.72,64.3
"2011","Sefton 028C","E01006954","Total",1501,730,771,1473,28,21,69.71,21.5
"2011","Sefton 028D","E01007104","Total",1396,671,725,1377,19,24,22.54,61.9
"2011","Sefton 028E","E01007109","Total",1531,690,841,1531,0,17,18.04,84.9
"2011","Sefton 029A","E01007048","Total",1620,762,858,1620,0,10,65.41,24.8
"2011","Sefton 029B","E01007054","Total",1396,681,715,1396,0,10,77.75,18.0
"2011","Sefton 029C","E01007087","Total",1319,616,703,1316,3,8,40.62,32.5
"2011","Sefton 029D","E01007088","Total",1293,606,687,1293,0,12,40.82,31.7
"2011","Sefton 029E","E01007090","Total",1143,535,608,1143,0,3,27.06,42.2
"2011","Sefton 030A","E01006955","Total",1650,804,846,1650,0,13,20.04,82.3
"2011","Sefton 030B","E01006956","Total",1568,792,776,1552,16,11,24.85,63.1
"2011","Sefton 030C","E01006958","Total",1460,749,711,1460,0,10,19.16,76.2
"2011","Sefton 030D","E01007102","Total",1513,739,774,1513,0,18,20.12,75.2
"2011","Sefton 030E","E01007103","Total",1477,713,764,1477,0,24,23.46,63.0
"2011","Sefton 031A","E01006978","Total",1397,667,730,1397,0,14,27.84,50.2
"2011","Sefton 031B","E01006981","Total",1486,701,785,1486,0,6,53.61,27.7
"2011","Sefton 031C","E01006982","Total",1382,634,748,1382,0,11,25.90,53.4
"2011","Sefton 031D","E01006983","Total",1651,786,865,1651,0,9,23.85,69.2
"2011","Sefton 031E","E01006984","Total",1351,625,726,1351,0,2,14.74,91.7
"2011","Sefton 032A","E01006952","Total",1370,690,680,1339,31,16,21.34,64.2
"2011","Sefton 032B","E01006953","Total",1438,707,731,1414,24,7,35.12,40.9
"2011","Sefton 032C","E01006957","Total",1529,813,716,1454,75,9,118.86,12.9
"2011","Sefton 032D","E01006959","Total",1552,745,807,1483,69,13,30.79,50.4
"2011","Sefton 032E","E01006977","Total",1639,789,850,1637,2,4,102.31,16.0
"2011","Sefton 033A","E01006976","Total",1454,711,743,1454,0,8,23.12,62.9
"2011","Sefton 033B","E01007014","Total",1588,770,818,1588,0,8,23.79,66.8
"2011","Sefton 033E","E01007047","Total",1439,700,739,1439,0,6,56.53,25.5
"2011","Sefton 033F","E01033095","Total",1845,893,952,1845,0,6,53.06,34.8
"2011","Sefton 034A","E01007004","Total",1415,674,741,1415,0,10,18.44,76.7
"2011","Sefton 034B","E01007005","Total",1317,632,685,1316,1,5,125.14,10.5
"2011","Sefton 034C","E01007011","Total",1454,704,750,1440,14,9,21.01,69.2
"2011","Sefton 034D","E01007016","Total",1802,844,958,1802,0,10,35.45,50.8
"2011","Sefton 034E","E01007017","Total",1541,736,805,1541,0,3,20.23,76.2
"2011","Sefton 035A","E01007019","Total",1376,629,747,1376,0,6,32.26,42.7
"2011","Sefton 035B","E01007049","Total",1526,751,775,1518,8,12,56.76,26.9
"2011","Sefton 035C","E01007050","Total",1349,640,709,1314,35,5,17.72,76.1
"2011","Sefton 035D","E01007051","Total",1213,573,640,1213,0,6,31.14,39.0
"2011","Sefton 035E","E01007052","Total",1386,657,729,1386,0,19,16.48,84.1
"2011","Sefton 036A","E01006964","Total",1469,704,765,1469,0,8,22.62,64.9
"2011","Sefton 036B","E01007003","Total",1222,604,618,1179,43,2,12.54,97.4
"2011","Sefton 036C","E01007006","Total",1427,643,784,1423,4,7,24.16,59.1
"2011","Sefton 036D","E01007012","Total",1318,638,680,1318,0,0,21.28,61.9
"2011","Sefton 036E","E01007013","Total",1431,688,743,1423,8,9,14.96,95.7
"2011","Sefton 037A","E01006967","Total",1511,746,765,1458,53,2,28.30,53.4
"2011","Sefton 037B","E01007007","Total",1232,649,583,1232,0,4,38.23,32.2
"2011","Sefton 037C","E01007008","Total",1261,623,638,1261,0,5,44.04,28.6
"2011","Sefton 037D","E01007009","Total",1300,712,588,1184,116,6,210.22,6.2
"2011","Sefton 037E","E01007010","Total",1091,543,548,1090,1,1,32.65,33.4
"2011","Sefton 038A","E01006960","Total",1161,574,587,1161,0,6,42.53,27.3
"2011","Sefton 038B","E01006961","Total",1562,772,790,1509,53,10,30.62,51.0
"2011","Sefton 038C","E01006962","Total",1406,638,768,1402,4,8,19.43,72.4
"2011","Sefton 038D","E01006963","Total",1496,733,763,1491,5,6,9.82,152.3
"2011","Sefton 038E","E01006965","Total",1478,694,784,1478,0,9,17.32,85.3
"2011","Sefton 038F","E01006966","Total",1487,717,770,1487,0,9,21.29,69.8
"2011","St. Helens 001A","E01006882","Total",1188,572,616,1188,0,19,72.69,16.3
"2011","St. Helens 001B","E01006883","Total",1305,615,690,1305,0,21,954.42,1.4
"2011","St. Helens 001C","E01006884","Total",1353,651,702,1353,0,26,67.37,20.1
"2011","St. Helens 001D","E01006885","Total",1278,608,670,1276,2,21,1196.64,1.1
"2011","St. Helens 001E","E01006886","Total",1311,618,693,1311,0,15,268.33,4.9
"2011","St. Helens 001F","E01006887","Total",1344,635,709,1299,45,22,112.81,11.9
"2011","St. Helens 002A","E01006802","Total",1653,815,838,1653,0,24,319.70,5.2
"2011","St. Helens 002B","E01006804","Total",1613,812,801,1599,14,11,142.70,11.3
"2011","St. Helens 002C","E01006806","Total",1544,803,741,1519,25,17,63.72,24.2
"2011","St. Helens 002D","E01006807","Total",1369,652,717,1335,34,24,208.87,6.6
"2011","St. Helens 003A","E01006803","Total",1446,743,703,1434,12,14,805.74,1.8
"2011","St. Helens 003B","E01006805","Total",1539,777,762,1539,0,8,45.78,33.6
"2011","St. Helens 003C","E01006808","Total",1300,658,642,1300,0,18,18.37,70.8
"2011","St. Helens 003D","E01006809","Total",1468,711,757,1468,0,13,56.07,26.2
"2011","St. Helens 004A","E01006849","Total",1444,692,752,1444,0,4,25.80,56.0
"2011","St. Helens 004B","E01006850","Total",1519,761,758,1519,0,5,72.28,21.0
"2011","St. Helens 004C","E01006851","Total",1274,623,651,1264,10,14,161.84,7.9
"2011","St. Helens 004D","E01006852","Total",1319,665,654,1319,0,10,41.01,32.2
"2011","St. Helens 004E","E01006853","Total",1342,690,652,1342,0,9,99.07,13.5
"2011","St. Helens 004F","E01006854","Total",1458,707,751,1458,0,12,60.75,24.0
"2011","St. Helens 004G","E01006855","Total",1459,699,760,1453,6,12,94.32,15.5
"2011","St. Helens 005A","E01006836","Total",1417,704,713,1415,2,8,367.93,3.9
"2011","St. Helens 005B","E01006839","Total",1341,659,682,1341,0,7,130.20,10.3
"2011","St. Helens 005C","E01006840","Total",1502,760,742,1502,0,10,160.79,9.3
"2011","St. Helens 005D","E01006842","Total",1577,738,839,1538,39,7,30.89,51.1
"2011","St. Helens 006A","E01006837","Total",1551,769,782,1531,20,13,146.21,10.6
"2011","St. Helens 006B","E01006838","Total",1444,705,739,1444,0,10,31.95,45.2
"2011","St. Helens 006C","E01006841","Total",1681,824,857,1681,0,15,39.88,42.2
"2011","St. Helens 006D","E01006843","Total",1195,580,615,1195,0,8,19.49,61.3
"2011","St. Helens 007A","E01006914","Total",1224,622,602,1224,0,18,363.53,3.4
"2011","St. Helens 007B","E01006915","Total",1576,776,800,1573,3,15,50.36,31.3
"2011","St. Helens 007C","E01006916","Total",1558,785,773,1503,55,14,84.61,18.4
"2011","St. Helens 007D","E01006917","Total",1666,796,870,1662,4,21,38.70,43.0
"2011","St. Helens 007E","E01006918","Total",1254,617,637,1250,4,26,33.86,37.0
"2011","St. Helens 007F","E01006919","Total",1545,737,808,1545,0,7,128.24,12.0
"2011","St. Helens 008A","E01006810","Total",1279,639,640,1279,0,5,15.96,80.1
"2011","St. Helens 008B","E01006811","Total",1361,674,687,1361,0,5,24.10,56.5
"2011","St. Helens 008C","E01006812","Total",1416,668,748,1416,0,11,30.39,46.6
"2011","St. Helens 008D","E01006813","Total",1490,722,768,1487,3,17,25.26,59.0
"2011","St. Helens 008E","E01006814","Total",1554,787,767,1554,0,11,20.96,74.1
"2011","St. Helens 008F","E01006815","Total",1299,597,702,1279,20,8,40.89,31.8
"2011","St. Helens 008G","E01006818","Total",1283,621,662,1283,0,11,21.31,60.2
"2011","St. Helens 009A","E01006822","Total",1382,669,713,1382,0,23,46.65,29.6
"2011","St. Helens 009B","E01006823","Total",1264,601,663,1264,0,10,36.90,34.3
"2011","St. Helens 009C","E01006824","Total",1246,620,626,1224,22,22,30.29,41.1
"2011","St. Helens 009D","E01006825","Total",1463,718,745,1450,13,35,428.25,3.4
"2011","St. Helens 010A","E01006866","Total",1546,732,814,1546,0,6,58.85,26.3
"2011","St. Helens 010B","E01006867","Total",2075,1013,1062,2054,21,17,47.22,43.9
"2011","St. Helens 010C","E01006868","Total",1497,756,741,1497,0,3,30.98,48.3
"2011","St. Helens 010D","E01006869","Total",1474,745,729,1474,0,7,87.58,16.8
"2011","St. Helens 011A","E01006819","Total",1507,761,746,1507,0,9,109.63,13.7
"2011","St. Helens 011B","E01006820","Total",1455,697,758,1455,0,6,26.05,55.9
"2011","St. Helens 011C","E01006821","Total",1417,694,723,1417,0,7,27.25,52.0
"2011","St. Helens 011D","E01006871","Total",1547,736,811,1485,62,9,34.53,44.8
"2011","St. Helens 012A","E01006832","Total",1646,851,795,1646,0,8,64.67,25.5
"2011","St. Helens 012B","E01006834","Total",1236,594,642,1178,58,10,26.76,46.2
"2011","St. Helens 012C","E01006877","Total",1424,762,662,1321,103,12,42.86,33.2
"2011","St. Helens 012D","E01006880","Total",1440,704,736,1440,0,7,14.01,102.8
"2011","St. Helens 012E","E01006881","Total",1441,735,706,1441,0,5,21.19,68.0
"2011","St. Helens 013A","E01006863","Total",1631,818,813,1631,0,8,34.76,46.9
"2011","St. Helens 013B","E01006864","Total",1866,903,963,1866,0,17,41.05,45.5
"2011","St. Helens 013C","E01006865","Total",1738,839,899,1738,0,10,144.09,12.1
"2011","St. Helens 014A","E01006845","Total",1508,744,764,1508,0,4,118.00,12.8
"2011","St. Helens 014B","E01006870","Total",1370,676,694,1370,0,6,33.41,41.0
"2011","St. Helens 014C","E01006872","Total",1443,790,653,1381,62,8,63.62,22.7
"2011","St. Helens 014D","E01006873","Total",1293,588,705,1179,114,3,62.83,20.6
"2011","St. Helens 014E","E01006874","Total",1204,583,621,1204,0,1,57.08,21.1
"2011","St. Helens 015A","E01006856","Total",1346,708,638,1346,0,24,104.43,12.9
"2011","St. Helens 015B","E01006857","Total",1424,710,714,1402,22,12,114.18,12.5
"2011","St. Helens 015C","E01006858","Total",1486,693,793,1486,0,15,23.77,62.5
"2011","St. Helens 015D","E01006859","Total",1644,847,797,1641,3,33,334.53,4.9
"2011","St. Helens 015E","E01006860","Total",1391,699,692,1391,0,10,29.72,46.8
"2011","St. Helens 015F","E01006861","Total",1595,746,849,1547,48,9,38.56,41.4
"2011","St. Helens 015G","E01006862","Total",1320,637,683,1292,28,8,89.12,14.8
"2011","St. Helens 016A","E01006831","Total",1464,711,753,1464,0,13,19.01,77.0
"2011","St. Helens 016B","E01006833","Total",1615,791,824,1615,0,19,43.00,37.6
"2011","St. Helens 016C","E01006835","Total",1409,713,696,1389,20,20,100.38,14.0
"2011","St. Helens 016D","E01006876","Total",1477,737,740,1477,0,13,21.81,67.7
"2011","St. Helens 016E","E01006878","Total",1346,662,684,1346,0,4,17.59,76.5
"2011","St. Helens 016F","E01006879","Total",1512,753,759,1512,0,14,25.04,60.4
"2011","St. Helens 016G","E01006904","Total",1686,821,865,1686,0,4,24.47,68.9
"2011","St. Helens 017A","E01006816","Total",1694,841,853,1694,0,5,50.13,33.8
"2011","St. Helens 017B","E01006817","Total",1330,668,662,1330,0,0,40.96,32.5
"2011","St. Helens 017C","E01006875","Total",1292,621,671,1292,0,3,48.90,26.4
"2011","St. Helens 017D","E01006899","Total",2046,1003,1043,2042,4,7,103.58,19.8
"2011","St. Helens 018A","E01006826","Total",1338,677,661,1338,0,10,28.95,46.2
"2011","St. Helens 018B","E01006827","Total",1594,791,803,1591,3,20,99.77,16.0
"2011","St. Helens 018C","E01006828","Total",2146,1024,1122,2118,28,45,228.70,9.4
"2011","St. Helens 018D","E01006829","Total",1246,599,647,1202,44,17,83.11,15.0
"2011","St. Helens 019A","E01006830","Total",1344,648,696,1344,0,9,25.66,52.4
"2011","St. Helens 019C","E01006903","Total",1521,755,766,1521,0,10,38.77,39.2
"2011","St. Helens 019D","E01006905","Total",1338,659,679,1338,0,9,65.20,20.5
"2011","St. Helens 019E","E01006906","Total",1481,711,770,1455,26,10,28.91,51.2
"2011","St. Helens 019F","E01006907","Total",1570,757,813,1527,43,13,21.38,73.4
"2011","St. Helens 019G","E01006912","Total",1508,744,764,1466,42,11,402.93,3.7
"2011","St. Helens 019H","E01006913","Total",1317,627,690,1317,0,7,34.94,37.7
"2011","St. Helens 019I","E01032904","Total",1880,948,932,1880,0,24,33.63,55.9
"2011","St. Helens 019J","E01032905","Total",1570,772,798,1564,6,18,130.48,12.0
"2011","St. Helens 020A","E01006844","Total",1603,762,841,1603,0,9,38.12,42.1
"2011","St. Helens 020B","E01006846","Total",1428,693,735,1390,38,14,28.59,49.9
"2011","St. Helens 020C","E01006847","Total",1725,841,884,1725,0,9,34.95,49.4
"2011","St. Helens 020D","E01006848","Total",1403,703,700,1403,0,13,23.80,58.9
"2011","St. Helens 020E","E01006896","Total",1523,755,768,1523,0,12,25.44,59.9
"2011","St. Helens 020F","E01006897","Total",1469,719,750,1435,34,9,122.12,12.0
"2011","St. Helens 020G","E01006901","Total",1309,658,651,1309,0,7,27.92,46.9
"2011","St. Helens 021A","E01006890","Total",1459,725,734,1418,41,13,25.05,58.2
"2011","St. Helens 021B","E01006892","Total",1208,598,610,1164,44,13,30.45,39.7
"2011","St. Helens 021C","E01006893","Total",1382,679,703,1382,0,5,28.50,48.5
"2011","St. Helens 021D","E01006894","Total",1351,662,689,1351,0,18,55.92,24.2
"2011","St. Helens 022A","E01006898","Total",1618,764,854,1618,0,8,1451.44,1.1
"2011","St. Helens 022B","E01006900","Total",2712,1354,1358,2712,0,19,181.44,14.9
"2011","St. Helens 022C","E01006908","Total",1339,660,679,1339,0,8,14.66,91.3
"2011","St. Helens 022D","E01006909","Total",1325,632,693,1325,0,7,17.46,75.9
"2011","St. Helens 022E","E01006910","Total",1711,845,866,1711,0,5,127.46,13.4
"2011","St. Helens 022F","E01006911","Total",1508,758,750,1508,0,17,48.45,31.1
"2011","St. Helens 023A","E01006888","Total",1217,578,639,1182,35,17,32.13,37.9
"2011","St. Helens 023B","E01006889","Total",1444,722,722,1444,0,34,224.22,6.4
"2011","St. Helens 023C","E01006891","Total",1391,672,719,1343,48,8,206.83,6.7
"2011","St. Helens 023D","E01006895","Total",1401,669,732,1361,40,19,59.39,23.6
"2011","Wirral 001A","E01007229","Total",1665,801,864,1660,5,7,17.88,93.1
"2011","Wirral 001B","E01007230","Total",1239,585,654,1239,0,18,29.38,42.2
"2011","Wirral 001C","E01007231","Total",1578,803,775,1545,33,16,26.49,59.6
"2011","Wirral 001D","E01007237","Total",1516,747,769,1483,33,11,43.52,34.8
"2011","Wirral 001E","E01007238","Total",1549,768,781,1546,3,9,19.43,79.7
"2011","Wirral 002A","E01007218","Total",1492,730,762,1476,16,16,13.82,108.0
"2011","Wirral 002B","E01007232","Total",1522,740,782,1375,147,16,22.82,66.7
"2011","Wirral 002C","E01007233","Total",1848,901,947,1822,26,16,20.69,89.3
"2011","Wirral 002D","E01007234","Total",1577,785,792,1577,0,12,20.42,77.2
"2011","Wirral 002E","E01007236","Total",1402,640,762,1360,42,12,23.27,60.2
"2011","Wirral 003A","E01007307","Total",1753,861,892,1737,16,25,55.57,31.5
"2011","Wirral 003B","E01007308","Total",1489,715,774,1486,3,17,88.26,16.9
"2011","Wirral 003C","E01007312","Total",1491,712,779,1491,0,8,34.56,43.1
"2011","Wirral 003D","E01007313","Total",1553,746,807,1553,0,20,27.10,57.3
"2011","Wirral 003E","E01007315","Total",1543,750,793,1543,0,21,22.94,67.3
"2011","Wirral 004A","E01007211","Total",1183,590,593,1183,0,14,25.81,45.8
"2011","Wirral 004B","E01007235","Total",1525,730,795,1525,0,20,24.00,63.5
"2011","Wirral 004C","E01007310","Total",1388,653,735,1371,17,43,24.25,57.2
"2011","Wirral 004D","E01007311","Total",1473,722,751,1473,0,33,21.36,69.0
"2011","Wirral 004E","E01007314","Total",1489,687,802,1489,0,14,25.31,58.8
"2011","Wirral 004F","E01007316","Total",1535,730,805,1523,12,31,25.81,59.5
"2011","Wirral 005A","E01007215","Total",1596,805,791,1562,34,3,24.60,64.9
"2011","Wirral 005B","E01007216","Total",1550,762,788,1548,2,11,16.71,92.8
"2011","Wirral 005C","E01007219","Total",1558,793,765,1526,32,11,15.04,103.6
"2011","Wirral 005D","E01007220","Total",1259,601,658,1220,39,6,12.06,104.4
"2011","Wirral 005E","E01007275","Total",1562,765,797,1541,21,8,25.80,60.5
"2011","Wirral 006A","E01007203","Total",2022,1000,1022,2022,0,23,105.44,19.2
"2011","Wirral 006B","E01007205","Total",1541,732,809,1541,0,12,43.29,35.6
"2011","Wirral 006C","E01007210","Total",1955,925,1030,1955,0,9,150.33,13.0
"2011","Wirral 006D","E01007309","Total",1546,764,782,1546,0,17,122.71,12.6
"2011","Wirral 007A","E01007212","Total",1468,721,747,1468,0,15,17.66,83.1
"2011","Wirral 007B","E01007213","Total",1553,738,815,1529,24,16,31.12,49.9
"2011","Wirral 007C","E01007214","Total",1507,739,768,1442,65,6,23.64,63.7
"2011","Wirral 007D","E01007217","Total",1582,762,820,1582,0,13,21.22,74.6
"2011","Wirral 007E","E01007276","Total",1550,773,777,1550,0,11,26.72,58.0
"2011","Wirral 008A","E01007272","Total",1487,749,738,1446,41,3,12.66,117.5
"2011","Wirral 008B","E01007273","Total",1310,611,699,1310,0,7,19.84,66.0
"2011","Wirral 008C","E01007274","Total",1368,654,714,1368,0,5,53.57,25.5
"2011","Wirral 008D","E01007277","Total",1459,730,729,1449,10,5,19.02,76.7
"2011","Wirral 008E","E01007278","Total",1476,735,741,1476,0,7,14.84,99.5
"2011","Wirral 009A","E01007204","Total",1656,749,907,1656,0,9,61.84,26.8
"2011","Wirral 009B","E01007206","Total",1868,917,951,1868,0,9,85.60,21.8
"2011","Wirral 009C","E01007207","Total",1351,621,730,1351,0,8,54.66,24.7
"2011","Wirral 009D","E01007209","Total",1293,623,670,1290,3,5,58.73,22.0
"2011","Wirral 010C","E01007269","Total",1816,863,953,1816,0,13,105.74,17.2
"2011","Wirral 010D","E01007270","Total",1689,863,826,1689,0,10,35.24,47.9
"2011","Wirral 010E","E01007271","Total",1670,811,859,1668,2,9,14.14,118.1
"2011","Wirral 010F","E01032903","Total",2451,1137,1314,2451,0,9,106.58,23.0
"2011","Wirral 011A","E01007120","Total",1394,653,741,1376,18,13,49.55,28.1
"2011","Wirral 011B","E01007121","Total",1475,677,798,1475,0,0,153.11,9.6
"2011","Wirral 011C","E01007122","Total",1381,667,714,1381,0,7,29.06,47.5
"2011","Wirral 011D","E01007123","Total",1748,782,966,1724,24,13,28.32,61.7
"2011","Wirral 011E","E01007124","Total",1512,667,845,1512,0,4,97.06,15.6
"2011","Wirral 012A","E01007208","Total",1727,820,907,1727,0,9,33.14,52.1
"2011","Wirral 012B","E01007221","Total",1472,717,755,1467,5,20,29.30,50.2
"2011","Wirral 012C","E01007225","Total",1804,896,908,1799,5,13,40.70,44.3
"2011","Wirral 012D","E01007227","Total",1507,713,794,1475,32,8,53.17,28.3
"2011","Wirral 012E","E01007228","Total",1399,698,701,1392,7,2,34.81,40.2
"2011","Wirral 013A","E01007195","Total",1624,756,868,1624,0,42,414.83,3.9
"2011","Wirral 013B","E01007199","Total",1547,751,796,1547,0,24,74.63,20.7
"2011","Wirral 013C","E01007222","Total",1608,789,819,1608,0,12,35.54,45.2
"2011","Wirral 013D","E01007223","Total",1394,664,730,1353,41,20,189.07,7.4
"2011","Wirral 014A","E01007193","Total",1668,803,865,1610,58,41,104.05,16.0
"2011","Wirral 014B","E01007194","Total",1495,696,799,1418,77,16,19.00,78.7
"2011","Wirral 014C","E01007200","Total",1732,826,906,1653,79,49,40.53,42.7
"2011","Wirral 014D","E01007201","Total",1460,699,761,1460,0,41,24.88,58.7
"2011","Wirral 014E","E01007202","Total",1383,665,718,1330,53,11,142.84,9.7
"2011","Wirral 015A","E01007125","Total",1683,813,870,1683,0,13,18.40,91.5
"2011","Wirral 015B","E01007156","Total",1525,745,780,1454,71,10,52.69,28.9
"2011","Wirral 015C","E01007157","Total",1538,745,793,1526,12,15,49.00,31.4
"2011","Wirral 015D","E01007158","Total",1517,736,781,1509,8,25,34.27,44.3
"2011","Wirral 015E","E01007159","Total",1846,877,969,1737,109,32,120.34,15.3
"2011","Wirral 016A","E01007126","Total",1858,989,869,1824,34,2,131.96,14.1
"2011","Wirral 016B","E01007127","Total",1565,732,833,1565,0,9,16.65,94.0
"2011","Wirral 016C","E01007128","Total",1651,861,790,1651,0,9,44.56,37.1
"2011","Wirral 016D","E01007129","Total",1563,797,766,1506,57,7,20.37,76.7
"2011","Wirral 016E","E01007133","Total",1086,559,527,1086,0,1,73.00,14.9
"2011","Wirral 017A","E01007224","Total",1476,708,768,1475,1,12,65.08,22.7
"2011","Wirral 017B","E01007226","Total",1599,751,848,1599,0,12,36.26,44.1
"2011","Wirral 017C","E01007265","Total",1365,649,716,1365,0,19,21.40,63.8
"2011","Wirral 017D","E01007299","Total",1344,652,692,1331,13,20,30.62,43.9
"2011","Wirral 017E","E01007306","Total",1612,762,850,1612,0,17,35.60,45.3
"2011","Wirral 018A","E01007297","Total",1436,626,810,1390,46,9,38.75,37.1
"2011","Wirral 018B","E01007298","Total",1529,708,821,1472,57,47,58.08,26.3
"2011","Wirral 018C","E01007301","Total",1632,783,849,1632,0,27,40.85,40.0
"2011","Wirral 018D","E01007302","Total",1435,703,732,1435,0,27,77.70,18.5
"2011","Wirral 018E","E01007305","Total",1631,766,865,1631,0,13,52.81,30.9
"2011","Wirral 019A","E01007119","Total",1427,667,760,1427,0,7,40.96,34.8
"2011","Wirral 019B","E01007161","Total",1538,746,792,1538,0,11,52.52,29.3
"2011","Wirral 019C","E01007162","Total",1503,652,851,1500,3,7,20.23,74.3
"2011","Wirral 019D","E01007300","Total",1914,853,1061,1868,46,12,48.49,39.5
"2011","Wirral 020A","E01007155","Total",1830,906,924,1653,177,15,69.91,26.2
"2011","Wirral 020B","E01007160","Total",1704,858,846,1662,42,25,38.36,44.4
"2011","Wirral 020C","E01007240","Total",1580,828,752,1464,116,20,38.88,40.6
"2011","Wirral 020D","E01007241","Total",1472,665,807,1377,95,16,66.54,22.1
"2011","Wirral 020E","E01007242","Total",1662,795,867,1644,18,26,47.13,35.3
"2011","Wirral 021A","E01007130","Total",1774,866,908,1774,0,11,15.29,116.0
"2011","Wirral 021B","E01007131","Total",1595,769,826,1595,0,6,18.19,87.7
"2011","Wirral 021C","E01007179","Total",1292,638,654,1272,20,4,14.99,86.2
"2011","Wirral 021D","E01007291","Total",1670,823,847,1670,0,11,91.33,18.3
"2011","Wirral 021E","E01007292","Total",1472,689,783,1472,0,10,29.17,50.5
"2011","Wirral 021F","E01007294","Total",1481,686,795,1481,0,8,13.67,108.3
"2011","Wirral 022A","E01007180","Total",1552,767,785,1528,24,7,19.89,78.0
"2011","Wirral 022B","E01007181","Total",1493,714,779,1465,28,14,24.06,62.1
"2011","Wirral 022C","E01007239","Total",1754,863,891,1724,30,10,21.82,80.4
"2011","Wirral 022D","E01007243","Total",1604,754,850,1604,0,24,38.24,41.9
"2011","Wirral 022E","E01007244","Total",2077,1025,1052,2077,0,15,18.75,110.8
"2011","Wirral 023A","E01007259","Total",1208,585,623,1208,0,23,29.74,40.6
"2011","Wirral 023B","E01007261","Total",1364,663,701,1364,0,28,236.94,5.8
"2011","Wirral 023C","E01007264","Total",1412,677,735,1412,0,22,69.15,20.4
"2011","Wirral 023D","E01007266","Total",1538,737,801,1538,0,29,53.99,28.5
"2011","Wirral 023E","E01007267","Total",1454,675,779,1454,0,21,31.04,46.8
"2011","Wirral 023F","E01007268","Total",1317,634,683,1262,55,31,109.67,12.0
"2011","Wirral 024A","E01007163","Total",2347,1140,1207,2347,0,22,63.63,36.9
"2011","Wirral 024B","E01007245","Total",1539,785,754,1539,0,16,40.42,38.1
"2011","Wirral 024C","E01007246","Total",1553,770,783,1553,0,9,24.92,62.3
"2011","Wirral 024D","E01007247","Total",1756,866,890,1756,0,16,41.50,42.3
"2011","Wirral 024E","E01007252","Total",1548,735,813,1548,0,19,78.83,19.6
"2011","Wirral 025A","E01007249","Total",1358,644,714,1358,0,4,25.79,52.7
"2011","Wirral 025B","E01007251","Total",1169,597,572,1166,3,16,65.83,17.8
"2011","Wirral 025C","E01007257","Total",1299,615,684,1299,0,6,21.66,60.0
"2011","Wirral 025D","E01007303","Total",1438,666,772,1438,0,8,36.23,39.7
"2011","Wirral 025E","E01007304","Total",1569,694,875,1486,83,8,51.20,30.6
"2011","Wirral 026A","E01007196","Total",1617,718,899,1529,88,33,168.63,9.6
"2011","Wirral 026B","E01007197","Total",1693,827,866,1671,22,30,58.48,29.0
"2011","Wirral 026C","E01007198","Total",1703,807,896,1680,23,34,53.85,31.6
"2011","Wirral 026D","E01007263","Total",1415,672,743,1412,3,10,115.91,12.2
"2011","Wirral 026E","E01007282","Total",1418,660,758,1418,0,20,35.04,40.5
"2011","Wirral 027A","E01007175","Total",1846,898,948,1788,58,12,25.08,73.6
"2011","Wirral 027B","E01007290","Total",1743,875,868,1691,52,4,56.18,31.0
"2011","Wirral 027C","E01007293","Total",1483,684,799,1483,0,9,55.28,26.8
"2011","Wirral 027D","E01007295","Total",1185,566,619,1180,5,7,28.03,42.3
"2011","Wirral 027E","E01007296","Total",1713,783,930,1713,0,9,18.71,91.6
"2011","Wirral 028A","E01007258","Total",1454,701,753,1454,0,26,145.60,10.0
"2011","Wirral 028B","E01007260","Total",1561,743,818,1561,0,56,37.57,41.5
"2011","Wirral 028C","E01007262","Total",1499,749,750,1499,0,49,86.62,17.3
"2011","Wirral 028D","E01007281","Total",1333,636,697,1333,0,34,71.48,18.6
"2011","Wirral 028E","E01007283","Total",1266,604,662,1229,37,53,291.08,4.3
"2011","Wirral 029A","E01007173","Total",1552,754,798,1521,31,26,27.57,56.3
"2011","Wirral 029B","E01007174","Total",1562,744,818,1562,0,2,27.29,57.2
"2011","Wirral 029C","E01007176","Total",1612,801,811,1560,52,10,25.66,62.8
"2011","Wirral 029D","E01007177","Total",1507,674,833,1502,5,13,37.21,40.5
"2011","Wirral 029E","E01007178","Total",1556,759,797,1535,21,14,34.21,45.5
"2011","Wirral 030A","E01007248","Total",1535,754,781,1505,30,28,34.00,45.1
"2011","Wirral 030B","E01007250","Total",1415,691,724,1415,0,15,26.16,54.1
"2011","Wirral 030C","E01007253","Total",1552,743,809,1552,0,10,52.56,29.5
"2011","Wirral 030D","E01007254","Total",1524,722,802,1499,25,32,85.77,17.8
"2011","Wirral 031A","E01007115","Total",1594,767,827,1594,0,12,47.10,33.8
"2011","Wirral 031B","E01007138","Total",1633,825,808,1633,0,11,20.15,81.0
"2011","Wirral 031C","E01007139","Total",1552,766,786,1552,0,8,32.51,47.7
"2011","Wirral 031D","E01007141","Total",1593,740,853,1590,3,8,43.73,36.4
"2011","Wirral 031E","E01007289","Total",1599,768,831,1578,21,5,24.39,65.6
"2011","Wirral 032A","E01007111","Total",1575,759,816,1575,0,29,31.10,50.6
"2011","Wirral 032B","E01007112","Total",1535,732,803,1534,1,21,30.18,50.9
"2011","Wirral 032C","E01007113","Total",1376,671,705,1364,12,36,61.44,22.4
"2011","Wirral 032D","E01007114","Total",1530,724,806,1530,0,3,23.03,66.4
"2011","Wirral 032E","E01007116","Total",1552,764,788,1552,0,21,41.40,37.5
"2011","Wirral 033A","E01007280","Total",1742,852,890,1742,0,40,165.27,10.5
"2011","Wirral 033B","E01007284","Total",1623,781,842,1623,0,38,489.39,3.3
"2011","Wirral 033C","E01007285","Total",1489,701,788,1489,0,26,116.46,12.8
"2011","Wirral 033D","E01007287","Total",1837,868,969,1837,0,31,56.04,32.8
"2011","Wirral 034A","E01007183","Total",1285,647,638,1285,0,35,222.27,5.8
"2011","Wirral 034B","E01007255","Total",1502,728,774,1486,16,24,427.62,3.5
"2011","Wirral 034C","E01007256","Total",1581,715,866,1581,0,17,98.52,16.0
"2011","Wirral 034D","E01007279","Total",1680,802,878,1647,33,42,33.53,50.1
"2011","Wirral 034E","E01007286","Total",1437,714,723,1437,0,18,57.22,25.1
"2011","Wirral 035A","E01007110","Total",1601,754,847,1601,0,18,607.88,2.6
"2011","Wirral 035B","E01007117","Total",1697,818,879,1697,0,29,40.29,42.1
"2011","Wirral 035C","E01007118","Total",1558,739,819,1503,55,12,31.76,49.1
"2011","Wirral 035D","E01007151","Total",1570,752,818,1570,0,30,38.38,40.9
"2011","Wirral 035E","E01007154","Total",1545,748,797,1540,5,31,28.41,54.4
"2011","Wirral 036A","E01007140","Total",1692,847,845,1692,0,9,110.58,15.3
"2011","Wirral 036B","E01007142","Total",1812,838,974,1697,115,17,152.47,11.9
"2011","Wirral 036C","E01007143","Total",1672,822,850,1648,24,11,188.86,8.9
"2011","Wirral 036D","E01007152","Total",1653,776,877,1650,3,12,50.70,32.6
"2011","Wirral 036E","E01007153","Total",1513,669,844,1411,102,9,23.94,63.2
"2011","Wirral 037A","E01007182","Total",1522,708,814,1508,14,37,79.44,19.2
"2011","Wirral 037B","E01007184","Total",1509,685,824,1462,47,20,37.69,40.0
"2011","Wirral 037C","E01007185","Total",1594,748,846,1594,0,30,28.90,55.2
"2011","Wirral 037D","E01007192","Total",1306,615,691,1298,8,27,99.11,13.2
"2011","Wirral 037E","E01007288","Total",1587,720,867,1587,0,9,58.84,27.0
"2011","Wirral 038A","E01007144","Total",1383,628,755,1240,143,17,1932.47,0.7
"2011","Wirral 038B","E01007145","Total",1318,638,680,1299,19,20,48.35,27.3
"2011","Wirral 038C","E01007146","Total",1566,753,813,1566,0,24,32.10,48.8
"2011","Wirral 038D","E01007147","Total",1402,683,719,1402,0,18,73.50,19.1
"2011","Wirral 038E","E01007148","Total",1660,821,839,1615,45,34,105.03,15.8
"2011","Wirral 039A","E01007135","Total",1572,775,797,1511,61,16,153.88,10.2
"2011","Wirral 039B","E01007136","Total",1681,804,877,1681,0,18,26.84,62.6
"2011","Wirral 039C","E01007137","Total",1643,766,877,1643,0,18,35.42,46.4
"2011","Wirral 039D","E01007170","Total",1532,748,784,1530,2,20,60.61,25.3
"2011","Wirral 040A","E01007186","Total",1590,752,838,1590,0,31,48.47,32.8
"2011","Wirral 040B","E01007187","Total",1464,697,767,1445,19,39,209.09,7.0
"2011","Wirral 040C","E01007188","Total",1491,729,762,1491,0,43,119.74,12.5
"2011","Wirral 040D","E01007189","Total",1614,780,834,1596,18,47,76.03,21.2
"2011","Wirral 040E","E01007190","Total",1485,705,780,1485,0,50,175.53,8.5
"2011","Wirral 040F","E01007191","Total",1336,675,661,1336,0,50,381.57,3.5
"2011","Wirral 041A","E01007149","Total",1489,750,739,1489,0,23,38.84,38.3
"2011","Wirral 041B","E01007150","Total",1480,746,734,1480,0,17,64.91,22.8
"2011","Wirral 041C","E01007165","Total",1338,655,683,1338,0,8,26.60,50.3
"2011","Wirral 041D","E01007171","Total",1551,796,755,1545,6,23,56.92,27.2
"2011","Wirral 041E","E01007172","Total",1438,677,761,1436,2,20,33.96,42.3
"2011","Wirral 042A","E01007164","Total",1730,844,886,1730,0,15,243.16,7.1
"2011","Wirral 042B","E01007166","Total",1446,715,731,1446,0,14,30.48,47.4
"2011","Wirral 042C","E01007167","Total",1492,715,777,1492,0,7,33.39,44.7
"2011","Wirral 042D","E01007168","Total",1640,762,878,1640,0,9,78.57,20.9
"2011","Wirral 042E","E01007169","Total",1715,818,897,1715,0,12,210.48,8.1
"2011","East Riding of Yorkshire 001A","E01012933","Total",1040,499,541,1027,13,17,1869.67,0.6
"2011","East Riding of Yorkshire 001B","E01012934","Total",1536,740,796,1511,25,18,2907.80,0.5
"2011","East Riding of Yorkshire 001C","E01012938","Total",2273,1072,1201,2256,17,18,311.87,7.3
"2011","East Riding of Yorkshire 001D","E01012939","Total",1820,872,948,1820,0,11,177.53,10.3
"2011","East Riding of Yorkshire 001E","E01012940","Total",1655,817,838,1655,0,15,47.05,35.2
"2011","East Riding of Yorkshire 001F","E01012941","Total",1364,649,715,1361,3,13,36.07,37.8
"2011","East Riding of Yorkshire 002A","E01012929","Total",1952,945,1007,1952,0,21,34.51,56.6
"2011","East Riding of Yorkshire 002B","E01012930","Total",1424,664,760,1424,0,17,32.07,44.4
"2011","East Riding of Yorkshire 002C","E01012935","Total",1308,611,697,1270,38,19,85.10,15.4
"2011","East Riding of Yorkshire 002D","E01012937","Total",2161,1058,1103,2158,3,19,1239.45,1.7
"2011","East Riding of Yorkshire 002E","E01012942","Total",1226,566,660,1226,0,11,248.51,4.9
"2011","East Riding of Yorkshire 003A","E01012928","Total",1680,793,887,1680,0,5,27.30,61.5
"2011","East Riding of Yorkshire 003B","E01012931","Total",1580,743,837,1550,30,2,27.81,56.8
"2011","East Riding of Yorkshire 003C","E01012932","Total",1637,790,847,1629,8,6,84.95,19.3
"2011","East Riding of Yorkshire 003D","E01012946","Total",1617,775,842,1562,55,15,405.27,4.0
"2011","East Riding of Yorkshire 003E","E01012949","Total",1390,636,754,1337,53,7,69.90,19.9
"2011","East Riding of Yorkshire 004A","E01012936","Total",1359,625,734,1240,119,13,30.88,44.0
"2011","East Riding of Yorkshire 004B","E01012943","Total",1628,779,849,1577,51,8,27.11,60.1
"2011","East Riding of Yorkshire 004C","E01012945","Total",1601,806,795,1570,31,5,41.38,38.7
"2011","East Riding of Yorkshire 004D","E01012952","Total",1444,742,702,1337,107,7,24.05,60.0
"2011","East Riding of Yorkshire 005A","E01012944","Total",1448,772,676,1419,29,15,16.53,87.6
"2011","East Riding of Yorkshire 005B","E01012947","Total",1424,683,741,1416,8,16,35.86,39.7
"2011","East Riding of Yorkshire 005C","E01012948","Total",1409,718,691,1296,113,11,22.43,62.8
"2011","East Riding of Yorkshire 005D","E01012951","Total",1381,657,724,1212,169,12,23.04,59.9
"2011","East Riding of Yorkshire 006A","E01012950","Total",1442,702,740,1360,82,20,157.81,9.1
"2011","East Riding of Yorkshire 006B","E01012990","Total",1379,663,716,1364,15,22,6870.06,0.2
"2011","East Riding of Yorkshire 006C","E01012991","Total",1580,766,814,1579,1,22,4757.44,0.3
"2011","East Riding of Yorkshire 006D","E01012992","Total",1490,726,764,1486,4,18,7288.91,0.2
"2011","East Riding of Yorkshire 008A","E01012978","Total",1418,678,740,1418,0,27,65.84,21.5
"2011","East Riding of Yorkshire 008B","E01012981","Total",1406,694,712,1403,3,27,12528.37,0.1
"2011","East Riding of Yorkshire 008C","E01012983","Total",1795,895,900,1775,20,18,462.85,3.9
"2011","East Riding of Yorkshire 008D","E01012989","Total",1731,811,920,1704,27,36,3397.39,0.5
"2011","East Riding of Yorkshire 008E","E01013125","Total",1724,842,882,1724,0,31,6880.00,0.3
"2011","East Riding of Yorkshire 009A","E01013057","Total",1503,738,765,1503,0,28,2340.01,0.6
"2011","East Riding of Yorkshire 009B","E01013059","Total",1620,793,827,1620,0,28,1661.80,1.0
"2011","East Riding of Yorkshire 009C","E01013060","Total",1914,899,1015,1846,68,41,362.44,5.3
"2011","East Riding of Yorkshire 009D","E01013061","Total",1614,768,846,1614,0,17,102.05,15.8
"2011","East Riding of Yorkshire 009E","E01013126","Total",2154,1388,766,1550,604,39,2939.48,0.7
"2011","East Riding of Yorkshire 010A","E01012986","Total",1563,778,785,1563,0,8,3739.55,0.4
"2011","East Riding of Yorkshire 010B","E01012987","Total",1698,840,858,1698,0,37,3743.11,0.5
"2011","East Riding of Yorkshire 010C","E01012988","Total",1522,760,762,1498,24,27,2493.87,0.6
"2011","East Riding of Yorkshire 010D","E01013048","Total",2059,1019,1040,2059,0,26,4796.22,0.4
"2011","East Riding of Yorkshire 011A","E01013052","Total",1540,753,787,1539,1,33,569.87,2.7
"2011","East Riding of Yorkshire 011B","E01013053","Total",1379,651,728,1364,15,21,222.62,6.2
"2011","East Riding of Yorkshire 011C","E01013054","Total",2057,986,1071,1939,118,27,42.05,48.9
"2011","East Riding of Yorkshire 011D","E01013055","Total",1523,740,783,1523,0,28,167.48,9.1
"2011","East Riding of Yorkshire 011E","E01013056","Total",1624,784,840,1582,42,16,29.99,54.2
"2011","East Riding of Yorkshire 011F","E01013058","Total",1328,648,680,1328,0,32,1050.31,1.3
"2011","East Riding of Yorkshire 011G","E01013119","Total",1492,747,745,1476,16,33,12204.24,0.1
"2011","East Riding of Yorkshire 012A","E01013046","Total",1640,759,881,1621,19,27,73.35,22.4
"2011","East Riding of Yorkshire 012B","E01013047","Total",1601,757,844,1529,72,16,82.03,19.5
"2011","East Riding of Yorkshire 012C","E01013049","Total",1603,771,832,1536,67,28,72.67,22.1
"2011","East Riding of Yorkshire 012D","E01013050","Total",1676,857,819,1624,52,15,1463.51,1.1
"2011","East Riding of Yorkshire 012E","E01013051","Total",1579,752,827,1579,0,17,58.12,27.2
"2011","East Riding of Yorkshire 013A","E01012922","Total",1490,747,743,1490,0,39,4227.58,0.4
"2011","East Riding of Yorkshire 013B","E01012923","Total",1618,844,774,1520,98,25,4726.53,0.3
"2011","East Riding of Yorkshire 013C","E01012925","Total",1329,642,687,1301,28,51,2480.19,0.5
"2011","East Riding of Yorkshire 013D","E01012927","Total",1571,794,777,1571,0,33,604.24,2.6
"2011","East Riding of Yorkshire 014A","E01012924","Total",1731,865,866,1731,0,36,2326.32,0.7
"2011","East Riding of Yorkshire 014B","E01012926","Total",2433,1195,1238,2425,8,29,1622.60,1.5
"2011","East Riding of Yorkshire 014C","E01013027","Total",1628,790,838,1622,6,4,3565.82,0.5
"2011","East Riding of Yorkshire 014D","E01013034","Total",1801,892,909,1797,4,24,4841.46,0.4
"2011","East Riding of Yorkshire 015A","E01013120","Total",1957,958,999,1931,26,23,1563.97,1.3
"2011","East Riding of Yorkshire 015B","E01013121","Total",2026,1010,1016,2026,0,27,4886.95,0.4
"2011","East Riding of Yorkshire 015C","E01013123","Total",1552,779,773,1528,24,20,364.48,4.3
"2011","East Riding of Yorkshire 015D","E01013124","Total",2051,954,1097,2043,8,19,55.71,36.8
"2011","East Riding of Yorkshire 016A","E01013064","Total",1492,705,787,1429,63,40,28.36,52.6
"2011","East Riding of Yorkshire 016B","E01013065","Total",1644,804,840,1644,0,10,43.92,37.4
"2011","East Riding of Yorkshire 016C","E01013066","Total",1621,768,853,1621,0,53,34.05,47.6
"2011","East Riding of Yorkshire 016D","E01013067","Total",1732,844,888,1732,0,40,34.25,50.6
"2011","East Riding of Yorkshire 016E","E01013068","Total",1419,669,750,1396,23,44,443.22,3.2
"2011","East Riding of Yorkshire 016F","E01013070","Total",1534,708,826,1501,33,40,102.81,14.9
"2011","East Riding of Yorkshire 017A","E01013038","Total",1554,772,782,1554,0,8,22.13,70.2
"2011","East Riding of Yorkshire 017B","E01013045","Total",1572,749,823,1571,1,10,126.86,12.4
"2011","East Riding of Yorkshire 017C","E01013069","Total",1563,779,784,1563,0,12,39.58,39.5
"2011","East Riding of Yorkshire 017D","E01013071","Total",1619,751,868,1551,68,7,31.20,51.9
"2011","East Riding of Yorkshire 018A","E01013022","Total",1884,951,933,1884,0,30,5130.85,0.4
"2011","East Riding of Yorkshire 018B","E01013023","Total",1838,909,929,1801,37,27,7696.60,0.2
"2011","East Riding of Yorkshire 018C","E01013024","Total",1832,882,950,1832,0,19,180.93,10.1
"2011","East Riding of Yorkshire 018D","E01013122","Total",1487,728,759,1474,13,42,5479.97,0.3
"2011","East Riding of Yorkshire 018E","E01013127","Total",1500,760,740,1500,0,43,4186.69,0.4
"2011","East Riding of Yorkshire 019A","E01013036","Total",1530,722,808,1527,3,11,21.59,70.9
"2011","East Riding of Yorkshire 019B","E01013037","Total",1481,726,755,1481,0,20,254.21,5.8
"2011","East Riding of Yorkshire 019C","E01013040","Total",2022,995,1027,1972,50,25,38.93,51.9
"2011","East Riding of Yorkshire 019D","E01013041","Total",1559,701,858,1523,36,22,46.00,33.9
"2011","East Riding of Yorkshire 019E","E01013062","Total",1690,811,879,1679,11,25,45.03,37.5
"2011","East Riding of Yorkshire 019F","E01013063","Total",1514,724,790,1514,0,45,218.65,6.9
"2011","East Riding of Yorkshire 020A","E01012919","Total",1527,696,831,1226,301,42,2159.35,0.7
"2011","East Riding of Yorkshire 020B","E01012921","Total",1149,552,597,1149,0,29,111.70,10.3
"2011","East Riding of Yorkshire 020C","E01013039","Total",1735,870,865,1735,0,12,1355.97,1.3
"2011","East Riding of Yorkshire 020D","E01013042","Total",1698,826,872,1696,2,35,74.43,22.8
"2011","East Riding of Yorkshire 020E","E01013043","Total",1468,696,772,1414,54,28,44.80,32.8
"2011","East Riding of Yorkshire 020F","E01013044","Total",1621,804,817,1621,0,34,108.79,14.9
"2011","East Riding of Yorkshire 021A","E01013029","Total",1468,717,751,1462,6,14,3504.50,0.4
"2011","East Riding of Yorkshire 021B","E01013030","Total",1493,751,742,1493,0,19,3037.21,0.5
"2011","East Riding of Yorkshire 021C","E01013031","Total",1512,740,772,1489,23,23,927.57,1.6
"2011","East Riding of Yorkshire 021D","E01013032","Total",1444,704,740,1444,0,8,872.48,1.7
"2011","East Riding of Yorkshire 021E","E01013035","Total",1324,670,654,1324,0,21,1335.45,1.0
"2011","East Riding of Yorkshire 022A","E01012954","Total",1241,593,648,1241,0,19,303.28,4.1
"2011","East Riding of Yorkshire 022B","E01012956","Total",1242,606,636,1242,0,20,41.17,30.2
"2011","East Riding of Yorkshire 022C","E01012958","Total",1047,507,540,1047,0,22,27.06,38.7
"2011","East Riding of Yorkshire 022D","E01012961","Total",1516,738,778,1466,50,16,130.90,11.6
"2011","East Riding of Yorkshire 022E","E01012966","Total",1284,607,677,1257,27,36,1838.89,0.7
"2011","East Riding of Yorkshire 023A","E01012953","Total",1076,536,540,1076,0,12,516.86,2.1
"2011","East Riding of Yorkshire 023B","E01012955","Total",1538,721,817,1503,35,19,70.09,21.9
"2011","East Riding of Yorkshire 023C","E01012959","Total",1463,721,742,1459,4,25,49.93,29.3
"2011","East Riding of Yorkshire 023D","E01012962","Total",1150,532,618,1067,83,19,143.42,8.0
"2011","East Riding of Yorkshire 023E","E01012964","Total",1680,838,842,1680,0,8,43.00,39.1
"2011","East Riding of Yorkshire 024A","E01012920","Total",1472,726,746,1470,2,27,3388.84,0.4
"2011","East Riding of Yorkshire 024B","E01012965","Total",1015,478,537,986,29,27,2599.86,0.4
"2011","East Riding of Yorkshire 024C","E01012967","Total",1569,742,827,1536,33,30,136.77,11.5
"2011","East Riding of Yorkshire 024D","E01012968","Total",1717,866,851,1716,1,61,1308.40,1.3
"2011","East Riding of Yorkshire 024E","E01012969","Total",1844,1251,593,1131,713,18,1725.01,1.1
"2011","East Riding of Yorkshire 025A","E01012957","Total",2586,1300,1286,1428,1158,59,35.11,73.7
"2011","East Riding of Yorkshire 025B","E01012960","Total",1653,763,890,1567,86,33,44.79,36.9
"2011","East Riding of Yorkshire 025C","E01012963","Total",1457,671,786,1426,31,8,74.40,19.6
"2011","East Riding of Yorkshire 025D","E01013112","Total",1424,683,741,1424,0,20,282.20,5.0
"2011","East Riding of Yorkshire 026A","E01013018","Total",1855,876,979,1819,36,18,530.77,3.5
"2011","East Riding of Yorkshire 026B","E01013019","Total",1174,584,590,1174,0,16,3687.70,0.3
"2011","East Riding of Yorkshire 026C","E01013021","Total",1496,746,750,1496,0,8,2370.16,0.6
"2011","East Riding of Yorkshire 026D","E01013025","Total",1348,670,678,1348,0,29,262.01,5.1
"2011","East Riding of Yorkshire 026E","E01013026","Total",1661,835,826,1661,0,15,1257.28,1.3
"2011","East Riding of Yorkshire 027A","E01013105","Total",1439,679,760,1439,0,12,37.61,38.3
"2011","East Riding of Yorkshire 027B","E01013110","Total",1574,722,852,1551,23,13,47.76,33.0
"2011","East Riding of Yorkshire 027C","E01013111","Total",1464,720,744,1464,0,18,50.97,28.7
"2011","East Riding of Yorkshire 027D","E01013115","Total",1533,743,790,1533,0,26,35.03,43.8
"2011","East Riding of Yorkshire 027E","E01013117","Total",1540,750,790,1502,38,21,55.65,27.7
"2011","East Riding of Yorkshire 028A","E01013108","Total",1541,766,775,1486,55,29,222.10,6.9
"2011","East Riding of Yorkshire 028B","E01013113","Total",1522,729,793,1460,62,25,89.07,17.1
"2011","East Riding of Yorkshire 028C","E01013114","Total",1502,755,747,1502,0,28,323.45,4.6
"2011","East Riding of Yorkshire 028D","E01013116","Total",1543,774,769,1519,24,29,106.54,14.5
"2011","East Riding of Yorkshire 028E","E01013118","Total",1476,703,773,1476,0,20,52.15,28.3
"2011","East Riding of Yorkshire 029A","E01013094","Total",1412,686,726,1395,17,17,764.41,1.8
"2011","East Riding of Yorkshire 029B","E01013095","Total",1563,723,840,1449,114,19,62.21,25.1
"2011","East Riding of Yorkshire 029C","E01013096","Total",1674,795,879,1650,24,17,666.28,2.5
"2011","East Riding of Yorkshire 029D","E01013097","Total",1437,720,717,1437,0,9,29.42,48.8
"2011","East Riding of Yorkshire 029E","E01013102","Total",1425,683,742,1417,8,17,581.89,2.4
"2011","East Riding of Yorkshire 031A","E01013028","Total",1558,798,760,1558,0,15,3305.72,0.5
"2011","East Riding of Yorkshire 031B","E01013078","Total",1423,712,711,1399,24,6,3458.67,0.4
"2011","East Riding of Yorkshire 031C","E01013081","Total",1485,734,751,1485,0,22,5950.77,0.2
"2011","East Riding of Yorkshire 031D","E01013082","Total",1587,805,782,1521,66,11,1565.92,1.0
"2011","East Riding of Yorkshire 031E","E01013085","Total",1654,830,824,1654,0,19,248.89,6.6
"2011","East Riding of Yorkshire 032A","E01012970","Total",1460,711,749,1460,0,40,622.64,2.3
"2011","East Riding of Yorkshire 032C","E01012972","Total",1544,747,797,1524,20,36,54.13,28.5
"2011","East Riding of Yorkshire 032D","E01012973","Total",2795,1399,1396,2772,23,37,592.01,4.7
"2011","East Riding of Yorkshire 032E","E01012974","Total",1532,720,812,1508,24,9,32.05,47.8
"2011","East Riding of Yorkshire 032F","E01013092","Total",2027,996,1031,2025,2,34,1203.97,1.7
"2011","East Riding of Yorkshire 032G","E01033495","Total",1392,689,703,1392,0,11,21.79,63.9
"2011","East Riding of Yorkshire 032H","E01033496","Total",1722,839,883,1722,0,31,50.38,34.2
"2011","East Riding of Yorkshire 033A","E01013033","Total",1608,792,816,1608,0,20,486.04,3.3
"2011","East Riding of Yorkshire 033B","E01013098","Total",2229,1086,1143,2229,0,30,72.73,30.6
"2011","East Riding of Yorkshire 033C","E01013099","Total",1341,646,695,1341,0,15,1975.37,0.7
"2011","East Riding of Yorkshire 033D","E01013100","Total",1697,847,850,1661,36,23,1203.68,1.4
"2011","East Riding of Yorkshire 033E","E01013101","Total",1695,856,839,1695,0,11,49.61,34.2
"2011","East Riding of Yorkshire 034A","E01013008","Total",1501,712,789,1474,27,14,49.14,30.5
"2011","East Riding of Yorkshire 034B","E01013009","Total",1522,728,794,1517,5,19,74.32,20.5
"2011","East Riding of Yorkshire 034C","E01013013","Total",1528,733,795,1528,0,15,28.83,53.0
"2011","East Riding of Yorkshire 034D","E01013014","Total",1521,760,761,1521,0,16,23.97,63.5
"2011","East Riding of Yorkshire 034E","E01013107","Total",1534,713,821,1534,0,4,72.27,21.2
"2011","East Riding of Yorkshire 035A","E01013088","Total",1657,825,832,1657,0,36,532.33,3.1
"2011","East Riding of Yorkshire 035B","E01013089","Total",1674,790,884,1621,53,37,89.84,18.6
"2011","East Riding of Yorkshire 035C","E01013090","Total",1414,700,714,1414,0,32,325.92,4.3
"2011","East Riding of Yorkshire 035D","E01013091","Total",1612,800,812,1593,19,31,287.41,5.6
"2011","East Riding of Yorkshire 035E","E01013093","Total",1487,736,751,1487,0,45,342.60,4.3
"2011","East Riding of Yorkshire 036A","E01013005","Total",1472,704,768,1232,240,33,193.42,7.6
"2011","East Riding of Yorkshire 036B","E01013007","Total",1568,737,831,1539,29,24,27.77,56.5
"2011","East Riding of Yorkshire 036C","E01013011","Total",1512,723,789,1512,0,21,54.31,27.8
"2011","East Riding of Yorkshire 036D","E01013012","Total",1373,670,703,1339,34,31,68.61,20.0
"2011","East Riding of Yorkshire 037A","E01012996","Total",1579,771,808,1518,61,11,232.70,6.8
"2011","East Riding of Yorkshire 037B","E01012998","Total",2189,1052,1137,2155,34,18,63.99,34.2
"2011","East Riding of Yorkshire 037C","E01013015","Total",1570,798,772,1547,23,18,80.45,19.5
"2011","East Riding of Yorkshire 037D","E01013016","Total",1656,831,825,1656,0,16,1530.67,1.1
"2011","East Riding of Yorkshire 038A","E01013003","Total",1447,711,736,1402,45,8,63.00,23.0
"2011","East Riding of Yorkshire 038B","E01013017","Total",1639,803,836,1632,7,14,574.01,2.9
"2011","East Riding of Yorkshire 038C","E01013020","Total",1800,871,929,1800,0,16,5079.19,0.4
"2011","East Riding of Yorkshire 038D","E01013076","Total",1493,757,736,1476,17,19,3736.57,0.4
"2011","East Riding of Yorkshire 039A","E01013079","Total",1516,761,755,1516,0,16,2777.03,0.5
"2011","East Riding of Yorkshire 039B","E01013080","Total",1365,674,691,1365,0,8,80.76,16.9
"2011","East Riding of Yorkshire 039C","E01013083","Total",1483,748,735,1409,74,4,28.14,52.7
"2011","East Riding of Yorkshire 039D","E01013084","Total",1439,683,756,1397,42,9,35.89,40.1
"2011","East Riding of Yorkshire 039E","E01013086","Total",1576,815,761,1464,112,9,575.20,2.7
"2011","East Riding of Yorkshire 039F","E01013087","Total",1365,674,691,1362,3,9,4398.97,0.3
"2011","East Riding of Yorkshire 040A","E01012993","Total",1410,654,756,1322,88,8,83.62,16.9
"2011","East Riding of Yorkshire 040B","E01012997","Total",1855,912,943,1855,0,12,21.62,85.8
"2011","East Riding of Yorkshire 040C","E01012999","Total",1740,865,875,1740,0,14,16.50,105.5
"2011","East Riding of Yorkshire 040D","E01013001","Total",1801,864,937,1750,51,8,274.56,6.6
"2011","East Riding of Yorkshire 040E","E01013074","Total",1633,811,822,1593,40,20,4613.17,0.4
"2011","East Riding of Yorkshire 041A","E01012994","Total",1755,864,891,1755,0,13,31.25,56.2
"2011","East Riding of Yorkshire 041B","E01012995","Total",1923,929,994,1923,0,11,27.00,71.2
"2011","East Riding of Yorkshire 041C","E01013000","Total",1820,968,852,1801,19,6,99.47,18.3
"2011","East Riding of Yorkshire 041D","E01013002","Total",1619,812,807,1619,0,10,78.58,20.6
"2011","East Riding of Yorkshire 041E","E01013004","Total",1672,787,885,1672,0,17,24.20,69.1
"2011","East Riding of Yorkshire 042A","E01013072","Total",1698,832,866,1664,34,14,955.54,1.8
"2011","East Riding of Yorkshire 042B","E01013073","Total",1592,793,799,1581,11,25,2065.05,0.8
"2011","East Riding of Yorkshire 042C","E01013075","Total",1322,670,652,1321,1,17,1283.11,1.0
"2011","East Riding of Yorkshire 042D","E01013077","Total",1987,945,1042,1947,40,31,323.46,6.1
"2011","East Riding of Yorkshire 043A","E01013006","Total",1532,743,789,1530,2,12,24.96,61.4
"2011","East Riding of Yorkshire 043B","E01013010","Total",1471,712,759,1471,0,19,26.71,55.1
"2011","East Riding of Yorkshire 043C","E01013103","Total",1419,688,731,1419,0,17,23.09,61.5
"2011","East Riding of Yorkshire 043D","E01013104","Total",1243,590,653,1243,0,10,23.53,52.8
"2011","East Riding of Yorkshire 043E","E01013106","Total",1198,594,604,1198,0,11,104.82,11.4
"2011","East Riding of Yorkshire 043F","E01032596","Total",1420,673,747,1420,0,10,31.24,45.5
"2011","East Riding of Yorkshire 044A","E01012975","Total",1509,721,788,1480,29,30,373.55,4.0
"2011","East Riding of Yorkshire 044B","E01012977","Total",2597,1252,1345,2551,46,41,346.47,7.5
"2011","East Riding of Yorkshire 044C","E01012984","Total",1679,843,836,1679,0,30,3583.62,0.5
"2011","East Riding of Yorkshire 044D","E01012985","Total",1692,813,879,1678,14,19,2378.13,0.7
"2011","East Riding of Yorkshire 045A","E01012976","Total",1457,696,761,1457,0,11,21.96,66.3
"2011","East Riding of Yorkshire 045B","E01012979","Total",1508,734,774,1508,0,7,42.97,35.1
"2011","East Riding of Yorkshire 045C","E01012980","Total",1855,884,971,1725,130,14,45.56,40.7
"2011","East Riding of Yorkshire 045D","E01012982","Total",1654,783,871,1652,2,30,76.28,21.7
"2011","Kingston upon Hull 001A","E01012779","Total",1283,586,697,1283,0,3,35.87,35.8
"2011","Kingston upon Hull 001B","E01012780","Total",1560,750,810,1560,0,7,31.18,50.0
"2011","Kingston upon Hull 001C","E01012781","Total",1241,579,662,1218,23,7,25.31,49.0
"2011","Kingston upon Hull 001E","E01012832","Total",1393,685,708,1350,43,6,60.17,23.2
"2011","Kingston upon Hull 001F","E01033105","Total",1448,735,713,1448,0,13,40.74,35.5
"2011","Kingston upon Hull 001G","E01033106","Total",1155,574,581,1150,5,11,70.78,16.3
"2011","Kingston upon Hull 001H","E01033107","Total",1315,636,679,1314,1,6,39.22,33.5
"2011","Kingston upon Hull 001I","E01033108","Total",1451,732,719,1451,0,16,111.49,13.0
"2011","Kingston upon Hull 002A","E01012782","Total",1441,682,759,1411,30,5,29.50,48.8
"2011","Kingston upon Hull 002B","E01012785","Total",1328,656,672,1328,0,1,18.12,73.3
"2011","Kingston upon Hull 002C","E01012786","Total",1222,600,622,1222,0,0,34.00,35.9
"2011","Kingston upon Hull 002D","E01012787","Total",1517,775,742,1517,0,2,29.50,51.4
"2011","Kingston upon Hull 002E","E01012788","Total",1472,717,755,1472,0,2,43.79,33.6
"2011","Kingston upon Hull 002F","E01012789","Total",1343,643,700,1343,0,3,35.99,37.3
"2011","Kingston upon Hull 003A","E01012875","Total",1495,729,766,1495,0,3,32.71,45.7
"2011","Kingston upon Hull 003B","E01012876","Total",1706,804,902,1706,0,5,23.05,74.0
"2011","Kingston upon Hull 003C","E01012877","Total",1434,668,766,1434,0,9,23.44,61.2
"2011","Kingston upon Hull 003D","E01012878","Total",1574,759,815,1574,0,7,25.43,61.9
"2011","Kingston upon Hull 003E","E01012879","Total",1431,738,693,1431,0,8,21.95,65.2
"2011","Kingston upon Hull 004A","E01012778","Total",1480,683,797,1480,0,2,21.81,67.9
"2011","Kingston upon Hull 004B","E01012783","Total",1217,585,632,1214,3,7,201.01,6.1
"2011","Kingston upon Hull 004C","E01012784","Total",2108,1009,1099,2108,0,13,82.49,25.6
"2011","Kingston upon Hull 004D","E01012790","Total",1321,641,680,1256,65,3,24.42,54.1
"2011","Kingston upon Hull 004E","E01012906","Total",1611,745,866,1611,0,7,47.78,33.7
"2011","Kingston upon Hull 004F","E01012908","Total",1189,590,599,1087,102,3,33.45,35.5
"2011","Kingston upon Hull 005A","E01012764","Total",1165,591,574,1133,32,4,31.22,37.3
"2011","Kingston upon Hull 005B","E01012765","Total",1503,730,773,1503,0,15,22.94,65.5
"2011","Kingston upon Hull 005C","E01012768","Total",1359,648,711,1359,0,7,28.44,47.8
"2011","Kingston upon Hull 005D","E01012769","Total",1334,669,665,1334,0,7,26.95,49.5
"2011","Kingston upon Hull 006A","E01012829","Total",1593,787,806,1593,0,8,112.84,14.1
"2011","Kingston upon Hull 006B","E01012830","Total",1470,737,733,1468,2,4,18.58,79.1
"2011","Kingston upon Hull 006C","E01012905","Total",1339,651,688,1339,0,4,23.67,56.6
"2011","Kingston upon Hull 006D","E01012910","Total",1298,657,641,1298,0,7,12.39,104.8
"2011","Kingston upon Hull 006E","E01012912","Total",1837,932,905,1837,0,7,35.30,52.0
"2011","Kingston upon Hull 007A","E01012822","Total",1506,741,765,1475,31,12,30.68,49.1
"2011","Kingston upon Hull 007B","E01012904","Total",1460,709,751,1377,83,16,27.21,53.7
"2011","Kingston upon Hull 007C","E01012907","Total",1398,702,696,1397,1,8,30.69,45.6
"2011","Kingston upon Hull 007D","E01012909","Total",1303,640,663,1303,0,15,46.79,27.8
"2011","Kingston upon Hull 007E","E01012911","Total",1214,610,604,1214,0,8,23.58,51.5
"2011","Kingston upon Hull 008A","E01012873","Total",1542,725,817,1542,0,6,20.70,74.5
"2011","Kingston upon Hull 008B","E01012874","Total",1580,786,794,1580,0,2,27.82,56.8
"2011","Kingston upon Hull 008C","E01012880","Total",1720,816,904,1720,0,9,21.89,78.6
"2011","Kingston upon Hull 008D","E01012881","Total",1520,752,768,1520,0,5,43.61,34.9
"2011","Kingston upon Hull 008E","E01012915","Total",1483,705,778,1483,0,7,26.25,56.5
"2011","Kingston upon Hull 008F","E01012917","Total",1621,786,835,1621,0,6,40.10,40.4
"2011","Kingston upon Hull 008G","E01012918","Total",1552,772,780,1552,0,6,20.15,77.0
"2011","Kingston upon Hull 009A","E01012833","Total",1494,686,808,1494,0,7,36.92,40.5
"2011","Kingston upon Hull 009B","E01012835","Total",1154,567,587,1154,0,8,21.08,54.7
"2011","Kingston upon Hull 009C","E01012836","Total",1507,806,701,1487,20,13,53.58,28.1
"2011","Kingston upon Hull 009D","E01012839","Total",1297,637,660,1297,0,5,29.37,44.2
"2011","Kingston upon Hull 009E","E01012840","Total",1490,706,784,1490,0,3,23.89,62.4
"2011","Kingston upon Hull 010A","E01012824","Total",1685,833,852,1590,95,9,80.63,20.9
"2011","Kingston upon Hull 010B","E01012825","Total",1499,688,811,1499,0,7,39.42,38.0
"2011","Kingston upon Hull 010C","E01012834","Total",1613,739,874,1578,35,2,23.08,69.9
"2011","Kingston upon Hull 010D","E01012837","Total",1656,733,923,1571,85,2,27.92,59.3
"2011","Kingston upon Hull 010E","E01012838","Total",1510,710,800,1510,0,9,31.47,48.0
"2011","Kingston upon Hull 011A","E01012821","Total",1219,565,654,1213,6,5,52.24,23.3
"2011","Kingston upon Hull 011B","E01012823","Total",1456,719,737,1433,23,7,28.17,51.7
"2011","Kingston upon Hull 011C","E01012826","Total",1510,717,793,1510,0,8,33.31,45.3
"2011","Kingston upon Hull 011D","E01012827","Total",1491,694,797,1436,55,8,32.94,45.3
"2011","Kingston upon Hull 011E","E01012828","Total",1539,743,796,1539,0,8,49.85,30.9
"2011","Kingston upon Hull 012A","E01012766","Total",1433,727,706,1433,0,17,101.83,14.1
"2011","Kingston upon Hull 012B","E01012767","Total",1709,896,813,1689,20,16,23.03,74.2
"2011","Kingston upon Hull 012C","E01012914","Total",2150,1134,1016,1734,416,65,71.02,30.3
"2011","Kingston upon Hull 012D","E01012916","Total",1558,795,763,1531,27,11,54.70,28.5
"2011","Kingston upon Hull 013A","E01012812","Total",1449,742,707,1449,0,12,37.79,38.3
"2011","Kingston upon Hull 013B","E01012813","Total",1777,884,893,1777,0,16,41.91,42.4
"2011","Kingston upon Hull 013C","E01012814","Total",1540,746,794,1540,0,10,24.24,63.5
"2011","Kingston upon Hull 013D","E01012815","Total",1598,835,763,1598,0,4,34.80,45.9
"2011","Kingston upon Hull 013E","E01012818","Total",1250,609,641,1250,0,20,32.01,39.1
"2011","Kingston upon Hull 014A","E01012791","Total",1672,822,850,1672,0,26,61.93,27.0
"2011","Kingston upon Hull 014B","E01012792","Total",1590,793,797,1590,0,20,30.07,52.9
"2011","Kingston upon Hull 014C","E01012793","Total",1483,694,789,1412,71,32,53.96,27.5
"2011","Kingston upon Hull 014D","E01012794","Total",1588,797,791,1588,0,15,30.54,52.0
"2011","Kingston upon Hull 014E","E01012913","Total",1979,952,1027,1979,0,12,33.39,59.3
"2011","Kingston upon Hull 015A","E01012761","Total",1757,961,796,1683,74,9,27.89,63.0
"2011","Kingston upon Hull 015B","E01012868","Total",1749,920,829,1718,31,15,15.36,113.9
"2011","Kingston upon Hull 015C","E01012869","Total",1774,971,803,1765,9,17,17.01,104.3
"2011","Kingston upon Hull 015D","E01012871","Total",1829,1006,823,1829,0,16,60.00,30.5
"2011","Kingston upon Hull 015E","E01012872","Total",1852,1001,851,1851,1,29,16.79,110.3
"2011","Kingston upon Hull 016A","E01012804","Total",1467,743,724,1467,0,8,45.17,32.5
"2011","Kingston upon Hull 016B","E01012806","Total",1461,738,723,1461,0,5,70.53,20.7
"2011","Kingston upon Hull 016C","E01012807","Total",1377,677,700,1346,31,9,30.57,45.0
"2011","Kingston upon Hull 016D","E01012817","Total",1370,701,669,1370,0,3,176.65,7.8
"2011","Kingston upon Hull 016E","E01012819","Total",1435,711,724,1435,0,7,20.28,70.8
"2011","Kingston upon Hull 017A","E01012841","Total",1603,738,865,1603,0,6,23.25,68.9
"2011","Kingston upon Hull 017B","E01012844","Total",1333,646,687,1333,0,4,19.37,68.8
"2011","Kingston upon Hull 017C","E01012849","Total",1496,733,763,1496,0,7,29.70,50.4
"2011","Kingston upon Hull 017D","E01012895","Total",1501,718,783,1501,0,1,51.02,29.4
"2011","Kingston upon Hull 017E","E01012897","Total",1551,714,837,1551,0,4,32.64,47.5
"2011","Kingston upon Hull 017F","E01012898","Total",1380,625,755,1380,0,3,28.02,49.3
"2011","Kingston upon Hull 018A","E01012758","Total",1588,811,777,1555,33,28,31.20,50.9
"2011","Kingston upon Hull 018B","E01012762","Total",1575,788,787,1570,5,25,20.47,76.9
"2011","Kingston upon Hull 018C","E01012763","Total",2064,1170,894,2032,32,15,29.56,69.8
"2011","Kingston upon Hull 018D","E01012866","Total",1576,830,746,1576,0,15,12.13,129.9
"2011","Kingston upon Hull 018E","E01012870","Total",1683,837,846,1683,0,13,21.04,80.0
"2011","Kingston upon Hull 019A","E01012774","Total",1549,765,784,1549,0,5,25.22,61.4
"2011","Kingston upon Hull 019B","E01012795","Total",1937,930,1007,1937,0,7,100.24,19.3
"2011","Kingston upon Hull 019C","E01012797","Total",1386,651,735,1386,0,8,19.40,71.4
"2011","Kingston upon Hull 019D","E01012798","Total",1543,690,853,1543,0,10,31.97,48.3
"2011","Kingston upon Hull 019E","E01012801","Total",1456,728,728,1456,0,6,28.61,50.9
"2011","Kingston upon Hull 020A","E01012816","Total",1391,685,706,1372,19,12,60.67,22.9
"2011","Kingston upon Hull 020B","E01012848","Total",1828,1318,510,1180,648,6,568.57,3.2
"2011","Kingston upon Hull 020C","E01012894","Total",1562,758,804,1562,0,2,47.24,33.1
"2011","Kingston upon Hull 020D","E01012896","Total",2102,1015,1087,2102,0,16,36.48,57.6
"2011","Kingston upon Hull 020E","E01012901","Total",1482,734,748,1427,55,8,18.22,81.3
"2011","Kingston upon Hull 021A","E01012842","Total",1523,720,803,1523,0,2,23.07,66.0
"2011","Kingston upon Hull 021B","E01012843","Total",1543,717,826,1449,94,1,78.90,19.6
"2011","Kingston upon Hull 021C","E01012845","Total",1572,763,809,1572,0,4,60.65,25.9
"2011","Kingston upon Hull 021D","E01012846","Total",1437,693,744,1437,0,2,34.85,41.2
"2011","Kingston upon Hull 021E","E01012847","Total",1298,626,672,1298,0,4,18.57,69.9
"2011","Kingston upon Hull 022A","E01012820","Total",1430,723,707,1414,16,5,17.32,82.6
"2011","Kingston upon Hull 022B","E01012899","Total",1530,747,783,1483,47,6,23.08,66.3
"2011","Kingston upon Hull 022C","E01012900","Total",1646,835,811,1571,75,12,16.96,97.1
"2011","Kingston upon Hull 022D","E01012902","Total",1586,806,780,1586,0,14,16.12,98.4
"2011","Kingston upon Hull 022E","E01012903","Total",1724,847,877,1676,48,11,15.34,112.4
"2011","Kingston upon Hull 023A","E01012796","Total",1310,638,672,1310,0,10,25.01,52.4
"2011","Kingston upon Hull 023B","E01012799","Total",1253,609,644,1253,0,2,18.29,68.5
"2011","Kingston upon Hull 023C","E01012800","Total",1499,757,742,1499,0,10,38.35,39.1
"2011","Kingston upon Hull 023D","E01012802","Total",1403,689,714,1403,0,4,24.13,58.1
"2011","Kingston upon Hull 023E","E01012803","Total",1440,702,738,1440,0,6,18.87,76.3
"2011","Kingston upon Hull 024A","E01012850","Total",1917,1120,797,1917,0,10,17.50,109.5
"2011","Kingston upon Hull 024B","E01012852","Total",1693,912,781,1684,9,3,39.88,42.5
"2011","Kingston upon Hull 024C","E01012856","Total",1599,835,764,1599,0,4,50.24,31.8
"2011","Kingston upon Hull 024D","E01012857","Total",1607,858,749,1580,27,4,28.26,56.9
"2011","Kingston upon Hull 024E","E01012867","Total",1648,847,801,1577,71,7,58.67,28.1
"2011","Kingston upon Hull 025A","E01012756","Total",1532,741,791,1532,0,12,19.89,77.0
"2011","Kingston upon Hull 025B","E01012757","Total",1551,822,729,1505,46,25,31.82,48.7
"2011","Kingston upon Hull 025C","E01012759","Total",1649,836,813,1649,0,12,39.81,41.4
"2011","Kingston upon Hull 025D","E01012760","Total",1510,777,733,1510,0,9,12.59,119.9
"2011","Kingston upon Hull 025E","E01012862","Total",1339,668,671,1307,32,11,22.54,59.4
"2011","Kingston upon Hull 026A","E01012805","Total",1369,721,648,1369,0,6,19.13,71.6
"2011","Kingston upon Hull 026B","E01012808","Total",1679,850,829,1660,19,1,25.63,65.5
"2011","Kingston upon Hull 026C","E01012809","Total",1803,976,827,1794,9,5,105.58,17.1
"2011","Kingston upon Hull 026D","E01012810","Total",1893,954,939,1880,13,7,50.53,37.5
"2011","Kingston upon Hull 026E","E01012811","Total",1676,925,751,1633,43,3,55.00,30.5
"2011","Kingston upon Hull 027A","E01012773","Total",1703,842,861,1703,0,4,22.67,75.1
"2011","Kingston upon Hull 027B","E01012776","Total",1453,686,767,1453,0,10,26.71,54.4
"2011","Kingston upon Hull 027C","E01012863","Total",1449,735,714,1418,31,8,27.32,53.0
"2011","Kingston upon Hull 027D","E01012864","Total",1688,939,749,1679,9,9,18.79,89.8
"2011","Kingston upon Hull 027E","E01012865","Total",1399,708,691,1351,48,5,17.05,82.1
"2011","Kingston upon Hull 028A","E01012770","Total",1499,750,749,1499,0,25,28.69,52.2
"2011","Kingston upon Hull 028B","E01012771","Total",1536,758,778,1536,0,7,20.00,76.8
"2011","Kingston upon Hull 028C","E01012772","Total",1466,724,742,1466,0,17,31.77,46.1
"2011","Kingston upon Hull 028D","E01012775","Total",1452,706,746,1452,0,8,34.29,42.3
"2011","Kingston upon Hull 028E","E01012777","Total",1462,695,767,1393,69,9,35.67,41.0
"2011","Kingston upon Hull 029A","E01012851","Total",2333,1381,952,2218,115,5,76.25,30.6
"2011","Kingston upon Hull 029C","E01012854","Total",2144,1296,848,2026,118,15,84.96,25.2
"2011","Kingston upon Hull 029D","E01012855","Total",1774,986,788,1739,35,15,46.84,37.9
"2011","Kingston upon Hull 029E","E01033104","Total",1314,761,553,1220,94,30,66.92,19.6
"2011","Kingston upon Hull 029F","E01033109","Total",1306,812,494,1258,48,1,55.08,23.7
"2011","Kingston upon Hull 030A","E01012859","Total",1498,764,734,1498,0,10,54.65,27.4
"2011","Kingston upon Hull 030B","E01012889","Total",1391,680,711,1358,33,4,195.09,7.1
"2011","Kingston upon Hull 030C","E01012891","Total",2181,1232,949,2111,70,6,24.19,90.2
"2011","Kingston upon Hull 030D","E01012892","Total",1928,975,953,1894,34,7,22.41,86.0
"2011","Kingston upon Hull 030E","E01012893","Total",1513,709,804,1457,56,9,17.84,84.8
"2011","Kingston upon Hull 031A","E01012858","Total",1756,835,921,1752,4,8,43.34,40.5
"2011","Kingston upon Hull 031B","E01012860","Total",1622,793,829,1622,0,11,32.81,49.4
"2011","Kingston upon Hull 031D","E01012886","Total",1584,780,804,1584,0,5,65.15,24.3
"2011","Kingston upon Hull 031E","E01012888","Total",1489,755,734,1488,1,4,36.72,40.6
"2011","Kingston upon Hull 031G","E01033110","Total",1502,736,766,1502,0,5,40.97,36.7
"2011","Kingston upon Hull 033A","E01012882","Total",1617,786,831,1577,40,6,104.14,15.5
"2011","Kingston upon Hull 033B","E01012883","Total",1487,688,799,1462,25,6,62.03,24.0
"2011","Kingston upon Hull 033C","E01012884","Total",1839,849,990,1787,52,4,32.97,55.8
"2011","Kingston upon Hull 033D","E01012887","Total",1460,740,720,1460,0,6,31.40,46.5
"2011","Kingston upon Hull 033E","E01032595","Total",1817,876,941,1802,15,9,56.26,32.3
"2011","North East Lincolnshire 001A","E01013174","Total",1462,660,802,1462,0,6,715.62,2.0
"2011","North East Lincolnshire 001B","E01013175","Total",1380,699,681,1380,0,11,856.17,1.6
"2011","North East Lincolnshire 001C","E01013176","Total",1403,693,710,1403,0,14,60.01,23.4
"2011","North East Lincolnshire 001D","E01013177","Total",1588,800,788,1572,16,6,39.48,40.2
"2011","North East Lincolnshire 001E","E01013178","Total",1472,723,749,1472,0,9,37.16,39.6
"2011","North East Lincolnshire 001F","E01013179","Total",1516,730,786,1469,47,6,76.88,19.7
"2011","North East Lincolnshire 001G","E01013180","Total",1452,725,727,1427,25,17,544.61,2.7
"2011","North East Lincolnshire 002A","E01013136","Total",1484,806,678,1462,22,5,134.93,11.0
"2011","North East Lincolnshire 002B","E01013137","Total",1476,856,620,1476,0,0,33.20,44.5
"2011","North East Lincolnshire 002C","E01013139","Total",1217,597,620,1217,0,7,21.85,55.7
"2011","North East Lincolnshire 002D","E01013142","Total",1717,845,872,1702,15,4,23.99,71.6
"2011","North East Lincolnshire 003A","E01013218","Total",1407,714,693,1407,0,12,59.69,23.6
"2011","North East Lincolnshire 003B","E01013219","Total",1407,653,754,1407,0,7,24.56,57.3
"2011","North East Lincolnshire 003C","E01013220","Total",1636,801,835,1636,0,12,96.10,17.0
"2011","North East Lincolnshire 003D","E01013221","Total",1744,909,835,1744,0,5,161.21,10.8
"2011","North East Lincolnshire 003E","E01013222","Total",1560,765,795,1560,0,8,22.96,67.9
"2011","North East Lincolnshire 004A","E01013144","Total",1463,720,743,1455,8,7,88.18,16.6
"2011","North East Lincolnshire 004B","E01013145","Total",1302,634,668,1275,27,13,48.52,26.8
"2011","North East Lincolnshire 004C","E01013146","Total",1742,859,883,1742,0,21,204.10,8.5
"2011","North East Lincolnshire 004D","E01013148","Total",1439,737,702,1439,0,21,46.81,30.7
"2011","North East Lincolnshire 005A","E01013195","Total",1448,705,743,1447,1,6,15.28,94.8
"2011","North East Lincolnshire 005B","E01013196","Total",1415,695,720,1415,0,4,12.99,108.9
"2011","North East Lincolnshire 005C","E01013201","Total",1540,783,757,1540,0,9,22.10,69.7
"2011","North East Lincolnshire 005D","E01013202","Total",1543,765,778,1543,0,12,29.76,51.8
"2011","North East Lincolnshire 005E","E01013203","Total",1653,859,794,1653,0,5,12.71,130.1
"2011","North East Lincolnshire 006A","E01013138","Total",1382,705,677,1382,0,5,11.38,121.4
"2011","North East Lincolnshire 006B","E01013140","Total",1555,746,809,1555,0,6,17.80,87.4
"2011","North East Lincolnshire 006C","E01013141","Total",1628,803,825,1628,0,10,13.97,116.5
"2011","North East Lincolnshire 006D","E01013143","Total",1376,661,715,1376,0,5,11.76,117.0
"2011","North East Lincolnshire 007A","E01013173","Total",1234,593,641,1194,40,19,1828.31,0.7
"2011","North East Lincolnshire 007B","E01013223","Total",2940,1456,1484,2936,4,55,1136.26,2.6
"2011","North East Lincolnshire 007C","E01013224","Total",1883,931,952,1857,26,26,145.64,12.9
"2011","North East Lincolnshire 007D","E01013226","Total",1531,772,759,1531,0,19,1574.27,1.0
"2011","North East Lincolnshire 008A","E01013187","Total",1405,707,698,1307,98,19,36.60,38.4
"2011","North East Lincolnshire 008B","E01013188","Total",1568,780,788,1568,0,20,25.48,61.5
"2011","North East Lincolnshire 008C","E01013231","Total",1635,779,856,1615,20,6,19.20,85.2
"2011","North East Lincolnshire 008D","E01013233","Total",1444,699,745,1444,0,17,18.00,80.2
"2011","North East Lincolnshire 009A","E01013147","Total",1406,662,744,1406,0,3,43.48,32.3
"2011","North East Lincolnshire 009D","E01013234","Total",1443,654,789,1379,64,7,35.88,40.2
"2011","North East Lincolnshire 009E","E01033414","Total",2297,1105,1192,2253,44,33,91.29,25.2
"2011","North East Lincolnshire 010A","E01013128","Total",1449,718,731,1406,43,10,17.73,81.7
"2011","North East Lincolnshire 010B","E01013198","Total",1439,694,745,1419,20,13,30.09,47.8
"2011","North East Lincolnshire 010C","E01013199","Total",1187,587,600,1081,106,8,24.84,47.8
"2011","North East Lincolnshire 010D","E01013200","Total",1279,637,642,1279,0,8,23.79,53.8
"2011","North East Lincolnshire 011A","E01013159","Total",1489,779,710,1489,0,9,19.52,76.3
"2011","North East Lincolnshire 011B","E01013161","Total",1429,716,713,1429,0,4,15.54,92.0
"2011","North East Lincolnshire 011C","E01013162","Total",1608,857,751,1602,6,11,16.80,95.7
"2011","North East Lincolnshire 011D","E01013165","Total",1346,699,647,1346,0,6,26.06,51.7
"2011","North East Lincolnshire 012A","E01013158","Total",1465,709,756,1465,0,10,38.58,38.0
"2011","North East Lincolnshire 012B","E01013160","Total",1483,740,743,1483,0,9,53.26,27.8
"2011","North East Lincolnshire 012C","E01013163","Total",1324,679,645,1316,8,8,123.93,10.7
"2011","North East Lincolnshire 012D","E01013164","Total",1869,895,974,1745,124,8,76.76,24.3
"2011","North East Lincolnshire 012E","E01013197","Total",1285,621,664,1285,0,4,20.84,61.7
"2011","North East Lincolnshire 013A","E01013149","Total",1152,568,584,1152,0,5,35.18,32.7
"2011","North East Lincolnshire 013B","E01013150","Total",1324,646,678,1324,0,14,25.56,51.8
"2011","North East Lincolnshire 013C","E01013227","Total",1618,767,851,1618,0,7,31.70,51.0
"2011","North East Lincolnshire 013D","E01013228","Total",1573,783,790,1573,0,8,72.60,21.7
"2011","North East Lincolnshire 013E","E01013229","Total",1494,729,765,1494,0,9,24.08,62.0
"2011","North East Lincolnshire 014A","E01013131","Total",1529,715,814,1510,19,9,18.00,84.9
"2011","North East Lincolnshire 014B","E01013132","Total",1465,731,734,1465,0,7,28.14,52.1
"2011","North East Lincolnshire 014C","E01013133","Total",1530,727,803,1528,2,7,16.39,93.3
"2011","North East Lincolnshire 014D","E01013134","Total",1450,659,791,1449,1,7,27.79,52.2
"2011","North East Lincolnshire 015A","E01013206","Total",1351,640,711,1351,0,9,28.53,47.4
"2011","North East Lincolnshire 015B","E01013207","Total",1345,639,706,1345,0,14,39.41,34.1
"2011","North East Lincolnshire 015C","E01013211","Total",1512,739,773,1512,0,8,47.59,31.8
"2011","North East Lincolnshire 015D","E01013212","Total",1396,677,719,1351,45,8,25.14,55.5
"2011","North East Lincolnshire 016A","E01013181","Total",1541,790,751,1541,0,16,13.93,110.6
"2011","North East Lincolnshire 016B","E01013182","Total",1532,744,788,1383,149,17,68.61,22.3
"2011","North East Lincolnshire 016C","E01013183","Total",1560,780,780,1548,12,14,81.21,19.2
"2011","North East Lincolnshire 016D","E01013184","Total",1573,806,767,1449,124,20,30.15,52.2
"2011","North East Lincolnshire 016E","E01013185","Total",1616,780,836,1592,24,29,97.33,16.6
"2011","North East Lincolnshire 016F","E01013186","Total",1378,673,705,1297,81,32,50.34,27.4
"2011","North East Lincolnshire 017A","E01013129","Total",1533,790,743,1490,43,5,25.08,61.1
"2011","North East Lincolnshire 017B","E01013151","Total",1262,617,645,1260,2,19,78.06,16.2
"2011","North East Lincolnshire 017C","E01013152","Total",1505,739,766,1454,51,11,35.09,42.9
"2011","North East Lincolnshire 017D","E01013155","Total",1393,672,721,1393,0,18,35.00,39.8
"2011","North East Lincolnshire 018A","E01013130","Total",1375,653,722,1375,0,11,38.27,35.9
"2011","North East Lincolnshire 018B","E01013135","Total",1439,675,764,1439,0,3,42.20,34.1
"2011","North East Lincolnshire 018C","E01013154","Total",1396,702,694,1396,0,16,36.37,38.4
"2011","North East Lincolnshire 018D","E01013156","Total",1250,542,708,1250,0,4,56.59,22.1
"2011","North East Lincolnshire 019A","E01013204","Total",1415,675,740,1398,17,7,44.76,31.6
"2011","North East Lincolnshire 019B","E01013205","Total",1362,636,726,1337,25,9,18.67,73.0
"2011","North East Lincolnshire 019C","E01013208","Total",1418,670,748,1418,0,4,21.06,67.3
"2011","North East Lincolnshire 019D","E01013209","Total",1483,729,754,1483,0,6,39.04,38.0
"2011","North East Lincolnshire 019E","E01013210","Total",1446,684,762,1446,0,8,22.13,65.3
"2011","North East Lincolnshire 020A","E01013153","Total",1332,631,701,1332,0,10,179.66,7.4
"2011","North East Lincolnshire 020B","E01013157","Total",1864,877,987,1847,17,31,55.57,33.5
"2011","North East Lincolnshire 020C","E01013166","Total",1589,766,823,1552,37,14,39.33,40.4
"2011","North East Lincolnshire 020D","E01013167","Total",1787,904,883,1748,39,25,530.95,3.4
"2011","North East Lincolnshire 020E","E01013169","Total",1049,498,551,1049,0,12,61.33,17.1
"2011","North East Lincolnshire 021A","E01013189","Total",1480,712,768,1434,46,20,38.65,38.3
"2011","North East Lincolnshire 021B","E01013190","Total",2822,1387,1435,2822,0,29,103.73,27.2
"2011","North East Lincolnshire 021C","E01013191","Total",1584,758,826,1540,44,19,67.92,23.3
"2011","North East Lincolnshire 021D","E01013192","Total",1485,724,761,1485,0,6,34.97,42.5
"2011","North East Lincolnshire 021E","E01013194","Total",1461,690,771,1461,0,14,35.34,41.3
"2011","North East Lincolnshire 022A","E01013168","Total",1658,829,829,1618,40,29,343.96,4.8
"2011","North East Lincolnshire 022B","E01013170","Total",1508,721,787,1508,0,27,222.07,6.8
"2011","North East Lincolnshire 022C","E01013171","Total",1776,894,882,1776,0,31,197.06,9.0
"2011","North East Lincolnshire 022D","E01013172","Total",1481,702,779,1467,14,12,90.54,16.4
"2011","North East Lincolnshire 022E","E01013193","Total",1576,768,808,1576,0,17,47.56,33.1
"2011","North East Lincolnshire 023A","E01013213","Total",1225,552,673,1163,62,7,69.61,17.6
"2011","North East Lincolnshire 023B","E01013214","Total",1441,710,731,1441,0,28,1114.52,1.3
"2011","North East Lincolnshire 023C","E01013215","Total",1608,765,843,1518,90,33,462.56,3.5
"2011","North East Lincolnshire 023D","E01013216","Total",1301,639,662,1301,0,24,50.90,25.6
"2011","North East Lincolnshire 023E","E01013217","Total",1442,727,715,1438,4,21,44.67,32.3
"2011","North East Lincolnshire 023F","E01013225","Total",1086,499,587,1008,78,32,5253.66,0.2
"2011","North Lincolnshire 001A","E01013254","Total",1706,818,888,1679,27,14,236.44,7.2
"2011","North Lincolnshire 001B","E01013255","Total",1678,802,876,1634,44,11,72.27,23.2
"2011","North Lincolnshire 001C","E01013256","Total",2479,1249,1230,2460,19,24,100.97,24.6
"2011","North Lincolnshire 001D","E01013257","Total",1788,886,902,1788,0,30,1917.37,0.9
"2011","North Lincolnshire 001E","E01013258","Total",1699,825,874,1699,0,18,61.15,27.8
"2011","North Lincolnshire 001F","E01013259","Total",1716,800,916,1703,13,12,174.70,9.8
"2011","North Lincolnshire 002A","E01013303","Total",1292,660,632,1292,0,19,2056.25,0.6
"2011","North Lincolnshire 002B","E01013304","Total",1614,806,808,1614,0,21,402.02,4.0
"2011","North Lincolnshire 002C","E01013305","Total",1636,829,807,1596,40,21,1622.53,1.0
"2011","North Lincolnshire 002D","E01013307","Total",1740,841,899,1704,36,14,284.24,6.1
"2011","North Lincolnshire 003A","E01013288","Total",1579,808,771,1579,0,22,273.08,5.8
"2011","North Lincolnshire 003B","E01013291","Total",1595,780,815,1591,4,7,336.82,4.7
"2011","North Lincolnshire 003C","E01013292","Total",1725,845,880,1708,17,14,934.85,1.8
"2011","North Lincolnshire 003D","E01013294","Total",1552,780,772,1552,0,24,2662.69,0.6
"2011","North Lincolnshire 004A","E01013270","Total",1929,934,995,1914,15,26,1778.44,1.1
"2011","North Lincolnshire 004B","E01013306","Total",1544,762,782,1544,0,17,4523.72,0.3
"2011","North Lincolnshire 004C","E01013308","Total",1742,865,877,1742,0,13,2434.48,0.7
"2011","North Lincolnshire 004D","E01013309","Total",1586,765,821,1586,0,17,2763.66,0.6
"2011","North Lincolnshire 005A","E01013286","Total",2329,1129,1200,2309,20,18,757.92,3.1
"2011","North Lincolnshire 005B","E01013287","Total",1487,746,741,1461,26,14,888.04,1.7
"2011","North Lincolnshire 005C","E01013289","Total",1664,824,840,1639,25,17,1356.66,1.2
"2011","North Lincolnshire 005D","E01013290","Total",1662,827,835,1644,18,24,2570.79,0.6
"2011","North Lincolnshire 005E","E01013293","Total",1549,776,773,1549,0,16,101.96,15.2
"2011","North Lincolnshire 006A","E01013245","Total",1488,750,738,1488,0,6,106.39,14.0
"2011","North Lincolnshire 006B","E01013246","Total",1530,787,743,1530,0,8,4499.79,0.3
"2011","North Lincolnshire 006C","E01013247","Total",1756,874,882,1740,16,33,4202.86,0.4
"2011","North Lincolnshire 006D","E01013248","Total",1779,904,875,1747,32,37,393.63,4.5
"2011","North Lincolnshire 006E","E01013249","Total",1735,872,863,1735,0,14,120.86,14.4
"2011","North Lincolnshire 007A","E01013297","Total",2193,1112,1081,2138,55,14,439.71,5.0
"2011","North Lincolnshire 007B","E01013300","Total",1707,887,820,1671,36,11,90.82,18.8
"2011","North Lincolnshire 007C","E01013302","Total",1465,753,712,1419,46,28,114.59,12.8
"2011","North Lincolnshire 007D","E01013331","Total",1673,864,809,1673,0,11,335.58,5.0
"2011","North Lincolnshire 008A","E01013296","Total",1655,876,779,1633,22,8,17.78,93.1
"2011","North Lincolnshire 008B","E01013298","Total",1605,798,807,1605,0,13,29.21,54.9
"2011","North Lincolnshire 008C","E01013299","Total",1640,798,842,1640,0,5,32.63,50.3
"2011","North Lincolnshire 008D","E01013330","Total",1745,914,831,1695,50,5,49.29,35.4
"2011","North Lincolnshire 008E","E01013332","Total",1877,963,914,1863,14,25,28.64,65.5
"2011","North Lincolnshire 009A","E01013295","Total",1385,680,705,1385,0,11,36.44,38.0
"2011","North Lincolnshire 009B","E01013301","Total",1616,794,822,1616,0,13,45.56,35.5
"2011","North Lincolnshire 009C","E01013333","Total",1631,853,778,1631,0,26,37.23,43.8
"2011","North Lincolnshire 009D","E01013334","Total",1556,778,778,1556,0,12,68.02,22.9
"2011","North Lincolnshire 010A","E01013310","Total",1481,717,764,1481,0,14,581.31,2.5
"2011","North Lincolnshire 010B","E01013312","Total",1798,867,931,1798,0,9,39.30,45.8
"2011","North Lincolnshire 010C","E01013313","Total",1554,766,788,1552,2,12,310.76,5.0
"2011","North Lincolnshire 010D","E01013314","Total",1516,776,740,1516,0,14,44.23,34.3
"2011","North Lincolnshire 011A","E01013267","Total",1253,624,629,1226,27,25,3577.77,0.4
"2011","North Lincolnshire 011B","E01013268","Total",1262,600,662,1259,3,24,2933.96,0.4
"2011","North Lincolnshire 011C","E01013269","Total",1752,886,866,1738,14,31,1123.66,1.6
"2011","North Lincolnshire 011D","E01013271","Total",1923,927,996,1891,32,23,111.82,17.2
"2011","North Lincolnshire 011E","E01013272","Total",1675,841,834,1621,54,15,127.12,13.2
"2011","North Lincolnshire 011F","E01013273","Total",1745,842,903,1702,43,20,98.03,17.8
"2011","North Lincolnshire 012A","E01013279","Total",1474,706,768,1427,47,7,33.21,44.4
"2011","North Lincolnshire 012B","E01013285","Total",1262,633,629,1262,0,9,74.69,16.9
"2011","North Lincolnshire 012C","E01013316","Total",1456,735,721,1437,19,41,101.74,14.3
"2011","North Lincolnshire 012D","E01013321","Total",1684,827,857,1647,37,19,94.26,17.9
"2011","North Lincolnshire 013A","E01013274","Total",2116,1031,1085,1939,177,19,6331.11,0.3
"2011","North Lincolnshire 013B","E01013275","Total",1563,767,796,1563,0,16,330.64,4.7
"2011","North Lincolnshire 013C","E01013276","Total",1628,796,832,1622,6,10,67.46,24.1
"2011","North Lincolnshire 013D","E01013277","Total",1486,716,770,1486,0,14,78.50,18.9
"2011","North Lincolnshire 014A","E01013315","Total",1520,688,832,1494,26,4,35.68,42.6
"2011","North Lincolnshire 014B","E01013317","Total",1407,673,734,1352,55,15,39.87,35.3
"2011","North Lincolnshire 014C","E01013318","Total",1537,743,794,1537,0,12,34.04,45.2
"2011","North Lincolnshire 014D","E01013319","Total",2243,1138,1105,2243,0,6,31.79,70.6
"2011","North Lincolnshire 015A","E01013238","Total",1677,829,848,1677,0,7,37.74,44.4
"2011","North Lincolnshire 015B","E01013240","Total",2356,1170,1186,2301,55,12,113.12,20.8
"2011","North Lincolnshire 015C","E01013311","Total",1852,901,951,1809,43,6,49.14,37.7
"2011","North Lincolnshire 015D","E01013320","Total",1494,758,736,1494,0,6,27.98,53.4
"2011","North Lincolnshire 016A","E01013278","Total",1500,737,763,1500,0,5,21.08,71.2
"2011","North Lincolnshire 016B","E01013280","Total",1462,703,759,1462,0,6,47.97,30.5
"2011","North Lincolnshire 016C","E01013281","Total",1375,652,723,1375,0,10,41.34,33.3
"2011","North Lincolnshire 016D","E01013283","Total",1483,723,760,1483,0,5,64.31,23.1
"2011","North Lincolnshire 017A","E01013236","Total",1557,738,819,1557,0,11,32.74,47.6
"2011","North Lincolnshire 017B","E01013239","Total",1623,792,831,1557,66,16,36.46,44.5
"2011","North Lincolnshire 017C","E01013282","Total",1587,778,809,1587,0,11,36.32,43.7
"2011","North Lincolnshire 017D","E01013284","Total",1606,772,834,1606,0,12,29.81,53.9
"2011","North Lincolnshire 018B","E01013237","Total",1802,832,970,1747,55,15,27.39,65.8
"2011","North Lincolnshire 018C","E01013261","Total",1458,712,746,1458,0,21,36.85,39.6
"2011","North Lincolnshire 018D","E01013262","Total",1358,683,675,1358,0,16,40.63,33.4
"2011","North Lincolnshire 018E","E01013263","Total",1434,695,739,1434,0,13,42.46,33.8
"2011","North Lincolnshire 018F","E01033296","Total",1439,702,737,1439,0,13,37.13,38.8
"2011","North Lincolnshire 018G","E01033297","Total",1669,844,825,1669,0,25,25.17,66.3
"2011","North Lincolnshire 019A","E01013260","Total",1477,722,755,1477,0,17,37.50,39.4
"2011","North Lincolnshire 019B","E01013264","Total",1729,859,870,1729,0,18,396.58,4.4
"2011","North Lincolnshire 019C","E01013265","Total",1648,818,830,1648,0,16,112.33,14.7
"2011","North Lincolnshire 019D","E01013266","Total",1934,925,1009,1934,0,25,52.19,37.1
"2011","North Lincolnshire 020A","E01013241","Total",1520,724,796,1520,0,18,492.37,3.1
"2011","North Lincolnshire 020B","E01013242","Total",1770,902,868,1770,0,24,2966.63,0.6
"2011","North Lincolnshire 020C","E01013243","Total",2147,1026,1121,2147,0,36,2053.09,1.0
"2011","North Lincolnshire 020D","E01013244","Total",1810,891,919,1806,4,21,541.34,3.3
"2011","North Lincolnshire 021A","E01013324","Total",1553,783,770,1553,0,32,5546.60,0.3
"2011","North Lincolnshire 021B","E01013326","Total",1586,782,804,1580,6,39,365.61,4.3
"2011","North Lincolnshire 021C","E01013327","Total",1409,680,729,1409,0,18,82.33,17.1
"2011","North Lincolnshire 021D","E01013328","Total",1293,611,682,1293,0,25,166.47,7.8
"2011","North Lincolnshire 022A","E01013322","Total",1940,948,992,1919,21,33,990.44,2.0
"2011","North Lincolnshire 022B","E01013323","Total",1691,861,830,1580,111,40,2514.60,0.7
"2011","North Lincolnshire 022C","E01013325","Total",1564,784,780,1536,28,30,2922.30,0.5
"2011","North Lincolnshire 022D","E01013329","Total",1819,887,932,1818,1,11,1565.69,1.2
"2011","North Lincolnshire 023A","E01013250","Total",1618,768,850,1597,21,29,1707.82,0.9
"2011","North Lincolnshire 023B","E01013251","Total",1816,887,929,1816,0,37,3743.51,0.5
"2011","North Lincolnshire 023C","E01013252","Total",1761,862,899,1735,26,29,258.14,6.8
"2011","North Lincolnshire 023D","E01013253","Total",1967,969,998,1946,21,17,2207.08,0.9
"2011","York 001A","E01013436","Total",1762,863,899,1687,75,56,772.99,2.3
"2011","York 001B","E01013438","Total",1790,854,936,1779,11,31,367.59,4.9
"2011","York 001C","E01013439","Total",1515,737,778,1450,65,34,743.43,2.0
"2011","York 001D","E01013440","Total",1856,896,960,1856,0,44,176.90,10.5
"2011","York 002A","E01013370","Total",1501,686,815,1495,6,11,31.42,47.8
"2011","York 002B","E01013373","Total",1480,702,778,1429,51,26,60.13,24.6
"2011","York 002C","E01013375","Total",1308,592,716,1308,0,20,63.85,20.5
"2011","York 002D","E01013376","Total",1467,701,766,1467,0,27,637.52,2.3
"2011","York 003A","E01013371","Total",1465,716,749,1465,0,38,33.04,44.3
"2011","York 003B","E01013372","Total",1608,691,917,1573,35,14,38.13,42.2
"2011","York 003C","E01013374","Total",1557,766,791,1526,31,31,71.95,21.6
"2011","York 003D","E01013377","Total",1652,770,882,1620,32,40,718.55,2.3
"2011","York 004A","E01013404","Total",1452,693,759,1433,19,13,117.46,12.4
"2011","York 004B","E01013407","Total",1441,645,796,1389,52,29,230.23,6.3
"2011","York 004C","E01013408","Total",1329,622,707,1324,5,19,52.91,25.1
"2011","York 004D","E01013410","Total",1431,637,794,1397,34,7,33.90,42.2
"2011","York 005A","E01013405","Total",1404,669,735,1404,0,16,19.94,70.4
"2011","York 005B","E01013406","Total",1959,959,1000,1959,0,24,39.03,50.2
"2011","York 005C","E01013409","Total",1566,743,823,1566,0,15,521.21,3.0
"2011","York 005D","E01013411","Total",1526,721,805,1526,0,15,42.50,35.9
"2011","York 006A","E01013428","Total",1638,809,829,1636,2,9,34.87,47.0
"2011","York 006B","E01013429","Total",2065,1035,1030,2065,0,33,105.97,19.5
"2011","York 006C","E01013430","Total",1549,762,787,1549,0,36,980.63,1.6
"2011","York 006D","E01013431","Total",1556,755,801,1556,0,23,217.37,7.2
"2011","York 006E","E01013435","Total",1466,714,752,1466,0,18,22.40,65.4
"2011","York 007A","E01013344","Total",1597,818,779,1432,165,31,32.66,48.9
"2011","York 007B","E01013346","Total",1651,806,845,1623,28,42,68.17,24.2
"2011","York 007C","E01013432","Total",2109,987,1122,2038,71,19,145.48,14.5
"2011","York 007D","E01013433","Total",1461,701,760,1461,0,29,36.67,39.8
"2011","York 007E","E01013434","Total",1462,720,742,1398,64,18,128.51,11.4
"2011","York 008A","E01013379","Total",1476,708,768,1467,9,27,30.56,48.3
"2011","York 008B","E01013380","Total",1771,883,888,1672,99,25,25.90,68.4
"2011","York 008C","E01013385","Total",1459,715,744,1455,4,14,45.06,32.4
"2011","York 008D","E01013387","Total",1477,705,772,1475,2,32,59.96,24.6
"2011","York 008E","E01013388","Total",1033,497,536,1033,0,10,305.96,3.4
"2011","York 008F","E01013389","Total",1158,578,580,1158,0,11,32.73,35.4
"2011","York 008G","E01013437","Total",1214,625,589,1180,34,20,1322.76,0.9
"2011","York 009A","E01013343","Total",2005,943,1062,1883,122,22,24.52,81.8
"2011","York 009B","E01013345","Total",1720,818,902,1720,0,19,19.84,86.7
"2011","York 009C","E01013347","Total",1637,799,838,1637,0,5,20.82,78.6
"2011","York 009D","E01013349","Total",1387,686,701,1387,0,9,15.76,88.0
"2011","York 009E","E01013350","Total",1638,786,852,1609,29,12,29.42,55.7
"2011","York 010A","E01013348","Total",1913,893,1020,1545,368,18,48.40,39.5
"2011","York 010B","E01013368","Total",2246,1079,1167,2234,12,29,17.62,127.5
"2011","York 010C","E01013382","Total",1656,786,870,1656,0,13,34.69,47.7
"2011","York 010D","E01013383","Total",2298,1170,1128,2281,17,24,44.77,51.3
"2011","York 010E","E01013386","Total",1772,836,936,1769,3,19,24.65,71.9
"2011","York 011A","E01013421","Total",1548,703,845,1237,311,41,2332.15,0.7
"2011","York 011B","E01013422","Total",1686,801,885,1686,0,44,354.88,4.8
"2011","York 011C","E01013426","Total",1669,788,881,1648,21,41,1259.56,1.3
"2011","York 011D","E01013427","Total",1442,698,744,1442,0,29,82.81,17.4
"2011","York 012A","E01013335","Total",1582,730,852,1577,5,6,32.25,49.1
"2011","York 012B","E01013336","Total",1470,744,726,1470,0,16,31.29,47.0
"2011","York 012C","E01013337","Total",1650,812,838,1650,0,23,35.40,46.6
"2011","York 012D","E01013338","Total",2307,1146,1161,2229,78,13,46.50,49.6
"2011","York 012E","E01013339","Total",1595,782,813,1595,0,14,70.46,22.6
"2011","York 012F","E01013392","Total",1560,815,745,1542,18,26,51.10,30.5
"2011","York 013A","E01013366","Total",1992,1086,906,1732,260,38,68.75,29.0
"2011","York 013C","E01013369","Total",1863,929,934,1819,44,9,27.39,68.0
"2011","York 013E","E01013416","Total",1564,754,810,1550,14,21,24.71,63.3
"2011","York 013F","E01033067","Total",1363,691,672,1327,36,3,51.00,26.7
"2011","York 013G","E01033068","Total",1144,613,531,1144,0,9,33.80,33.8
"2011","York 013H","E01033069","Total",1158,602,556,1143,15,12,12.44,93.1
"2011","York 013I","E01033070","Total",1538,760,778,1119,419,14,34.92,44.0
"2011","York 014A","E01013381","Total",1544,770,774,1544,0,19,36.98,41.8
"2011","York 014B","E01013402","Total",1758,873,885,1717,41,28,41.95,41.9
"2011","York 014C","E01013419","Total",1532,704,828,1484,48,25,477.74,3.2
"2011","York 014D","E01013420","Total",2038,1011,1027,2038,0,14,99.63,20.5
"2011","York 015A","E01013384","Total",1749,868,881,1749,0,7,26.13,66.9
"2011","York 015B","E01013398","Total",1625,787,838,1608,17,12,24.01,67.7
"2011","York 015C","E01013399","Total",1774,846,928,1774,0,12,23.56,75.3
"2011","York 015D","E01013400","Total",1936,1018,918,1936,0,15,15.10,128.2
"2011","York 015E","E01013401","Total",1697,898,799,1696,1,16,25.00,67.9
"2011","York 015F","E01013403","Total",1887,951,936,1887,0,14,32.10,58.8
"2011","York 016A","E01013393","Total",1599,759,840,1599,0,12,25.53,62.6
"2011","York 016B","E01013394","Total",1312,623,689,1312,0,8,21.11,62.2
"2011","York 016C","E01013395","Total",1450,733,717,1450,0,20,21.94,66.1
"2011","York 016D","E01013396","Total",1644,769,875,1571,73,20,42.81,38.4
"2011","York 016E","E01013441","Total",1532,717,815,1528,4,17,33.28,46.0
"2011","York 016F","E01013445","Total",1538,725,813,1538,0,20,28.58,53.8
"2011","York 017A","E01013390","Total",1573,774,799,1573,0,10,26.93,58.4
"2011","York 017B","E01013391","Total",2198,1124,1074,2167,31,20,92.40,23.8
"2011","York 017C","E01013397","Total",1496,744,752,1494,2,20,29.49,50.7
"2011","York 017D","E01013413","Total",1676,843,833,1665,11,23,23.95,70.0
"2011","York 017E","E01013417","Total",1978,975,1003,1855,123,46,42.23,46.8
"2011","York 018A","E01013442","Total",1379,644,735,1379,0,15,42.61,32.4
"2011","York 018B","E01013443","Total",1536,731,805,1440,96,1,35.68,43.0
"2011","York 018C","E01013444","Total",1413,662,751,1413,0,7,20.59,68.6
"2011","York 018D","E01013446","Total",1660,799,861,1660,0,10,29.75,55.8
"2011","York 018E","E01013447","Total",1499,710,789,1499,0,9,31.24,48.0
"2011","York 018F","E01013448","Total",1375,700,675,1375,0,8,15.08,91.2
"2011","York 019A","E01013360","Total",1848,892,956,1820,28,28,64.69,28.6
"2011","York 019B","E01013361","Total",1894,940,954,1879,15,26,22.34,84.8
"2011","York 019C","E01013362","Total",1977,1098,879,1678,299,26,83.05,23.8
"2011","York 019D","E01013363","Total",2094,1031,1063,1865,229,23,44.37,47.2
"2011","York 019E","E01013364","Total",2031,1053,978,2007,24,11,31.96,63.5
"2011","York 019F","E01013418","Total",1555,737,818,1549,6,9,22.93,67.8
"2011","York 020A","E01013351","Total",1907,917,990,1855,52,41,3024.65,0.6
"2011","York 020B","E01013352","Total",1720,836,884,1700,20,31,112.72,15.3
"2011","York 020C","E01013451","Total",1239,602,637,1239,0,25,962.92,1.3
"2011","York 020D","E01013452","Total",1674,784,890,1634,40,27,541.08,3.1
"2011","York 021A","E01013357","Total",2024,953,1071,1990,34,36,77.29,26.2
"2011","York 021B","E01013358","Total",1574,773,801,1559,15,16,52.57,29.9
"2011","York 021C","E01013412","Total",1780,857,923,1780,0,19,195.97,9.1
"2011","York 021D","E01013414","Total",1661,810,851,1661,0,17,47.70,34.8
"2011","York 022A","E01013353","Total",1597,766,831,1596,1,20,35.43,45.1
"2011","York 022B","E01013354","Total",1414,688,726,1414,0,23,71.38,19.8
"2011","York 022C","E01013355","Total",1476,704,772,1476,0,20,113.38,13.0
"2011","York 022D","E01013356","Total",1452,709,743,1452,0,18,28.37,51.2
"2011","York 022E","E01013359","Total",1547,757,790,1547,0,11,51.29,30.2
"2011","York 022F","E01013449","Total",1679,813,866,1679,0,20,41.17,40.8
"2011","York 023A","E01013365","Total",2785,1311,1474,2683,102,42,624.25,4.5
"2011","York 023B","E01013378","Total",4792,2185,2607,1125,3667,68,1268.44,3.8
"2011","York 023C","E01013450","Total",1240,629,611,1237,3,26,3193.08,0.4
"2011","York 024A","E01013340","Total",1274,634,640,1274,0,44,312.56,4.1
"2011","York 024B","E01013341","Total",1272,578,694,1266,6,14,62.00,20.5
"2011","York 024C","E01013342","Total",1360,666,694,1355,5,29,778.27,1.7
"2011","York 024D","E01013423","Total",1285,640,645,1285,0,23,48.76,26.4
"2011","York 024E","E01013424","Total",1335,665,670,1335,0,56,190.23,7.0
"2011","York 024F","E01013425","Total",1553,737,816,1553,0,25,527.14,2.9
"2011","Craven 001A","E01027558","Total",1881,918,963,1870,11,42,3515.38,0.5
"2011","Craven 001B","E01027559","Total",1725,863,862,1713,12,32,237.48,7.3
"2011","Craven 001C","E01027569","Total",1334,651,683,1328,6,41,10239.40,0.1
"2011","Craven 001D","E01027570","Total",2474,1196,1278,2425,49,35,10100.24,0.2
"2011","Craven 002A","E01027562","Total",1641,838,803,1580,61,51,14914.53,0.1
"2011","Craven 002B","E01027567","Total",1611,748,863,1585,26,27,4777.50,0.3
"2011","Craven 002C","E01027585","Total",1874,906,968,1791,83,49,21750.88,0.1
"2011","Craven 003A","E01027568","Total",2168,1066,1102,2164,4,37,3480.52,0.6
"2011","Craven 003B","E01027571","Total",1929,965,964,1730,199,57,10232.21,0.2
"2011","Craven 003C","E01027572","Total",2012,986,1026,2008,4,36,1093.45,1.8
"2011","Craven 003D","E01027573","Total",1569,745,824,1516,53,29,6280.95,0.2
"2011","Craven 004A","E01027557","Total",1673,832,841,1592,81,53,15788.32,0.1
"2011","Craven 004B","E01027561","Total",1879,905,974,1879,0,41,1802.85,1.0
"2011","Craven 004C","E01027576","Total",1567,749,818,1561,6,74,445.39,3.5
"2011","Craven 005A","E01027574","Total",1458,709,749,1458,0,19,422.94,3.4
"2011","Craven 005B","E01027575","Total",1898,885,1013,1897,1,19,40.12,47.3
"2011","Craven 005C","E01027577","Total",1918,934,984,1915,3,45,58.63,32.7
"2011","Craven 005D","E01027579","Total",1132,529,603,1132,0,7,43.79,25.9
"2011","Craven 006A","E01027578","Total",1517,726,791,1515,2,15,17.65,85.9
"2011","Craven 006B","E01027580","Total",1122,535,587,1121,1,9,396.40,2.8
"2011","Craven 006C","E01027581","Total",2500,1206,1294,2454,46,24,178.86,14.0
"2011","Craven 006D","E01027582","Total",1511,730,781,1511,0,19,100.71,15.0
"2011","Craven 007A","E01027556","Total",1690,835,855,1690,0,42,1558.63,1.1
"2011","Craven 007B","E01027560","Total",2355,1169,1186,2345,10,36,1904.32,1.2
"2011","Craven 007C","E01027563","Total",1396,641,755,1379,17,17,680.01,2.1
"2011","Craven 007D","E01027586","Total",1934,933,1001,1874,60,38,4818.15,0.4
"2011","Craven 008A","E01027555","Total",1947,920,1027,1879,68,47,1318.34,1.5
"2011","Craven 008B","E01027564","Total",1211,542,669,1111,100,13,27.73,43.7
"2011","Craven 008C","E01027565","Total",1530,720,810,1530,0,28,137.90,11.1
"2011","Craven 008D","E01027566","Total",1239,604,635,1235,4,15,426.71,2.9
"2011","Craven 008E","E01027583","Total",2098,974,1124,2006,92,27,51.52,40.7
"2011","Craven 008F","E01027584","Total",1616,794,822,1581,35,31,897.30,1.8
"2011","Hambleton 001A","E01027591","Total",1669,828,841,1668,1,33,4796.94,0.3
"2011","Hambleton 001B","E01027597","Total",1568,791,777,1568,0,32,3620.59,0.4
"2011","Hambleton 001C","E01027599","Total",1653,791,862,1653,0,19,34.65,47.7
"2011","Hambleton 001D","E01027623","Total",1297,597,700,1297,0,35,102.49,12.7
"2011","Hambleton 001E","E01027625","Total",1651,761,890,1651,0,14,74.48,22.2
"2011","Hambleton 002A","E01027598","Total",1752,850,902,1751,1,39,804.45,2.2
"2011","Hambleton 002B","E01027618","Total",2421,1187,1234,2421,0,71,3037.07,0.8
"2011","Hambleton 002C","E01027624","Total",1269,615,654,1269,0,30,448.02,2.8
"2011","Hambleton 002D","E01027626","Total",1320,630,690,1320,0,28,1818.20,0.7
"2011","Hambleton 002E","E01027627","Total",1820,919,901,1820,0,55,11228.37,0.2
"2011","Hambleton 003A","E01027590","Total",2055,1015,1040,2055,0,31,1497.44,1.4
"2011","Hambleton 003B","E01027592","Total",1744,888,856,1744,0,52,7445.73,0.2
"2011","Hambleton 003C","E01027613","Total",1764,887,877,1761,3,50,9218.71,0.2
"2011","Hambleton 003D","E01027617","Total",1100,560,540,1100,0,23,3459.45,0.3
"2011","Hambleton 004A","E01027605","Total",1632,810,822,1524,108,24,27.22,60.0
"2011","Hambleton 004B","E01027606","Total",1522,708,814,1522,0,28,72.28,21.1
"2011","Hambleton 004C","E01027608","Total",1822,999,823,1652,170,11,43.82,41.6
"2011","Hambleton 004D","E01027609","Total",1342,642,700,1342,0,10,441.33,3.0
"2011","Hambleton 004E","E01027610","Total",1685,802,883,1685,0,16,27.16,62.0
"2011","Hambleton 004F","E01027611","Total",1953,926,1027,1903,50,31,876.01,2.2
"2011","Hambleton 004G","E01027612","Total",1693,817,876,1686,7,7,37.96,44.6
"2011","Hambleton 004H","E01027616","Total",1434,669,765,1430,4,23,148.43,9.7
"2011","Hambleton 005A","E01027603","Total",1966,967,999,1883,83,33,2767.05,0.7
"2011","Hambleton 005B","E01027604","Total",1761,848,913,1761,0,36,6789.28,0.3
"2011","Hambleton 005C","E01027607","Total",1237,603,634,1237,0,30,352.78,3.5
"2011","Hambleton 005D","E01027614","Total",1236,583,653,1236,0,15,131.53,9.4
"2011","Hambleton 005E","E01027615","Total",1276,626,650,1276,0,38,151.90,8.4
"2011","Hambleton 006A","E01027587","Total",1358,652,706,1330,28,10,43.32,31.3
"2011","Hambleton 006B","E01027588","Total",1570,744,826,1519,51,18,631.46,2.5
"2011","Hambleton 006C","E01027589","Total",1673,829,844,1673,0,42,482.20,3.5
"2011","Hambleton 006D","E01027593","Total",1728,864,864,1726,2,45,6232.03,0.3
"2011","Hambleton 007B","E01027628","Total",1865,921,944,1862,3,45,5620.76,0.3
"2011","Hambleton 007C","E01027633","Total",1852,898,954,1844,8,37,5812.30,0.3
"2011","Hambleton 007D","E01033065","Total",1199,602,597,1197,2,32,1196.87,1.0
"2011","Hambleton 007E","E01033066","Total",2301,1426,875,1677,624,26,2241.73,1.0
"2011","Hambleton 008A","E01027620","Total",1979,940,1039,1921,58,30,88.30,22.4
"2011","Hambleton 008B","E01027630","Total",1740,842,898,1730,10,20,59.39,29.3
"2011","Hambleton 008C","E01027631","Total",1386,692,694,1386,0,19,335.64,4.1
"2011","Hambleton 008D","E01027632","Total",1484,740,744,1479,5,23,1487.69,1.0
"2011","Hambleton 008E","E01027637","Total",1863,903,960,1863,0,45,7566.34,0.2
"2011","Hambleton 009A","E01027621","Total",2270,1107,1163,2239,31,33,1063.65,2.1
"2011","Hambleton 009B","E01027629","Total",1378,655,723,1378,0,2,30.29,45.5
"2011","Hambleton 009C","E01027635","Total",2604,1445,1159,2346,258,58,4975.37,0.5
"2011","Hambleton 009D","E01027636","Total",2078,1018,1060,2067,11,56,7411.86,0.3
"2011","Hambleton 010A","E01027594","Total",1499,677,822,1485,14,11,64.07,23.4
"2011","Hambleton 010B","E01027595","Total",1620,748,872,1620,0,48,2556.91,0.6
"2011","Hambleton 010C","E01027596","Total",1508,695,813,1504,4,45,202.15,7.5
"2011","Hambleton 010D","E01027601","Total",1940,941,999,1938,2,51,4310.35,0.5
"2011","Hambleton 010E","E01027622","Total",1919,931,988,1917,2,42,6967.97,0.3
"2011","Hambleton 011A","E01027600","Total",1922,987,935,1914,8,45,5523.21,0.3
"2011","Hambleton 011B","E01027619","Total",2672,1384,1288,2461,211,46,3434.52,0.8
"2011","Hambleton 011C","E01027634","Total",2090,1022,1068,2030,60,63,3325.23,0.6
"2011","Harrogate 001A","E01027666","Total",1715,833,882,1715,0,34,7721.69,0.2
"2011","Harrogate 001B","E01027667","Total",1394,690,704,1364,30,58,4852.52,0.3
"2011","Harrogate 001C","E01027685","Total",1205,558,647,1201,4,14,615.33,2.0
"2011","Harrogate 001D","E01027686","Total",1145,577,568,1128,17,26,11289.76,0.1
"2011","Harrogate 002A","E01027712","Total",1748,1047,701,1318,430,34,230.52,7.6
"2011","Harrogate 002B","E01027713","Total",1686,809,877,1630,56,23,122.53,13.8
"2011","Harrogate 002C","E01027714","Total",1657,808,849,1609,48,22,144.63,11.5
"2011","Harrogate 002D","E01027715","Total",1196,594,602,1114,82,23,48.29,24.8
"2011","Harrogate 003A","E01027643","Total",1449,725,724,1447,2,32,2977.11,0.5
"2011","Harrogate 003B","E01027688","Total",1590,742,848,1553,37,33,3538.66,0.4
"2011","Harrogate 003C","E01027736","Total",1638,765,873,1564,74,25,4506.36,0.4
"2011","Harrogate 003D","E01027737","Total",1841,1031,810,1611,230,32,2463.23,0.7
"2011","Harrogate 004A","E01027705","Total",1668,843,825,1659,9,27,117.32,14.2
"2011","Harrogate 004B","E01027706","Total",1943,951,992,1931,12,12,34.78,55.9
"2011","Harrogate 004C","E01027707","Total",1751,863,888,1751,0,20,142.69,12.3
"2011","Harrogate 004D","E01027708","Total",1430,692,738,1383,47,12,38.85,36.8
"2011","Harrogate 004E","E01027709","Total",1207,603,604,1203,4,6,69.80,17.3
"2011","Harrogate 004F","E01027710","Total",1120,527,593,1054,66,4,24.60,45.5
"2011","Harrogate 004G","E01027711","Total",1296,644,652,1296,0,10,19.82,65.4
"2011","Harrogate 005A","E01027644","Total",1511,722,789,1488,23,31,896.95,1.7
"2011","Harrogate 005B","E01027645","Total",1593,762,831,1524,69,20,86.06,18.5
"2011","Harrogate 005C","E01027647","Total",1609,796,813,1604,5,52,3499.41,0.5
"2011","Harrogate 005D","E01027687","Total",1498,759,739,1494,4,30,2328.53,0.6
"2011","Harrogate 006A","E01027681","Total",1607,796,811,1605,2,43,3857.09,0.4
"2011","Harrogate 006B","E01027693","Total",1793,881,912,1791,2,30,8558.81,0.2
"2011","Harrogate 006C","E01027701","Total",1576,787,789,1568,8,29,15224.39,0.1
"2011","Harrogate 006D","E01027702","Total",1142,541,601,1125,17,10,80.76,14.1
"2011","Harrogate 007A","E01027642","Total",1393,681,712,1393,0,39,2098.82,0.7
"2011","Harrogate 007B","E01027646","Total",1546,733,813,1546,0,43,2634.26,0.6
"2011","Harrogate 007C","E01027674","Total",1398,679,719,1352,46,53,201.15,7.0
"2011","Harrogate 007D","E01027675","Total",2395,1189,1206,2384,11,54,462.55,5.2
"2011","Harrogate 008A","E01027641","Total",1297,656,641,1297,0,51,57.18,22.7
"2011","Harrogate 008B","E01027664","Total",2169,1052,1117,2118,51,36,1251.15,1.7
"2011","Harrogate 008C","E01027665","Total",1137,565,572,1081,56,27,1459.49,0.8
"2011","Harrogate 008D","E01027722","Total",1425,692,733,1425,0,16,58.19,24.5
"2011","Harrogate 009A","E01027668","Total",1539,722,817,1539,0,16,29.84,51.6
"2011","Harrogate 009B","E01027669","Total",1847,906,941,1841,6,26,36.60,50.5
"2011","Harrogate 009C","E01027673","Total",1754,854,900,1750,4,34,159.47,11.0
"2011","Harrogate 009D","E01027676","Total",1762,869,893,1762,0,12,35.77,49.3
"2011","Harrogate 010A","E01027638","Total",1339,668,671,1339,0,11,29.59,45.3
"2011","Harrogate 010B","E01027639","Total",1284,615,669,1284,0,20,323.11,4.0
"2011","Harrogate 010C","E01027640","Total",1489,713,776,1489,0,14,22.53,66.1
"2011","Harrogate 010D","E01027690","Total",1424,676,748,1424,0,18,26.49,53.8
"2011","Harrogate 010E","E01027738","Total",1321,651,670,1321,0,14,17.82,74.1
"2011","Harrogate 010F","E01027739","Total",1100,546,554,1094,6,11,11.88,92.6
"2011","Harrogate 010G","E01027741","Total",1369,652,717,1369,0,12,26.57,51.5
"2011","Harrogate 011A","E01027689","Total",1392,678,714,1392,0,20,29.06,47.9
"2011","Harrogate 011B","E01027691","Total",1494,724,770,1494,0,14,80.11,18.6
"2011","Harrogate 011C","E01027720","Total",1480,738,742,1480,0,8,43.75,33.8
"2011","Harrogate 011D","E01027721","Total",1507,731,776,1507,0,15,48.54,31.0
"2011","Harrogate 011E","E01027723","Total",1490,726,764,1490,0,12,28.54,52.2
"2011","Harrogate 012A","E01027670","Total",1627,802,825,1627,0,30,292.83,5.6
"2011","Harrogate 012B","E01027671","Total",1570,760,810,1567,3,42,131.99,11.9
"2011","Harrogate 012C","E01027672","Total",1782,851,931,1703,79,48,179.85,9.9
"2011","Harrogate 012D","E01027704","Total",1171,578,593,1159,12,27,2193.01,0.5
"2011","Harrogate 013A","E01027649","Total",1754,849,905,1631,123,20,102.68,17.1
"2011","Harrogate 013B","E01027651","Total",1519,708,811,1519,0,14,29.04,52.3
"2011","Harrogate 013C","E01027657","Total",1260,656,604,1245,15,9,15.06,83.7
"2011","Harrogate 013D","E01027658","Total",1566,758,808,1566,0,18,26.12,60.0
"2011","Harrogate 013E","E01027692","Total",1176,577,599,1171,5,15,15.81,74.4
"2011","Harrogate 013F","E01027740","Total",1556,733,823,1536,20,7,71.36,21.8
"2011","Harrogate 014A","E01027648","Total",1606,783,823,1596,10,16,25.02,64.2
"2011","Harrogate 014B","E01027650","Total",1538,727,811,1538,0,21,25.13,61.2
"2011","Harrogate 014C","E01027726","Total",1749,850,899,1558,191,18,82.77,21.1
"2011","Harrogate 014D","E01027727","Total",1558,757,801,1553,5,18,36.36,42.8
"2011","Harrogate 014E","E01027728","Total",1343,628,715,1343,0,9,33.16,40.5
"2011","Harrogate 014F","E01027729","Total",1576,751,825,1576,0,9,20.06,78.6
"2011","Harrogate 015A","E01027652","Total",1585,742,843,1483,102,19,50.71,31.3
"2011","Harrogate 015B","E01027655","Total",1483,638,845,1176,307,38,59.83,24.8
"2011","Harrogate 015C","E01027659","Total",1786,955,831,1775,11,25,21.95,81.4
"2011","Harrogate 015D","E01027677","Total",1429,722,707,1349,80,21,31.78,45.0
"2011","Harrogate 015E","E01027678","Total",1697,910,787,1682,15,19,34.81,48.8
"2011","Harrogate 015F","E01027680","Total",1307,639,668,1299,8,18,14.48,90.3
"2011","Harrogate 016A","E01027683","Total",1457,717,740,1457,0,31,720.49,2.0
"2011","Harrogate 016B","E01027684","Total",1431,721,710,1431,0,46,4974.47,0.3
"2011","Harrogate 016C","E01027695","Total",1686,826,860,1653,33,42,2108.50,0.8
"2011","Harrogate 016D","E01027696","Total",1989,1037,952,1403,586,60,3811.19,0.5
"2011","Harrogate 016E","E01027703","Total",1844,873,971,1789,55,31,5324.90,0.3
"2011","Harrogate 017A","E01027660","Total",1537,744,793,1495,42,33,181.08,8.5
"2011","Harrogate 017B","E01027661","Total",1438,684,754,1438,0,10,62.06,23.2
"2011","Harrogate 017C","E01027662","Total",1262,611,651,1202,60,45,122.96,10.3
"2011","Harrogate 017D","E01027663","Total",1359,635,724,1359,0,18,85.24,15.9
"2011","Harrogate 017E","E01027697","Total",1454,711,743,1454,0,27,38.40,37.9
"2011","Harrogate 017F","E01027733","Total",1415,667,748,1317,98,52,65.27,21.7
"2011","Harrogate 018A","E01027682","Total",1639,797,842,1639,0,34,2577.75,0.6
"2011","Harrogate 018B","E01027694","Total",1332,662,670,1220,112,18,1156.03,1.2
"2011","Harrogate 018C","E01027734","Total",1549,767,782,1549,0,51,7343.74,0.2
"2011","Harrogate 018D","E01027735","Total",1649,834,815,1648,1,33,9239.50,0.2
"2011","Harrogate 019A","E01027656","Total",1652,803,849,1631,21,31,40.52,40.8
"2011","Harrogate 019B","E01027679","Total",1595,733,862,1522,73,32,41.44,38.5
"2011","Harrogate 019C","E01027730","Total",1533,756,777,1516,17,35,38.33,40.0
"2011","Harrogate 019D","E01027731","Total",1459,675,784,1446,13,17,29.24,49.9
"2011","Harrogate 019E","E01027732","Total",1342,634,708,1260,82,48,58.67,22.9
"2011","Harrogate 020A","E01027653","Total",1454,647,807,1359,95,34,97.12,15.0
"2011","Harrogate 020B","E01027654","Total",1228,580,648,1187,41,35,243.03,5.1
"2011","Harrogate 020C","E01027698","Total",1561,747,814,1545,16,48,83.07,18.8
"2011","Harrogate 020D","E01027716","Total",1437,680,757,1437,0,42,111.11,12.9
"2011","Harrogate 020E","E01027717","Total",1560,734,826,1531,29,35,31.82,49.0
"2011","Harrogate 020F","E01027718","Total",1886,871,1015,1849,37,58,53.93,35.0
"2011","Harrogate 020G","E01027719","Total",1477,721,756,1371,106,24,71.99,20.5
"2011","Harrogate 021A","E01027699","Total",1362,653,709,1301,61,67,196.02,6.9
"2011","Harrogate 021B","E01027700","Total",1185,585,600,1185,0,40,306.87,3.9
"2011","Harrogate 021C","E01027724","Total",1595,794,801,1595,0,59,2608.09,0.6
"2011","Harrogate 021D","E01027725","Total",1505,702,803,1479,26,33,2814.09,0.5
"2011","Richmondshire 001A","E01027743","Total",1224,602,622,1224,0,29,2139.00,0.6
"2011","Richmondshire 001B","E01027751","Total",1272,635,637,1266,6,39,4096.37,0.3
"2011","Richmondshire 001C","E01027752","Total",1184,596,588,1177,7,28,5226.60,0.2
"2011","Richmondshire 001D","E01027759","Total",1406,682,724,1404,2,38,3308.77,0.4
"2011","Richmondshire 001E","E01027761","Total",1183,574,609,1123,60,28,2862.90,0.4
"2011","Richmondshire 001F","E01027762","Total",1309,667,642,1298,11,38,5790.54,0.2
"2011","Richmondshire 002A","E01027765","Total",1613,766,847,1576,37,35,28.81,56.0
"2011","Richmondshire 002B","E01027766","Total",1220,577,643,1174,46,25,46.22,26.4
"2011","Richmondshire 002C","E01027767","Total",1515,718,797,1515,0,44,57.27,26.5
"2011","Richmondshire 002D","E01027768","Total",1166,558,608,1166,0,36,33.06,35.3
"2011","Richmondshire 002E","E01027769","Total",1293,627,666,1293,0,23,725.80,1.8
"2011","Richmondshire 002F","E01027770","Total",1606,793,813,1592,14,19,128.29,12.5
"2011","Richmondshire 003A","E01027745","Total",1662,802,860,1582,80,33,3462.08,0.5
"2011","Richmondshire 003B","E01027746","Total",1412,689,723,1412,0,30,166.65,8.5
"2011","Richmondshire 003C","E01027747","Total",1979,1267,712,1366,613,22,583.81,3.4
"2011","Richmondshire 003D","E01027748","Total",1176,564,612,1166,10,21,117.38,10.0
"2011","Richmondshire 004A","E01027749","Total",1983,960,1023,1941,42,12,56.48,35.1
"2011","Richmondshire 004B","E01027750","Total",2877,1554,1323,2532,345,45,492.25,5.8
"2011","Richmondshire 004C","E01027754","Total",1382,707,675,1292,90,43,511.67,2.7
"2011","Richmondshire 004E","E01027771","Total",3508,2624,884,1606,1902,28,543.23,6.5
"2011","Richmondshire 004F","E01027772","Total",1302,652,650,1258,44,19,120.70,10.8
"2011","Richmondshire 004G","E01033183","Total",1600,827,773,1599,1,21,53.51,29.9
"2011","Richmondshire 004H","E01033184","Total",2628,1798,830,1502,1126,20,619.04,4.2
"2011","Richmondshire 005A","E01027742","Total",1328,654,674,1328,0,27,10236.58,0.1
"2011","Richmondshire 005B","E01027753","Total",1347,670,677,1343,4,18,13687.29,0.1
"2011","Richmondshire 005C","E01027763","Total",1135,563,572,1133,2,20,13630.98,0.1
"2011","Richmondshire 005D","E01027764","Total",1230,599,631,1225,5,20,14650.31,0.1
"2011","Richmondshire 005E","E01027773","Total",1075,547,528,1068,7,27,22679.69,0.0
"2011","Richmondshire 006A","E01027744","Total",1269,613,656,1267,2,16,8060.57,0.2
"2011","Richmondshire 006B","E01027756","Total",1766,864,902,1763,3,30,3251.13,0.5
"2011","Richmondshire 006D","E01027758","Total",1477,804,673,1368,109,33,6465.04,0.2
"2011","Richmondshire 006E","E01027760","Total",1284,635,649,1272,12,27,6568.61,0.2
"2011","Richmondshire 006F","E01033185","Total",1256,594,662,1245,11,9,781.09,1.6
"2011","Richmondshire 006G","E01033186","Total",1298,625,673,1268,30,23,685.40,1.9
"2011","Ryedale 001A","E01027776","Total",1542,767,775,1531,11,25,8501.49,0.2
"2011","Ryedale 001B","E01027777","Total",1413,727,686,1401,12,42,18181.54,0.1
"2011","Ryedale 001C","E01027783","Total",1765,863,902,1759,6,29,2702.20,0.7
"2011","Ryedale 001D","E01027784","Total",1679,805,874,1678,1,12,81.28,20.7
"2011","Ryedale 002A","E01027792","Total",1802,828,974,1750,52,33,463.03,3.9
"2011","Ryedale 002B","E01027793","Total",1418,642,776,1418,0,22,1096.03,1.3
"2011","Ryedale 002C","E01027794","Total",2029,954,1075,2000,29,36,2329.18,0.9
"2011","Ryedale 002D","E01027795","Total",1581,754,827,1581,0,11,42.34,37.3
"2011","Ryedale 002E","E01027801","Total",1633,770,863,1598,35,22,3076.39,0.5
"2011","Ryedale 002F","E01027802","Total",1623,796,827,1609,14,46,14124.55,0.1
"2011","Ryedale 003A","E01027775","Total",2153,1211,942,1486,667,72,5424.23,0.4
"2011","Ryedale 003B","E01027780","Total",1811,913,898,1780,31,44,20855.16,0.1
"2011","Ryedale 003C","E01027781","Total",1255,600,655,1249,6,13,592.49,2.1
"2011","Ryedale 003D","E01027800","Total",1685,808,877,1683,2,48,8189.50,0.2
"2011","Ryedale 004A","E01027779","Total",1165,578,587,1157,8,17,6944.85,0.2
"2011","Ryedale 004B","E01027796","Total",1743,884,859,1743,0,21,5184.26,0.3
"2011","Ryedale 004C","E01027798","Total",1980,984,996,1977,3,26,6941.92,0.3
"2011","Ryedale 004D","E01027803","Total",1801,909,892,1801,0,36,14496.59,0.1
"2011","Ryedale 007A","E01027774","Total",2032,1013,1019,2010,22,34,4622.10,0.4
"2011","Ryedale 007B","E01027778","Total",2285,1147,1138,2285,0,50,7641.90,0.3
"2011","Ryedale 007C","E01027782","Total",1656,793,863,1645,11,54,5586.30,0.3
"2011","Ryedale 007D","E01027797","Total",1696,832,864,1688,8,49,6019.00,0.3
"2011","Ryedale 007E","E01027799","Total",1729,830,899,1729,0,48,4790.75,0.4
"2011","Ryedale 008A","E01027785","Total",1531,778,753,1516,15,7,87.74,17.4
"2011","Ryedale 008B","E01027786","Total",1566,761,805,1534,32,43,177.46,8.8
"2011","Ryedale 008C","E01027787","Total",1791,873,918,1731,60,22,1359.88,1.3
"2011","Ryedale 008D","E01027788","Total",1405,696,709,1405,0,6,217.25,6.5
"2011","Ryedale 008E","E01027789","Total",2491,1182,1309,2432,59,15,177.83,14.0
"2011","Ryedale 008F","E01027790","Total",1936,944,992,1896,40,25,558.24,3.5
"2011","Ryedale 008G","E01027791","Total",1555,771,784,1539,16,20,193.93,8.0
"2011","Scarborough 001A","E01027837","Total",1406,641,765,1403,3,8,27.34,51.4
"2011","Scarborough 001B","E01027839","Total",1685,788,897,1661,24,15,116.13,14.5
"2011","Scarborough 001C","E01027869","Total",1100,585,515,966,134,11,34.61,31.8
"2011","Scarborough 001D","E01027870","Total",1332,652,680,1272,60,17,37.66,35.4
"2011","Scarborough 001E","E01027871","Total",1521,688,833,1454,67,14,47.27,32.2
"2011","Scarborough 002A","E01027813","Total",2072,1023,1049,2061,11,60,13306.99,0.2
"2011","Scarborough 002B","E01027822","Total",1401,702,699,1391,10,25,8922.74,0.2
"2011","Scarborough 002C","E01027840","Total",2098,1042,1056,2091,7,25,3284.27,0.6
"2011","Scarborough 002D","E01027841","Total",1320,651,669,1310,10,20,6008.54,0.2
"2011","Scarborough 003A","E01027838","Total",1561,749,812,1556,5,36,343.93,4.5
"2011","Scarborough 003B","E01027864","Total",1457,737,720,1456,1,11,101.12,14.4
"2011","Scarborough 003C","E01027865","Total",1616,829,787,1612,4,13,72.13,22.4
"2011","Scarborough 003D","E01027866","Total",1535,750,785,1495,40,25,168.76,9.1
"2011","Scarborough 004A","E01027821","Total",1412,677,735,1403,9,21,7771.63,0.2
"2011","Scarborough 004B","E01027823","Total",1442,665,777,1429,13,22,165.92,8.7
"2011","Scarborough 004C","E01027831","Total",1070,522,548,1045,25,19,4725.06,0.2
"2011","Scarborough 004D","E01027832","Total",1066,526,540,918,148,15,1911.17,0.6
"2011","Scarborough 004E","E01027836","Total",2210,1057,1153,2203,7,39,1913.63,1.2
"2011","Scarborough 004F","E01027857","Total",1325,645,680,1283,42,25,9744.74,0.1
"2011","Scarborough 005A","E01027842","Total",1625,767,858,1625,0,22,39.17,41.5
"2011","Scarborough 005B","E01027843","Total",1430,665,765,1401,29,17,39.49,36.2
"2011","Scarborough 005C","E01027844","Total",1556,756,800,1556,0,23,72.12,21.6
"2011","Scarborough 005D","E01027845","Total",1741,821,920,1718,23,28,74.79,23.3
"2011","Scarborough 005E","E01027855","Total",1482,711,771,1478,4,41,332.55,4.5
"2011","Scarborough 005F","E01027856","Total",1157,529,628,1153,4,13,108.70,10.6
"2011","Scarborough 006A","E01027805","Total",1498,728,770,1475,23,6,45.96,32.6
"2011","Scarborough 006B","E01027806","Total",1740,910,830,1693,47,3,26.85,64.8
"2011","Scarborough 006C","E01027846","Total",1884,941,943,1764,120,17,37.30,50.5
"2011","Scarborough 006D","E01027847","Total",1883,1010,873,1789,94,14,27.02,69.7
"2011","Scarborough 006E","E01027848","Total",1052,511,541,1052,0,15,59.38,17.7
"2011","Scarborough 007A","E01027849","Total",1199,586,613,1100,99,20,41.73,28.7
"2011","Scarborough 007B","E01027850","Total",1302,644,658,1302,0,15,29.53,44.1
"2011","Scarborough 007C","E01027872","Total",1466,699,767,1455,11,15,35.57,41.2
"2011","Scarborough 007D","E01027874","Total",1658,787,871,1658,0,1,30.93,53.6
"2011","Scarborough 008A","E01027810","Total",1691,805,886,1691,0,21,14.22,118.9
"2011","Scarborough 008B","E01027811","Total",1708,782,926,1708,0,15,11.05,154.6
"2011","Scarborough 008C","E01027812","Total",1783,854,929,1783,0,17,20.82,85.6
"2011","Scarborough 008D","E01027851","Total",1537,740,797,1537,0,27,16.69,92.1
"2011","Scarborough 008E","E01027862","Total",1638,790,848,1571,67,10,20.79,78.8
"2011","Scarborough 009A","E01027824","Total",1431,655,776,1426,5,15,120.87,11.8
"2011","Scarborough 009B","E01027825","Total",1898,917,981,1787,111,13,117.02,16.2
"2011","Scarborough 009C","E01027826","Total",1526,761,765,1489,37,16,18.57,82.2
"2011","Scarborough 009D","E01027861","Total",1318,631,687,1295,23,12,15.68,84.1
"2011","Scarborough 009E","E01027863","Total",1425,661,764,1372,53,28,43.80,32.5
"2011","Scarborough 009F","E01027873","Total",1486,692,794,1482,4,45,250.57,5.9
"2011","Scarborough 010A","E01027804","Total",1505,780,725,1453,52,17,39.31,38.3
"2011","Scarborough 010B","E01027852","Total",1674,883,791,1518,156,20,16.24,103.1
"2011","Scarborough 010C","E01027853","Total",1263,617,646,1189,74,9,28.95,43.6
"2011","Scarborough 010D","E01027854","Total",1488,754,734,1358,130,15,23.28,63.9
"2011","Scarborough 010E","E01027868","Total",2270,1023,1247,1967,303,25,186.24,12.2
"2011","Scarborough 011A","E01027807","Total",1464,703,761,1464,0,14,1833.20,0.8
"2011","Scarborough 011B","E01027808","Total",1440,708,732,1440,0,15,67.67,21.3
"2011","Scarborough 011C","E01027809","Total",1248,589,659,1248,0,7,89.96,13.9
"2011","Scarborough 011D","E01027818","Total",1371,640,731,1371,0,8,51.78,26.5
"2011","Scarborough 011E","E01027867","Total",1561,729,832,1350,211,25,314.59,5.0
"2011","Scarborough 012A","E01027817","Total",1407,684,723,1379,28,9,49.07,28.7
"2011","Scarborough 012B","E01027819","Total",1432,702,730,1432,0,11,199.29,7.2
"2011","Scarborough 012C","E01027820","Total",1400,657,743,1400,0,8,25.41,55.1
"2011","Scarborough 012D","E01027858","Total",1377,663,714,1377,0,13,80.34,17.1
"2011","Scarborough 012E","E01027860","Total",1550,760,790,1545,5,15,430.37,3.6
"2011","Scarborough 013A","E01027814","Total",1588,755,833,1565,23,33,3765.19,0.4
"2011","Scarborough 013B","E01027815","Total",1327,623,704,1322,5,37,3688.82,0.4
"2011","Scarborough 013C","E01027816","Total",1571,740,831,1571,0,20,1064.95,1.5
"2011","Scarborough 013D","E01027859","Total",1720,837,883,1720,0,34,1536.29,1.1
"2011","Scarborough 014A","E01027827","Total",1617,750,867,1614,3,19,178.46,9.1
"2011","Scarborough 014B","E01027828","Total",1636,750,886,1636,0,15,145.42,11.3
"2011","Scarborough 014C","E01027829","Total",1471,700,771,1471,0,14,137.42,10.7
"2011","Scarborough 014D","E01027830","Total",1806,860,946,1806,0,10,54.73,33.0
"2011","Scarborough 014E","E01027833","Total",1581,780,801,1581,0,22,4040.45,0.4
"2011","Scarborough 014F","E01027834","Total",1542,735,807,1542,0,19,101.24,15.2
"2011","Scarborough 014G","E01027835","Total",1741,866,875,1739,2,16,3150.65,0.6
"2011","Selby 001A","E01027918","Total",1485,740,745,1485,0,23,58.82,25.2
"2011","Selby 001B","E01027919","Total",1149,580,569,1149,0,31,98.74,11.6
"2011","Selby 001C","E01027920","Total",1187,580,607,1187,0,16,437.91,2.7
"2011","Selby 001D","E01027921","Total",1741,827,914,1732,9,16,113.23,15.4
"2011","Selby 001E","E01027922","Total",1699,837,862,1699,0,47,2065.07,0.8
"2011","Selby 002A","E01027875","Total",1865,938,927,1865,0,42,5703.31,0.3
"2011","Selby 002B","E01027886","Total",1334,669,665,1334,0,13,1644.38,0.8
"2011","Selby 002C","E01027887","Total",1548,757,791,1548,0,24,1311.02,1.2
"2011","Selby 002D","E01027888","Total",1754,839,915,1754,0,24,2438.63,0.7
"2011","Selby 002E","E01027904","Total",2341,1150,1191,2310,31,41,3772.44,0.6
"2011","Selby 003A","E01027876","Total",1635,796,839,1635,0,8,159.25,10.3
"2011","Selby 003B","E01027877","Total",1249,616,633,1225,24,14,302.94,4.1
"2011","Selby 003C","E01027900","Total",1913,924,989,1902,11,50,4080.92,0.5
"2011","Selby 003D","E01027901","Total",1559,751,808,1541,18,18,126.87,12.3
"2011","Selby 003E","E01027902","Total",1559,759,800,1490,69,32,1903.62,0.8
"2011","Selby 003F","E01027903","Total",1194,505,689,1025,169,32,2550.57,0.5
"2011","Selby 004A","E01027898","Total",2368,1143,1225,2363,5,28,1888.76,1.3
"2011","Selby 004B","E01027914","Total",1680,826,854,1680,0,18,505.40,3.3
"2011","Selby 004C","E01027915","Total",1614,799,815,1614,0,14,208.58,7.7
"2011","Selby 004D","E01027916","Total",1532,739,793,1504,28,18,86.92,17.6
"2011","Selby 004E","E01027917","Total",1831,931,900,1831,0,39,1163.63,1.6
"2011","Selby 005A","E01027878","Total",1279,628,651,1272,7,10,171.44,7.5
"2011","Selby 005B","E01027905","Total",1871,941,930,1831,40,16,115.43,16.2
"2011","Selby 005C","E01027907","Total",1377,689,688,1377,0,4,18.16,75.8
"2011","Selby 005D","E01027908","Total",1578,766,812,1562,16,9,40.18,39.3
"2011","Selby 005E","E01027909","Total",2022,1014,1008,1996,26,11,98.72,20.5
"2011","Selby 005F","E01027910","Total",2759,1333,1426,2759,0,18,308.92,8.9
"2011","Selby 006A","E01027881","Total",1294,618,676,1294,0,9,298.26,4.3
"2011","Selby 006B","E01027906","Total",1424,673,751,1424,0,14,883.99,1.6
"2011","Selby 006C","E01027911","Total",1479,682,797,1352,127,18,44.15,33.5
"2011","Selby 006D","E01027912","Total",1030,500,530,1030,0,22,25.78,40.0
"2011","Selby 006E","E01027913","Total",1191,581,610,1191,0,22,66.08,18.0
"2011","Selby 007A","E01027879","Total",1345,666,679,1345,0,15,53.79,25.0
"2011","Selby 007B","E01027880","Total",1583,767,816,1583,0,30,101.76,15.6
"2011","Selby 007C","E01027882","Total",1830,941,889,1827,3,28,1182.02,1.5
"2011","Selby 007D","E01027894","Total",1889,947,942,1889,0,27,131.18,14.4
"2011","Selby 007E","E01027895","Total",1567,774,793,1567,0,11,1900.60,0.8
"2011","Selby 008A","E01027883","Total",1125,541,584,1116,9,15,2043.15,0.6
"2011","Selby 008B","E01027884","Total",1628,822,806,1565,63,27,1439.20,1.1
"2011","Selby 008C","E01027885","Total",1564,752,812,1562,2,16,646.04,2.4
"2011","Selby 008D","E01027896","Total",1998,994,1004,1998,0,21,1113.87,1.8
"2011","Selby 008E","E01027897","Total",2100,1050,1050,2100,0,28,2405.56,0.9
"2011","Selby 009A","E01027891","Total",1672,819,853,1672,0,23,2060.14,0.8
"2011","Selby 009B","E01027892","Total",1866,914,952,1866,0,7,740.30,2.5
"2011","Selby 009C","E01027893","Total",1859,902,957,1841,18,23,946.72,2.0
"2011","Selby 009D","E01027899","Total",1728,862,866,1721,7,39,1247.82,1.4
"2011","Selby 010A","E01027889","Total",1794,906,888,1768,26,17,712.01,2.5
"2011","Selby 010B","E01027890","Total",1969,961,1008,1959,10,31,2266.17,0.9
"2011","Selby 010C","E01027923","Total",2266,1134,1132,2266,0,21,5233.70,0.4
"2011","Selby 010D","E01027924","Total",2125,1064,1061,2119,6,23,3015.04,0.7
"2011","Barnsley 001A","E01007434","Total",1933,963,970,1924,9,11,60.93,31.7
"2011","Barnsley 001B","E01007435","Total",1579,771,808,1579,0,16,42.08,37.5
"2011","Barnsley 001C","E01007438","Total",1557,722,835,1497,60,18,93.17,16.7
"2011","Barnsley 001D","E01007439","Total",1210,607,603,1210,0,14,250.55,4.8
"2011","Barnsley 002A","E01007433","Total",1615,775,840,1615,0,7,238.31,6.8
"2011","Barnsley 002B","E01007436","Total",1267,620,647,1267,0,9,84.30,15.0
"2011","Barnsley 002C","E01007437","Total",1476,755,721,1476,0,11,109.30,13.5
"2011","Barnsley 002D","E01007440","Total",1520,753,767,1520,0,13,40.68,37.4
"2011","Barnsley 003A","E01007329","Total",1594,788,806,1565,29,13,195.75,8.1
"2011","Barnsley 003B","E01007331","Total",1853,926,927,1853,0,11,193.34,9.6
"2011","Barnsley 003C","E01007342","Total",1398,686,712,1398,0,13,140.98,9.9
"2011","Barnsley 003D","E01007343","Total",1346,656,690,1346,0,8,101.48,13.3
"2011","Barnsley 004A","E01007356","Total",1381,669,712,1381,0,17,154.37,8.9
"2011","Barnsley 004B","E01007357","Total",1397,667,730,1347,50,6,27.38,51.0
"2011","Barnsley 004C","E01007361","Total",1656,799,857,1585,71,12,126.03,13.1
"2011","Barnsley 004D","E01007362","Total",1633,816,817,1633,0,13,150.61,10.8
"2011","Barnsley 004E","E01007363","Total",1575,755,820,1575,0,11,72.29,21.8
"2011","Barnsley 005A","E01007355","Total",1537,773,764,1537,0,8,64.33,23.9
"2011","Barnsley 005B","E01007358","Total",1497,717,780,1497,0,19,115.51,13.0
"2011","Barnsley 005C","E01007359","Total",1509,739,770,1509,0,15,516.22,2.9
"2011","Barnsley 005D","E01007360","Total",1546,733,813,1522,24,19,138.62,11.2
"2011","Barnsley 005E","E01007386","Total",1714,830,884,1701,13,22,144.82,11.8
"2011","Barnsley 006A","E01007328","Total",1922,940,982,1899,23,6,464.45,4.1
"2011","Barnsley 006B","E01007330","Total",1708,826,882,1708,0,13,229.15,7.5
"2011","Barnsley 006C","E01007332","Total",2306,1132,1174,2203,103,14,275.55,8.4
"2011","Barnsley 006D","E01007333","Total",1331,659,672,1331,0,7,74.17,17.9
"2011","Barnsley 007A","E01007323","Total",1483,748,735,1483,0,4,29.22,50.8
"2011","Barnsley 007B","E01007324","Total",1667,819,848,1667,0,5,40.34,41.3
"2011","Barnsley 007C","E01007325","Total",1714,829,885,1689,25,7,42.72,40.1
"2011","Barnsley 007D","E01007326","Total",1526,736,790,1525,1,3,37.71,40.5
"2011","Barnsley 007E","E01007327","Total",1676,809,867,1676,0,13,91.31,18.4
"2011","Barnsley 007F","E01007411","Total",1191,605,586,1191,0,3,51.91,22.9
"2011","Barnsley 008A","E01007341","Total",1264,627,637,1264,0,8,94.92,13.3
"2011","Barnsley 008B","E01007345","Total",1620,800,820,1567,53,11,47.93,33.8
"2011","Barnsley 008C","E01007346","Total",1620,788,832,1620,0,12,64.12,25.3
"2011","Barnsley 008D","E01007347","Total",1594,791,803,1594,0,10,254.85,6.3
"2011","Barnsley 009A","E01007334","Total",1356,683,673,1356,0,11,53.97,25.1
"2011","Barnsley 009B","E01007335","Total",1506,739,767,1454,52,10,60.26,25.0
"2011","Barnsley 009C","E01007400","Total",2017,1018,999,2017,0,13,84.60,23.8
"2011","Barnsley 009D","E01007404","Total",1287,642,645,1287,0,9,45.48,28.3
"2011","Barnsley 009E","E01007406","Total",1720,840,880,1720,0,2,125.72,13.7
"2011","Barnsley 010C","E01007408","Total",1516,719,797,1485,31,13,27.05,56.0
"2011","Barnsley 010D","E01007409","Total",1458,734,724,1428,30,21,35.74,40.8
"2011","Barnsley 010E","E01007410","Total",1631,792,839,1631,0,12,47.93,34.0
"2011","Barnsley 010G","E01032550","Total",2841,1408,1433,2841,0,19,158.31,17.9
"2011","Barnsley 010H","E01032551","Total",2567,1285,1282,2567,0,15,119.47,21.5
"2011","Barnsley 011A","E01007344","Total",2135,1069,1066,2128,7,15,127.74,16.7
"2011","Barnsley 011B","E01007402","Total",1660,782,878,1660,0,7,199.90,8.3
"2011","Barnsley 011C","E01007403","Total",1536,754,782,1495,41,4,71.20,21.6
"2011","Barnsley 011D","E01007405","Total",1418,653,765,1334,84,9,62.74,22.6
"2011","Barnsley 012A","E01007379","Total",1591,764,827,1591,0,10,321.19,5.0
"2011","Barnsley 012B","E01007380","Total",1810,910,900,1810,0,26,117.25,15.4
"2011","Barnsley 012C","E01007381","Total",1547,759,788,1547,0,24,152.85,10.1
"2011","Barnsley 012D","E01007387","Total",1452,716,736,1452,0,8,77.71,18.7
"2011","Barnsley 012E","E01007442","Total",1377,670,707,1377,0,14,127.41,10.8
"2011","Barnsley 012F","E01007444","Total",1550,759,791,1516,34,15,66.52,23.3
"2011","Barnsley 012G","E01007446","Total",1335,650,685,1308,27,10,41.22,32.4
"2011","Barnsley 013A","E01007336","Total",1557,801,756,1543,14,7,59.52,26.2
"2011","Barnsley 013B","E01007340","Total",1636,826,810,1636,0,9,47.49,34.4
"2011","Barnsley 013C","E01007415","Total",1495,732,763,1478,17,11,117.22,12.8
"2011","Barnsley 013D","E01007417","Total",1591,789,802,1552,39,10,20.67,77.0
"2011","Barnsley 013E","E01007441","Total",1537,773,764,1537,0,11,23.22,66.2
"2011","Barnsley 013F","E01007443","Total",2000,1086,914,2000,0,21,22.99,87.0
"2011","Barnsley 013G","E01007445","Total",1451,715,736,1451,0,6,50.91,28.5
"2011","Barnsley 014A","E01007372","Total",1287,608,679,1281,6,5,58.34,22.1
"2011","Barnsley 014B","E01007373","Total",1594,809,785,1594,0,8,69.08,23.1
"2011","Barnsley 014C","E01007374","Total",1470,704,766,1470,0,4,184.44,8.0
"2011","Barnsley 014D","E01007375","Total",1659,792,867,1605,54,5,68.39,24.3
"2011","Barnsley 014E","E01007377","Total",1105,561,544,1105,0,6,34.08,32.4
"2011","Barnsley 014F","E01007378","Total",1572,771,801,1556,16,5,89.14,17.6
"2011","Barnsley 015A","E01007319","Total",1465,718,747,1465,0,8,124.53,11.8
"2011","Barnsley 015B","E01007321","Total",1433,690,743,1433,0,10,176.11,8.1
"2011","Barnsley 015C","E01007322","Total",2082,1039,1043,2004,78,11,154.12,13.5
"2011","Barnsley 015D","E01007337","Total",1775,928,847,1775,0,7,80.30,22.1
"2011","Barnsley 016A","E01007418","Total",1279,618,661,1279,0,19,1843.89,0.7
"2011","Barnsley 016B","E01007419","Total",1721,828,893,1721,0,24,325.02,5.3
"2011","Barnsley 016C","E01007420","Total",1432,703,729,1432,0,29,305.67,4.7
"2011","Barnsley 016D","E01007425","Total",1470,737,733,1470,0,31,1086.56,1.4
"2011","Barnsley 017A","E01007338","Total",1533,756,777,1533,0,1,27.15,56.5
"2011","Barnsley 017B","E01007339","Total",1490,763,727,1479,11,9,25.43,58.6
"2011","Barnsley 017C","E01007413","Total",1349,650,699,1349,0,5,43.35,31.1
"2011","Barnsley 017D","E01007414","Total",1638,788,850,1572,66,22,42.38,38.7
"2011","Barnsley 018A","E01007317","Total",1493,747,746,1493,0,5,62.36,23.9
"2011","Barnsley 018B","E01007318","Total",1544,781,763,1507,37,9,29.72,52.0
"2011","Barnsley 018C","E01007320","Total",1596,798,798,1596,0,7,36.92,43.2
"2011","Barnsley 018D","E01007416","Total",1194,577,617,1194,0,9,36.54,32.7
"2011","Barnsley 019A","E01007382","Total",1483,714,769,1483,0,11,143.04,10.4
"2011","Barnsley 019B","E01007383","Total",1370,698,672,1370,0,22,48.16,28.4
"2011","Barnsley 019C","E01007384","Total",1614,798,816,1614,0,15,312.18,5.2
"2011","Barnsley 019D","E01007385","Total",1433,688,745,1369,64,8,72.11,19.9
"2011","Barnsley 020A","E01007348","Total",1444,696,748,1399,45,9,75.65,19.1
"2011","Barnsley 020B","E01007349","Total",1533,728,805,1529,4,9,518.08,3.0
"2011","Barnsley 020C","E01007350","Total",1185,600,585,1183,2,7,494.11,2.4
"2011","Barnsley 020D","E01007351","Total",1426,699,727,1426,0,23,361.32,3.9
"2011","Barnsley 020E","E01007352","Total",1412,683,729,1412,0,8,26.78,52.7
"2011","Barnsley 020F","E01007353","Total",1605,771,834,1583,22,14,52.52,30.6
"2011","Barnsley 020G","E01007354","Total",1681,817,864,1645,36,8,543.13,3.1
"2011","Barnsley 021A","E01007458","Total",1455,727,728,1432,23,13,207.69,7.0
"2011","Barnsley 021B","E01007459","Total",1509,726,783,1509,0,3,364.68,4.1
"2011","Barnsley 021C","E01007460","Total",1437,720,717,1427,10,16,61.08,23.5
"2011","Barnsley 021D","E01007461","Total",1647,844,803,1641,6,9,44.42,37.1
"2011","Barnsley 021E","E01007462","Total",1602,741,861,1602,0,9,153.83,10.4
"2011","Barnsley 021F","E01007463","Total",1766,843,923,1747,19,4,33.29,53.0
"2011","Barnsley 022A","E01007369","Total",1490,762,728,1490,0,9,51.97,28.7
"2011","Barnsley 022B","E01007370","Total",1389,683,706,1389,0,10,249.75,5.6
"2011","Barnsley 022C","E01007371","Total",1954,957,997,1954,0,18,102.10,19.1
"2011","Barnsley 022D","E01007376","Total",1407,691,716,1403,4,3,154.86,9.1
"2011","Barnsley 023A","E01007447","Total",1544,750,794,1538,6,5,33.31,46.4
"2011","Barnsley 023B","E01007448","Total",1594,828,766,1593,1,6,98.93,16.1
"2011","Barnsley 023C","E01007449","Total",1770,887,883,1770,0,3,141.77,12.5
"2011","Barnsley 023D","E01007450","Total",1516,763,753,1497,19,6,117.62,12.9
"2011","Barnsley 024A","E01007427","Total",1554,787,767,1554,0,22,84.49,18.4
"2011","Barnsley 024B","E01007428","Total",1445,715,730,1444,1,18,624.10,2.3
"2011","Barnsley 024C","E01007429","Total",1422,674,748,1422,0,7,32.03,44.4
"2011","Barnsley 024D","E01007430","Total",2277,1130,1147,2273,4,28,80.47,28.3
"2011","Barnsley 024E","E01007431","Total",1363,677,686,1363,0,21,125.26,10.9
"2011","Barnsley 024F","E01007432","Total",1431,709,722,1431,0,25,59.75,23.9
"2011","Barnsley 025A","E01007364","Total",1390,662,728,1390,0,5,104.93,13.2
"2011","Barnsley 025B","E01007365","Total",1212,564,648,1203,9,2,56.00,21.6
"2011","Barnsley 025C","E01007366","Total",2005,991,1014,2005,0,9,133.91,15.0
"2011","Barnsley 025D","E01007367","Total",1178,590,588,1178,0,5,161.99,7.3
"2011","Barnsley 025E","E01007368","Total",1675,814,861,1626,49,7,39.51,42.4
"2011","Barnsley 026A","E01007451","Total",1712,845,867,1683,29,11,102.26,16.7
"2011","Barnsley 026B","E01007452","Total",1555,777,778,1555,0,13,92.94,16.7
"2011","Barnsley 026C","E01007453","Total",1558,721,837,1558,0,9,29.06,53.6
"2011","Barnsley 026E","E01007455","Total",1358,666,692,1358,0,11,61.04,22.2
"2011","Barnsley 026F","E01032924","Total",1562,761,801,1535,27,9,313.76,5.0
"2011","Barnsley 026G","E01032925","Total",1390,656,734,1327,63,6,50.40,27.6
"2011","Barnsley 027A","E01007421","Total",1330,669,661,1320,10,20,2814.72,0.5
"2011","Barnsley 027B","E01007422","Total",1571,808,763,1571,0,31,1201.33,1.3
"2011","Barnsley 027C","E01007423","Total",1655,809,846,1655,0,25,851.83,1.9
"2011","Barnsley 027D","E01007426","Total",1558,785,773,1547,11,17,6511.97,0.2
"2011","Barnsley 028A","E01007396","Total",1580,754,826,1580,0,11,29.72,53.2
"2011","Barnsley 028B","E01007397","Total",1456,681,775,1422,34,10,132.22,11.0
"2011","Barnsley 028C","E01007398","Total",1632,784,848,1619,13,9,344.38,4.7
"2011","Barnsley 028D","E01007399","Total",2057,993,1064,2057,0,13,232.74,8.8
"2011","Barnsley 028E","E01007424","Total",1671,817,854,1671,0,13,828.08,2.0
"2011","Barnsley 029A","E01007388","Total",1615,815,800,1615,0,15,172.03,9.4
"2011","Barnsley 029B","E01007393","Total",1837,882,955,1811,26,9,32.21,57.0
"2011","Barnsley 029C","E01007394","Total",1384,687,697,1384,0,4,23.93,57.8
"2011","Barnsley 029D","E01007456","Total",1756,854,902,1756,0,10,130.20,13.5
"2011","Barnsley 029E","E01007457","Total",1648,793,855,1648,0,10,381.91,4.3
"2011","Barnsley 030A","E01007389","Total",1396,701,695,1396,0,7,57.28,24.4
"2011","Barnsley 030B","E01007390","Total",1527,744,783,1527,0,8,107.13,14.3
"2011","Barnsley 030C","E01007391","Total",1468,723,745,1468,0,6,33.75,43.5
"2011","Barnsley 030D","E01007392","Total",1538,763,775,1498,40,9,33.57,45.8
"2011","Barnsley 030E","E01007395","Total",2016,956,1060,2016,0,15,142.83,14.1
"2011","Doncaster 001A","E01007632","Total",1617,782,835,1617,0,9,3556.51,0.5
"2011","Doncaster 001B","E01007633","Total",1355,660,695,1355,0,11,186.14,7.3
"2011","Doncaster 001C","E01007634","Total",1636,803,833,1636,0,11,80.18,20.4
"2011","Doncaster 001D","E01007635","Total",1410,681,729,1410,0,10,229.26,6.2
"2011","Doncaster 002A","E01007487","Total",1615,771,844,1615,0,13,173.00,9.3
"2011","Doncaster 002B","E01007488","Total",1738,897,841,1735,3,15,4207.70,0.4
"2011","Doncaster 002C","E01007489","Total",1721,847,874,1673,48,10,481.61,3.6
"2011","Doncaster 002D","E01007490","Total",1565,782,783,1550,15,17,1558.69,1.0
"2011","Doncaster 002E","E01007491","Total",1754,854,900,1754,0,5,24.26,72.3
"2011","Doncaster 002F","E01007492","Total",1496,726,770,1496,0,5,139.15,10.8
"2011","Doncaster 002G","E01007493","Total",1784,879,905,1736,48,14,255.21,7.0
"2011","Doncaster 003A","E01007636","Total",1521,718,803,1517,4,7,42.35,35.9
"2011","Doncaster 003B","E01007637","Total",1542,722,820,1489,53,21,48.54,31.8
"2011","Doncaster 003C","E01007638","Total",1587,760,827,1587,0,15,39.43,40.2
"2011","Doncaster 003D","E01007639","Total",1894,951,943,1832,62,19,52.45,36.1
"2011","Doncaster 003E","E01007640","Total",1616,815,801,1616,0,16,329.19,4.9
"2011","Doncaster 003F","E01007641","Total",1512,726,786,1479,33,14,78.92,19.2
"2011","Doncaster 003G","E01007642","Total",1605,780,825,1605,0,7,57.32,28.0
"2011","Doncaster 004A","E01007625","Total",1537,783,754,1537,0,15,2889.48,0.5
"2011","Doncaster 004B","E01007626","Total",1226,626,600,1193,33,5,404.35,3.0
"2011","Doncaster 004C","E01007627","Total",1671,786,885,1671,0,3,129.18,12.9
"2011","Doncaster 004D","E01007628","Total",1439,688,751,1404,35,5,23.44,61.4
"2011","Doncaster 004E","E01007629","Total",1606,779,827,1606,0,4,69.36,23.2
"2011","Doncaster 005A","E01007468","Total",1296,612,684,1296,0,5,102.62,12.6
"2011","Doncaster 005B","E01007469","Total",1355,675,680,1326,29,6,68.12,19.9
"2011","Doncaster 005C","E01007470","Total",1428,708,720,1428,0,7,27.79,51.4
"2011","Doncaster 005D","E01007472","Total",1624,799,825,1593,31,12,25.11,64.7
"2011","Doncaster 005E","E01007473","Total",1457,721,736,1430,27,5,258.75,5.6
"2011","Doncaster 005F","E01007474","Total",1325,611,714,1321,4,5,155.16,8.5
"2011","Doncaster 006A","E01007554","Total",1594,787,807,1594,0,23,150.66,10.6
"2011","Doncaster 006B","E01007555","Total",1464,667,797,1464,0,8,46.99,31.2
"2011","Doncaster 006C","E01007556","Total",1364,661,703,1364,0,6,65.24,20.9
"2011","Doncaster 006D","E01007561","Total",1472,716,756,1393,79,15,264.67,5.6
"2011","Doncaster 006E","E01007562","Total",1362,682,680,1362,0,9,86.33,15.8
"2011","Doncaster 006F","E01007563","Total",1455,695,760,1451,4,1,56.95,25.5
"2011","Doncaster 007A","E01007621","Total",1410,691,719,1410,0,15,218.41,6.5
"2011","Doncaster 007B","E01007622","Total",1515,733,782,1515,0,15,57.69,26.3
"2011","Doncaster 007C","E01007623","Total",1224,607,617,1224,0,6,29.37,41.7
"2011","Doncaster 007D","E01007624","Total",1864,929,935,1858,6,22,422.18,4.4
"2011","Doncaster 007E","E01007630","Total",1358,668,690,1358,0,8,588.41,2.3
"2011","Doncaster 007F","E01007631","Total",1221,594,627,1221,0,10,24.58,49.7
"2011","Doncaster 008A","E01007553","Total",1693,845,848,1648,45,19,227.28,7.4
"2011","Doncaster 008B","E01007557","Total",2784,2284,500,1002,1782,12,2190.79,1.3
"2011","Doncaster 008C","E01007558","Total",1453,715,738,1453,0,21,25.86,56.2
"2011","Doncaster 008D","E01007559","Total",1162,686,476,941,221,19,2921.02,0.4
"2011","Doncaster 008E","E01007560","Total",1523,728,795,1497,26,14,170.10,9.0
"2011","Doncaster 009A","E01007464","Total",1497,728,769,1497,0,9,58.63,25.5
"2011","Doncaster 009B","E01007465","Total",1483,721,762,1483,0,9,65.23,22.7
"2011","Doncaster 009C","E01007466","Total",1755,855,900,1755,0,8,90.62,19.4
"2011","Doncaster 009D","E01007467","Total",1553,767,786,1523,30,4,62.82,24.7
"2011","Doncaster 009E","E01007471","Total",1542,762,780,1507,35,14,73.21,21.1
"2011","Doncaster 009F","E01007504","Total",1532,765,767,1532,0,5,330.31,4.6
"2011","Doncaster 009G","E01007507","Total",1375,693,682,1375,0,9,138.13,10.0
"2011","Doncaster 010A","E01007506","Total",1441,708,733,1397,44,3,136.38,10.6
"2011","Doncaster 010B","E01007508","Total",1664,808,856,1664,0,15,67.86,24.5
"2011","Doncaster 010C","E01007509","Total",1760,847,913,1758,2,9,47.59,37.0
"2011","Doncaster 010D","E01007510","Total",1568,720,848,1539,29,12,38.14,41.1
"2011","Doncaster 010E","E01007511","Total",1576,751,825,1576,0,6,919.60,1.7
"2011","Doncaster 011A","E01007475","Total",1549,768,781,1549,0,27,190.45,8.1
"2011","Doncaster 011B","E01007476","Total",1457,685,772,1439,18,9,40.39,36.1
"2011","Doncaster 011C","E01007477","Total",1431,690,741,1431,0,11,46.21,31.0
"2011","Doncaster 011D","E01007478","Total",1532,780,752,1532,0,20,139.39,11.0
"2011","Doncaster 012A","E01007512","Total",1671,827,844,1668,3,8,46.73,35.8
"2011","Doncaster 012B","E01007513","Total",1435,657,778,1435,0,11,51.61,27.8
"2011","Doncaster 012C","E01007515","Total",1570,773,797,1554,16,18,33.35,47.1
"2011","Doncaster 012D","E01007518","Total",1489,715,774,1486,3,21,111.50,13.4
"2011","Doncaster 012E","E01007519","Total",1298,622,676,1298,0,9,26.24,49.5
"2011","Doncaster 013A","E01007505","Total",1673,844,829,1654,19,16,409.94,4.1
"2011","Doncaster 013B","E01007514","Total",1465,734,731,1465,0,6,21.69,67.5
"2011","Doncaster 013C","E01007516","Total",1336,652,684,1336,0,19,39.04,34.2
"2011","Doncaster 013D","E01007517","Total",1553,756,797,1551,2,14,51.86,29.9
"2011","Doncaster 014A","E01007479","Total",1593,785,808,1593,0,11,493.54,3.2
"2011","Doncaster 014B","E01007480","Total",1509,723,786,1472,37,6,32.32,46.7
"2011","Doncaster 014D","E01007482","Total",1374,632,742,1350,24,3,29.52,46.5
"2011","Doncaster 014E","E01033259","Total",1599,784,815,1567,32,8,47.58,33.6
"2011","Doncaster 014F","E01033260","Total",1611,807,804,1611,0,12,44.53,36.2
"2011","Doncaster 015A","E01007570","Total",1482,691,791,1482,0,14,31.92,46.4
"2011","Doncaster 015B","E01007650","Total",1649,808,841,1649,0,15,97.39,16.9
"2011","Doncaster 015C","E01007651","Total",1830,868,962,1830,0,24,33.99,53.8
"2011","Doncaster 015D","E01007652","Total",1889,909,980,1889,0,11,184.63,10.2
"2011","Doncaster 015E","E01007653","Total",1579,823,756,1579,0,10,39.38,40.1
"2011","Doncaster 015F","E01007656","Total",1589,742,847,1589,0,4,147.30,10.8
"2011","Doncaster 016A","E01007581","Total",1559,784,775,1559,0,28,177.61,8.8
"2011","Doncaster 016B","E01007582","Total",1457,709,748,1457,0,21,28.41,51.3
"2011","Doncaster 016C","E01007588","Total",1692,814,878,1673,19,11,127.28,13.3
"2011","Doncaster 016D","E01007589","Total",1712,832,880,1712,0,30,35.58,48.1
"2011","Doncaster 017A","E01007483","Total",1381,663,718,1381,0,18,218.28,6.3
"2011","Doncaster 017B","E01007484","Total",1445,704,741,1382,63,15,32.77,44.1
"2011","Doncaster 017C","E01007485","Total",1435,697,738,1435,0,14,157.72,9.1
"2011","Doncaster 017D","E01007486","Total",1317,640,677,1317,0,6,28.55,46.1
"2011","Doncaster 018A","E01007564","Total",1536,716,820,1536,0,11,29.27,52.5
"2011","Doncaster 018B","E01007565","Total",1527,740,787,1512,15,24,35.10,43.5
"2011","Doncaster 018C","E01007566","Total",1626,800,826,1626,0,4,117.94,13.8
"2011","Doncaster 018D","E01007567","Total",1342,656,686,1302,40,17,33.45,40.1
"2011","Doncaster 018E","E01007568","Total",1662,777,885,1662,0,13,24.62,67.5
"2011","Doncaster 018F","E01007569","Total",1601,752,849,1601,0,10,35.86,44.6
"2011","Doncaster 019A","E01007644","Total",1549,771,778,1475,74,17,211.26,7.3
"2011","Doncaster 019B","E01007646","Total",1463,779,684,1341,122,34,25.97,56.3
"2011","Doncaster 019C","E01007647","Total",1503,712,791,1472,31,16,65.12,23.1
"2011","Doncaster 019D","E01007648","Total",1884,1047,837,1855,29,10,24.30,77.5
"2011","Doncaster 019E","E01007649","Total",1549,784,765,1549,0,27,20.76,74.6
"2011","Doncaster 019F","E01007654","Total",1539,783,756,1525,14,9,33.88,45.4
"2011","Doncaster 020A","E01007583","Total",1455,701,754,1452,3,14,2084.80,0.7
"2011","Doncaster 020B","E01007586","Total",1522,743,779,1487,35,22,601.92,2.5
"2011","Doncaster 020C","E01007587","Total",1542,718,824,1542,0,24,4112.18,0.4
"2011","Doncaster 020D","E01007620","Total",1606,786,820,1606,0,17,509.08,3.2
"2011","Doncaster 021A","E01007584","Total",1548,738,810,1548,0,13,83.15,18.6
"2011","Doncaster 021B","E01007585","Total",1606,738,868,1585,21,20,104.39,15.4
"2011","Doncaster 021C","E01007617","Total",1511,716,795,1511,0,24,465.54,3.2
"2011","Doncaster 021D","E01007618","Total",1267,613,654,1248,19,38,68.33,18.5
"2011","Doncaster 021E","E01007619","Total",1810,894,916,1810,0,45,152.51,11.9
"2011","Doncaster 022A","E01007529","Total",2047,1329,718,1448,599,10,78.67,26.0
"2011","Doncaster 022B","E01007530","Total",1206,616,590,1206,0,3,66.85,18.0
"2011","Doncaster 022C","E01007531","Total",1625,820,805,1618,7,12,69.12,23.5
"2011","Doncaster 022D","E01007643","Total",1665,799,866,1665,0,9,36.05,46.2
"2011","Doncaster 022E","E01007645","Total",2072,1100,972,1983,89,17,68.76,30.1
"2011","Doncaster 022F","E01007655","Total",1893,1017,876,1815,78,20,79.03,24.0
"2011","Doncaster 023A","E01007494","Total",1529,764,765,1529,0,20,46.65,32.8
"2011","Doncaster 023B","E01007532","Total",1774,1030,744,1771,3,9,26.59,66.7
"2011","Doncaster 023C","E01007533","Total",1419,735,684,1419,0,11,40.98,34.6
"2011","Doncaster 023D","E01007535","Total",1596,784,812,1544,52,6,16.84,94.8
"2011","Doncaster 024A","E01007522","Total",1550,758,792,1511,39,9,36.61,42.3
"2011","Doncaster 024B","E01007525","Total",1532,706,826,1532,0,11,185.63,8.3
"2011","Doncaster 024C","E01007528","Total",1392,659,733,1389,3,8,50.87,27.4
"2011","Doncaster 024D","E01007604","Total",1431,693,738,1426,5,29,30.69,46.6
"2011","Doncaster 025A","E01007521","Total",1491,698,793,1435,56,33,40.35,37.0
"2011","Doncaster 025B","E01007523","Total",1486,717,769,1486,0,17,33.79,44.0
"2011","Doncaster 025C","E01007524","Total",1581,790,791,1581,0,33,50.47,31.3
"2011","Doncaster 025D","E01007526","Total",1633,773,860,1606,27,39,96.06,17.0
"2011","Doncaster 025E","E01007607","Total",1444,693,751,1412,32,28,37.73,38.3
"2011","Doncaster 026A","E01007599","Total",1763,861,902,1763,0,25,1560.31,1.1
"2011","Doncaster 026B","E01007600","Total",1434,694,740,1434,0,37,266.48,5.4
"2011","Doncaster 026C","E01007601","Total",1367,653,714,1367,0,23,144.30,9.5
"2011","Doncaster 026D","E01007602","Total",1500,735,765,1500,0,27,412.63,3.6
"2011","Doncaster 026E","E01007603","Total",1484,728,756,1467,17,22,1103.03,1.3
"2011","Doncaster 027A","E01007520","Total",1418,675,743,1411,7,24,64.06,22.1
"2011","Doncaster 027B","E01007527","Total",2325,1156,1169,2325,0,42,114.52,20.3
"2011","Doncaster 027C","E01007605","Total",1543,762,781,1509,34,25,52.18,29.6
"2011","Doncaster 027D","E01007606","Total",1536,792,744,1524,12,43,326.62,4.7
"2011","Doncaster 028A","E01007495","Total",1857,888,969,1857,0,20,156.20,11.9
"2011","Doncaster 028B","E01007500","Total",1308,638,670,1308,0,11,46.70,28.0
"2011","Doncaster 028C","E01007502","Total",2750,1387,1363,2710,40,34,175.17,15.7
"2011","Doncaster 028D","E01007534","Total",2022,1061,961,2018,4,11,221.31,9.1
"2011","Doncaster 029A","E01007496","Total",1622,797,825,1622,0,11,30.63,53.0
"2011","Doncaster 029B","E01007497","Total",1376,661,715,1376,0,12,21.95,62.7
"2011","Doncaster 029C","E01007498","Total",1580,803,777,1576,4,15,46.49,34.0
"2011","Doncaster 029D","E01007499","Total",1501,694,807,1452,49,15,29.91,50.2
"2011","Doncaster 029E","E01007501","Total",1456,707,749,1456,0,16,37.18,39.2
"2011","Doncaster 029F","E01007503","Total",1620,819,801,1617,3,13,50.48,32.1
"2011","Doncaster 030A","E01007575","Total",1408,632,776,1408,0,7,26.99,52.2
"2011","Doncaster 030B","E01007578","Total",1616,807,809,1616,0,5,51.60,31.3
"2011","Doncaster 030C","E01007579","Total",1504,775,729,1504,0,10,237.68,6.3
"2011","Doncaster 030D","E01007580","Total",1378,707,671,1378,0,9,72.15,19.1
"2011","Doncaster 031A","E01007571","Total",1610,797,813,1607,3,7,32.46,49.6
"2011","Doncaster 031B","E01007572","Total",1416,705,711,1416,0,14,38.34,36.9
"2011","Doncaster 031C","E01007573","Total",1546,763,783,1546,0,7,30.74,50.3
"2011","Doncaster 031D","E01007574","Total",1577,738,839,1482,95,6,39.93,39.5
"2011","Doncaster 031E","E01007576","Total",1518,733,785,1518,0,10,25.29,60.0
"2011","Doncaster 031F","E01007577","Total",1540,767,773,1486,54,5,30.68,50.2
"2011","Doncaster 032A","E01007536","Total",1971,982,989,1952,19,10,87.02,22.6
"2011","Doncaster 032B","E01007542","Total",1778,864,914,1772,6,5,107.61,16.5
"2011","Doncaster 032C","E01007543","Total",1500,710,790,1500,0,10,339.66,4.4
"2011","Doncaster 032D","E01007544","Total",1752,836,916,1674,78,5,36.38,48.2
"2011","Doncaster 033A","E01007546","Total",1428,709,719,1425,3,10,68.67,20.8
"2011","Doncaster 033B","E01007551","Total",1671,840,831,1671,0,18,152.70,10.9
"2011","Doncaster 033C","E01007552","Total",1408,674,734,1408,0,17,99.32,14.2
"2011","Doncaster 033D","E01007613","Total",1579,781,798,1548,31,22,2852.08,0.6
"2011","Doncaster 034A","E01007545","Total",1484,736,748,1456,28,6,420.61,3.5
"2011","Doncaster 034B","E01007547","Total",1529,753,776,1529,0,3,41.73,36.6
"2011","Doncaster 034C","E01007548","Total",1103,506,597,1103,0,5,31.76,34.7
"2011","Doncaster 034D","E01007549","Total",1455,711,744,1439,16,8,51.94,28.0
"2011","Doncaster 034E","E01007550","Total",1665,793,872,1665,0,10,204.51,8.1
"2011","Doncaster 035A","E01007537","Total",1733,842,891,1733,0,10,53.52,32.4
"2011","Doncaster 035B","E01007538","Total",1530,722,808,1530,0,8,46.47,32.9
"2011","Doncaster 035C","E01007539","Total",1443,682,761,1398,45,8,32.88,43.9
"2011","Doncaster 035D","E01007540","Total",1633,796,837,1633,0,10,40.28,40.5
"2011","Doncaster 035E","E01007541","Total",1520,773,747,1517,3,3,84.42,18.0
"2011","Doncaster 036A","E01007591","Total",1452,713,739,1452,0,8,22.14,65.6
"2011","Doncaster 036B","E01007594","Total",2036,1011,1025,2019,17,17,493.37,4.1
"2011","Doncaster 036C","E01007596","Total",1246,598,648,1205,41,18,161.12,7.7
"2011","Doncaster 036D","E01007598","Total",1534,772,762,1532,2,14,70.20,21.9
"2011","Doncaster 037A","E01007590","Total",1215,605,610,1212,3,6,36.03,33.7
"2011","Doncaster 037B","E01007592","Total",1652,786,866,1589,63,10,31.30,52.8
"2011","Doncaster 037C","E01007593","Total",1306,618,688,1306,0,2,264.93,4.9
"2011","Doncaster 037D","E01007595","Total",1528,726,802,1471,57,3,33.97,45.0
"2011","Doncaster 037E","E01007597","Total",1568,714,854,1568,0,5,117.28,13.4
"2011","Doncaster 038A","E01007608","Total",1707,832,875,1701,6,26,407.75,4.2
"2011","Doncaster 038B","E01007609","Total",2310,1129,1181,2305,5,45,1795.76,1.3
"2011","Doncaster 038C","E01007610","Total",1799,873,926,1795,4,34,152.49,11.8
"2011","Doncaster 039A","E01007611","Total",1293,624,669,1293,0,20,1839.17,0.7
"2011","Doncaster 039B","E01007612","Total",1378,662,716,1378,0,23,1300.99,1.1
"2011","Doncaster 039C","E01007614","Total",1353,655,698,1257,96,35,1384.92,1.0
"2011","Doncaster 039D","E01007615","Total",1258,576,682,1258,0,7,48.33,26.0
"2011","Doncaster 039E","E01007616","Total",1239,573,666,1239,0,17,45.71,27.1
"2011","Rotherham 001A","E01007693","Total",2148,1075,1073,2148,0,15,126.03,17.0
"2011","Rotherham 001B","E01007694","Total",1758,884,874,1753,5,11,59.38,29.6
"2011","Rotherham 001C","E01007695","Total",2461,1204,1257,2461,0,11,131.22,18.8
"2011","Rotherham 001D","E01007697","Total",1577,760,817,1522,55,10,32.16,49.0
"2011","Rotherham 001E","E01007698","Total",1517,761,756,1482,35,19,96.30,15.8
"2011","Rotherham 002A","E01007816","Total",1672,828,844,1655,17,26,213.32,7.8
"2011","Rotherham 002B","E01007817","Total",1421,676,745,1421,0,10,43.64,32.6
"2011","Rotherham 002C","E01007819","Total",1481,758,723,1445,36,12,205.76,7.2
"2011","Rotherham 002D","E01007820","Total",1483,734,749,1483,0,15,311.03,4.8
"2011","Rotherham 002E","E01007821","Total",1608,746,862,1535,73,11,51.43,31.3
"2011","Rotherham 002F","E01007822","Total",1540,696,844,1540,0,14,72.18,21.3
"2011","Rotherham 003A","E01007796","Total",1156,523,633,1156,0,7,20.09,57.5
"2011","Rotherham 003B","E01007797","Total",1362,688,674,1362,0,3,39.24,34.7
"2011","Rotherham 003C","E01007798","Total",1261,630,631,1261,0,15,39.90,31.6
"2011","Rotherham 003D","E01007799","Total",1414,685,729,1414,0,20,45.16,31.3
"2011","Rotherham 003E","E01007800","Total",1474,729,745,1428,46,10,102.01,14.4
"2011","Rotherham 003F","E01007818","Total",1594,776,818,1591,3,20,131.33,12.1
"2011","Rotherham 004A","E01007777","Total",1616,789,827,1576,40,7,74.32,21.7
"2011","Rotherham 004B","E01007793","Total",1366,688,678,1366,0,10,90.89,15.0
"2011","Rotherham 004C","E01007794","Total",1433,685,748,1433,0,6,23.83,60.1
"2011","Rotherham 004D","E01007795","Total",1439,722,717,1439,0,10,32.34,44.5
"2011","Rotherham 005A","E01007778","Total",1526,763,763,1526,0,12,125.57,12.2
"2011","Rotherham 005B","E01007779","Total",1257,638,619,1215,42,9,99.53,12.6
"2011","Rotherham 005C","E01007780","Total",1414,698,716,1414,0,7,74.91,18.9
"2011","Rotherham 005D","E01007781","Total",1524,743,781,1524,0,9,35.43,43.0
"2011","Rotherham 005E","E01007782","Total",1495,705,790,1495,0,11,60.64,24.7
"2011","Rotherham 006A","E01007771","Total",1421,701,720,1421,0,17,73.24,19.4
"2011","Rotherham 006B","E01007772","Total",1329,651,678,1325,4,11,186.85,7.1
"2011","Rotherham 006C","E01007773","Total",1412,653,759,1412,0,4,22.19,63.6
"2011","Rotherham 006D","E01007774","Total",1503,737,766,1503,0,7,80.84,18.6
"2011","Rotherham 007A","E01007696","Total",1478,693,785,1453,25,22,2206.06,0.7
"2011","Rotherham 007B","E01007801","Total",1491,718,773,1491,0,18,363.54,4.1
"2011","Rotherham 007C","E01007802","Total",1330,651,679,1330,0,17,55.56,23.9
"2011","Rotherham 007D","E01007803","Total",1337,664,673,1337,0,7,82.00,16.3
"2011","Rotherham 007E","E01007808","Total",1469,746,723,1469,0,31,62.91,23.4
"2011","Rotherham 008A","E01007775","Total",1341,637,704,1341,0,5,22.24,60.3
"2011","Rotherham 008B","E01007776","Total",1487,733,754,1487,0,6,109.84,13.5
"2011","Rotherham 008C","E01007783","Total",1674,802,872,1658,16,8,80.62,20.8
"2011","Rotherham 008D","E01007784","Total",1761,872,889,1645,116,8,138.63,12.7
"2011","Rotherham 009A","E01007728","Total",1116,561,555,1104,12,10,255.55,4.4
"2011","Rotherham 009B","E01007729","Total",1620,841,779,1602,18,2,28.42,57.0
"2011","Rotherham 009C","E01007730","Total",1417,711,706,1417,0,7,39.97,35.5
"2011","Rotherham 009D","E01007731","Total",1238,600,638,1187,51,12,151.24,8.2
"2011","Rotherham 009E","E01007732","Total",1415,734,681,1415,0,6,69.49,20.4
"2011","Rotherham 009F","E01007733","Total",1323,668,655,1323,0,4,26.50,49.9
"2011","Rotherham 010A","E01007719","Total",1247,618,629,1247,0,4,36.03,34.6
"2011","Rotherham 010B","E01007720","Total",1504,728,776,1454,50,15,905.44,1.7
"2011","Rotherham 010C","E01007721","Total",1575,744,831,1575,0,6,148.90,10.6
"2011","Rotherham 010D","E01007727","Total",1498,722,776,1498,0,2,95.26,15.7
"2011","Rotherham 011A","E01007740","Total",1533,726,807,1471,62,6,38.54,39.8
"2011","Rotherham 011B","E01007804","Total",1436,693,743,1430,6,10,39.63,36.2
"2011","Rotherham 011C","E01007805","Total",1430,683,747,1425,5,1,29.37,48.7
"2011","Rotherham 011D","E01007806","Total",1304,637,667,1304,0,7,20.35,64.1
"2011","Rotherham 011E","E01007807","Total",1448,720,728,1448,0,6,34.18,42.4
"2011","Rotherham 012A","E01007681","Total",1331,647,684,1331,0,8,100.62,13.2
"2011","Rotherham 012B","E01007691","Total",2045,1011,1034,2045,0,18,257.06,8.0
"2011","Rotherham 012C","E01007692","Total",1519,734,785,1519,0,20,372.53,4.1
"2011","Rotherham 012E","E01032926","Total",1773,886,887,1762,11,14,59.18,30.0
"2011","Rotherham 012F","E01032927","Total",1505,741,764,1505,0,6,90.78,16.6
"2011","Rotherham 013A","E01007723","Total",1379,690,689,1379,0,7,28.78,47.9
"2011","Rotherham 013B","E01007735","Total",1427,699,728,1427,0,3,54.02,26.4
"2011","Rotherham 013C","E01007737","Total",1583,782,801,1583,0,5,143.77,11.0
"2011","Rotherham 013D","E01007738","Total",1516,737,779,1497,19,6,26.71,56.8
"2011","Rotherham 013E","E01007739","Total",1587,780,807,1587,0,7,27.05,58.7
"2011","Rotherham 014A","E01007736","Total",1618,800,818,1593,25,5,127.90,12.7
"2011","Rotherham 014B","E01007765","Total",1518,753,765,1513,5,3,19.37,78.4
"2011","Rotherham 014C","E01007766","Total",1468,729,739,1468,0,5,22.76,64.5
"2011","Rotherham 014D","E01007768","Total",1936,1003,933,1901,35,5,36.73,52.7
"2011","Rotherham 014E","E01007770","Total",1759,864,895,1744,15,10,26.96,65.2
"2011","Rotherham 015A","E01007741","Total",1527,750,777,1527,0,8,31.89,47.9
"2011","Rotherham 015B","E01007742","Total",1421,676,745,1421,0,15,30.46,46.7
"2011","Rotherham 015C","E01007743","Total",1302,656,646,1302,0,17,224.64,5.8
"2011","Rotherham 015D","E01007744","Total",1556,794,762,1534,22,12,49.05,31.7
"2011","Rotherham 015E","E01007745","Total",1551,735,816,1537,14,6,95.12,16.3
"2011","Rotherham 015F","E01007746","Total",1542,756,786,1542,0,12,79.66,19.4
"2011","Rotherham 016A","E01007715","Total",1797,923,874,1761,36,8,47.64,37.7
"2011","Rotherham 016B","E01007716","Total",1911,983,928,1902,9,11,108.86,17.6
"2011","Rotherham 016C","E01007717","Total",1898,904,994,1882,16,12,62.13,30.5
"2011","Rotherham 016D","E01007718","Total",1489,785,704,1489,0,6,100.18,14.9
"2011","Rotherham 017A","E01007677","Total",1467,708,759,1343,124,9,54.26,27.0
"2011","Rotherham 017B","E01007714","Total",2022,1081,941,1992,30,10,151.69,13.3
"2011","Rotherham 017C","E01007767","Total",1663,836,827,1501,162,21,89.59,18.6
"2011","Rotherham 017D","E01007769","Total",1728,899,829,1728,0,17,16.26,106.3
"2011","Rotherham 018A","E01007685","Total",1437,715,722,1437,0,14,276.82,5.2
"2011","Rotherham 018B","E01007754","Total",1409,704,705,1387,22,20,74.59,18.9
"2011","Rotherham 018C","E01007755","Total",1386,691,695,1386,0,10,22.91,60.5
"2011","Rotherham 018D","E01007756","Total",1446,710,736,1446,0,19,32.04,45.1
"2011","Rotherham 018E","E01007761","Total",1616,782,834,1616,0,10,70.50,22.9
"2011","Rotherham 018F","E01007762","Total",1471,700,771,1386,85,11,61.62,23.9
"2011","Rotherham 019A","E01007682","Total",1440,717,723,1440,0,11,23.22,62.0
"2011","Rotherham 019B","E01007683","Total",1433,714,719,1401,32,17,26.67,53.7
"2011","Rotherham 019C","E01007686","Total",1417,668,749,1417,0,19,39.85,35.6
"2011","Rotherham 019D","E01007688","Total",1429,653,776,1429,0,22,33.96,42.1
"2011","Rotherham 019E","E01007725","Total",1332,648,684,1270,62,19,20.60,64.7
"2011","Rotherham 019F","E01007726","Total",1600,765,835,1600,0,7,28.80,55.6
"2011","Rotherham 020A","E01007757","Total",1669,806,863,1667,2,14,166.29,10.0
"2011","Rotherham 020B","E01007758","Total",1336,645,691,1336,0,9,34.98,38.2
"2011","Rotherham 020C","E01007759","Total",1473,716,757,1473,0,8,32.26,45.7
"2011","Rotherham 020D","E01007760","Total",1784,907,877,1784,0,6,35.21,50.7
"2011","Rotherham 020E","E01007763","Total",1561,761,800,1517,44,12,46.28,33.7
"2011","Rotherham 020F","E01007764","Total",1705,850,855,1704,1,8,1449.97,1.2
"2011","Rotherham 021A","E01007708","Total",1672,773,899,1672,0,6,35.58,47.0
"2011","Rotherham 021B","E01007709","Total",1456,701,755,1456,0,18,31.50,46.2
"2011","Rotherham 021C","E01007710","Total",1564,762,802,1564,0,27,71.96,21.7
"2011","Rotherham 021D","E01007711","Total",1799,856,943,1754,45,23,39.25,45.8
"2011","Rotherham 021E","E01007724","Total",1372,665,707,1372,0,17,222.70,6.2
"2011","Rotherham 021F","E01007734","Total",1766,795,971,1757,9,13,26.88,65.7
"2011","Rotherham 022A","E01007684","Total",1627,803,824,1617,10,15,45.56,35.7
"2011","Rotherham 022B","E01007687","Total",1452,701,751,1452,0,30,103.39,14.0
"2011","Rotherham 022C","E01007689","Total",1537,735,802,1537,0,13,31.51,48.8
"2011","Rotherham 022D","E01007690","Total",1644,791,853,1644,0,44,309.46,5.3
"2011","Rotherham 023A","E01007675","Total",1854,895,959,1850,4,32,43.65,42.5
"2011","Rotherham 023B","E01007678","Total",1597,789,808,1576,21,39,161.54,9.9
"2011","Rotherham 023C","E01007679","Total",1854,920,934,1854,0,30,35.86,51.7
"2011","Rotherham 023D","E01007680","Total",1882,945,937,1880,2,16,46.90,40.1
"2011","Rotherham 023E","E01007712","Total",1965,973,992,1965,0,37,50.37,39.0
"2011","Rotherham 023F","E01007713","Total",1625,786,839,1604,21,26,43.85,37.1
"2011","Rotherham 024A","E01007811","Total",1358,666,692,1358,0,12,120.22,11.3
"2011","Rotherham 024B","E01007812","Total",1241,616,625,1241,0,12,21.91,56.6
"2011","Rotherham 024C","E01007813","Total",1331,676,655,1331,0,9,57.62,23.1
"2011","Rotherham 024D","E01007814","Total",1112,542,570,1097,15,19,827.10,1.3
"2011","Rotherham 025A","E01007676","Total",1629,772,857,1629,0,12,334.19,4.9
"2011","Rotherham 025B","E01007702","Total",1595,780,815,1595,0,8,31.90,50.0
"2011","Rotherham 025C","E01007703","Total",1237,587,650,1237,0,15,21.24,58.2
"2011","Rotherham 025D","E01007704","Total",1450,712,738,1450,0,9,35.05,41.4
"2011","Rotherham 025E","E01007705","Total",1522,758,764,1522,0,8,42.29,36.0
"2011","Rotherham 025F","E01007707","Total",1527,762,765,1527,0,8,47.66,32.0
"2011","Rotherham 026A","E01007666","Total",1357,672,685,1357,0,11,547.09,2.5
"2011","Rotherham 026B","E01007809","Total",1553,781,772,1550,3,4,49.04,31.7
"2011","Rotherham 026C","E01007810","Total",1958,984,974,1955,3,14,378.23,5.2
"2011","Rotherham 026D","E01007815","Total",1715,816,899,1700,15,13,364.02,4.7
"2011","Rotherham 027A","E01007665","Total",1820,906,914,1766,54,10,449.91,4.0
"2011","Rotherham 027B","E01007699","Total",1826,890,936,1826,0,12,214.98,8.5
"2011","Rotherham 027C","E01007700","Total",1813,863,950,1758,55,13,156.12,11.6
"2011","Rotherham 027D","E01007701","Total",1658,809,849,1647,11,11,334.47,5.0
"2011","Rotherham 027E","E01007706","Total",1458,742,716,1458,0,6,102.91,14.2
"2011","Rotherham 028A","E01007787","Total",2769,1389,1380,2751,18,28,1418.43,2.0
"2011","Rotherham 028B","E01007788","Total",1501,764,737,1501,0,11,1639.58,0.9
"2011","Rotherham 028C","E01007789","Total",1617,787,830,1617,0,6,264.78,6.1
"2011","Rotherham 028D","E01007792","Total",1347,688,659,1347,0,36,46.20,29.2
"2011","Rotherham 029A","E01007657","Total",1447,709,738,1447,0,14,32.11,45.1
"2011","Rotherham 029B","E01007659","Total",1148,576,572,1148,0,10,31.52,36.4
"2011","Rotherham 029C","E01007785","Total",1351,650,701,1351,0,20,358.30,3.8
"2011","Rotherham 029D","E01007786","Total",1208,559,649,1112,96,17,29.48,41.0
"2011","Rotherham 029E","E01007790","Total",1485,734,751,1467,18,4,48.07,30.9
"2011","Rotherham 029F","E01007791","Total",1371,681,690,1371,0,6,28.87,47.5
"2011","Rotherham 030A","E01007667","Total",1359,672,687,1342,17,7,35.22,38.6
"2011","Rotherham 030B","E01007668","Total",1571,764,807,1571,0,5,26.63,59.0
"2011","Rotherham 030C","E01007669","Total",1504,746,758,1497,7,13,84.50,17.8
"2011","Rotherham 030D","E01007670","Total",1449,713,736,1449,0,22,379.49,3.8
"2011","Rotherham 030E","E01007672","Total",1433,702,731,1433,0,15,29.65,48.3
"2011","Rotherham 030F","E01007673","Total",1496,718,778,1496,0,6,25.58,58.5
"2011","Rotherham 031A","E01007671","Total",2117,1042,1075,2117,0,20,93.86,22.6
"2011","Rotherham 031B","E01007674","Total",1939,948,991,1939,0,16,190.12,10.2
"2011","Rotherham 031C","E01007747","Total",1295,636,659,1295,0,5,79.44,16.3
"2011","Rotherham 031D","E01007750","Total",1521,746,775,1521,0,14,659.17,2.3
"2011","Rotherham 032A","E01007658","Total",1391,670,721,1391,0,5,277.88,5.0
"2011","Rotherham 032B","E01007660","Total",1227,628,599,1212,15,15,145.87,8.4
"2011","Rotherham 032C","E01007661","Total",1401,706,695,1401,0,31,305.42,4.6
"2011","Rotherham 032D","E01007662","Total",1035,490,545,1035,0,8,20.30,51.0
"2011","Rotherham 032E","E01007663","Total",1460,700,760,1460,0,23,68.41,21.3
"2011","Rotherham 032F","E01007664","Total",1854,893,961,1854,0,36,1031.19,1.8
"2011","Rotherham 033A","E01007748","Total",1444,688,756,1443,1,18,763.81,1.9
"2011","Rotherham 033B","E01007749","Total",1804,885,919,1804,0,22,88.80,20.3
"2011","Rotherham 033C","E01007751","Total",1962,964,998,1962,0,17,492.58,4.0
"2011","Rotherham 033D","E01007752","Total",1487,714,773,1487,0,28,273.56,5.4
"2011","Rotherham 033E","E01007753","Total",1545,739,806,1527,18,17,1495.79,1.0
"2011","Sheffield 001A","E01008144","Total",1666,825,841,1614,52,10,256.04,6.5
"2011","Sheffield 001B","E01008145","Total",1472,735,737,1472,0,22,57.09,25.8
"2011","Sheffield 001C","E01008148","Total",1509,739,770,1509,0,10,77.21,19.5
"2011","Sheffield 001D","E01008149","Total",1496,733,763,1496,0,11,148.08,10.1
"2011","Sheffield 001E","E01008150","Total",1454,686,768,1372,82,5,33.48,43.4
"2011","Sheffield 002A","E01008142","Total",1478,738,740,1464,14,9,42.01,35.2
"2011","Sheffield 002B","E01008143","Total",1620,794,826,1620,0,20,99.28,16.3
"2011","Sheffield 002C","E01008146","Total",1334,656,678,1334,0,20,24.02,55.5
"2011","Sheffield 002D","E01008147","Total",1426,688,738,1426,0,11,1166.08,1.2
"2011","Sheffield 003A","E01007888","Total",1379,686,693,1379,0,10,38.15,36.1
"2011","Sheffield 003B","E01007892","Total",1466,689,777,1448,18,5,26.32,55.7
"2011","Sheffield 003C","E01007893","Total",1491,728,763,1491,0,17,109.11,13.7
"2011","Sheffield 003D","E01007898","Total",1470,689,781,1469,1,11,123.77,11.9
"2011","Sheffield 003E","E01007899","Total",1463,704,759,1463,0,15,65.60,22.3
"2011","Sheffield 003F","E01007900","Total",1694,826,868,1694,0,9,36.05,47.0
"2011","Sheffield 003G","E01007901","Total",1481,710,771,1481,0,2,28.42,52.1
"2011","Sheffield 004A","E01007887","Total",1362,661,701,1362,0,4,28.31,48.1
"2011","Sheffield 004B","E01007889","Total",2677,1339,1338,2658,19,31,166.81,16.0
"2011","Sheffield 004C","E01007890","Total",1442,712,730,1422,20,7,26.30,54.8
"2011","Sheffield 004D","E01007891","Total",1551,775,776,1551,0,23,151.22,10.3
"2011","Sheffield 004E","E01007894","Total",1458,701,757,1410,48,11,97.93,14.9
"2011","Sheffield 004F","E01007895","Total",1456,695,761,1400,56,3,30.22,48.2
"2011","Sheffield 004G","E01007896","Total",1280,628,652,1280,0,14,31.35,40.8
"2011","Sheffield 005A","E01007897","Total",1386,699,687,1386,0,9,98.96,14.0
"2011","Sheffield 005B","E01008134","Total",1331,641,690,1331,0,21,126.17,10.5
"2011","Sheffield 005C","E01008135","Total",1770,864,906,1710,60,10,557.57,3.2
"2011","Sheffield 005D","E01008137","Total",1441,676,765,1441,0,22,119.97,12.0
"2011","Sheffield 005E","E01008141","Total",1591,758,833,1589,2,15,206.43,7.7
"2011","Sheffield 006A","E01008053","Total",1245,611,634,1245,0,3,26.42,47.1
"2011","Sheffield 006B","E01008056","Total",1497,732,765,1497,0,15,26.28,57.0
"2011","Sheffield 006C","E01008058","Total",1465,715,750,1460,5,6,44.04,33.3
"2011","Sheffield 006D","E01008138","Total",1302,618,684,1302,0,7,29.64,43.9
"2011","Sheffield 006E","E01008139","Total",1582,782,800,1582,0,6,38.17,41.4
"2011","Sheffield 007A","E01007856","Total",1317,650,667,1317,0,6,72.15,18.3
"2011","Sheffield 007B","E01008054","Total",1324,623,701,1324,0,7,19.50,67.9
"2011","Sheffield 007C","E01008055","Total",1485,689,796,1485,0,6,39.55,37.5
"2011","Sheffield 007D","E01008057","Total",1489,700,789,1489,0,7,31.89,46.7
"2011","Sheffield 008A","E01008126","Total",1552,758,794,1552,0,22,88.61,17.5
"2011","Sheffield 008C","E01008128","Total",1714,846,868,1702,12,15,11869.77,0.1
"2011","Sheffield 008D","E01008136","Total",1355,682,673,1355,0,19,129.60,10.5
"2011","Sheffield 008E","E01008140","Total",1806,877,929,1786,20,18,56.03,32.2
"2011","Sheffield 008F","E01033275","Total",1611,804,807,1611,0,10,45.20,35.6
"2011","Sheffield 008G","E01033280","Total",1637,843,794,1575,62,31,281.15,5.8
"2011","Sheffield 009A","E01008085","Total",1368,660,708,1368,0,3,29.03,47.1
"2011","Sheffield 009B","E01008086","Total",1349,643,706,1349,0,11,34.08,39.6
"2011","Sheffield 009C","E01008116","Total",1327,652,675,1327,0,4,36.01,36.9
"2011","Sheffield 009D","E01008117","Total",1221,633,588,1221,0,5,32.08,38.1
"2011","Sheffield 009E","E01008118","Total",1397,687,710,1397,0,15,36.02,38.8
"2011","Sheffield 009F","E01008119","Total",1279,606,673,1248,31,5,35.56,36.0
"2011","Sheffield 009G","E01008125","Total",1481,707,774,1481,0,6,29.13,50.8
"2011","Sheffield 010A","E01007849","Total",2113,1024,1089,2113,0,10,55.64,38.0
"2011","Sheffield 010B","E01007857","Total",1557,737,820,1552,5,9,32.52,47.9
"2011","Sheffield 010C","E01008059","Total",1512,700,812,1512,0,7,23.17,65.3
"2011","Sheffield 010D","E01008060","Total",1386,655,731,1386,0,9,29.33,47.3
"2011","Sheffield 011A","E01008061","Total",1596,744,852,1596,0,5,27.60,57.8
"2011","Sheffield 011B","E01008063","Total",1541,760,781,1505,36,13,48.08,32.1
"2011","Sheffield 011E","E01033277","Total",2334,1163,1171,2334,0,9,72.90,32.0
"2011","Sheffield 012A","E01008087","Total",1555,766,789,1514,41,9,40.45,38.4
"2011","Sheffield 012B","E01008088","Total",1429,703,726,1429,0,4,26.66,53.6
"2011","Sheffield 012C","E01008090","Total",1624,773,851,1624,0,3,29.72,54.6
"2011","Sheffield 012D","E01008092","Total",1427,696,731,1389,38,3,66.39,21.5
"2011","Sheffield 012E","E01008122","Total",1350,648,702,1350,0,4,22.53,59.9
"2011","Sheffield 012F","E01008124","Total",1499,709,790,1499,0,3,25.70,58.3
"2011","Sheffield 013A","E01007848","Total",1717,811,906,1616,101,7,33.86,50.7
"2011","Sheffield 013B","E01007851","Total",1483,710,773,1483,0,5,43.97,33.7
"2011","Sheffield 013C","E01007947","Total",1626,794,832,1615,11,7,30.83,52.7
"2011","Sheffield 013D","E01007948","Total",1757,786,971,1756,1,11,24.06,73.0
"2011","Sheffield 013E","E01008062","Total",1693,796,897,1693,0,10,20.72,81.7
"2011","Sheffield 014A","E01007847","Total",1297,650,647,1297,0,7,15.81,82.0
"2011","Sheffield 014B","E01007850","Total",1562,743,819,1562,0,7,98.46,15.9
"2011","Sheffield 014C","E01007852","Total",1482,763,719,1482,0,8,104.87,14.1
"2011","Sheffield 014D","E01007853","Total",1568,775,793,1568,0,13,39.45,39.7
"2011","Sheffield 014E","E01007854","Total",1735,785,950,1735,0,3,54.08,32.1
"2011","Sheffield 014F","E01007855","Total",2035,1023,1012,1976,59,6,45.73,44.5
"2011","Sheffield 015A","E01007941","Total",1623,798,825,1534,89,6,36.38,44.6
"2011","Sheffield 015B","E01007945","Total",1780,857,923,1771,9,2,28.72,62.0
"2011","Sheffield 015C","E01007946","Total",1585,763,822,1585,0,4,24.50,64.7
"2011","Sheffield 015D","E01007950","Total",1529,720,809,1529,0,2,24.68,62.0
"2011","Sheffield 015E","E01008123","Total",1313,635,678,1293,20,7,36.08,36.4
"2011","Sheffield 016A","E01007987","Total",1468,721,747,1468,0,14,17.43,84.2
"2011","Sheffield 016B","E01007988","Total",1520,722,798,1520,0,14,31.76,47.9
"2011","Sheffield 016C","E01007989","Total",1419,666,753,1419,0,13,13.01,109.1
"2011","Sheffield 016D","E01007991","Total",1503,674,829,1503,0,10,28.66,52.4
"2011","Sheffield 017A","E01007995","Total",1472,719,753,1470,2,12,13.66,107.8
"2011","Sheffield 017B","E01008089","Total",1679,807,872,1679,0,10,148.32,11.3
"2011","Sheffield 017C","E01008091","Total",1464,746,718,1464,0,9,50.82,28.8
"2011","Sheffield 017D","E01008093","Total",1455,720,735,1455,0,3,111.76,13.0
"2011","Sheffield 018A","E01007903","Total",1588,813,775,1537,51,10,232.42,6.8
"2011","Sheffield 018B","E01007904","Total",1701,844,857,1700,1,7,184.84,9.2
"2011","Sheffield 018C","E01007913","Total",1481,755,726,1481,0,4,272.24,5.4
"2011","Sheffield 018D","E01007914","Total",1559,785,774,1559,0,13,26.71,58.4
"2011","Sheffield 019A","E01007870","Total",1843,983,860,1756,87,19,54.69,33.7
"2011","Sheffield 019B","E01007871","Total",1783,926,857,1783,0,14,46.66,38.2
"2011","Sheffield 019C","E01007943","Total",1748,828,920,1748,0,5,29.95,58.4
"2011","Sheffield 019D","E01008094","Total",1115,565,550,1115,0,1,40.78,27.3
"2011","Sheffield 020A","E01007869","Total",1714,839,875,1693,21,10,34.34,49.9
"2011","Sheffield 020B","E01007872","Total",1753,866,887,1713,40,13,46.11,38.0
"2011","Sheffield 020C","E01007873","Total",1760,914,846,1752,8,10,54.59,32.2
"2011","Sheffield 020D","E01007942","Total",1862,983,879,1834,28,10,41.87,44.5
"2011","Sheffield 020E","E01007949","Total",1592,792,800,1555,37,11,20.95,76.0
"2011","Sheffield 021A","E01007990","Total",1485,722,763,1485,0,10,32.01,46.4
"2011","Sheffield 021B","E01007992","Total",1624,798,826,1612,12,19,15.29,106.2
"2011","Sheffield 021C","E01007993","Total",1682,835,847,1682,0,6,27.13,62.0
"2011","Sheffield 021D","E01007994","Total",1435,700,735,1435,0,8,12.65,113.4
"2011","Sheffield 021E","E01007996","Total",1552,756,796,1532,20,10,49.17,31.6
"2011","Sheffield 022A","E01007874","Total",1862,880,982,1848,14,11,23.41,79.5
"2011","Sheffield 022B","E01007875","Total",1838,994,844,1838,0,9,28.08,65.5
"2011","Sheffield 022D","E01007877","Total",1446,695,751,1372,74,5,77.26,18.7
"2011","Sheffield 022E","E01007940","Total",1693,826,867,1690,3,7,18.06,93.7
"2011","Sheffield 022F","E01007944","Total",2058,1113,945,2058,0,8,11.06,186.1
"2011","Sheffield 022G","E01033269","Total",1919,988,931,1919,0,8,287.12,6.7
"2011","Sheffield 022H","E01033270","Total",1484,862,622,1463,21,1,108.96,13.6
"2011","Sheffield 023A","E01008129","Total",1409,694,715,1377,32,22,1511.68,0.9
"2011","Sheffield 023B","E01008130","Total",1494,716,778,1494,0,18,160.23,9.3
"2011","Sheffield 023C","E01008131","Total",1576,757,819,1576,0,15,37.65,41.9
"2011","Sheffield 023D","E01008132","Total",1416,691,725,1416,0,22,45.42,31.2
"2011","Sheffield 023E","E01008133","Total",1530,724,806,1530,0,17,66.53,23.0
"2011","Sheffield 024A","E01008151","Total",1539,818,721,1539,0,21,17.60,87.4
"2011","Sheffield 024B","E01008153","Total",1653,837,816,1653,0,10,19.18,86.2
"2011","Sheffield 024C","E01008154","Total",1628,778,850,1628,0,14,29.41,55.4
"2011","Sheffield 024D","E01008155","Total",1546,792,754,1546,0,9,16.88,91.6
"2011","Sheffield 024E","E01008156","Total",1449,720,729,1449,0,10,24.62,58.9
"2011","Sheffield 024F","E01008160","Total",1399,660,739,1399,0,8,34.76,40.2
"2011","Sheffield 025A","E01007997","Total",1479,716,763,1479,0,18,38.11,38.8
"2011","Sheffield 025B","E01007998","Total",1592,807,785,1561,31,2,20.72,76.8
"2011","Sheffield 025C","E01008152","Total",1426,722,704,1426,0,15,49.86,28.6
"2011","Sheffield 025D","E01008158","Total",1535,730,805,1535,0,20,231.28,6.6
"2011","Sheffield 026A","E01008065","Total",1922,1056,866,1903,19,6,24.98,76.9
"2011","Sheffield 026B","E01008068","Total",2860,1458,1402,2077,783,24,22.83,125.3
"2011","Sheffield 026C","E01008072","Total",1590,816,774,1552,38,6,56.23,28.3
"2011","Sheffield 026D","E01008157","Total",1557,742,815,1557,0,3,34.13,45.6
"2011","Sheffield 026E","E01008161","Total",1668,833,835,1668,0,4,38.06,43.8
"2011","Sheffield 027A","E01007883","Total",1322,629,693,1322,0,6,117.50,11.3
"2011","Sheffield 027B","E01007902","Total",1752,930,822,1752,0,3,250.84,7.0
"2011","Sheffield 027C","E01007905","Total",1770,851,919,1770,0,8,30.71,57.6
"2011","Sheffield 027D","E01007906","Total",2081,1054,1027,2081,0,12,27.78,74.9
"2011","Sheffield 028A","E01008064","Total",1687,850,837,1687,0,15,12.60,133.9
"2011","Sheffield 028B","E01008066","Total",1598,799,799,1554,44,15,9.81,162.9
"2011","Sheffield 028C","E01008069","Total",1617,815,802,1617,0,19,10.83,149.3
"2011","Sheffield 028D","E01008074","Total",1460,760,700,1460,0,29,12.82,113.9
"2011","Sheffield 029A","E01007951","Total",1585,769,816,1567,18,16,28.55,55.5
"2011","Sheffield 029B","E01007960","Total",1580,762,818,1580,0,9,23.01,68.7
"2011","Sheffield 029C","E01007962","Total",1465,690,775,1426,39,16,11.69,125.3
"2011","Sheffield 029D","E01008159","Total",1527,735,792,1527,0,7,18.24,83.7
"2011","Sheffield 030A","E01007866","Total",1727,886,841,1714,13,24,42.78,40.4
"2011","Sheffield 030B","E01007867","Total",2010,955,1055,2006,4,14,18.38,109.4
"2011","Sheffield 030C","E01007868","Total",1179,548,631,1110,69,22,28.16,41.9
"2011","Sheffield 030D","E01008067","Total",1684,886,798,1646,38,6,30.34,55.5
"2011","Sheffield 030E","E01008073","Total",1702,922,780,1702,0,16,22.67,75.1
"2011","Sheffield 032A","E01007907","Total",1656,854,802,1656,0,5,41.92,39.5
"2011","Sheffield 032B","E01007908","Total",1492,747,745,1492,0,7,24.84,60.1
"2011","Sheffield 032C","E01007909","Total",2047,1019,1028,2047,0,13,99.45,20.6
"2011","Sheffield 032D","E01007911","Total",1397,683,714,1397,0,4,87.94,15.9
"2011","Sheffield 032E","E01008014","Total",1579,752,827,1531,48,6,46.64,33.9
"2011","Sheffield 032F","E01008016","Total",1492,764,728,1466,26,3,42.66,35.0
"2011","Sheffield 033A","E01007952","Total",1569,758,811,1569,0,50,35.07,44.7
"2011","Sheffield 033B","E01007953","Total",1565,746,819,1561,4,30,114.51,13.7
"2011","Sheffield 033C","E01007954","Total",1650,799,851,1650,0,30,37.02,44.6
"2011","Sheffield 033D","E01007961","Total",1508,749,759,1508,0,23,145.50,10.4
"2011","Sheffield 036A","E01007859","Total",1638,870,768,1420,218,21,27.80,58.9
"2011","Sheffield 036B","E01007860","Total",1553,783,770,1528,25,19,27.61,56.2
"2011","Sheffield 036C","E01007863","Total",1865,889,976,1702,163,31,27.91,66.8
"2011","Sheffield 036D","E01007864","Total",1882,932,950,1882,0,7,11.75,160.2
"2011","Sheffield 036E","E01008104","Total",1587,827,760,1406,181,23,36.41,43.6
"2011","Sheffield 037A","E01007910","Total",1638,767,871,1579,59,11,93.85,17.5
"2011","Sheffield 037B","E01007912","Total",1516,739,777,1516,0,3,26.57,57.1
"2011","Sheffield 037C","E01007971","Total",1434,688,746,1434,0,14,50.40,28.5
"2011","Sheffield 037D","E01007973","Total",1523,763,760,1523,0,7,36.82,41.4
"2011","Sheffield 038A","E01007858","Total",1443,713,730,1358,85,29,39.11,36.9
"2011","Sheffield 038B","E01007861","Total",1525,738,787,1525,0,58,58.88,25.9
"2011","Sheffield 038C","E01007862","Total",4183,1985,2198,2286,1897,54,69.11,60.5
"2011","Sheffield 038D","E01007865","Total",1682,832,850,1682,0,45,44.90,37.5
"2011","Sheffield 039A","E01008011","Total",1633,786,847,1633,0,6,34.67,47.1
"2011","Sheffield 039B","E01008012","Total",2144,1044,1100,2144,0,16,50.97,42.1
"2011","Sheffield 039C","E01008013","Total",1168,574,594,1168,0,2,38.28,30.5
"2011","Sheffield 039D","E01008015","Total",1608,836,772,1608,0,5,78.87,20.4
"2011","Sheffield 039E","E01008017","Total",1588,792,796,1588,0,5,71.22,22.3
"2011","Sheffield 039F","E01008018","Total",1287,599,688,1283,4,2,39.64,32.5
"2011","Sheffield 040A","E01008105","Total",3329,1689,1640,2046,1283,24,18.02,184.7
"2011","Sheffield 040C","E01008107","Total",1527,805,722,1492,35,14,10.89,140.2
"2011","Sheffield 040D","E01008111","Total",1688,826,862,1592,96,20,27.11,62.3
"2011","Sheffield 040E","E01033271","Total",1403,817,586,1403,0,5,17.37,80.8
"2011","Sheffield 040F","E01033272","Total",1159,639,520,1154,5,3,10.61,109.2
"2011","Sheffield 041A","E01007955","Total",1371,659,712,1371,0,40,39.73,34.5
"2011","Sheffield 041B","E01007956","Total",2197,1070,1127,2196,1,60,2967.36,0.7
"2011","Sheffield 041C","E01007957","Total",1629,804,825,1629,0,31,37.66,43.3
"2011","Sheffield 041D","E01007958","Total",1465,689,776,1458,7,57,64.56,22.7
"2011","Sheffield 041E","E01007959","Total",1491,706,785,1491,0,42,49.58,30.1
"2011","Sheffield 042A","E01008108","Total",1981,1077,904,1972,9,18,31.92,62.1
"2011","Sheffield 042B","E01008109","Total",2035,1064,971,1993,42,21,23.49,86.6
"2011","Sheffield 042D","E01008112","Total",1750,953,797,1750,0,13,21.89,79.9
"2011","Sheffield 042E","E01008113","Total",1732,922,810,1732,0,23,13.70,126.4
"2011","Sheffield 042F","E01033273","Total",2422,1246,1176,1576,846,33,27.55,87.9
"2011","Sheffield 042G","E01033274","Total",2410,1130,1280,1287,1123,29,35.55,67.8
"2011","Sheffield 043A","E01008095","Total",1589,857,732,1245,344,11,82.73,19.2
"2011","Sheffield 043B","E01008096","Total",2176,1023,1153,2176,0,3,60.66,35.9
"2011","Sheffield 043C","E01008097","Total",1621,784,837,1572,49,8,38.28,42.3
"2011","Sheffield 043D","E01008101","Total",1763,859,904,1763,0,5,20.80,84.8
"2011","Sheffield 044A","E01007965","Total",1906,865,1041,1906,0,15,28.06,67.9
"2011","Sheffield 044B","E01007969","Total",1557,781,776,1418,139,4,68.10,22.9
"2011","Sheffield 044C","E01007972","Total",1473,707,766,1473,0,4,60.34,24.4
"2011","Sheffield 044D","E01007974","Total",1468,722,746,1468,0,7,96.70,15.2
"2011","Sheffield 045A","E01007963","Total",1443,713,730,1443,0,7,61.29,23.5
"2011","Sheffield 045B","E01007967","Total",1668,821,847,1665,3,4,50.38,33.1
"2011","Sheffield 045C","E01007999","Total",1349,678,671,1349,0,12,30.76,43.9
"2011","Sheffield 045D","E01008008","Total",1648,759,889,1617,31,9,32.90,50.1
"2011","Sheffield 045E","E01008009","Total",1547,713,834,1547,0,4,24.70,62.6
"2011","Sheffield 046A","E01008043","Total",1730,847,883,1730,0,30,48.02,36.0
"2011","Sheffield 046B","E01008044","Total",1615,770,845,1603,12,19,38.05,42.4
"2011","Sheffield 046C","E01008047","Total",1509,782,727,1509,0,22,11.34,133.1
"2011","Sheffield 046D","E01008048","Total",1534,793,741,1516,18,21,26.89,57.0
"2011","Sheffield 046E","E01008050","Total",1411,727,684,1411,0,23,16.16,87.3
"2011","Sheffield 047A","E01007931","Total",1604,762,842,1604,0,67,33.60,47.7
"2011","Sheffield 047B","E01007934","Total",1468,709,759,1468,0,30,42.51,34.5
"2011","Sheffield 047C","E01007935","Total",1419,683,736,1419,0,27,20.04,70.8
"2011","Sheffield 047D","E01007936","Total",1590,752,838,1590,0,23,15.47,102.8
"2011","Sheffield 047E","E01007937","Total",1395,682,713,1395,0,45,28.18,49.5
"2011","Sheffield 047F","E01007938","Total",1509,713,796,1509,0,37,36.03,41.9
"2011","Sheffield 048A","E01008098","Total",1590,740,850,1590,0,6,24.56,64.7
"2011","Sheffield 048B","E01008100","Total",1265,587,678,1265,0,3,24.74,51.1
"2011","Sheffield 048C","E01008102","Total",1115,517,598,1115,0,2,26.51,42.1
"2011","Sheffield 048D","E01008103","Total",1410,676,734,1390,20,5,25.91,54.4
"2011","Sheffield 049A","E01007964","Total",1529,752,777,1517,12,5,41.58,36.8
"2011","Sheffield 049B","E01007966","Total",1551,753,798,1551,0,5,79.03,19.6
"2011","Sheffield 049C","E01007968","Total",1467,703,764,1467,0,7,42.60,34.4
"2011","Sheffield 049D","E01007970","Total",1577,830,747,1528,49,0,67.49,23.4
"2011","Sheffield 050A","E01008042","Total",1634,852,782,1616,18,27,19.93,82.0
"2011","Sheffield 050B","E01008045","Total",1393,696,697,1377,16,27,21.65,64.3
"2011","Sheffield 050C","E01008046","Total",1659,832,827,1659,0,23,20.40,81.3
"2011","Sheffield 050D","E01008049","Total",1589,775,814,1527,62,18,42.04,37.8
"2011","Sheffield 050E","E01008051","Total",1762,924,838,1741,21,24,16.78,105.0
"2011","Sheffield 050F","E01008052","Total",1794,958,836,1782,12,31,24.92,72.0
"2011","Sheffield 051A","E01007975","Total",1636,828,808,1636,0,5,27.19,60.2
"2011","Sheffield 051B","E01007976","Total",1485,708,777,1426,59,19,33.23,44.7
"2011","Sheffield 051C","E01007977","Total",1496,750,746,1496,0,3,31.19,48.0
"2011","Sheffield 051D","E01007979","Total",1634,721,913,1614,20,3,39.64,41.2
"2011","Sheffield 051E","E01008099","Total",1598,823,775,1545,53,14,23.60,67.7
"2011","Sheffield 052A","E01008000","Total",1503,729,774,1446,57,4,30.74,48.9
"2011","Sheffield 052B","E01008001","Total",1535,741,794,1471,64,9,39.93,38.4
"2011","Sheffield 052C","E01008004","Total",1606,752,854,1606,0,6,31.34,51.2
"2011","Sheffield 052D","E01008005","Total",1546,757,789,1546,0,11,35.96,43.0
"2011","Sheffield 052E","E01008010","Total",1454,688,766,1454,0,8,24.04,60.5
"2011","Sheffield 053A","E01007978","Total",1664,844,820,1664,0,16,26.40,63.0
"2011","Sheffield 053B","E01007980","Total",1544,738,806,1527,17,22,15.03,102.7
"2011","Sheffield 053C","E01007981","Total",1448,744,704,1427,21,19,48.66,29.8
"2011","Sheffield 053D","E01007983","Total",1483,731,752,1483,0,11,23.26,63.8
"2011","Sheffield 053E","E01007985","Total",1555,764,791,1515,40,9,26.40,58.9
"2011","Sheffield 054A","E01007982","Total",1821,923,898,1821,0,17,44.46,41.0
"2011","Sheffield 054B","E01008002","Total",1565,773,792,1557,8,11,26.56,58.9
"2011","Sheffield 054C","E01008003","Total",1410,681,729,1410,0,7,28.06,50.2
"2011","Sheffield 054D","E01008006","Total",1362,658,704,1362,0,3,25.93,52.5
"2011","Sheffield 055A","E01007927","Total",1672,817,855,1608,64,43,63.43,26.4
"2011","Sheffield 055B","E01007928","Total",1751,850,901,1751,0,83,52.76,33.2
"2011","Sheffield 055C","E01007929","Total",1628,816,812,1628,0,42,68.81,23.7
"2011","Sheffield 055D","E01007930","Total",1476,697,779,1470,6,57,61.60,24.0
"2011","Sheffield 055E","E01007932","Total",1415,687,728,1415,0,47,98.95,14.3
"2011","Sheffield 055F","E01007939","Total",1534,733,801,1534,0,67,307.80,5.0
"2011","Sheffield 056A","E01008028","Total",1547,749,798,1547,0,3,54.32,28.5
"2011","Sheffield 056B","E01008029","Total",1496,739,757,1496,0,11,49.63,30.1
"2011","Sheffield 056C","E01008032","Total",1407,672,735,1407,0,8,30.04,46.8
"2011","Sheffield 056D","E01008034","Total",1745,837,908,1737,8,12,81.43,21.4
"2011","Sheffield 059A","E01007828","Total",1710,780,930,1699,11,11,28.17,60.7
"2011","Sheffield 059B","E01007829","Total",1562,784,778,1562,0,12,44.05,35.5
"2011","Sheffield 059C","E01007831","Total",1523,716,807,1469,54,16,30.62,49.7
"2011","Sheffield 059D","E01007832","Total",1543,744,799,1543,0,19,20.37,75.7
"2011","Sheffield 059E","E01007986","Total",1369,685,684,1369,0,15,16.79,81.5
"2011","Sheffield 060A","E01008007","Total",1698,849,849,1658,40,10,60.21,28.2
"2011","Sheffield 060B","E01008075","Total",1441,685,756,1441,0,5,39.22,36.7
"2011","Sheffield 060C","E01008076","Total",1352,648,704,1352,0,4,20.26,66.7
"2011","Sheffield 060D","E01008077","Total",1461,684,777,1461,0,10,22.26,65.6
"2011","Sheffield 061A","E01008031","Total",1436,701,735,1436,0,5,27.44,52.3
"2011","Sheffield 061B","E01008033","Total",1290,630,660,1290,0,10,63.75,20.2
"2011","Sheffield 061C","E01008038","Total",1535,734,801,1535,0,14,33.69,45.6
"2011","Sheffield 061D","E01008040","Total",1704,845,859,1704,0,23,72.86,23.4
"2011","Sheffield 062A","E01007835","Total",1442,691,751,1381,61,9,60.29,23.9
"2011","Sheffield 062B","E01007836","Total",1631,797,834,1605,26,8,56.03,29.1
"2011","Sheffield 062C","E01007843","Total",1600,780,820,1600,0,6,37.10,43.1
"2011","Sheffield 062D","E01007846","Total",1494,712,782,1494,0,6,24.25,61.6
"2011","Sheffield 063A","E01008030","Total",1456,714,742,1384,72,11,44.85,32.5
"2011","Sheffield 063B","E01008035","Total",1195,617,578,1195,0,11,49.69,24.0
"2011","Sheffield 063C","E01008036","Total",1427,723,704,1427,0,20,17.91,79.7
"2011","Sheffield 063D","E01008041","Total",1519,742,777,1519,0,14,116.65,13.0
"2011","Sheffield 064A","E01007827","Total",1504,754,750,1504,0,18,154.68,9.7
"2011","Sheffield 064B","E01007830","Total",1547,739,808,1455,92,15,28.68,53.9
"2011","Sheffield 064C","E01007833","Total",1648,789,859,1648,0,19,116.87,14.1
"2011","Sheffield 064D","E01007984","Total",1435,711,724,1435,0,9,31.54,45.5
"2011","Sheffield 064E","E01008078","Total",1335,649,686,1335,0,18,86.46,15.4
"2011","Sheffield 064F","E01008079","Total",1235,609,626,1235,0,23,68.40,18.1
"2011","Sheffield 065A","E01008019","Total",1866,900,966,1840,26,13,105.68,17.7
"2011","Sheffield 065B","E01008020","Total",1434,727,707,1434,0,12,20.68,69.3
"2011","Sheffield 065C","E01008022","Total",1513,770,743,1513,0,3,19.40,78.0
"2011","Sheffield 065D","E01008027","Total",1532,750,782,1501,31,4,31.53,48.6
"2011","Sheffield 065E","E01008037","Total",1392,629,763,1392,0,6,58.37,23.8
"2011","Sheffield 065F","E01008039","Total",1312,625,687,1312,0,8,50.29,26.1
"2011","Sheffield 066A","E01007824","Total",1393,684,709,1393,0,21,34.55,40.3
"2011","Sheffield 066B","E01007825","Total",1457,682,775,1404,53,34,126.26,11.5
"2011","Sheffield 066C","E01007826","Total",1526,749,777,1526,0,24,104.90,14.5
"2011","Sheffield 066D","E01007834","Total",1654,771,883,1654,0,17,65.06,25.4
"2011","Sheffield 068A","E01007920","Total",1638,784,854,1622,16,37,84.20,19.5
"2011","Sheffield 068B","E01007921","Total",1571,726,845,1562,9,33,75.20,20.9
"2011","Sheffield 068C","E01007923","Total",1802,859,943,1802,0,30,61.69,29.2
"2011","Sheffield 068D","E01007925","Total",1630,789,841,1630,0,28,129.89,12.5
"2011","Sheffield 068E","E01007926","Total",1714,819,895,1686,28,39,889.55,1.9
"2011","Sheffield 068F","E01007933","Total",1663,809,854,1658,5,65,184.23,9.0
"2011","Sheffield 069A","E01007823","Total",1658,791,867,1658,0,20,41.99,39.5
"2011","Sheffield 069B","E01007916","Total",1529,733,796,1529,0,7,30.62,49.9
"2011","Sheffield 069C","E01007919","Total",1603,757,846,1603,0,7,22.49,71.3
"2011","Sheffield 069D","E01008080","Total",1483,735,748,1483,0,15,29.68,50.0
"2011","Sheffield 070A","E01008081","Total",1481,784,697,1481,0,3,39.44,37.6
"2011","Sheffield 070B","E01008082","Total",1488,711,777,1488,0,6,44.40,33.5
"2011","Sheffield 070C","E01008083","Total",1514,699,815,1471,43,2,23.30,65.0
"2011","Sheffield 070D","E01008084","Total",1644,791,853,1644,0,5,27.29,60.2
"2011","Sheffield 071A","E01007915","Total",1415,663,752,1415,0,25,56.53,25.0
"2011","Sheffield 071B","E01007917","Total",1460,699,761,1460,0,22,82.47,17.7
"2011","Sheffield 071C","E01007918","Total",1635,778,857,1635,0,31,51.04,32.0
"2011","Sheffield 071D","E01007922","Total",1406,690,716,1406,0,35,39.40,35.7
"2011","Sheffield 071E","E01007924","Total",1543,768,775,1484,59,22,48.00,32.1
"2011","Sheffield 072A","E01008021","Total",1472,732,740,1472,0,19,135.50,10.9
"2011","Sheffield 072B","E01008023","Total",2110,1087,1023,2110,0,18,63.65,33.2
"2011","Sheffield 072C","E01008024","Total",1786,869,917,1786,0,4,114.10,15.7
"2011","Sheffield 072D","E01008025","Total",2021,989,1032,2021,0,9,233.11,8.7
"2011","Sheffield 072E","E01032585","Total",1409,691,718,1409,0,12,35.89,39.3
"2011","Sheffield 073A","E01033261","Total",1767,901,866,1701,66,17,12.94,136.6
"2011","Sheffield 073B","E01033262","Total",1749,1064,685,1139,610,10,23.42,74.7
"2011","Sheffield 073C","E01033263","Total",1330,692,638,1330,0,8,27.50,48.4
"2011","Sheffield 073D","E01033264","Total",1487,698,789,1299,188,15,38.88,38.2
"2011","Sheffield 073E","E01033276","Total",2923,1570,1353,1641,1282,31,11.90,245.6
"2011","Sheffield 074A","E01008114","Total",2615,1295,1320,2309,306,25,30.95,84.5
"2011","Sheffield 074B","E01008115","Total",1817,1029,788,1775,42,9,14.95,121.5
"2011","Sheffield 074C","E01033265","Total",1304,756,548,966,338,13,17.41,74.9
"2011","Sheffield 074D","E01033266","Total",1611,879,732,1424,187,13,15.88,101.4
"2011","Sheffield 074E","E01033267","Total",1387,656,731,1386,1,20,4.92,281.9
"2011","Sheffield 075A","E01007878","Total",1716,1022,694,1716,0,4,25.23,68.0
"2011","Sheffield 075B","E01007879","Total",1646,854,792,1637,9,19,31.93,51.6
"2011","Sheffield 075C","E01007881","Total",1609,823,786,1609,0,8,54.20,29.7
"2011","Sheffield 075D","E01007882","Total",1637,936,701,1637,0,15,21.02,77.9
"2011","Sheffield 075E","E01007885","Total",1557,774,783,1557,0,9,67.41,23.1
"2011","Sheffield 075F","E01007886","Total",1623,739,884,1623,0,10,36.96,43.9
"2011","Sheffield 075G","E01033268","Total",2373,1333,1040,2359,14,16,91.14,26.0
"2011","Sheffield 076A","E01007838","Total",1507,731,776,1507,0,7,35.06,43.0
"2011","Sheffield 076B","E01007839","Total",1635,803,832,1635,0,11,35.76,45.7
"2011","Sheffield 076C","E01007841","Total",1665,793,872,1604,61,7,45.17,36.9
"2011","Sheffield 076D","E01007842","Total",1575,741,834,1575,0,14,64.49,24.4
"2011","Sheffield 076E","E01033278","Total",2431,1145,1286,2431,0,9,80.66,30.1
"2011","Sheffield 076F","E01033279","Total",2378,1179,1199,2313,65,6,102.32,23.2
"2011","Bradford 001A","E01010646","Total",1319,639,680,1319,0,34,1129.28,1.2
"2011","Bradford 001B","E01010647","Total",1091,518,573,1091,0,26,89.41,12.2
"2011","Bradford 001C","E01010648","Total",1320,637,683,1320,0,26,80.47,16.4
"2011","Bradford 001D","E01010692","Total",1864,912,952,1800,64,50,1163.82,1.6
"2011","Bradford 002A","E01010691","Total",1528,707,821,1510,18,68,71.97,21.2
"2011","Bradford 002B","E01010693","Total",1549,719,830,1448,101,55,101.07,15.3
"2011","Bradford 002C","E01010694","Total",1576,741,835,1494,82,54,293.29,5.4
"2011","Bradford 002D","E01010695","Total",1664,758,906,1639,25,45,37.15,44.8
"2011","Bradford 002E","E01010696","Total",1548,744,804,1531,17,43,87.68,17.7
"2011","Bradford 002F","E01010697","Total",1515,706,809,1468,47,58,44.58,34.0
"2011","Bradford 002G","E01010698","Total",1808,888,920,1808,0,32,65.47,27.6
"2011","Bradford 002H","E01010699","Total",1757,804,953,1757,0,15,41.53,42.3
"2011","Bradford 003A","E01010767","Total",1450,688,762,1450,0,36,33.77,42.9
"2011","Bradford 003B","E01010768","Total",1659,815,844,1659,0,39,263.85,6.3
"2011","Bradford 003C","E01010769","Total",1579,723,856,1540,39,29,34.80,45.4
"2011","Bradford 003D","E01010771","Total",1260,641,619,1260,0,27,149.48,8.4
"2011","Bradford 004A","E01010638","Total",1523,731,792,1479,44,25,1097.04,1.4
"2011","Bradford 004B","E01010639","Total",1762,885,877,1762,0,9,98.12,18.0
"2011","Bradford 004C","E01010640","Total",1691,812,879,1691,0,10,22.10,76.5
"2011","Bradford 004D","E01010641","Total",1528,708,820,1457,71,18,66.51,23.0
"2011","Bradford 004E","E01010642","Total",1764,858,906,1745,19,22,1595.68,1.1
"2011","Bradford 004F","E01010643","Total",1423,687,736,1364,59,14,533.39,2.7
"2011","Bradford 004G","E01010644","Total",1614,766,848,1537,77,20,146.88,11.0
"2011","Bradford 004H","E01010645","Total",1338,629,709,1301,37,23,149.12,9.0
"2011","Bradford 005A","E01010770","Total",1629,817,812,1629,0,77,833.31,2.0
"2011","Bradford 005B","E01010772","Total",1270,617,653,1270,0,38,68.43,18.6
"2011","Bradford 005C","E01010773","Total",1400,697,703,1400,0,43,80.70,17.3
"2011","Bradford 005D","E01010774","Total",1589,732,857,1570,19,28,108.27,14.7
"2011","Bradford 006A","E01010706","Total",1671,818,853,1645,26,28,640.79,2.6
"2011","Bradford 006B","E01010707","Total",1736,849,887,1727,9,17,676.22,2.6
"2011","Bradford 006C","E01010708","Total",1656,812,844,1656,0,14,92.69,17.9
"2011","Bradford 006D","E01010709","Total",2663,1301,1362,2652,11,34,135.75,19.6
"2011","Bradford 007A","E01010719","Total",1721,862,859,1710,11,20,21.19,81.2
"2011","Bradford 007B","E01010727","Total",1718,859,859,1690,28,24,144.07,11.9
"2011","Bradford 007C","E01010728","Total",1800,888,912,1800,0,6,48.78,36.9
"2011","Bradford 007D","E01010729","Total",1603,765,838,1446,157,28,117.45,13.6
"2011","Bradford 008A","E01010700","Total",1533,771,762,1533,0,5,60.78,25.2
"2011","Bradford 008B","E01010701","Total",1474,732,742,1474,0,0,9.91,148.7
"2011","Bradford 008C","E01010702","Total",2145,1067,1078,2145,0,13,25.25,85.0
"2011","Bradford 008D","E01010703","Total",1642,770,872,1625,17,9,100.22,16.4
"2011","Bradford 008E","E01010704","Total",1461,759,702,1461,0,10,157.88,9.3
"2011","Bradford 008F","E01010705","Total",1699,824,875,1684,15,19,235.33,7.2
"2011","Bradford 008G","E01010710","Total",2047,1124,923,2044,3,7,61.26,33.4
"2011","Bradford 009A","E01010712","Total",1771,885,886,1752,19,7,17.49,101.3
"2011","Bradford 009B","E01010720","Total",1571,746,825,1571,0,8,25.12,62.5
"2011","Bradford 009C","E01010721","Total",1450,709,741,1450,0,12,36.22,40.0
"2011","Bradford 009D","E01010723","Total",1614,837,777,1614,0,11,13.59,118.8
"2011","Bradford 009E","E01010724","Total",1452,687,765,1426,26,11,33.73,43.0
"2011","Bradford 009F","E01010725","Total",1555,731,824,1540,15,7,20.18,77.1
"2011","Bradford 010A","E01010579","Total",1574,748,826,1527,47,56,51.99,30.3
"2011","Bradford 010B","E01010580","Total",2499,1199,1300,2452,47,51,83.48,29.9
"2011","Bradford 010C","E01010764","Total",1637,820,817,1637,0,40,1189.19,1.4
"2011","Bradford 010D","E01010765","Total",2227,1082,1145,2227,0,39,131.56,16.9
"2011","Bradford 010E","E01010766","Total",1302,640,662,1302,0,40,28.00,46.5
"2011","Bradford 011A","E01010711","Total",1401,743,658,1401,0,1,32.82,42.7
"2011","Bradford 011B","E01010713","Total",1350,651,699,1350,0,5,49.73,27.1
"2011","Bradford 011C","E01010714","Total",1393,664,729,1393,0,3,18.40,75.7
"2011","Bradford 011D","E01010716","Total",1865,916,949,1865,0,10,203.03,9.2
"2011","Bradford 012A","E01010715","Total",1144,526,618,1144,0,6,37.60,30.4
"2011","Bradford 012B","E01010717","Total",1606,746,860,1606,0,4,27.18,59.1
"2011","Bradford 012C","E01010718","Total",1583,775,808,1583,0,8,37.93,41.7
"2011","Bradford 012D","E01010726","Total",1517,724,793,1517,0,15,37.18,40.8
"2011","Bradford 012E","E01010859","Total",1650,806,844,1650,0,25,49.40,33.4
"2011","Bradford 013A","E01010573","Total",1782,894,888,1782,0,22,613.77,2.9
"2011","Bradford 013B","E01010574","Total",1400,647,753,1358,42,30,52.75,26.5
"2011","Bradford 013C","E01010575","Total",1619,810,809,1619,0,16,38.43,42.1
"2011","Bradford 013D","E01010577","Total",1592,765,827,1581,11,26,40.12,39.7
"2011","Bradford 014A","E01010722","Total",1584,765,819,1584,0,12,441.73,3.6
"2011","Bradford 014B","E01010860","Total",1549,763,786,1549,0,32,776.35,2.0
"2011","Bradford 014C","E01010862","Total",1726,832,894,1706,20,24,47.08,36.7
"2011","Bradford 014D","E01010863","Total",1505,750,755,1505,0,17,122.45,12.3
"2011","Bradford 015A","E01010578","Total",1531,780,751,1488,43,31,675.72,2.3
"2011","Bradford 015B","E01010581","Total",1686,835,851,1686,0,16,30.87,54.6
"2011","Bradford 015C","E01010582","Total",1629,843,786,1629,0,27,25.86,63.0
"2011","Bradford 015D","E01010584","Total",1747,901,846,1747,0,12,31.54,55.4
"2011","Bradford 015E","E01010585","Total",1924,901,1023,1924,0,16,50.48,38.1
"2011","Bradford 016A","E01010568","Total",1782,896,886,1782,0,28,61.01,29.2
"2011","Bradford 016B","E01010569","Total",1712,802,910,1712,0,1,63.99,26.8
"2011","Bradford 016C","E01010571","Total",1649,815,834,1649,0,9,53.09,31.1
"2011","Bradford 016D","E01010572","Total",1450,671,779,1450,0,11,26.51,54.7
"2011","Bradford 016E","E01010576","Total",1546,728,818,1513,33,22,53.91,28.7
"2011","Bradford 017A","E01010683","Total",1613,816,797,1613,0,22,221.66,7.3
"2011","Bradford 017B","E01010684","Total",1523,703,820,1496,27,24,69.18,22.0
"2011","Bradford 017C","E01010685","Total",1654,812,842,1654,0,13,538.74,3.1
"2011","Bradford 017D","E01010686","Total",1617,810,807,1617,0,24,62.61,25.8
"2011","Bradford 018A","E01010570","Total",1412,698,714,1412,0,37,82.56,17.1
"2011","Bradford 018B","E01010583","Total",1620,815,805,1620,0,22,183.43,8.8
"2011","Bradford 018C","E01010784","Total",1592,759,833,1592,0,12,76.12,20.9
"2011","Bradford 018D","E01010785","Total",1568,740,828,1552,16,14,21.39,73.3
"2011","Bradford 018E","E01010786","Total",1545,747,798,1442,103,29,48.31,32.0
"2011","Bradford 018F","E01010790","Total",1479,711,768,1445,34,27,80.90,18.3
"2011","Bradford 019A","E01010680","Total",1778,882,896,1778,0,6,28.04,63.4
"2011","Bradford 019B","E01010681","Total",1385,704,681,1385,0,23,43.77,31.6
"2011","Bradford 019C","E01010682","Total",1508,676,832,1487,21,5,33.75,44.7
"2011","Bradford 019D","E01010687","Total",1853,913,940,1836,17,23,54.39,34.1
"2011","Bradford 019E","E01010688","Total",1880,973,907,1819,61,22,33.42,56.3
"2011","Bradford 019F","E01010689","Total",1696,819,877,1696,0,15,41.34,41.0
"2011","Bradford 019G","E01010690","Total",1922,942,980,1907,15,22,37.64,51.1
"2011","Bradford 020B","E01010782","Total",1747,861,886,1745,2,17,67.14,26.0
"2011","Bradford 020C","E01010787","Total",1591,772,819,1591,0,22,102.13,15.6
"2011","Bradford 020D","E01010788","Total",1484,739,745,1441,43,26,18.77,79.1
"2011","Bradford 020E","E01033689","Total",1196,679,517,1196,0,6,48.53,24.6
"2011","Bradford 020F","E01033694","Total",1011,526,485,1011,0,7,24.18,41.8
"2011","Bradford 021A","E01010776","Total",1681,835,846,1681,0,8,47.00,35.8
"2011","Bradford 021B","E01010777","Total",1482,733,749,1482,0,8,40.55,36.5
"2011","Bradford 021C","E01010779","Total",1420,674,746,1420,0,9,58.09,24.4
"2011","Bradford 021D","E01010781","Total",1501,740,761,1501,0,11,42.20,35.6
"2011","Bradford 021E","E01010783","Total",1571,751,820,1571,0,14,39.29,40.0
"2011","Bradford 022A","E01010586","Total",1600,790,810,1600,0,30,109.00,14.7
"2011","Bradford 022B","E01010587","Total",1859,899,960,1859,0,27,561.98,3.3
"2011","Bradford 022C","E01010588","Total",1665,801,864,1665,0,26,37.37,44.6
"2011","Bradford 022D","E01010589","Total",1516,719,797,1516,0,26,61.34,24.7
"2011","Bradford 022E","E01010591","Total",1524,731,793,1524,0,13,38.61,39.5
"2011","Bradford 022F","E01010593","Total",1768,803,965,1707,61,29,51.10,34.6
"2011","Bradford 022G","E01010596","Total",1462,721,741,1440,22,19,202.36,7.2
"2011","Bradford 023A","E01010854","Total",1756,870,886,1738,18,14,144.20,12.2
"2011","Bradford 023B","E01010855","Total",1755,874,881,1747,8,26,2923.52,0.6
"2011","Bradford 023C","E01010856","Total",1601,787,814,1549,52,11,48.95,32.7
"2011","Bradford 023D","E01010857","Total",1580,789,791,1580,0,24,1630.49,1.0
"2011","Bradford 023E","E01010858","Total",1584,742,842,1584,0,27,133.48,11.9
"2011","Bradford 023F","E01010861","Total",1837,907,930,1837,0,21,113.11,16.2
"2011","Bradford 024A","E01010603","Total",1646,822,824,1646,0,10,39.09,42.1
"2011","Bradford 024B","E01010604","Total",1809,882,927,1808,1,7,41.40,43.7
"2011","Bradford 024C","E01010605","Total",1541,752,789,1541,0,6,25.85,59.6
"2011","Bradford 024D","E01010775","Total",1849,928,921,1849,0,16,23.26,79.5
"2011","Bradford 024E","E01010778","Total",1876,917,959,1876,0,14,56.40,33.3
"2011","Bradford 025A","E01010789","Total",1799,889,910,1799,0,15,34.49,52.2
"2011","Bradford 025B","E01010791","Total",1747,850,897,1699,48,24,33.79,51.7
"2011","Bradford 025C","E01010792","Total",1876,944,932,1876,0,6,20.15,93.1
"2011","Bradford 025D","E01010793","Total",1953,1036,917,1929,24,17,43.08,45.3
"2011","Bradford 026A","E01010652","Total",1554,730,824,1554,0,7,29.06,53.5
"2011","Bradford 026B","E01010653","Total",1572,739,833,1572,0,12,40.92,38.4
"2011","Bradford 026C","E01010655","Total",1446,695,751,1446,0,3,32.75,44.2
"2011","Bradford 026D","E01010656","Total",1507,741,766,1507,0,12,25.94,58.1
"2011","Bradford 026E","E01010657","Total",1542,738,804,1542,0,7,21.37,72.2
"2011","Bradford 027A","E01010649","Total",1395,694,701,1395,0,3,34.08,40.9
"2011","Bradford 027B","E01010650","Total",1647,763,884,1647,0,6,30.57,53.9
"2011","Bradford 027C","E01010654","Total",1398,662,736,1398,0,5,45.63,30.6
"2011","Bradford 027D","E01010826","Total",1468,716,752,1468,0,10,47.76,30.7
"2011","Bradford 028A","E01010597","Total",1518,758,760,1518,0,13,37.12,40.9
"2011","Bradford 028B","E01010598","Total",1751,846,905,1751,0,17,29.90,58.6
"2011","Bradford 028C","E01010599","Total",1376,675,701,1356,20,20,26.39,52.1
"2011","Bradford 028D","E01010600","Total",1433,686,747,1433,0,14,19.36,74.0
"2011","Bradford 028E","E01010602","Total",1549,733,816,1521,28,16,26.47,58.5
"2011","Bradford 029A","E01010670","Total",1699,888,811,1563,136,27,55.98,30.4
"2011","Bradford 029B","E01010671","Total",1694,844,850,1694,0,13,28.49,59.5
"2011","Bradford 029C","E01010673","Total",1816,903,913,1809,7,9,23.38,77.7
"2011","Bradford 029D","E01010675","Total",1990,946,1044,1886,104,25,114.30,17.4
"2011","Bradford 030A","E01010669","Total",1934,929,1005,1934,0,16,104.54,18.5
"2011","Bradford 030B","E01010674","Total",1627,798,829,1627,0,14,35.38,46.0
"2011","Bradford 030C","E01010677","Total",2129,1014,1115,2129,0,13,58.32,36.5
"2011","Bradford 030D","E01010805","Total",1604,804,800,1545,59,21,57.64,27.8
"2011","Bradford 031A","E01010590","Total",1796,844,952,1796,0,44,1055.43,1.7
"2011","Bradford 031B","E01010592","Total",1460,685,775,1460,0,21,130.77,11.2
"2011","Bradford 031C","E01010594","Total",1690,823,867,1690,0,21,538.56,3.1
"2011","Bradford 031D","E01010595","Total",1799,894,905,1799,0,11,486.93,3.7
"2011","Bradford 032A","E01010601","Total",1728,857,871,1722,6,11,24.61,70.2
"2011","Bradford 032B","E01010651","Total",1521,749,772,1521,0,18,24.75,61.5
"2011","Bradford 032C","E01010825","Total",1346,667,679,1346,0,12,35.10,38.3
"2011","Bradford 032D","E01010827","Total",1322,618,704,1322,0,14,20.06,65.9
"2011","Bradford 033A","E01010804","Total",2330,1185,1145,2314,16,19,19.90,117.1
"2011","Bradford 033B","E01010806","Total",1581,762,819,1581,0,11,35.42,44.6
"2011","Bradford 033C","E01010807","Total",2094,1068,1026,2094,0,6,28.27,74.1
"2011","Bradford 033D","E01010808","Total",2275,1148,1127,2275,0,6,13.96,163.0
"2011","Bradford 033E","E01010809","Total",2235,1096,1139,2235,0,13,12.14,184.1
"2011","Bradford 034A","E01010676","Total",2439,1165,1274,2420,19,15,15.12,161.3
"2011","Bradford 034B","E01010679","Total",1746,954,792,1654,92,13,43.41,40.2
"2011","Bradford 034C","E01010824","Total",1689,947,742,1630,59,6,84.49,20.0
"2011","Bradford 034D","E01010840","Total",1664,808,856,1603,61,6,17.80,93.5
"2011","Bradford 034E","E01010841","Total",1827,968,859,1802,25,17,13.99,130.6
"2011","Bradford 035A","E01010828","Total",1624,783,841,1624,0,10,27.63,58.8
"2011","Bradford 035B","E01010829","Total",1650,826,824,1630,20,10,44.92,36.7
"2011","Bradford 035C","E01010830","Total",1836,913,923,1836,0,16,58.24,31.5
"2011","Bradford 035D","E01010831","Total",1995,1028,967,1995,0,12,27.69,72.0
"2011","Bradford 035E","E01010832","Total",1750,825,925,1694,56,4,39.98,43.8
"2011","Bradford 036A","E01010672","Total",1301,644,657,1301,0,11,110.70,11.8
"2011","Bradford 036B","E01010678","Total",1345,671,674,1345,0,8,23.44,57.4
"2011","Bradford 036C","E01010799","Total",1518,729,789,1518,0,9,55.48,27.4
"2011","Bradford 036D","E01010800","Total",1759,819,940,1759,0,4,32.78,53.7
"2011","Bradford 036E","E01010801","Total",1831,898,933,1829,2,13,41.35,44.3
"2011","Bradford 036F","E01010802","Total",1600,776,824,1594,6,5,58.33,27.4
"2011","Bradford 037A","E01010803","Total",1809,968,841,1809,0,12,12.75,141.9
"2011","Bradford 037B","E01010810","Total",2055,1025,1030,2014,41,18,37.97,54.1
"2011","Bradford 037C","E01010811","Total",2202,1061,1141,2202,0,8,11.64,189.2
"2011","Bradford 037D","E01010813","Total",1811,908,903,1811,0,4,15.84,114.3
"2011","Bradford 038A","E01010618","Total",1704,877,827,1704,0,10,18.34,92.9
"2011","Bradford 038B","E01010619","Total",2240,1094,1146,2240,0,12,20.08,111.6
"2011","Bradford 038C","E01010625","Total",1731,854,877,1660,71,7,47.31,36.6
"2011","Bradford 038D","E01010626","Total",2009,980,1029,1991,18,10,18.04,111.4
"2011","Bradford 038E","E01010627","Total",1604,786,818,1604,0,10,30.39,52.8
"2011","Bradford 039A","E01010606","Total",1998,1054,944,1961,37,7,31.18,64.1
"2011","Bradford 039B","E01010607","Total",2072,1043,1029,2072,0,11,13.62,152.1
"2011","Bradford 039C","E01010617","Total",1403,695,708,1369,34,11,17.49,80.2
"2011","Bradford 039E","E01010842","Total",1945,1004,941,1911,34,5,31.99,60.8
"2011","Bradford 039G","E01033690","Total",1138,704,434,1134,4,2,43.24,26.3
"2011","Bradford 039H","E01033691","Total",1524,847,677,1524,0,6,46.76,32.6
"2011","Bradford 039I","E01033692","Total",1079,636,443,1079,0,8,16.49,65.4
"2011","Bradford 039J","E01033693","Total",2417,1266,1151,2380,37,15,103.73,23.3
"2011","Bradford 040A","E01010628","Total",1727,830,897,1668,59,12,54.67,31.6
"2011","Bradford 040B","E01010629","Total",1928,920,1008,1904,24,8,52.19,36.9
"2011","Bradford 040C","E01010630","Total",1574,751,823,1574,0,7,34.61,45.5
"2011","Bradford 040D","E01010631","Total",1544,713,831,1495,49,10,17.78,86.8
"2011","Bradford 040E","E01010632","Total",1338,654,684,1338,0,9,18.56,72.1
"2011","Bradford 041A","E01010658","Total",1989,1006,983,1985,4,22,60.38,32.9
"2011","Bradford 041B","E01010812","Total",2044,1039,1005,2044,0,23,24.24,84.3
"2011","Bradford 041C","E01010833","Total",1663,850,813,1663,0,14,104.54,15.9
"2011","Bradford 041D","E01010843","Total",2125,1101,1024,2125,0,4,17.05,124.6
"2011","Bradford 042A","E01010620","Total",1826,913,913,1789,37,10,20.12,90.8
"2011","Bradford 042B","E01010621","Total",2371,1190,1181,2371,0,9,8.49,279.3
"2011","Bradford 042C","E01010622","Total",2436,1235,1201,2372,64,5,39.57,61.6
"2011","Bradford 042D","E01010623","Total",1682,880,802,1681,1,4,23.34,72.1
"2011","Bradford 042E","E01010624","Total",2274,1156,1118,2274,0,9,12.18,186.7
"2011","Bradford 043A","E01010794","Total",1835,887,948,1812,23,10,112.38,16.3
"2011","Bradford 043B","E01010795","Total",1796,892,904,1791,5,17,370.60,4.8
"2011","Bradford 043C","E01010796","Total",1619,790,829,1600,19,6,200.23,8.1
"2011","Bradford 043D","E01010797","Total",1406,699,707,1394,12,24,492.21,2.9
"2011","Bradford 043E","E01010798","Total",1584,772,812,1546,38,14,31.58,50.2
"2011","Bradford 044A","E01010834","Total",3721,2088,1633,1744,1977,96,67.98,54.7
"2011","Bradford 044B","E01010835","Total",3196,1674,1522,3196,0,30,14.19,225.2
"2011","Bradford 044C","E01010836","Total",2249,1219,1030,1783,466,25,26.92,83.5
"2011","Bradford 044D","E01010837","Total",2188,1120,1068,2188,0,12,17.16,127.5
"2011","Bradford 044E","E01010838","Total",1920,1009,911,1920,0,7,22.31,86.1
"2011","Bradford 044F","E01010839","Total",1664,864,800,1663,1,10,33.43,49.8
"2011","Bradford 045A","E01010608","Total",1884,939,945,1884,0,5,34.41,54.8
"2011","Bradford 045B","E01010613","Total",1477,684,793,1477,0,5,88.41,16.7
"2011","Bradford 045C","E01010730","Total",1568,880,688,1568,0,4,64.92,24.2
"2011","Bradford 045D","E01010734","Total",1574,801,773,1574,0,10,28.52,55.2
"2011","Bradford 046A","E01010609","Total",1542,723,819,1542,0,3,107.80,14.3
"2011","Bradford 046B","E01010610","Total",1573,735,838,1573,0,6,35.47,44.3
"2011","Bradford 046C","E01010611","Total",2210,1135,1075,2210,0,6,46.86,47.2
"2011","Bradford 046D","E01010614","Total",1470,782,688,1345,125,5,62.01,23.7
"2011","Bradford 047A","E01010633","Total",1563,742,821,1563,0,26,99.87,15.7
"2011","Bradford 047B","E01010634","Total",1488,723,765,1445,43,13,174.12,8.5
"2011","Bradford 047C","E01010635","Total",1453,695,758,1443,10,12,26.18,55.5
"2011","Bradford 047D","E01010636","Total",1757,811,946,1736,21,24,49.61,35.4
"2011","Bradford 047E","E01010637","Total",1883,631,1252,1377,506,16,41.56,45.3
"2011","Bradford 048A","E01010731","Total",1768,1029,739,1680,88,24,29.39,60.2
"2011","Bradford 048B","E01010732","Total",2066,1113,953,2016,50,18,29.51,70.0
"2011","Bradford 048C","E01010733","Total",1885,982,903,1885,0,9,28.90,65.2
"2011","Bradford 048D","E01010736","Total",2049,1051,998,2049,0,13,38.92,52.6
"2011","Bradford 048E","E01010737","Total",1734,872,862,1734,0,3,15.23,113.9
"2011","Bradford 049A","E01010659","Total",1876,893,983,1876,0,13,43.06,43.6
"2011","Bradford 049D","E01010662","Total",1376,663,713,1376,0,17,33.05,41.6
"2011","Bradford 049E","E01010664","Total",1523,742,781,1523,0,18,25.35,60.1
"2011","Bradford 049G","E01010761","Total",1637,778,859,1616,21,14,63.13,25.9
"2011","Bradford 049H","E01033695","Total",1975,980,995,1950,25,13,43.50,45.4
"2011","Bradford 049I","E01033696","Total",1533,742,791,1530,3,18,37.85,40.5
"2011","Bradford 049J","E01033697","Total",2837,1441,1396,2837,0,9,29.74,95.4
"2011","Bradford 050A","E01010663","Total",1641,816,825,1641,0,5,28.55,57.5
"2011","Bradford 050B","E01010665","Total",1661,800,861,1661,0,13,28.25,58.8
"2011","Bradford 050C","E01010666","Total",1551,706,845,1475,76,10,27.73,55.9
"2011","Bradford 050D","E01010667","Total",1605,807,798,1605,0,12,21.39,75.0
"2011","Bradford 051A","E01010735","Total",1776,876,900,1776,0,7,26.57,66.8
"2011","Bradford 051B","E01010738","Total",2032,1059,973,2032,0,16,13.51,150.4
"2011","Bradford 051C","E01010739","Total",1789,893,896,1789,0,6,18.89,94.7
"2011","Bradford 051D","E01010740","Total",1816,918,898,1816,0,20,14.67,123.8
"2011","Bradford 051E","E01010744","Total",1825,917,908,1825,0,8,12.71,143.6
"2011","Bradford 052A","E01010612","Total",1377,669,708,1377,0,8,41.72,33.0
"2011","Bradford 052B","E01010819","Total",1573,712,861,1540,33,5,28.22,55.7
"2011","Bradford 052C","E01010820","Total",1525,723,802,1525,0,7,25.54,59.7
"2011","Bradford 052D","E01010821","Total",2046,997,1049,2046,0,3,33.04,61.9
"2011","Bradford 052E","E01010822","Total",1412,674,738,1326,86,3,35.00,40.3
"2011","Bradford 053A","E01010615","Total",1419,697,722,1417,2,4,65.06,21.8
"2011","Bradford 053B","E01010616","Total",1859,892,967,1858,1,7,56.91,32.7
"2011","Bradford 053C","E01010742","Total",1988,993,995,1988,0,3,20.12,98.8
"2011","Bradford 053D","E01010743","Total",1817,935,882,1817,0,10,22.63,80.3
"2011","Bradford 054A","E01010847","Total",1579,768,811,1570,9,3,28.38,55.6
"2011","Bradford 054B","E01010848","Total",1504,706,798,1504,0,17,34.24,43.9
"2011","Bradford 054C","E01010852","Total",1594,756,838,1594,0,8,29.87,53.4
"2011","Bradford 054D","E01010853","Total",1325,648,677,1325,0,14,24.13,54.9
"2011","Bradford 055A","E01010668","Total",1356,670,686,1356,0,17,19.92,68.1
"2011","Bradford 055B","E01010755","Total",1673,777,896,1673,0,10,26.59,62.9
"2011","Bradford 055C","E01010762","Total",1594,766,828,1594,0,15,21.82,73.1
"2011","Bradford 055D","E01010763","Total",1531,721,810,1479,52,14,29.85,51.3
"2011","Bradford 055E","E01010846","Total",2150,1036,1114,2150,0,9,44.78,48.0
"2011","Bradford 056A","E01010745","Total",1657,803,854,1657,0,9,27.57,60.1
"2011","Bradford 056B","E01010747","Total",1614,793,821,1614,0,7,36.51,44.2
"2011","Bradford 056C","E01010748","Total",1507,692,815,1507,0,6,24.78,60.8
"2011","Bradford 056D","E01010749","Total",1344,647,697,1344,0,6,20.77,64.7
"2011","Bradford 057A","E01010814","Total",1652,816,836,1648,4,10,44.39,37.2
"2011","Bradford 057B","E01010815","Total",2397,1160,1237,2345,52,11,113.06,21.2
"2011","Bradford 057C","E01010816","Total",1873,936,937,1873,0,11,811.04,2.3
"2011","Bradford 057D","E01010817","Total",2186,1021,1165,2149,37,10,35.78,61.1
"2011","Bradford 057E","E01010818","Total",1856,918,938,1853,3,14,221.92,8.4
"2011","Bradford 058A","E01010752","Total",1733,859,874,1733,0,9,152.20,11.4
"2011","Bradford 058B","E01010753","Total",1437,691,746,1437,0,16,28.10,51.1
"2011","Bradford 058C","E01010754","Total",1607,784,823,1607,0,16,152.68,10.5
"2011","Bradford 058D","E01010756","Total",1478,710,768,1457,21,6,90.01,16.4
"2011","Bradford 058E","E01010758","Total",1290,630,660,1290,0,20,42.44,30.4
"2011","Bradford 058F","E01010759","Total",1565,773,792,1545,20,13,136.60,11.5
"2011","Bradford 058G","E01010760","Total",1576,771,805,1552,24,6,122.97,12.8
"2011","Bradford 059A","E01010741","Total",1487,747,740,1487,0,11,60.14,24.7
"2011","Bradford 059B","E01010845","Total",2031,936,1095,2013,18,7,39.82,51.0
"2011","Bradford 059C","E01010849","Total",1429,707,722,1411,18,12,23.51,60.8
"2011","Bradford 059D","E01010850","Total",1381,633,748,1381,0,6,27.59,50.1
"2011","Bradford 059E","E01010851","Total",1585,773,812,1578,7,17,25.81,61.4
"2011","Bradford 059F","E01010864","Total",1320,648,672,1320,0,6,21.30,62.0
"2011","Bradford 059G","E01010867","Total",1468,724,744,1468,0,10,53.16,27.6
"2011","Bradford 059H","E01010874","Total",1240,564,676,1157,83,7,25.88,47.9
"2011","Bradford 060A","E01010746","Total",1628,780,848,1628,0,10,109.08,14.9
"2011","Bradford 060B","E01010750","Total",1617,768,849,1602,15,9,42.98,37.6
"2011","Bradford 060C","E01010751","Total",1509,733,776,1509,0,4,24.76,60.9
"2011","Bradford 060D","E01010865","Total",1618,791,827,1618,0,16,112.54,14.4
"2011","Bradford 060E","E01010866","Total",1379,667,712,1355,24,12,93.56,14.7
"2011","Bradford 061A","E01010868","Total",1602,801,801,1602,0,13,204.34,7.8
"2011","Bradford 061B","E01010869","Total",1694,804,890,1693,1,5,40.03,42.3
"2011","Bradford 061C","E01010870","Total",1503,750,753,1503,0,14,152.78,9.8
"2011","Bradford 061D","E01010871","Total",1686,820,866,1686,0,8,63.02,26.8
"2011","Bradford 061E","E01010872","Total",1627,791,836,1611,16,6,70.72,23.0
"2011","Bradford 061F","E01010873","Total",1224,590,634,1224,0,8,29.88,41.0
"2011","Calderdale 001A","E01010911","Total",1713,838,875,1706,7,20,713.95,2.4
"2011","Calderdale 001B","E01010912","Total",1586,748,838,1565,21,5,28.67,55.3
"2011","Calderdale 001C","E01010913","Total",1283,633,650,1283,0,13,21.36,60.1
"2011","Calderdale 001D","E01010915","Total",1429,703,726,1394,35,11,159.35,9.0
"2011","Calderdale 002A","E01010914","Total",1841,877,964,1841,0,4,58.40,31.5
"2011","Calderdale 002B","E01010924","Total",1186,623,563,1186,0,9,30.69,38.6
"2011","Calderdale 002C","E01010925","Total",1404,673,731,1404,0,9,398.59,3.5
"2011","Calderdale 002D","E01010926","Total",1196,557,639,1196,0,7,55.47,21.6
"2011","Calderdale 003A","E01010931","Total",1406,675,731,1406,0,25,62.96,22.3
"2011","Calderdale 003B","E01010932","Total",1547,765,782,1536,11,13,80.40,19.2
"2011","Calderdale 003C","E01010933","Total",1578,747,831,1578,0,17,251.04,6.3
"2011","Calderdale 003D","E01010935","Total",1560,750,810,1560,0,25,67.35,23.2
"2011","Calderdale 003E","E01010936","Total",2000,958,1042,2000,0,35,322.96,6.2
"2011","Calderdale 003F","E01010937","Total",1560,774,786,1560,0,21,99.54,15.7
"2011","Calderdale 004A","E01010881","Total",1652,778,874,1652,0,37,573.49,2.9
"2011","Calderdale 004B","E01010882","Total",1448,682,766,1441,7,22,227.56,6.4
"2011","Calderdale 004C","E01010883","Total",1533,763,770,1528,5,31,2280.83,0.7
"2011","Calderdale 004D","E01010887","Total",1609,799,810,1607,2,26,6325.47,0.3
"2011","Calderdale 004E","E01010888","Total",1531,725,806,1531,0,26,33.72,45.4
"2011","Calderdale 004F","E01010923","Total",1601,773,828,1601,0,14,59.36,27.0
"2011","Calderdale 005A","E01010916","Total",1427,674,753,1427,0,6,67.41,21.2
"2011","Calderdale 005B","E01010939","Total",1766,874,892,1758,8,22,65.77,26.9
"2011","Calderdale 005C","E01010941","Total",1346,630,716,1346,0,6,34.59,38.9
"2011","Calderdale 005D","E01010942","Total",1605,810,795,1600,5,3,38.00,42.2
"2011","Calderdale 005E","E01010944","Total",1379,681,698,1363,16,6,24.44,56.4
"2011","Calderdale 006A","E01010938","Total",1427,670,757,1421,6,8,23.51,60.7
"2011","Calderdale 006B","E01010940","Total",1437,708,729,1426,11,8,43.48,33.0
"2011","Calderdale 006C","E01010943","Total",1495,725,770,1495,0,4,18.46,81.0
"2011","Calderdale 006D","E01010961","Total",1163,579,584,1133,30,11,37.11,31.3
"2011","Calderdale 007A","E01010917","Total",1814,872,942,1814,0,24,470.56,3.9
"2011","Calderdale 007B","E01010918","Total",1695,810,885,1695,0,12,2111.34,0.8
"2011","Calderdale 007C","E01010919","Total",1591,745,846,1589,2,21,63.36,25.1
"2011","Calderdale 007D","E01010920","Total",1670,855,815,1670,0,27,1442.17,1.2
"2011","Calderdale 007E","E01010921","Total",1640,805,835,1640,0,17,100.91,16.3
"2011","Calderdale 008A","E01010934","Total",1967,962,1005,1945,22,21,481.14,4.1
"2011","Calderdale 008D","E01010967","Total",1504,768,736,1488,16,21,68.08,22.1
"2011","Calderdale 008E","E01010994","Total",1727,934,793,1611,116,8,95.63,18.1
"2011","Calderdale 008F","E01032923","Total",2313,1172,1141,2313,0,6,50.43,45.9
"2011","Calderdale 009A","E01010927","Total",1657,797,860,1637,20,17,276.82,6.0
"2011","Calderdale 009B","E01010928","Total",1415,646,769,1415,0,8,79.68,17.8
"2011","Calderdale 009C","E01010997","Total",1455,703,752,1455,0,14,183.03,7.9
"2011","Calderdale 009D","E01010999","Total",1498,745,753,1486,12,8,39.60,37.8
"2011","Calderdale 010A","E01010929","Total",2369,1190,1179,2369,0,14,43.12,54.9
"2011","Calderdale 010B","E01010930","Total",1576,731,845,1576,0,4,37.47,42.1
"2011","Calderdale 010C","E01010998","Total",1611,792,819,1611,0,10,50.15,32.1
"2011","Calderdale 010D","E01011000","Total",2060,1005,1055,2051,9,9,30.77,66.9
"2011","Calderdale 011A","E01010904","Total",1395,702,693,1395,0,18,52.95,26.3
"2011","Calderdale 011B","E01010906","Total",1411,707,704,1404,7,41,107.02,13.2
"2011","Calderdale 011C","E01010907","Total",1436,724,712,1425,11,22,249.88,5.7
"2011","Calderdale 011D","E01010909","Total",1521,696,825,1485,36,22,95.22,16.0
"2011","Calderdale 012A","E01010960","Total",1692,846,846,1626,66,7,45.99,36.8
"2011","Calderdale 012B","E01010964","Total",1629,804,825,1629,0,5,23.50,69.3
"2011","Calderdale 012C","E01010965","Total",1473,758,715,1473,0,8,16.96,86.9
"2011","Calderdale 012D","E01010966","Total",1691,844,847,1691,0,6,27.37,61.8
"2011","Calderdale 012E","E01010995","Total",1351,720,631,1316,35,6,24.33,55.5
"2011","Calderdale 013A","E01010982","Total",1336,626,710,1336,0,22,50.86,26.3
"2011","Calderdale 013B","E01010983","Total",1610,792,818,1543,67,10,56.81,28.3
"2011","Calderdale 013C","E01010985","Total",1416,709,707,1416,0,20,1482.51,1.0
"2011","Calderdale 013D","E01010986","Total",1690,830,860,1690,0,19,114.13,14.8
"2011","Calderdale 013E","E01010987","Total",1791,827,964,1726,65,18,133.39,13.4
"2011","Calderdale 013F","E01010988","Total",1474,699,775,1454,20,18,614.54,2.4
"2011","Calderdale 014A","E01010996","Total",1603,800,803,1603,0,7,11.55,138.8
"2011","Calderdale 014B","E01011001","Total",1640,815,825,1640,0,9,17.35,94.5
"2011","Calderdale 014C","E01011002","Total",1745,869,876,1745,0,15,21.44,81.4
"2011","Calderdale 014D","E01011003","Total",1214,648,566,1214,0,3,14.83,81.9
"2011","Calderdale 015A","E01010878","Total",1756,900,856,1756,0,21,204.80,8.6
"2011","Calderdale 015B","E01010879","Total",1834,895,939,1831,3,39,464.35,3.9
"2011","Calderdale 015C","E01010905","Total",1865,882,983,1819,46,26,228.16,8.2
"2011","Calderdale 015D","E01010908","Total",2086,1041,1045,2086,0,31,237.86,8.8
"2011","Calderdale 015E","E01010910","Total",1275,617,658,1275,0,12,39.21,32.5
"2011","Calderdale 016A","E01010969","Total",1697,840,857,1686,11,25,24.85,68.3
"2011","Calderdale 016B","E01010970","Total",1841,898,943,1825,16,34,69.59,26.5
"2011","Calderdale 016C","E01010974","Total",1524,744,780,1524,0,9,24.38,62.5
"2011","Calderdale 016D","E01010977","Total",1515,733,782,1515,0,9,83.57,18.1
"2011","Calderdale 017A","E01010975","Total",1533,701,832,1533,0,15,34.27,44.7
"2011","Calderdale 017B","E01010976","Total",1794,900,894,1794,0,25,55.56,32.3
"2011","Calderdale 017C","E01010978","Total",1303,660,643,1303,0,9,41.78,31.2
"2011","Calderdale 017D","E01010979","Total",1513,772,741,1513,0,8,57.13,26.5
"2011","Calderdale 017E","E01010980","Total",1499,737,762,1463,36,15,17.72,84.6
"2011","Calderdale 017F","E01010981","Total",1472,741,731,1472,0,8,43.01,34.2
"2011","Calderdale 018A","E01010989","Total",1501,764,737,1501,0,15,98.26,15.3
"2011","Calderdale 018B","E01010990","Total",1636,804,832,1636,0,13,173.74,9.4
"2011","Calderdale 018C","E01010991","Total",1576,783,793,1576,0,12,329.84,4.8
"2011","Calderdale 018D","E01010992","Total",1709,853,856,1689,20,8,39.48,43.3
"2011","Calderdale 018E","E01010993","Total",1686,810,876,1686,0,10,96.62,17.4
"2011","Calderdale 019A","E01010875","Total",1734,815,919,1734,0,25,80.77,21.5
"2011","Calderdale 019B","E01010876","Total",1628,802,826,1628,0,20,34.07,47.8
"2011","Calderdale 019C","E01010877","Total",1525,764,761,1501,24,17,295.27,5.2
"2011","Calderdale 019D","E01010880","Total",1482,718,764,1482,0,14,54.50,27.2
"2011","Calderdale 019E","E01010949","Total",1545,763,782,1533,12,17,64.45,24.0
"2011","Calderdale 020A","E01010922","Total",1911,919,992,1896,15,25,203.51,9.4
"2011","Calderdale 020B","E01010956","Total",1539,754,785,1539,0,25,851.01,1.8
"2011","Calderdale 020C","E01010958","Total",1471,664,807,1471,0,13,44.67,32.9
"2011","Calderdale 020D","E01010959","Total",1776,872,904,1755,21,15,69.03,25.7
"2011","Calderdale 021A","E01010968","Total",1823,873,950,1732,91,34,40.66,44.8
"2011","Calderdale 021B","E01010971","Total",1906,899,1007,1905,1,35,61.95,30.8
"2011","Calderdale 021C","E01010972","Total",1593,765,828,1593,0,26,45.71,34.9
"2011","Calderdale 021D","E01010973","Total",1673,803,870,1668,5,19,88.12,19.0
"2011","Calderdale 022A","E01010884","Total",1602,734,868,1589,13,19,419.59,3.8
"2011","Calderdale 022B","E01010885","Total",1430,693,737,1396,34,17,130.62,10.9
"2011","Calderdale 022C","E01010886","Total",1113,551,562,1113,0,17,1612.65,0.7
"2011","Calderdale 022D","E01010984","Total",1287,649,638,1287,0,20,75.15,17.1
"2011","Calderdale 023A","E01010946","Total",1379,658,721,1379,0,20,80.12,17.2
"2011","Calderdale 023B","E01010947","Total",1490,740,750,1490,0,20,98.99,15.1
"2011","Calderdale 023C","E01010950","Total",1440,723,717,1432,8,7,28.79,50.0
"2011","Calderdale 023D","E01010951","Total",1511,729,782,1421,90,17,24.98,60.5
"2011","Calderdale 024A","E01010891","Total",1737,848,889,1737,0,15,79.98,21.7
"2011","Calderdale 024B","E01010892","Total",1904,933,971,1901,3,16,227.88,8.4
"2011","Calderdale 024C","E01010895","Total",1440,735,705,1398,42,21,72.76,19.8
"2011","Calderdale 024D","E01010945","Total",1618,790,828,1603,15,16,84.83,19.1
"2011","Calderdale 024E","E01010948","Total",1451,693,758,1378,73,13,58.75,24.7
"2011","Calderdale 025A","E01010889","Total",1742,838,904,1728,14,10,114.12,15.3
"2011","Calderdale 025B","E01010890","Total",1792,883,909,1786,6,6,199.77,9.0
"2011","Calderdale 025C","E01010893","Total",1420,669,751,1395,25,22,19.54,72.7
"2011","Calderdale 025D","E01010894","Total",1614,793,821,1613,1,3,81.40,19.8
"2011","Calderdale 025E","E01010901","Total",1653,781,872,1651,2,24,149.00,11.1
"2011","Calderdale 025F","E01010903","Total",1667,775,892,1647,20,20,136.34,12.2
"2011","Calderdale 026A","E01010896","Total",1628,802,826,1628,0,32,589.24,2.8
"2011","Calderdale 026B","E01010897","Total",1671,832,839,1671,0,21,591.74,2.8
"2011","Calderdale 026C","E01010898","Total",1651,833,818,1648,3,9,77.07,21.4
"2011","Calderdale 026D","E01010899","Total",1408,667,741,1408,0,18,37.66,37.4
"2011","Calderdale 026E","E01010900","Total",1595,786,809,1573,22,25,62.14,25.7
"2011","Calderdale 026F","E01010902","Total",1616,771,845,1589,27,11,97.31,16.6
"2011","Calderdale 027A","E01010952","Total",1546,712,834,1546,0,28,353.63,4.4
"2011","Calderdale 027B","E01010953","Total",1467,723,744,1467,0,26,616.16,2.4
"2011","Calderdale 027C","E01010954","Total",2389,1174,1215,2389,0,45,375.73,6.4
"2011","Calderdale 027D","E01010955","Total",1471,760,711,1388,83,33,4078.15,0.4
"2011","Calderdale 027E","E01010957","Total",1485,726,759,1485,0,27,531.40,2.8
"2011","Kirklees 001A","E01011051","Total",1566,731,835,1566,0,14,134.96,11.6
"2011","Kirklees 001B","E01011055","Total",1264,632,632,1256,8,16,101.31,12.5
"2011","Kirklees 001C","E01011056","Total",1642,768,874,1609,33,10,86.14,19.1
"2011","Kirklees 001D","E01011057","Total",1365,662,703,1365,0,17,319.63,4.3
"2011","Kirklees 001E","E01011058","Total",1263,609,654,1237,26,8,29.91,42.2
"2011","Kirklees 002A","E01011048","Total",1639,780,859,1599,40,13,92.83,17.7
"2011","Kirklees 002B","E01011049","Total",1644,785,859,1644,0,16,159.29,10.3
"2011","Kirklees 002C","E01011050","Total",1520,768,752,1520,0,9,111.16,13.7
"2011","Kirklees 002D","E01011052","Total",1642,797,845,1642,0,14,119.15,13.8
"2011","Kirklees 002E","E01011053","Total",1476,742,734,1476,0,11,27.47,53.7
"2011","Kirklees 002F","E01011059","Total",1524,719,805,1524,0,7,29.16,52.3
"2011","Kirklees 003A","E01011062","Total",1694,847,847,1694,0,13,379.99,4.5
"2011","Kirklees 003B","E01011064","Total",1470,712,758,1432,38,8,101.54,14.5
"2011","Kirklees 003C","E01011068","Total",1669,811,858,1669,0,10,185.02,9.0
"2011","Kirklees 003D","E01011069","Total",1341,676,665,1341,0,14,102.34,13.1
"2011","Kirklees 004A","E01011241","Total",1705,844,861,1648,57,14,69.94,24.4
"2011","Kirklees 004B","E01011242","Total",1580,753,827,1580,0,10,133.83,11.8
"2011","Kirklees 004C","E01011243","Total",1681,834,847,1681,0,18,101.02,16.6
"2011","Kirklees 004D","E01011244","Total",2033,1013,1020,2033,0,22,51.13,39.8
"2011","Kirklees 005A","E01011060","Total",1645,814,831,1621,24,7,29.23,56.3
"2011","Kirklees 005B","E01011061","Total",1689,839,850,1635,54,13,41.50,40.7
"2011","Kirklees 005C","E01011063","Total",2047,1005,1042,2047,0,4,85.78,23.9
"2011","Kirklees 005D","E01011065","Total",1662,813,849,1662,0,16,50.05,33.2
"2011","Kirklees 005E","E01011066","Total",1515,749,766,1514,1,13,41.41,36.6
"2011","Kirklees 006A","E01011027","Total",1258,616,642,1252,6,11,53.83,23.4
"2011","Kirklees 006B","E01011028","Total",1481,743,738,1444,37,6,48.48,30.5
"2011","Kirklees 006C","E01011030","Total",1530,758,772,1530,0,7,27.34,56.0
"2011","Kirklees 006D","E01011031","Total",1627,805,822,1627,0,9,52.13,31.2
"2011","Kirklees 006E","E01011054","Total",1385,689,696,1346,39,17,125.49,11.0
"2011","Kirklees 007A","E01011013","Total",1544,737,807,1487,57,13,265.71,5.8
"2011","Kirklees 007B","E01011014","Total",1534,770,764,1529,5,4,43.80,35.0
"2011","Kirklees 007C","E01011023","Total",1670,851,819,1670,0,12,46.40,36.0
"2011","Kirklees 007D","E01011024","Total",1762,886,876,1762,0,14,56.06,31.4
"2011","Kirklees 008A","E01011067","Total",1586,776,810,1574,12,14,112.76,14.1
"2011","Kirklees 008B","E01011247","Total",1579,769,810,1554,25,14,84.89,18.6
"2011","Kirklees 008C","E01011249","Total",1585,784,801,1585,0,14,54.78,28.9
"2011","Kirklees 008D","E01011251","Total",1622,777,845,1622,0,6,60.43,26.8
"2011","Kirklees 009A","E01011245","Total",1566,785,781,1566,0,11,171.66,9.1
"2011","Kirklees 009B","E01011246","Total",1475,704,771,1475,0,9,33.46,44.1
"2011","Kirklees 009C","E01011248","Total",1486,721,765,1483,3,13,59.09,25.1
"2011","Kirklees 009D","E01011250","Total",1647,825,822,1616,31,13,47.39,34.8
"2011","Kirklees 010A","E01011015","Total",1607,772,835,1580,27,0,29.96,53.6
"2011","Kirklees 010B","E01011029","Total",1446,750,696,1444,2,10,58.32,24.8
"2011","Kirklees 010C","E01011032","Total",1566,750,816,1566,0,6,44.62,35.1
"2011","Kirklees 010D","E01011034","Total",1629,805,824,1629,0,9,17.34,93.9
"2011","Kirklees 011A","E01011157","Total",1645,803,842,1645,0,10,21.92,75.0
"2011","Kirklees 011B","E01011161","Total",1311,626,685,1311,0,11,44.89,29.2
"2011","Kirklees 011C","E01011163","Total",1370,663,707,1370,0,7,27.67,49.5
"2011","Kirklees 011D","E01011164","Total",1695,822,873,1695,0,8,34.10,49.7
"2011","Kirklees 011E","E01011165","Total",1823,917,906,1823,0,6,26.25,69.4
"2011","Kirklees 011F","E01011166","Total",1623,834,789,1610,13,9,43.41,37.4
"2011","Kirklees 011G","E01011167","Total",1932,944,988,1864,68,5,28.31,68.2
"2011","Kirklees 012A","E01011033","Total",1686,856,830,1686,0,13,33.55,50.3
"2011","Kirklees 012B","E01011035","Total",1685,876,809,1677,8,6,19.65,85.8
"2011","Kirklees 012C","E01011036","Total",1728,866,862,1728,0,6,30.06,57.5
"2011","Kirklees 012D","E01011037","Total",2104,1038,1066,2104,0,10,31.24,67.3
"2011","Kirklees 013A","E01011016","Total",1557,788,769,1557,0,4,44.46,35.0
"2011","Kirklees 013B","E01011017","Total",1674,837,837,1674,0,9,14.67,114.1
"2011","Kirklees 013C","E01011018","Total",1540,775,765,1540,0,5,27.71,55.6
"2011","Kirklees 013D","E01011019","Total",1714,865,849,1714,0,11,57.46,29.8
"2011","Kirklees 013E","E01011020","Total",1348,687,661,1337,11,9,17.33,77.8
"2011","Kirklees 014A","E01011021","Total",1643,833,810,1643,0,12,92.73,17.7
"2011","Kirklees 014B","E01011022","Total",1449,713,736,1449,0,13,43.03,33.7
"2011","Kirklees 014C","E01011126","Total",1547,760,787,1547,0,8,115.38,13.4
"2011","Kirklees 014D","E01011127","Total",1415,706,709,1410,5,6,38.18,37.1
"2011","Kirklees 015A","E01011156","Total",1556,767,789,1556,0,14,55.80,27.9
"2011","Kirklees 015B","E01011158","Total",1808,889,919,1762,46,9,47.17,38.3
"2011","Kirklees 015C","E01011159","Total",1743,857,886,1696,47,21,494.97,3.5
"2011","Kirklees 015D","E01011160","Total",1399,694,705,1399,0,14,141.50,9.9
"2011","Kirklees 015E","E01011162","Total",1485,736,749,1485,0,10,73.71,20.1
"2011","Kirklees 016A","E01011025","Total",1570,794,776,1570,0,4,49.28,31.9
"2011","Kirklees 016B","E01011026","Total",1510,745,765,1510,0,13,36.52,41.3
"2011","Kirklees 016C","E01011136","Total",1480,733,747,1470,10,5,25.31,58.5
"2011","Kirklees 016D","E01011137","Total",1516,720,796,1509,7,11,37.25,40.7
"2011","Kirklees 017A","E01011128","Total",2000,1034,966,1996,4,11,36.11,55.4
"2011","Kirklees 017B","E01011130","Total",2017,1019,998,1927,90,9,75.40,26.8
"2011","Kirklees 017E","E01033542","Total",2916,1521,1395,2802,114,37,77.70,37.5
"2011","Kirklees 018A","E01011121","Total",1482,736,746,1482,0,4,32.40,45.7
"2011","Kirklees 018B","E01011122","Total",1414,668,746,1414,0,3,23.03,61.4
"2011","Kirklees 018C","E01011123","Total",1623,792,831,1551,72,9,63.48,25.6
"2011","Kirklees 018D","E01011124","Total",1858,936,922,1858,0,3,100.90,18.4
"2011","Kirklees 018E","E01011125","Total",1543,750,793,1543,0,13,64.93,23.8
"2011","Kirklees 018F","E01011129","Total",1353,637,716,1353,0,14,24.97,54.2
"2011","Kirklees 019A","E01011138","Total",1684,846,838,1684,0,18,41.91,40.2
"2011","Kirklees 019B","E01011139","Total",1446,720,726,1446,0,5,53.44,27.1
"2011","Kirklees 019C","E01011140","Total",1643,815,828,1643,0,0,30.10,54.6
"2011","Kirklees 019D","E01011141","Total",1787,901,886,1726,61,6,78.26,22.8
"2011","Kirklees 020A","E01011132","Total",1445,693,752,1434,11,43,66.90,21.6
"2011","Kirklees 020B","E01011142","Total",1557,772,785,1557,0,26,198.01,7.9
"2011","Kirklees 020C","E01011217","Total",1601,752,849,1601,0,9,50.13,31.9
"2011","Kirklees 020D","E01011218","Total",1626,779,847,1626,0,13,39.87,40.8
"2011","Kirklees 021A","E01011216","Total",1464,707,757,1374,90,19,101.77,14.4
"2011","Kirklees 021B","E01011219","Total",1551,755,796,1535,16,19,44.95,34.5
"2011","Kirklees 021C","E01011220","Total",1793,863,930,1793,0,4,39.96,44.9
"2011","Kirklees 021D","E01011221","Total",1744,836,908,1744,0,19,29.09,60.0
"2011","Kirklees 022A","E01011046","Total",1332,661,671,1316,16,31,117.26,11.4
"2011","Kirklees 022B","E01011100","Total",1502,716,786,1496,6,9,107.65,14.0
"2011","Kirklees 022C","E01011102","Total",1414,703,711,1414,0,21,235.95,6.0
"2011","Kirklees 022D","E01011108","Total",1460,717,743,1460,0,12,64.00,22.8
"2011","Kirklees 023A","E01011133","Total",1483,757,726,1468,15,2,41.41,35.8
"2011","Kirklees 023B","E01011134","Total",1964,962,1002,1964,0,6,30.82,63.7
"2011","Kirklees 023C","E01011143","Total",1621,809,812,1621,0,10,16.78,96.6
"2011","Kirklees 023D","E01011144","Total",1510,756,754,1492,18,8,56.65,26.7
"2011","Kirklees 023E","E01011260","Total",1354,688,666,1354,0,3,96.03,14.1
"2011","Kirklees 024A","E01011257","Total",2226,1124,1102,2226,0,9,64.08,34.7
"2011","Kirklees 024B","E01011258","Total",2074,1156,918,1893,181,26,31.31,66.2
"2011","Kirklees 024C","E01011259","Total",1697,838,859,1680,17,10,51.84,32.7
"2011","Kirklees 024D","E01011261","Total",1402,687,715,1402,0,7,18.48,75.9
"2011","Kirklees 024E","E01011262","Total",1656,815,841,1655,1,6,33.53,49.4
"2011","Kirklees 024F","E01011263","Total",1636,813,823,1636,0,10,144.87,11.3
"2011","Kirklees 025A","E01011101","Total",1738,830,908,1738,0,11,31.93,54.4
"2011","Kirklees 025B","E01011103","Total",1330,629,701,1316,14,9,148.93,8.9
"2011","Kirklees 025C","E01011104","Total",1583,727,856,1577,6,9,52.31,30.3
"2011","Kirklees 025D","E01011105","Total",2041,954,1087,2041,0,7,44.12,46.3
"2011","Kirklees 026A","E01011212","Total",1612,739,873,1612,0,14,32.67,49.3
"2011","Kirklees 026B","E01011213","Total",1587,776,811,1587,0,14,71.16,22.3
"2011","Kirklees 026C","E01011214","Total",1545,759,786,1545,0,15,224.44,6.9
"2011","Kirklees 026D","E01011215","Total",2038,1027,1011,1964,74,27,454.14,4.5
"2011","Kirklees 027A","E01011039","Total",1808,889,919,1808,0,11,55.10,32.8
"2011","Kirklees 027B","E01011042","Total",1590,810,780,1590,0,35,57.65,27.6
"2011","Kirklees 027C","E01011047","Total",1549,756,793,1549,0,25,259.38,6.0
"2011","Kirklees 027D","E01011210","Total",1952,982,970,1952,0,45,92.31,21.1
"2011","Kirklees 028A","E01011252","Total",1151,567,584,1151,0,29,644.31,1.8
"2011","Kirklees 028B","E01011253","Total",1264,590,674,1264,0,2,31.30,40.4
"2011","Kirklees 028C","E01011254","Total",1514,749,765,1472,42,26,48.58,31.2
"2011","Kirklees 028D","E01011255","Total",1464,692,772,1464,0,6,45.36,32.3
"2011","Kirklees 028E","E01011256","Total",1355,679,676,1355,0,7,192.52,7.0
"2011","Kirklees 029A","E01011038","Total",1713,791,922,1638,75,20,37.53,45.6
"2011","Kirklees 029B","E01011041","Total",1539,770,769,1487,52,12,45.07,34.1
"2011","Kirklees 029C","E01011106","Total",1485,727,758,1485,0,8,128.26,11.6
"2011","Kirklees 029D","E01011107","Total",1813,1061,752,1800,13,15,193.33,9.4
"2011","Kirklees 030A","E01011201","Total",1731,810,921,1700,31,19,32.49,53.3
"2011","Kirklees 030B","E01011203","Total",1805,863,942,1805,0,33,34.10,52.9
"2011","Kirklees 030C","E01011209","Total",1556,751,805,1556,0,28,130.84,11.9
"2011","Kirklees 030D","E01011211","Total",1591,771,820,1591,0,31,62.42,25.5
"2011","Kirklees 031A","E01011040","Total",1879,944,935,1879,0,10,30.99,60.6
"2011","Kirklees 031B","E01011043","Total",2346,1235,1111,2335,11,16,30.10,77.9
"2011","Kirklees 031C","E01011044","Total",1542,770,772,1542,0,11,23.41,65.9
"2011","Kirklees 031D","E01011045","Total",1888,1031,857,1888,0,13,30.44,62.0
"2011","Kirklees 032A","E01011089","Total",1297,593,704,1297,0,6,39.13,33.1
"2011","Kirklees 032B","E01011091","Total",1456,709,747,1456,0,11,338.31,4.3
"2011","Kirklees 032C","E01011092","Total",1276,628,648,1276,0,18,262.90,4.9
"2011","Kirklees 032D","E01011200","Total",2357,1177,1180,2319,38,21,217.14,10.9
"2011","Kirklees 033A","E01011204","Total",1485,718,767,1415,70,36,60.81,24.4
"2011","Kirklees 033B","E01011206","Total",1679,810,869,1679,0,11,29.35,57.2
"2011","Kirklees 033C","E01011208","Total",1606,771,835,1587,19,10,36.62,43.9
"2011","Kirklees 033D","E01011240","Total",1699,767,932,1699,0,10,26.90,63.2
"2011","Kirklees 034A","E01011231","Total",1533,742,791,1532,1,12,20.30,75.5
"2011","Kirklees 034B","E01011236","Total",1740,1010,730,1684,56,9,46.27,37.6
"2011","Kirklees 034C","E01011238","Total",1642,847,795,1575,67,18,66.94,24.5
"2011","Kirklees 034D","E01011239","Total",1627,803,824,1614,13,23,28.36,57.4
"2011","Kirklees 035A","E01011093","Total",1436,700,736,1436,0,7,91.56,15.7
"2011","Kirklees 035B","E01011094","Total",1542,714,828,1542,0,4,36.94,41.7
"2011","Kirklees 035C","E01011096","Total",1561,732,829,1561,0,12,27.29,57.2
"2011","Kirklees 035D","E01011098","Total",1532,824,708,1522,10,7,24.85,61.6
"2011","Kirklees 036A","E01011146","Total",1557,776,781,1557,0,21,45.03,34.6
"2011","Kirklees 036B","E01011151","Total",1636,817,819,1631,5,28,347.99,4.7
"2011","Kirklees 036C","E01011202","Total",1565,741,824,1552,13,21,34.35,45.6
"2011","Kirklees 036D","E01011205","Total",1605,779,826,1604,1,21,307.13,5.2
"2011","Kirklees 037A","E01011090","Total",1550,762,788,1550,0,8,143.60,10.8
"2011","Kirklees 037B","E01011095","Total",1405,677,728,1383,22,8,44.34,31.7
"2011","Kirklees 037C","E01011097","Total",1560,756,804,1556,4,20,26.13,59.7
"2011","Kirklees 037D","E01011099","Total",1489,744,745,1489,0,8,29.31,50.8
"2011","Kirklees 038A","E01011150","Total",1616,791,825,1598,18,9,69.88,23.1
"2011","Kirklees 038B","E01011155","Total",1861,938,923,1861,0,18,65.95,28.2
"2011","Kirklees 038C","E01011207","Total",1495,721,774,1495,0,10,67.45,22.2
"2011","Kirklees 038D","E01011234","Total",1487,722,765,1487,0,9,26.17,56.8
"2011","Kirklees 039A","E01011232","Total",1639,821,818,1579,60,8,47.86,34.2
"2011","Kirklees 039B","E01011233","Total",1653,803,850,1624,29,9,50.09,33.0
"2011","Kirklees 039C","E01011235","Total",1814,1014,800,1804,10,9,50.92,35.6
"2011","Kirklees 039D","E01011237","Total",1661,816,845,1657,4,9,40.03,41.5
"2011","Kirklees 040A","E01011004","Total",1363,637,726,1357,6,15,33.25,41.0
"2011","Kirklees 040B","E01011006","Total",1547,728,819,1516,31,13,41.26,37.5
"2011","Kirklees 040C","E01011008","Total",1505,770,735,1487,18,11,23.03,65.3
"2011","Kirklees 040D","E01011012","Total",1668,806,862,1668,0,16,23.07,72.3
"2011","Kirklees 041A","E01011145","Total",1530,766,764,1530,0,15,32.63,46.9
"2011","Kirklees 041B","E01011147","Total",1533,749,784,1483,50,10,52.79,29.0
"2011","Kirklees 041C","E01011148","Total",1656,793,863,1615,41,9,31.35,52.8
"2011","Kirklees 041D","E01011152","Total",1708,846,862,1686,22,26,93.09,18.3
"2011","Kirklees 042A","E01011007","Total",1486,797,689,1486,0,8,61.37,24.2
"2011","Kirklees 042B","E01011223","Total",1982,938,1044,1773,209,15,104.34,19.0
"2011","Kirklees 042C","E01011225","Total",1788,889,899,1765,23,11,37.65,47.5
"2011","Kirklees 042D","E01011229","Total",2881,1570,1311,1703,1178,36,83.83,34.4
"2011","Kirklees 043A","E01011080","Total",1924,973,951,1924,0,16,26.37,73.0
"2011","Kirklees 043B","E01011081","Total",1809,976,833,1773,36,9,36.50,49.6
"2011","Kirklees 043C","E01011082","Total",1836,978,858,1836,0,8,12.53,146.5
"2011","Kirklees 043D","E01011230","Total",2094,1092,1002,2077,17,10,27.31,76.7
"2011","Kirklees 044A","E01011005","Total",1521,747,774,1497,24,13,92.89,16.4
"2011","Kirklees 044B","E01011009","Total",1340,641,699,1322,18,22,69.38,19.3
"2011","Kirklees 044C","E01011010","Total",1572,738,834,1572,0,3,34.13,46.1
"2011","Kirklees 044D","E01011011","Total",1576,781,795,1576,0,23,216.49,7.3
"2011","Kirklees 045A","E01011077","Total",1612,816,796,1612,0,18,84.41,19.1
"2011","Kirklees 045B","E01011149","Total",1860,928,932,1856,4,9,66.82,27.8
"2011","Kirklees 045C","E01011153","Total",1715,860,855,1715,0,15,41.34,41.5
"2011","Kirklees 045D","E01011154","Total",1588,766,822,1562,26,6,47.66,33.3
"2011","Kirklees 046A","E01011191","Total",1576,777,799,1576,0,14,127.51,12.4
"2011","Kirklees 046B","E01011192","Total",1577,750,827,1577,0,16,564.89,2.8
"2011","Kirklees 046C","E01011193","Total",1912,933,979,1912,0,26,759.46,2.5
"2011","Kirklees 046D","E01011194","Total",1370,660,710,1370,0,17,35.85,38.2
"2011","Kirklees 047A","E01011079","Total",1887,937,950,1887,0,10,35.01,53.9
"2011","Kirklees 047B","E01011083","Total",1782,872,910,1782,0,16,60.26,29.6
"2011","Kirklees 047C","E01011084","Total",1819,842,977,1819,0,11,32.32,56.3
"2011","Kirklees 047D","E01011085","Total",1554,714,840,1551,3,11,81.12,19.2
"2011","Kirklees 048A","E01011224","Total",1726,798,928,1631,95,8,56.05,30.8
"2011","Kirklees 048B","E01011226","Total",1560,767,793,1560,0,13,164.76,9.5
"2011","Kirklees 048C","E01011227","Total",1619,792,827,1619,0,5,33.58,48.2
"2011","Kirklees 048D","E01011228","Total",1499,734,765,1498,1,20,67.21,22.3
"2011","Kirklees 049A","E01011071","Total",1678,861,817,1678,0,8,347.70,4.8
"2011","Kirklees 049B","E01011072","Total",1613,802,811,1613,0,12,100.24,16.1
"2011","Kirklees 049C","E01011073","Total",1504,751,753,1496,8,13,55.04,27.3
"2011","Kirklees 049D","E01011078","Total",1754,859,895,1721,33,19,80.02,21.9
"2011","Kirklees 050A","E01011086","Total",1628,797,831,1628,0,21,284.43,5.7
"2011","Kirklees 050B","E01011087","Total",1588,775,813,1575,13,24,93.03,17.1
"2011","Kirklees 050C","E01011088","Total",1414,667,747,1414,0,36,43.36,32.6
"2011","Kirklees 050D","E01011222","Total",1768,924,844,1768,0,5,136.45,13.0
"2011","Kirklees 051A","E01011190","Total",1617,795,822,1617,0,29,384.93,4.2
"2011","Kirklees 051B","E01011195","Total",2230,1147,1083,1069,1161,63,895.48,2.5
"2011","Kirklees 051C","E01011196","Total",1820,891,929,1820,0,34,88.78,20.5
"2011","Kirklees 051D","E01011197","Total",1565,754,811,1521,44,22,541.53,2.9
"2011","Kirklees 052A","E01011070","Total",1574,778,796,1572,2,24,1214.93,1.3
"2011","Kirklees 052B","E01011074","Total",1912,918,994,1912,0,19,151.91,12.6
"2011","Kirklees 052C","E01011075","Total",1439,702,737,1438,1,12,3450.06,0.4
"2011","Kirklees 052D","E01011076","Total",1476,720,756,1476,0,17,378.80,3.9
"2011","Kirklees 053A","E01011169","Total",1448,727,721,1431,17,27,287.67,5.0
"2011","Kirklees 053B","E01011170","Total",1838,924,914,1838,0,28,459.60,4.0
"2011","Kirklees 053C","E01011171","Total",1388,702,686,1388,0,15,71.64,19.4
"2011","Kirklees 053D","E01011172","Total",1016,458,558,1016,0,10,22.16,45.8
"2011","Kirklees 053E","E01011173","Total",1321,636,685,1321,0,23,43.26,30.5
"2011","Kirklees 053F","E01011176","Total",1432,697,735,1432,0,26,247.02,5.8
"2011","Kirklees 054A","E01011109","Total",1795,905,890,1795,0,36,1426.50,1.3
"2011","Kirklees 054B","E01011113","Total",1691,830,861,1691,0,23,65.12,26.0
"2011","Kirklees 054C","E01011114","Total",1537,729,808,1494,43,13,57.62,26.7
"2011","Kirklees 054D","E01011119","Total",1497,734,763,1497,0,14,220.81,6.8
"2011","Kirklees 055A","E01011168","Total",1631,773,858,1631,0,15,153.69,10.6
"2011","Kirklees 055B","E01011174","Total",1851,906,945,1772,79,28,813.74,2.3
"2011","Kirklees 055C","E01011175","Total",1450,721,729,1450,0,9,76.27,19.0
"2011","Kirklees 055D","E01011177","Total",1745,828,917,1709,36,22,1196.15,1.5
"2011","Kirklees 055E","E01011178","Total",1857,907,950,1857,0,27,110.35,16.8
"2011","Kirklees 056A","E01011118","Total",1578,778,800,1578,0,26,570.31,2.8
"2011","Kirklees 056B","E01011120","Total",1575,785,790,1575,0,37,61.95,25.4
"2011","Kirklees 056C","E01011198","Total",1593,765,828,1593,0,39,525.23,3.0
"2011","Kirklees 056D","E01011199","Total",1518,745,773,1518,0,28,187.89,8.1
"2011","Kirklees 057A","E01011110","Total",1358,692,666,1358,0,26,797.88,1.7
"2011","Kirklees 057B","E01011111","Total",1634,803,831,1587,47,17,102.22,16.0
"2011","Kirklees 057C","E01011112","Total",1616,778,838,1616,0,30,136.95,11.8
"2011","Kirklees 057D","E01011115","Total",1790,884,906,1768,22,31,486.23,3.7
"2011","Kirklees 057E","E01011116","Total",1661,829,832,1661,0,27,75.61,22.0
"2011","Kirklees 057F","E01011117","Total",1786,885,901,1786,0,33,746.37,2.4
"2011","Kirklees 058A","E01011180","Total",1917,949,968,1917,0,34,151.71,12.6
"2011","Kirklees 058B","E01011182","Total",1734,876,858,1733,1,30,2945.52,0.6
"2011","Kirklees 058C","E01011186","Total",1608,796,812,1534,74,31,192.37,8.4
"2011","Kirklees 058D","E01011188","Total",1717,844,873,1702,15,40,136.23,12.6
"2011","Kirklees 059A","E01011179","Total",1771,886,885,1767,4,39,359.98,4.9
"2011","Kirklees 059B","E01011181","Total",1788,901,887,1788,0,29,150.54,11.9
"2011","Kirklees 059C","E01011183","Total",1999,996,1003,1995,4,27,1246.82,1.6
"2011","Kirklees 059D","E01011184","Total",1472,729,743,1472,0,29,113.13,13.0
"2011","Kirklees 059E","E01011185","Total",1565,766,799,1565,0,27,112.12,14.0
"2011","Kirklees 059F","E01011187","Total",1758,853,905,1758,0,49,93.50,18.8
"2011","Kirklees 059G","E01011189","Total",1603,782,821,1601,2,36,546.99,2.9
"2011","Leeds 001A","E01011698","Total",1503,736,767,1501,2,18,33.11,45.4
"2011","Leeds 001B","E01011699","Total",1345,649,696,1341,4,24,32.83,41.0
"2011","Leeds 001C","E01011701","Total",1287,631,656,1287,0,37,39.85,32.3
"2011","Leeds 001D","E01011702","Total",1184,578,606,1184,0,39,189.71,6.2
"2011","Leeds 001E","E01011703","Total",1279,605,674,1279,0,36,41.58,30.8
"2011","Leeds 002A","E01011697","Total",2091,1432,659,1278,813,25,1360.64,1.5
"2011","Leeds 002B","E01011700","Total",1353,742,611,1108,245,22,97.43,13.9
"2011","Leeds 002C","E01011704","Total",1770,835,935,1746,24,16,658.87,2.7
"2011","Leeds 002D","E01011705","Total",1378,633,745,1375,3,16,38.06,36.2
"2011","Leeds 003A","E01011581","Total",1469,709,760,1469,0,20,62.55,23.5
"2011","Leeds 003B","E01011582","Total",1651,783,868,1651,0,8,126.95,13.0
"2011","Leeds 003C","E01011583","Total",1479,707,772,1479,0,22,33.02,44.8
"2011","Leeds 003D","E01011584","Total",1250,590,660,1250,0,29,68.56,18.2
"2011","Leeds 004A","E01011569","Total",1662,838,824,1662,0,27,509.04,3.3
"2011","Leeds 004B","E01011571","Total",1597,746,851,1557,40,27,140.80,11.3
"2011","Leeds 004C","E01011572","Total",1763,862,901,1763,0,29,52.22,33.8
"2011","Leeds 004D","E01011573","Total",1341,653,688,1341,0,19,166.63,8.0
"2011","Leeds 004E","E01011574","Total",1456,688,768,1406,50,24,29.55,49.3
"2011","Leeds 005A","E01011707","Total",1359,641,718,1359,0,19,240.25,5.7
"2011","Leeds 005B","E01011709","Total",1588,747,841,1555,33,33,113.16,14.0
"2011","Leeds 005C","E01011710","Total",1421,689,732,1421,0,31,145.96,9.7
"2011","Leeds 005D","E01011711","Total",1389,650,739,1389,0,30,88.62,15.7
"2011","Leeds 005E","E01011712","Total",1359,647,712,1359,0,39,1952.70,0.7
"2011","Leeds 006A","E01011561","Total",1217,586,631,1217,0,27,2551.48,0.5
"2011","Leeds 006B","E01011696","Total",1498,725,773,1498,0,45,700.09,2.1
"2011","Leeds 006C","E01011706","Total",1526,757,769,1526,0,41,404.34,3.8
"2011","Leeds 006D","E01011708","Total",1468,704,764,1468,0,55,562.23,2.6
"2011","Leeds 006E","E01011713","Total",1843,921,922,1843,0,34,989.32,1.9
"2011","Leeds 007A","E01011570","Total",2284,1152,1132,2284,0,44,387.98,5.9
"2011","Leeds 007C","E01011576","Total",1432,689,743,1404,28,46,909.38,1.6
"2011","Leeds 007E","E01032503","Total",1465,734,731,1462,3,21,1285.03,1.1
"2011","Leeds 007F","E01032504","Total",1584,757,827,1584,0,37,297.42,5.3
"2011","Leeds 008A","E01011266","Total",2027,1017,1010,2027,0,43,253.14,8.0
"2011","Leeds 008B","E01011270","Total",1616,794,822,1616,0,47,792.97,2.0
"2011","Leeds 008C","E01011279","Total",1312,601,711,1285,27,17,347.62,3.8
"2011","Leeds 008D","E01011280","Total",1757,857,900,1757,0,22,94.56,18.6
"2011","Leeds 009A","E01011265","Total",1625,765,860,1554,71,17,52.74,30.8
"2011","Leeds 009B","E01011267","Total",1496,732,764,1496,0,15,44.92,33.3
"2011","Leeds 009C","E01011271","Total",2158,1059,1099,2158,0,31,59.35,36.4
"2011","Leeds 009D","E01011272","Total",1521,767,754,1521,0,19,55.61,27.4
"2011","Leeds 010A","E01011268","Total",1394,696,698,1394,0,5,39.50,35.3
"2011","Leeds 010B","E01011273","Total",1487,705,782,1459,28,14,42.42,35.1
"2011","Leeds 010C","E01011274","Total",1488,711,777,1431,57,17,29.98,49.6
"2011","Leeds 010D","E01011275","Total",1350,645,705,1350,0,11,29.45,45.8
"2011","Leeds 011A","E01011264","Total",1279,601,678,1276,3,17,63.75,20.1
"2011","Leeds 011B","E01011269","Total",1552,751,801,1538,14,13,62.98,24.6
"2011","Leeds 011C","E01011276","Total",1384,703,681,1384,0,25,35.37,39.1
"2011","Leeds 011D","E01011578","Total",1321,616,705,1321,0,6,55.53,23.8
"2011","Leeds 012A","E01011554","Total",1446,705,741,1446,0,28,961.05,1.5
"2011","Leeds 012B","E01011562","Total",1592,779,813,1592,0,39,147.01,10.8
"2011","Leeds 012C","E01011563","Total",1416,694,722,1416,0,30,148.59,9.5
"2011","Leeds 012D","E01011564","Total",1501,734,767,1501,0,44,44.19,34.0
"2011","Leeds 012E","E01011567","Total",1393,661,732,1393,0,45,40.38,34.5
"2011","Leeds 013A","E01011376","Total",1516,739,777,1516,0,42,183.20,8.3
"2011","Leeds 013B","E01011377","Total",1386,672,714,1386,0,27,48.47,28.6
"2011","Leeds 013C","E01011378","Total",1394,674,720,1394,0,14,41.43,33.6
"2011","Leeds 013D","E01011382","Total",1456,697,759,1456,0,10,29.99,48.5
"2011","Leeds 014A","E01011277","Total",1511,708,803,1511,0,20,39.36,38.4
"2011","Leeds 014B","E01011278","Total",1631,777,854,1631,0,19,58.89,27.7
"2011","Leeds 014C","E01011579","Total",1245,617,628,1245,0,21,20.71,60.1
"2011","Leeds 014D","E01011580","Total",1342,642,700,1342,0,39,167.07,8.0
"2011","Leeds 015A","E01011556","Total",1576,732,844,1576,0,12,37.30,42.3
"2011","Leeds 015B","E01011557","Total",1529,705,824,1510,19,38,34.19,44.7
"2011","Leeds 015C","E01011565","Total",1433,693,740,1433,0,32,45.67,31.4
"2011","Leeds 015D","E01011566","Total",1309,621,688,1309,0,14,24.13,54.2
"2011","Leeds 015E","E01011568","Total",1831,855,976,1825,6,46,45.65,40.1
"2011","Leeds 016A","E01011380","Total",1523,753,770,1523,0,42,80.90,18.8
"2011","Leeds 016B","E01011381","Total",1312,622,690,1310,2,32,264.00,5.0
"2011","Leeds 016C","E01011385","Total",1249,605,644,1223,26,37,117.67,10.6
"2011","Leeds 016D","E01011386","Total",1419,699,720,1419,0,39,67.10,21.1
"2011","Leeds 017A","E01011379","Total",1482,699,783,1482,0,19,45.06,32.9
"2011","Leeds 017B","E01011384","Total",1485,717,768,1485,0,14,32.74,45.4
"2011","Leeds 017E","E01032501","Total",1173,584,589,1173,0,10,24.60,47.7
"2011","Leeds 017F","E01032502","Total",1842,880,962,1842,0,16,45.04,40.9
"2011","Leeds 018A","E01011555","Total",1362,663,699,1362,0,39,47.05,28.9
"2011","Leeds 018B","E01011558","Total",1577,709,868,1577,0,13,41.80,37.7
"2011","Leeds 018C","E01011559","Total",1259,579,680,1232,27,12,49.54,25.4
"2011","Leeds 018D","E01011560","Total",1800,894,906,1800,0,18,49.32,36.5
"2011","Leeds 019A","E01011383","Total",1566,736,830,1566,0,20,74.28,21.1
"2011","Leeds 019B","E01011388","Total",1407,653,754,1407,0,19,59.19,23.8
"2011","Leeds 019C","E01011684","Total",1548,748,800,1548,0,19,66.51,23.3
"2011","Leeds 019D","E01011695","Total",1590,762,828,1533,57,15,37.83,42.0
"2011","Leeds 020A","E01011650","Total",1443,674,769,1424,19,39,325.22,4.4
"2011","Leeds 020B","E01011651","Total",1446,711,735,1446,0,18,40.80,35.4
"2011","Leeds 020C","E01011653","Total",1352,663,689,1330,22,35,24.19,55.9
"2011","Leeds 020D","E01011655","Total",1396,670,726,1354,42,40,72.19,19.3
"2011","Leeds 021A","E01011455","Total",1382,672,710,1169,213,35,154.70,8.9
"2011","Leeds 021B","E01011456","Total",1707,822,885,1707,0,24,100.93,16.9
"2011","Leeds 021C","E01011459","Total",1582,789,793,1567,15,18,64.92,24.4
"2011","Leeds 021D","E01011461","Total",1530,753,777,1530,0,31,73.20,20.9
"2011","Leeds 022A","E01011311","Total",1217,588,629,1217,0,36,677.95,1.8
"2011","Leeds 022B","E01011649","Total",1466,720,746,1466,0,36,251.00,5.8
"2011","Leeds 022C","E01011715","Total",1289,631,658,1277,12,13,542.69,2.4
"2011","Leeds 022D","E01011719","Total",1427,687,740,1420,7,20,224.75,6.3
"2011","Leeds 023A","E01011509","Total",1351,625,726,1351,0,31,34.14,39.6
"2011","Leeds 023B","E01011511","Total",1329,672,657,1324,5,22,32.92,40.4
"2011","Leeds 023C","E01011512","Total",1566,774,792,1562,4,29,36.92,42.4
"2011","Leeds 023D","E01011515","Total",1421,704,717,1421,0,29,29.34,48.4
"2011","Leeds 023E","E01011516","Total",1704,852,852,1704,0,34,28.31,60.2
"2011","Leeds 024A","E01011508","Total",1414,719,695,1414,0,34,28.65,49.4
"2011","Leeds 024B","E01011517","Total",1638,792,846,1638,0,22,37.45,43.7
"2011","Leeds 024C","E01011652","Total",1331,663,668,1295,36,30,25.45,52.3
"2011","Leeds 024D","E01011654","Total",1434,714,720,1434,0,53,33.03,43.4
"2011","Leeds 025A","E01011505","Total",1599,762,837,1599,0,20,78.24,20.4
"2011","Leeds 025B","E01011506","Total",1439,702,737,1439,0,22,21.27,67.7
"2011","Leeds 025C","E01011507","Total",1580,763,817,1580,0,20,30.63,51.6
"2011","Leeds 025D","E01011510","Total",1576,769,807,1536,40,18,37.67,41.8
"2011","Leeds 025E","E01011514","Total",1631,791,840,1628,3,27,31.58,51.6
"2011","Leeds 027A","E01011452","Total",1524,741,783,1524,0,23,101.63,15.0
"2011","Leeds 027B","E01011454","Total",1492,721,771,1492,0,26,25.11,59.4
"2011","Leeds 027C","E01011457","Total",1591,768,823,1456,135,44,255.97,6.2
"2011","Leeds 027D","E01011458","Total",1382,691,691,1382,0,19,164.94,8.4
"2011","Leeds 027E","E01011465","Total",1532,687,845,1507,25,4,39.08,39.2
"2011","Leeds 028A","E01011453","Total",1482,718,764,1482,0,21,45.32,32.7
"2011","Leeds 028B","E01011460","Total",1409,665,744,1380,29,6,29.50,47.8
"2011","Leeds 028C","E01011462","Total",1632,814,818,1632,0,22,37.16,43.9
"2011","Leeds 028D","E01011463","Total",1583,739,844,1583,0,13,27.20,58.2
"2011","Leeds 028E","E01011464","Total",1678,814,864,1678,0,15,36.82,45.6
"2011","Leeds 029A","E01011714","Total",1474,716,758,1474,0,13,129.53,11.4
"2011","Leeds 029B","E01011716","Total",1486,717,769,1481,5,21,40.41,36.8
"2011","Leeds 029C","E01011717","Total",1495,717,778,1495,0,18,48.57,30.8
"2011","Leeds 029D","E01011718","Total",1400,659,741,1393,7,3,28.17,49.7
"2011","Leeds 029E","E01011720","Total",1498,758,740,1498,0,5,48.82,30.7
"2011","Leeds 030A","E01011296","Total",1678,800,878,1678,0,35,385.46,4.4
"2011","Leeds 030B","E01011297","Total",1585,787,798,1585,0,18,1997.00,0.8
"2011","Leeds 030C","E01011309","Total",1507,718,789,1507,0,24,1359.73,1.1
"2011","Leeds 030D","E01011310","Total",1623,776,847,1623,0,34,750.09,2.2
"2011","Leeds 031A","E01011513","Total",2181,1034,1147,2164,17,45,79.80,27.3
"2011","Leeds 031B","E01011688","Total",1488,719,769,1488,0,19,23.49,63.3
"2011","Leeds 031C","E01011689","Total",1552,730,822,1552,0,10,33.82,45.9
"2011","Leeds 031D","E01011691","Total",1527,710,817,1527,0,11,25.56,59.7
"2011","Leeds 032A","E01011504","Total",1426,673,753,1390,36,9,33.97,42.0
"2011","Leeds 032B","E01011641","Total",1522,740,782,1522,0,50,85.06,17.9
"2011","Leeds 032C","E01011642","Total",1326,646,680,1299,27,42,34.91,38.0
"2011","Leeds 032D","E01011645","Total",1472,678,794,1442,30,19,38.34,38.4
"2011","Leeds 033A","E01011484","Total",1538,739,799,1538,0,13,41.85,36.8
"2011","Leeds 033B","E01011485","Total",1524,733,791,1505,19,20,48.71,31.3
"2011","Leeds 033E","E01011686","Total",1545,753,792,1545,0,6,76.80,20.1
"2011","Leeds 033F","E01032493","Total",1343,646,697,1343,0,11,20.77,64.7
"2011","Leeds 033G","E01032494","Total",1745,847,898,1727,18,19,66.39,26.3
"2011","Leeds 034A","E01011350","Total",1625,791,834,1625,0,22,36.52,44.5
"2011","Leeds 034B","E01011351","Total",1696,804,892,1684,12,15,37.32,45.4
"2011","Leeds 034C","E01011352","Total",1790,855,935,1727,63,8,29.61,60.5
"2011","Leeds 034D","E01011353","Total",1865,871,994,1865,0,40,38.27,48.7
"2011","Leeds 035A","E01011656","Total",1490,722,768,1490,0,17,25.13,59.3
"2011","Leeds 035B","E01011657","Total",1307,610,697,1307,0,13,63.16,20.7
"2011","Leeds 035C","E01011659","Total",1373,664,709,1368,5,10,29.43,46.7
"2011","Leeds 035D","E01011661","Total",1598,734,864,1541,57,8,41.78,38.2
"2011","Leeds 037A","E01011643","Total",1392,653,739,1296,96,19,41.38,33.6
"2011","Leeds 037B","E01011644","Total",1249,584,665,1176,73,19,103.77,12.0
"2011","Leeds 037C","E01011646","Total",1666,814,852,1645,21,21,32.59,51.1
"2011","Leeds 037D","E01011647","Total",1716,845,871,1716,0,20,27.02,63.5
"2011","Leeds 037E","E01011648","Total",1744,860,884,1744,0,16,25.70,67.9
"2011","Leeds 038A","E01011354","Total",1397,665,732,1397,0,3,25.47,54.8
"2011","Leeds 038B","E01011355","Total",1378,638,740,1378,0,5,58.48,23.6
"2011","Leeds 038C","E01011357","Total",1914,886,1028,1914,0,6,55.11,34.7
"2011","Leeds 038D","E01011450","Total",1226,589,637,1226,0,11,39.90,30.7
"2011","Leeds 039A","E01011588","Total",1725,867,858,1692,33,20,117.38,14.7
"2011","Leeds 039B","E01011589","Total",1521,739,782,1521,0,11,244.27,6.2
"2011","Leeds 039C","E01011590","Total",1540,767,773,1514,26,22,315.90,4.9
"2011","Leeds 039D","E01011592","Total",1402,640,762,1402,0,10,37.57,37.3
"2011","Leeds 039E","E01011593","Total",1764,867,897,1764,0,24,70.61,25.0
"2011","Leeds 040A","E01011421","Total",1486,697,789,1486,0,14,26.39,56.3
"2011","Leeds 040B","E01011425","Total",1561,762,799,1553,8,15,27.31,57.2
"2011","Leeds 040C","E01011658","Total",1344,614,730,1344,0,9,34.32,39.2
"2011","Leeds 040D","E01011660","Total",1359,659,700,1320,39,6,44.56,30.5
"2011","Leeds 040E","E01011662","Total",1189,583,606,1189,0,3,38.59,30.8
"2011","Leeds 041A","E01011721","Total",1522,691,831,1522,0,2,55.47,27.4
"2011","Leeds 041B","E01011722","Total",1893,881,1012,1860,33,14,82.21,23.0
"2011","Leeds 041C","E01011723","Total",1417,666,751,1417,0,4,24.94,56.8
"2011","Leeds 041D","E01011724","Total",1821,872,949,1821,0,5,36.13,50.4
"2011","Leeds 042A","E01011356","Total",1926,956,970,1910,16,21,43.45,44.3
"2011","Leeds 042B","E01011358","Total",1453,697,756,1453,0,19,29.56,49.2
"2011","Leeds 042C","E01011359","Total",1682,809,873,1682,0,23,40.08,42.0
"2011","Leeds 042D","E01011360","Total",2075,1002,1073,2071,4,15,23.36,88.8
"2011","Leeds 042E","E01011361","Total",2478,1179,1299,2478,0,30,40.35,61.4
"2011","Leeds 044A","E01011435","Total",1820,920,900,1783,37,18,15.01,121.3
"2011","Leeds 044D","E01011440","Total",1622,726,896,1622,0,22,19.91,81.5
"2011","Leeds 044E","E01011441","Total",1954,1032,922,1882,72,22,20.74,94.2
"2011","Leeds 044F","E01032945","Total",3163,1629,1534,3161,2,32,30.91,102.3
"2011","Leeds 045A","E01011477","Total",1928,967,961,1842,86,20,53.30,36.2
"2011","Leeds 045B","E01011480","Total",1590,784,806,1582,8,5,26.82,59.3
"2011","Leeds 045C","E01011488","Total",1431,722,709,1431,0,14,47.15,30.3
"2011","Leeds 045D","E01011489","Total",1687,827,860,1687,0,12,39.96,42.2
"2011","Leeds 046A","E01011324","Total",2251,1148,1103,1307,944,32,59.21,38.0
"2011","Leeds 046B","E01011325","Total",1436,688,748,1436,0,4,138.21,10.4
"2011","Leeds 046C","E01011326","Total",1359,658,701,1354,5,6,23.42,58.0
"2011","Leeds 046D","E01011332","Total",1340,603,737,1296,44,4,24.16,55.5
"2011","Leeds 047A","E01011423","Total",1622,760,862,1622,0,16,37.05,43.8
"2011","Leeds 047B","E01011424","Total",1600,768,832,1600,0,18,20.09,79.6
"2011","Leeds 047C","E01011427","Total",1769,844,925,1769,0,16,23.21,76.2
"2011","Leeds 047D","E01011431","Total",1878,943,935,1854,24,24,30.22,62.1
"2011","Leeds 048A","E01011422","Total",1485,774,711,1463,22,6,12.17,122.0
"2011","Leeds 048B","E01011426","Total",1705,871,834,1701,4,5,8.44,202.0
"2011","Leeds 048C","E01011428","Total",1870,964,906,1870,0,5,11.90,157.1
"2011","Leeds 048D","E01011429","Total",2007,1017,990,1999,8,6,18.36,109.3
"2011","Leeds 050A","E01011663","Total",1256,572,684,1256,0,4,39.05,32.2
"2011","Leeds 050B","E01011664","Total",1110,501,609,1110,0,6,28.65,38.7
"2011","Leeds 050C","E01011665","Total",1386,696,690,1386,0,9,32.07,43.2
"2011","Leeds 050D","E01011667","Total",1491,675,816,1491,0,8,25.09,59.4
"2011","Leeds 051A","E01011323","Total",1267,594,673,1262,5,3,19.25,65.8
"2011","Leeds 051B","E01011329","Total",1486,719,767,1486,0,11,33.73,44.1
"2011","Leeds 051C","E01011330","Total",1254,615,639,1254,0,9,56.97,22.0
"2011","Leeds 051D","E01011333","Total",1263,642,621,1263,0,10,25.18,50.2
"2011","Leeds 052A","E01011327","Total",1325,647,678,1317,8,11,71.52,18.5
"2011","Leeds 052B","E01011328","Total",1491,754,737,1491,0,11,43.87,34.0
"2011","Leeds 052C","E01011335","Total",1671,796,875,1671,0,12,38.75,43.1
"2011","Leeds 052D","E01011591","Total",1616,800,816,1616,0,9,61.40,26.3
"2011","Leeds 053A","E01011430","Total",1508,793,715,1508,0,23,12.34,122.2
"2011","Leeds 053B","E01011432","Total",1558,774,784,1547,11,7,9.45,164.9
"2011","Leeds 053C","E01011433","Total",1538,764,774,1538,0,6,14.40,106.8
"2011","Leeds 053D","E01011434","Total",1397,723,674,1397,0,3,11.00,127.0
"2011","Leeds 054A","E01011445","Total",1679,746,933,1679,0,17,6.85,245.1
"2011","Leeds 054B","E01011446","Total",1574,788,786,1574,0,13,8.14,193.4
"2011","Leeds 054C","E01011447","Total",1428,726,702,1337,91,12,9.00,158.7
"2011","Leeds 054D","E01011448","Total",1572,768,804,1542,30,22,8.11,193.8
"2011","Leeds 054E","E01011449","Total",1383,734,649,1380,3,8,8.77,157.7
"2011","Leeds 055A","E01011670","Total",2634,1302,1332,1917,717,28,30.29,87.0
"2011","Leeds 055B","E01011671","Total",1535,708,827,1535,0,13,51.30,29.9
"2011","Leeds 055F","E01033002","Total",1310,741,569,1310,0,8,27.97,46.8
"2011","Leeds 055G","E01033003","Total",1783,1062,721,1783,0,6,21.74,82.0
"2011","Leeds 055H","E01033005","Total",3530,1718,1812,1993,1537,52,64.18,55.0
"2011","Leeds 056A","E01011478","Total",1679,885,794,1679,0,3,17.01,98.7
"2011","Leeds 056B","E01011479","Total",1476,804,672,1476,0,5,11.47,128.7
"2011","Leeds 056C","E01011481","Total",1578,844,734,1558,20,6,26.02,60.6
"2011","Leeds 056D","E01011482","Total",1693,887,806,1693,0,8,48.51,34.9
"2011","Leeds 056E","E01011483","Total",1570,819,751,1553,17,6,31.06,50.5
"2011","Leeds 057A","E01011406","Total",1403,655,748,1403,0,19,32.52,43.1
"2011","Leeds 057B","E01011407","Total",1448,685,763,1435,13,5,30.50,47.5
"2011","Leeds 057C","E01011408","Total",1451,675,776,1451,0,9,36.11,40.2
"2011","Leeds 057D","E01011409","Total",1397,687,710,1374,23,16,30.38,46.0
"2011","Leeds 057E","E01011410","Total",1274,617,657,1274,0,9,485.18,2.6
"2011","Leeds 057F","E01011412","Total",1370,670,700,1370,0,19,82.99,16.5
"2011","Leeds 058A","E01011331","Total",1238,605,633,1238,0,9,22.50,55.0
"2011","Leeds 058B","E01011334","Total",1293,637,656,1288,5,7,21.94,58.9
"2011","Leeds 058C","E01011336","Total",1525,718,807,1525,0,9,30.20,50.5
"2011","Leeds 058D","E01011337","Total",1399,637,762,1399,0,3,42.57,32.9
"2011","Leeds 059A","E01011281","Total",1878,910,968,1820,58,7,92.30,20.3
"2011","Leeds 059B","E01011282","Total",1378,644,734,1378,0,2,14.38,95.8
"2011","Leeds 059C","E01011283","Total",1331,637,694,1331,0,8,21.43,62.1
"2011","Leeds 059D","E01011286","Total",1244,613,631,1244,0,5,28.22,44.1
"2011","Leeds 059E","E01011295","Total",1526,732,794,1526,0,3,24.84,61.4
"2011","Leeds 060A","E01011339","Total",1783,881,902,1783,0,4,59.39,30.0
"2011","Leeds 060B","E01011340","Total",1616,742,874,1616,0,9,36.97,43.7
"2011","Leeds 060C","E01011342","Total",1410,675,735,1410,0,9,39.52,35.7
"2011","Leeds 060D","E01011346","Total",1791,874,917,1791,0,14,67.43,26.6
"2011","Leeds 061A","E01011341","Total",1484,675,809,1484,0,6,59.61,24.9
"2011","Leeds 061B","E01011343","Total",1663,835,828,1663,0,7,56.71,29.3
"2011","Leeds 061C","E01011345","Total",1418,628,790,1418,0,11,34.04,41.7
"2011","Leeds 061D","E01011666","Total",1490,728,762,1490,0,12,27.16,54.9
"2011","Leeds 062A","E01011585","Total",1435,684,751,1435,0,7,29.50,48.6
"2011","Leeds 062B","E01011587","Total",1663,826,837,1660,3,8,74.72,22.3
"2011","Leeds 062C","E01011594","Total",1455,685,770,1455,0,5,27.83,52.3
"2011","Leeds 062D","E01011596","Total",1675,818,857,1675,0,14,61.04,27.4
"2011","Leeds 062E","E01011598","Total",1544,722,822,1524,20,9,23.10,66.8
"2011","Leeds 063B","E01011678","Total",4156,1858,2298,1393,2763,74,47.71,87.1
"2011","Leeds 063D","E01011681","Total",1734,886,848,1557,177,8,28.04,61.8
"2011","Leeds 063E","E01033006","Total",3385,1690,1695,2218,1167,59,57.35,59.0
"2011","Leeds 064A","E01011338","Total",1671,858,813,1626,45,15,21.01,79.5
"2011","Leeds 064B","E01011673","Total",1691,869,822,1691,0,6,15.58,108.5
"2011","Leeds 064D","E01011677","Total",1526,790,736,1526,0,9,30.34,50.3
"2011","Leeds 064E","E01033031","Total",1289,716,573,1269,20,5,54.57,23.6
"2011","Leeds 064F","E01033035","Total",1412,834,578,1407,5,8,17.11,82.5
"2011","Leeds 065A","E01011344","Total",1764,866,898,1764,0,18,14.89,118.5
"2011","Leeds 065B","E01011347","Total",1671,796,875,1671,0,6,18.78,89.0
"2011","Leeds 065C","E01011348","Total",1622,816,806,1619,3,6,46.85,34.6
"2011","Leeds 065D","E01011349","Total",1716,914,802,1716,0,3,27.05,63.4
"2011","Leeds 066A","E01011586","Total",1494,719,775,1494,0,11,53.27,28.0
"2011","Leeds 066B","E01011595","Total",1804,873,931,1804,0,34,112.48,16.0
"2011","Leeds 066C","E01011597","Total",1507,748,759,1488,19,17,68.29,22.1
"2011","Leeds 066D","E01011599","Total",1535,729,806,1535,0,7,57.31,26.8
"2011","Leeds 067B","E01011287","Total",1320,633,687,1320,0,9,31.48,41.9
"2011","Leeds 067G","E01032499","Total",1749,857,892,1725,24,16,80.19,21.8
"2011","Leeds 067H","E01032500","Total",1144,631,513,1144,0,8,14.07,81.3
"2011","Leeds 067I","E01032606","Total",1982,997,985,1982,0,17,44.93,44.1
"2011","Leeds 067J","E01032607","Total",1101,558,543,1057,44,5,24.28,45.3
"2011","Leeds 067K","E01032608","Total",1170,583,587,1147,23,14,14.56,80.4
"2011","Leeds 068A","E01011608","Total",1384,672,712,1384,0,5,39.08,35.4
"2011","Leeds 068B","E01011609","Total",1453,719,734,1453,0,10,19.40,74.9
"2011","Leeds 068C","E01011610","Total",1418,674,744,1394,24,3,36.85,38.5
"2011","Leeds 068D","E01011611","Total",1364,644,720,1359,5,9,33.92,40.2
"2011","Leeds 068E","E01011614","Total",1811,876,935,1807,4,24,53.39,33.9
"2011","Leeds 069A","E01011413","Total",1562,773,789,1557,5,19,31.59,49.4
"2011","Leeds 069B","E01011415","Total",1594,795,799,1587,7,13,60.81,26.2
"2011","Leeds 069C","E01011416","Total",1498,737,761,1498,0,16,35.51,42.2
"2011","Leeds 069D","E01011417","Total",1496,723,773,1496,0,14,33.32,44.9
"2011","Leeds 069E","E01011420","Total",1293,626,667,1293,0,11,632.48,2.0
"2011","Leeds 070A","E01011615","Total",1529,758,771,1508,21,3,27.80,55.0
"2011","Leeds 070B","E01011617","Total",1608,748,860,1608,0,4,34.40,46.7
"2011","Leeds 070C","E01011618","Total",1581,742,839,1581,0,8,12.76,123.9
"2011","Leeds 070D","E01011621","Total",1486,694,792,1486,0,4,318.68,4.7
"2011","Leeds 071A","E01011284","Total",1751,907,844,1742,9,6,73.34,23.9
"2011","Leeds 071B","E01011292","Total",1619,807,812,1619,0,4,28.83,56.2
"2011","Leeds 071C","E01011293","Total",1720,904,816,1703,17,1,22.67,75.9
"2011","Leeds 071D","E01011294","Total",1518,979,539,1013,505,2,25.38,59.8
"2011","Leeds 071E","E01011363","Total",1614,808,806,1567,47,6,108.04,14.9
"2011","Leeds 072A","E01011616","Total",1431,659,772,1431,0,6,30.20,47.4
"2011","Leeds 072B","E01011620","Total",1314,615,699,1314,0,17,26.79,49.0
"2011","Leeds 072C","E01011622","Total",1635,782,853,1635,0,12,44.47,36.8
"2011","Leeds 072D","E01011624","Total",1823,874,949,1823,0,14,274.55,6.6
"2011","Leeds 073A","E01011411","Total",1591,784,807,1591,0,18,260.58,6.1
"2011","Leeds 073B","E01011414","Total",1484,735,749,1484,0,20,28.88,51.4
"2011","Leeds 073C","E01011418","Total",1476,717,759,1457,19,24,46.67,31.6
"2011","Leeds 073D","E01011419","Total",1223,615,608,1223,0,22,86.60,14.1
"2011","Leeds 074A","E01011396","Total",1766,842,924,1766,0,25,93.45,18.9
"2011","Leeds 074B","E01011399","Total",1481,703,778,1463,18,6,56.30,26.3
"2011","Leeds 074C","E01011400","Total",1428,674,754,1424,4,15,48.70,29.3
"2011","Leeds 074D","E01011403","Total",1396,638,758,1322,74,24,42.96,32.5
"2011","Leeds 075B","E01011623","Total",1517,754,763,1517,0,7,17.74,85.5
"2011","Leeds 075C","E01011625","Total",1472,755,717,1472,0,7,59.56,24.7
"2011","Leeds 075D","E01011626","Total",1782,948,834,1782,0,6,31.99,55.7
"2011","Leeds 075E","E01033021","Total",1300,638,662,1244,56,3,40.22,32.3
"2011","Leeds 075F","E01033033","Total",1580,860,720,1185,395,5,10.87,145.4
"2011","Leeds 075G","E01033034","Total",1025,590,435,1025,0,2,13.15,77.9
"2011","Leeds 076A","E01011602","Total",1525,710,815,1483,42,4,43.58,35.0
"2011","Leeds 076B","E01011603","Total",1516,727,789,1460,56,31,120.78,12.6
"2011","Leeds 076C","E01011605","Total",1458,712,746,1458,0,21,64.93,22.5
"2011","Leeds 076D","E01011606","Total",1682,804,878,1682,0,7,186.49,9.0
"2011","Leeds 076E","E01011613","Total",1303,615,688,1303,0,6,52.35,24.9
"2011","Leeds 077A","E01011397","Total",1506,717,789,1506,0,15,27.51,54.7
"2011","Leeds 077B","E01011398","Total",1257,610,647,1257,0,19,30.47,41.3
"2011","Leeds 077C","E01011401","Total",1509,750,759,1509,0,10,34.93,43.2
"2011","Leeds 077D","E01011404","Total",1321,648,673,1321,0,16,116.73,11.3
"2011","Leeds 077E","E01011405","Total",1425,668,757,1414,11,15,44.46,32.1
"2011","Leeds 078A","E01011725","Total",1557,790,767,1557,0,2,21.91,71.1
"2011","Leeds 078B","E01011729","Total",1614,767,847,1498,116,8,25.69,62.8
"2011","Leeds 078C","E01011730","Total",1559,752,807,1559,0,3,53.34,29.2
"2011","Leeds 078D","E01011735","Total",1659,771,888,1659,0,7,29.99,55.3
"2011","Leeds 079A","E01011600","Total",1519,729,790,1484,35,14,34.99,43.4
"2011","Leeds 079B","E01011601","Total",1494,721,773,1494,0,8,163.06,9.2
"2011","Leeds 079C","E01011604","Total",1334,627,707,1318,16,17,24.59,54.2
"2011","Leeds 079D","E01011607","Total",1588,754,834,1588,0,9,32.22,49.3
"2011","Leeds 079E","E01011612","Total",1302,549,753,1228,74,7,31.75,41.0
"2011","Leeds 080A","E01011726","Total",1449,705,744,1428,21,10,105.17,13.8
"2011","Leeds 080B","E01011727","Total",1547,761,786,1547,0,15,55.03,28.1
"2011","Leeds 080C","E01011728","Total",1414,654,760,1414,0,11,289.72,4.9
"2011","Leeds 080D","E01011739","Total",1530,759,771,1530,0,5,35.24,43.4
"2011","Leeds 081A","E01011362","Total",1820,961,859,1811,9,7,94.17,19.3
"2011","Leeds 081B","E01011731","Total",1418,699,719,1418,0,11,35.44,40.0
"2011","Leeds 081C","E01011732","Total",1861,919,942,1812,49,7,51.77,35.9
"2011","Leeds 081D","E01011733","Total",1492,718,774,1459,33,12,29.89,49.9
"2011","Leeds 082A","E01011366","Total",1588,831,757,1588,0,8,71.43,22.2
"2011","Leeds 082C","E01011368","Total",1275,683,592,1275,0,7,14.09,90.5
"2011","Leeds 082D","E01011370","Total",1724,961,763,1646,78,5,24.66,69.9
"2011","Leeds 082E","E01033013","Total",1189,670,519,1164,25,1,59.79,19.9
"2011","Leeds 082F","E01033032","Total",1278,724,554,1278,0,4,44.82,28.5
"2011","Leeds 083A","E01011734","Total",2315,1156,1159,2315,0,12,309.07,7.5
"2011","Leeds 083B","E01011736","Total",1485,722,763,1485,0,9,38.01,39.1
"2011","Leeds 083C","E01011737","Total",1563,747,816,1563,0,6,47.40,33.0
"2011","Leeds 083D","E01011738","Total",1435,699,736,1428,7,13,97.84,14.7
"2011","Leeds 085A","E01011364","Total",1631,857,774,1631,0,6,72.32,22.6
"2011","Leeds 085B","E01011371","Total",1460,733,727,1421,39,2,28.56,51.1
"2011","Leeds 085C","E01011373","Total",1439,746,693,1438,1,6,17.07,84.3
"2011","Leeds 085D","E01011374","Total",1195,595,600,1184,11,4,13.16,90.8
"2011","Leeds 086A","E01011312","Total",1599,812,787,1598,1,6,19.48,82.1
"2011","Leeds 086B","E01011316","Total",1657,892,765,1657,0,7,32.36,51.2
"2011","Leeds 086C","E01011372","Total",1380,754,626,1380,0,6,11.41,120.9
"2011","Leeds 086D","E01011375","Total",1847,1005,842,1847,0,12,8.71,212.1
"2011","Leeds 087A","E01011390","Total",1443,688,755,1443,0,5,85.99,16.8
"2011","Leeds 087B","E01011391","Total",1645,812,833,1645,0,12,74.49,22.1
"2011","Leeds 087C","E01011392","Total",1463,697,766,1463,0,11,419.62,3.5
"2011","Leeds 087D","E01011402","Total",1768,841,927,1751,17,20,960.54,1.8
"2011","Leeds 088A","E01011298","Total",1538,776,762,1538,0,7,317.65,4.8
"2011","Leeds 088B","E01011299","Total",2238,1113,1125,2238,0,26,1753.17,1.3
"2011","Leeds 088C","E01011302","Total",1406,693,713,1371,35,13,245.50,5.7
"2011","Leeds 088D","E01011303","Total",1145,547,598,1145,0,7,185.80,6.2
"2011","Leeds 089A","E01011300","Total",1469,717,752,1469,0,15,47.62,30.8
"2011","Leeds 089B","E01011301","Total",1336,673,663,1336,0,20,25.69,52.0
"2011","Leeds 089C","E01011304","Total",1591,765,826,1591,0,12,29.91,53.2
"2011","Leeds 089D","E01011305","Total",1496,733,763,1496,0,14,75.71,19.8
"2011","Leeds 089E","E01011306","Total",1342,657,685,1342,0,15,75.94,17.7
"2011","Leeds 090A","E01011315","Total",1552,794,758,1552,0,5,33.79,45.9
"2011","Leeds 090B","E01011317","Total",1705,825,880,1705,0,11,50.48,33.8
"2011","Leeds 090C","E01011318","Total",1470,698,772,1470,0,9,70.06,21.0
"2011","Leeds 090D","E01011321","Total",1544,751,793,1544,0,11,31.52,49.0
"2011","Leeds 090E","E01011369","Total",1561,719,842,1561,0,7,106.53,14.7
"2011","Leeds 091A","E01011313","Total",1595,785,810,1595,0,5,13.36,119.4
"2011","Leeds 091B","E01011314","Total",1472,728,744,1472,0,11,17.42,84.5
"2011","Leeds 091C","E01011319","Total",1568,767,801,1542,26,8,24.16,64.9
"2011","Leeds 091D","E01011320","Total",1674,805,869,1674,0,13,30.22,55.4
"2011","Leeds 091E","E01011322","Total",1544,754,790,1539,5,12,115.49,13.4
"2011","Leeds 092A","E01011471","Total",1400,650,750,1400,0,16,36.04,38.8
"2011","Leeds 092B","E01011472","Total",1598,736,862,1564,34,7,30.51,52.4
"2011","Leeds 092C","E01011473","Total",1476,691,785,1476,0,3,33.43,44.2
"2011","Leeds 092D","E01011474","Total",1457,715,742,1457,0,3,38.68,37.7
"2011","Leeds 093A","E01011518","Total",2187,1061,1126,2187,0,8,87.32,25.0
"2011","Leeds 093B","E01011524","Total",1241,612,629,1235,6,8,37.59,33.0
"2011","Leeds 093C","E01011526","Total",1291,648,643,1291,0,14,26.96,47.9
"2011","Leeds 093D","E01011531","Total",1461,686,775,1424,37,11,146.58,10.0
"2011","Leeds 094A","E01011466","Total",1489,730,759,1454,35,3,26.84,55.5
"2011","Leeds 094B","E01011469","Total",1460,743,717,1460,0,4,80.59,18.1
"2011","Leeds 094C","E01011475","Total",1497,731,766,1497,0,4,26.55,56.4
"2011","Leeds 094D","E01011476","Total",1195,549,646,1195,0,6,19.05,62.7
"2011","Leeds 095A","E01011519","Total",1488,725,763,1488,0,5,62.64,23.8
"2011","Leeds 095B","E01011522","Total",1396,690,706,1396,0,17,251.31,5.6
"2011","Leeds 095C","E01011525","Total",1576,775,801,1529,47,7,20.98,75.1
"2011","Leeds 095D","E01011528","Total",1596,797,799,1596,0,19,28.90,55.2
"2011","Leeds 095E","E01011532","Total",1556,733,823,1556,0,9,49.42,31.5
"2011","Leeds 096A","E01011520","Total",1491,741,750,1491,0,5,94.70,15.7
"2011","Leeds 096B","E01011521","Total",1968,974,994,1968,0,15,223.20,8.8
"2011","Leeds 096C","E01011523","Total",1782,823,959,1704,78,15,133.23,13.4
"2011","Leeds 096D","E01011527","Total",1773,901,872,1773,0,14,87.52,20.3
"2011","Leeds 096E","E01011529","Total",1434,692,742,1431,3,11,63.82,22.5
"2011","Leeds 097B","E01011635","Total",1547,744,803,1547,0,16,145.84,10.6
"2011","Leeds 097C","E01011637","Total",1768,880,888,1768,0,12,107.77,16.4
"2011","Leeds 097D","E01011638","Total",1487,754,733,1487,0,12,39.79,37.4
"2011","Leeds 097F","E01032487","Total",1013,488,525,1013,0,5,18.20,55.7
"2011","Leeds 097G","E01032488","Total",1846,888,958,1824,22,25,49.16,37.6
"2011","Leeds 098A","E01011627","Total",1417,674,743,1403,14,9,43.58,32.5
"2011","Leeds 098B","E01011628","Total",1328,630,698,1328,0,12,39.30,33.8
"2011","Leeds 098C","E01011629","Total",1302,619,683,1302,0,18,25.26,51.5
"2011","Leeds 098D","E01011632","Total",1335,605,730,1335,0,7,26.45,50.5
"2011","Leeds 098E","E01011633","Total",1472,716,756,1437,35,16,54.91,26.8
"2011","Leeds 099A","E01011490","Total",2518,1211,1307,2514,4,14,85.06,29.6
"2011","Leeds 099C","E01011502","Total",1333,605,728,1333,0,10,59.10,22.6
"2011","Leeds 099E","E01032497","Total",1496,731,765,1496,0,2,143.86,10.4
"2011","Leeds 099F","E01032498","Total",1531,757,774,1524,7,9,93.79,16.3
"2011","Leeds 100A","E01011496","Total",1510,756,754,1500,10,18,137.47,11.0
"2011","Leeds 100B","E01011630","Total",2088,993,1095,2064,24,7,68.63,30.4
"2011","Leeds 100C","E01011634","Total",1499,733,766,1499,0,11,216.72,6.9
"2011","Leeds 100D","E01011636","Total",1625,766,859,1592,33,14,959.86,1.7
"2011","Leeds 100E","E01011639","Total",1523,706,817,1523,0,12,283.03,5.4
"2011","Leeds 101A","E01011491","Total",1357,623,734,1357,0,6,20.10,67.5
"2011","Leeds 101B","E01011492","Total",1366,614,752,1344,22,4,33.31,41.0
"2011","Leeds 101C","E01011493","Total",1540,742,798,1528,12,5,147.50,10.4
"2011","Leeds 101D","E01011494","Total",1304,632,672,1304,0,4,23.38,55.8
"2011","Leeds 101E","E01011497","Total",1608,769,839,1608,0,8,44.60,36.1
"2011","Leeds 102B","E01011540","Total",1439,696,743,1439,0,10,174.06,8.3
"2011","Leeds 102F","E01032489","Total",1936,966,970,1923,13,19,39.72,48.7
"2011","Leeds 102G","E01032490","Total",1396,683,713,1396,0,7,28.68,48.7
"2011","Leeds 102H","E01032491","Total",1230,600,630,1230,0,15,53.17,23.1
"2011","Leeds 102I","E01032492","Total",1991,950,1041,1967,24,10,26.15,76.1
"2011","Leeds 103A","E01011307","Total",1526,731,795,1492,34,2,158.05,9.7
"2011","Leeds 103B","E01011308","Total",1528,739,789,1518,10,5,76.95,19.9
"2011","Leeds 103C","E01011393","Total",1725,826,899,1707,18,11,178.65,9.7
"2011","Leeds 103D","E01011394","Total",1237,611,626,1182,55,10,259.49,4.8
"2011","Leeds 103E","E01011395","Total",1184,588,596,1184,0,13,429.01,2.8
"2011","Leeds 104A","E01011533","Total",1294,643,651,1294,0,6,28.94,44.7
"2011","Leeds 104B","E01011541","Total",1714,822,892,1690,24,7,43.93,39.0
"2011","Leeds 104C","E01011545","Total",1388,684,704,1388,0,5,20.78,66.8
"2011","Leeds 104D","E01011547","Total",1781,844,937,1773,8,11,58.45,30.5
"2011","Leeds 105C","E01011499","Total",2588,1283,1305,2560,28,15,229.42,11.3
"2011","Leeds 105D","E01011500","Total",1590,745,845,1560,30,10,121.80,13.1
"2011","Leeds 105E","E01032495","Total",2399,1179,1220,2399,0,14,165.75,14.5
"2011","Leeds 105F","E01032496","Total",2044,1006,1038,2044,0,22,73.92,27.7
"2011","Leeds 106A","E01011530","Total",1460,735,725,1460,0,9,206.90,7.1
"2011","Leeds 106B","E01011534","Total",1421,705,716,1421,0,15,115.35,12.3
"2011","Leeds 106C","E01011546","Total",1664,784,880,1649,15,4,193.91,8.6
"2011","Leeds 106D","E01011548","Total",1445,706,739,1445,0,20,190.10,7.6
"2011","Leeds 106E","E01011550","Total",1404,700,704,1404,0,12,103.73,13.5
"2011","Leeds 107A","E01011537","Total",2066,1023,1043,2023,43,11,150.57,13.7
"2011","Leeds 107B","E01011538","Total",1507,734,773,1497,10,12,283.97,5.3
"2011","Leeds 107C","E01011551","Total",1565,782,783,1565,0,20,127.75,12.3
"2011","Leeds 107D","E01011552","Total",1467,699,768,1467,0,3,38.89,37.7
"2011","Leeds 108A","E01011535","Total",1664,822,842,1664,0,22,108.91,15.3
"2011","Leeds 108B","E01011536","Total",1587,751,836,1587,0,7,350.45,4.5
"2011","Leeds 108C","E01011549","Total",1503,748,755,1503,0,43,27.14,55.4
"2011","Leeds 108D","E01011553","Total",1436,703,733,1436,0,11,35.41,40.6
"2011","Leeds 109A","E01011685","Total",2153,1121,1032,1715,438,43,118.30,18.2
"2011","Leeds 109B","E01011687","Total",1488,746,742,1469,19,29,37.61,39.6
"2011","Leeds 109C","E01011690","Total",1356,672,684,1351,5,38,48.59,27.9
"2011","Leeds 109D","E01011692","Total",1404,729,675,1382,22,36,32.49,43.2
"2011","Leeds 109E","E01011693","Total",1521,779,742,1504,17,13,18.52,82.1
"2011","Leeds 109F","E01011694","Total",1804,897,907,1803,1,30,28.65,63.0
"2011","Leeds 109G","E01032876","Total",2691,1208,1483,1339,1352,60,159.63,16.9
"2011","Leeds 110A","E01011442","Total",1619,850,769,1615,4,14,12.42,130.4
"2011","Leeds 110B","E01011443","Total",1381,660,721,1372,9,6,15.51,89.0
"2011","Leeds 110C","E01011444","Total",1849,901,948,1836,13,21,9.74,189.8
"2011","Leeds 110D","E01011451","Total",2107,943,1164,937,1170,42,23.03,91.5
"2011","Leeds 110E","E01011668","Total",1609,821,788,1607,2,14,17.42,92.4
"2011","Leeds 110F","E01011669","Total",1475,780,695,1255,220,19,21.73,67.9
"2011","Leeds 110G","E01032946","Total",2472,1171,1301,1866,606,35,46.91,52.7
"2011","Leeds 111A","E01033008","Total",1120,631,489,1092,28,8,38.61,29.0
"2011","Leeds 111B","E01033010","Total",2807,1369,1438,1047,1760,58,69.90,40.2
"2011","Leeds 111C","E01033011","Total",1373,847,526,1172,201,12,30.37,45.2
"2011","Leeds 111D","E01033015","Total",1167,685,482,1167,0,2,36.95,31.6
"2011","Leeds 111E","E01033016","Total",1017,590,427,1015,2,7,76.11,13.4
"2011","Leeds 112A","E01011467","Total",1542,721,821,1379,163,1,74.19,20.8
"2011","Leeds 112B","E01011468","Total",1500,741,759,1500,0,3,231.00,6.5
"2011","Leeds 112C","E01011470","Total",1266,636,630,1266,0,5,155.11,8.2
"2011","Leeds 112D","E01033018","Total",1137,664,473,1136,1,4,41.02,27.7
"2011","Leeds 112E","E01033019","Total",1700,884,816,1214,486,11,20.16,84.3
"2011","Wakefield 001A","E01011740","Total",1499,716,783,1499,0,7,40.70,36.8
"2011","Wakefield 001B","E01011741","Total",1486,734,752,1486,0,6,54.66,27.2
"2011","Wakefield 001C","E01011742","Total",1637,815,822,1629,8,8,33.43,49.0
"2011","Wakefield 001D","E01011745","Total",1745,832,913,1745,0,6,44.31,39.4
"2011","Wakefield 001E","E01011746","Total",1504,736,768,1400,104,13,321.11,4.7
"2011","Wakefield 002A","E01011752","Total",1547,762,785,1547,0,9,150.56,10.3
"2011","Wakefield 002B","E01011753","Total",1402,684,718,1369,33,17,27.62,50.8
"2011","Wakefield 002C","E01011756","Total",1444,680,764,1431,13,1,27.80,51.9
"2011","Wakefield 002D","E01011760","Total",1674,849,825,1674,0,11,82.60,20.3
"2011","Wakefield 002E","E01011762","Total",1572,773,799,1572,0,5,19.18,82.0
"2011","Wakefield 003A","E01011743","Total",1466,742,724,1466,0,18,68.18,21.5
"2011","Wakefield 003B","E01011744","Total",1621,798,823,1621,0,13,67.78,23.9
"2011","Wakefield 003C","E01011747","Total",1640,754,886,1624,16,6,64.06,25.6
"2011","Wakefield 003D","E01011750","Total",1572,769,803,1572,0,24,29.94,52.5
"2011","Wakefield 003E","E01011754","Total",1452,698,754,1452,0,10,39.91,36.4
"2011","Wakefield 004A","E01011757","Total",1851,906,945,1851,0,20,58.30,31.7
"2011","Wakefield 004B","E01011759","Total",1895,945,950,1877,18,9,90.87,20.9
"2011","Wakefield 004C","E01011761","Total",1885,933,952,1820,65,13,61.78,30.5
"2011","Wakefield 004D","E01011763","Total",1443,701,742,1443,0,12,20.60,70.0
"2011","Wakefield 004E","E01011764","Total",1552,766,786,1492,60,3,42.00,37.0
"2011","Wakefield 005A","E01011748","Total",1630,798,832,1627,3,13,46.22,35.3
"2011","Wakefield 005B","E01011749","Total",2119,1059,1060,2116,3,20,185.94,11.4
"2011","Wakefield 005C","E01011751","Total",1317,662,655,1281,36,8,36.30,36.3
"2011","Wakefield 005D","E01011755","Total",1647,815,832,1647,0,18,117.46,14.0
"2011","Wakefield 006A","E01011873","Total",1575,777,798,1575,0,11,136.16,11.6
"2011","Wakefield 006B","E01011877","Total",1496,788,708,1372,124,21,165.27,9.1
"2011","Wakefield 006C","E01011894","Total",1390,659,731,1390,0,28,41.54,33.5
"2011","Wakefield 006D","E01011895","Total",1482,730,752,1482,0,16,25.38,58.4
"2011","Wakefield 007A","E01011875","Total",1435,681,754,1435,0,11,412.21,3.5
"2011","Wakefield 007B","E01011876","Total",1401,689,712,1401,0,9,398.41,3.5
"2011","Wakefield 007C","E01011878","Total",1565,765,800,1560,5,20,53.37,29.3
"2011","Wakefield 007D","E01011880","Total",1480,722,758,1478,2,17,61.14,24.2
"2011","Wakefield 008A","E01011881","Total",1468,745,723,1468,0,13,34.90,42.1
"2011","Wakefield 008B","E01011887","Total",1217,593,624,1217,0,18,102.59,11.9
"2011","Wakefield 008C","E01011893","Total",1505,716,789,1361,144,20,138.05,10.9
"2011","Wakefield 008D","E01011896","Total",1391,674,717,1376,15,15,30.72,45.3
"2011","Wakefield 008E","E01011897","Total",1423,682,741,1423,0,4,35.69,39.9
"2011","Wakefield 009A","E01011874","Total",1655,810,845,1611,44,16,41.92,39.5
"2011","Wakefield 009B","E01011879","Total",1458,732,726,1447,11,16,391.19,3.7
"2011","Wakefield 009C","E01011882","Total",1511,723,788,1511,0,8,37.58,40.2
"2011","Wakefield 009D","E01011883","Total",1414,695,719,1414,0,21,241.05,5.9
"2011","Wakefield 010A","E01011805","Total",1463,733,730,1400,63,4,95.13,15.4
"2011","Wakefield 010B","E01011807","Total",1425,710,715,1425,0,7,39.95,35.7
"2011","Wakefield 010C","E01011808","Total",1731,866,865,1707,24,10,62.95,27.5
"2011","Wakefield 010D","E01011810","Total",1527,756,771,1527,0,9,341.99,4.5
"2011","Wakefield 011A","E01011803","Total",1379,666,713,1379,0,6,249.29,5.5
"2011","Wakefield 011B","E01011804","Total",1618,759,859,1618,0,1,331.03,4.9
"2011","Wakefield 011C","E01011806","Total",1515,763,752,1496,19,12,57.79,26.2
"2011","Wakefield 011D","E01011809","Total",1474,721,753,1474,0,3,50.26,29.3
"2011","Wakefield 011E","E01011811","Total",1578,756,822,1561,17,8,71.28,22.1
"2011","Wakefield 012A","E01011835","Total",1503,755,748,1466,37,15,139.17,10.8
"2011","Wakefield 012B","E01011836","Total",1462,726,736,1424,38,18,45.11,32.4
"2011","Wakefield 012C","E01011839","Total",1612,779,833,1612,0,10,94.51,17.1
"2011","Wakefield 012D","E01011843","Total",1643,781,862,1643,0,17,78.88,20.8
"2011","Wakefield 012E","E01011844","Total",1918,943,975,1918,0,13,91.22,21.0
"2011","Wakefield 013A","E01011758","Total",1350,680,670,1334,16,10,389.73,3.5
"2011","Wakefield 013B","E01011812","Total",2595,1299,1296,2595,0,29,41.31,62.8
"2011","Wakefield 013C","E01011820","Total",1485,724,761,1477,8,8,19.39,76.6
"2011","Wakefield 013D","E01011821","Total",1327,642,685,1305,22,7,39.36,33.7
"2011","Wakefield 014A","E01011885","Total",1474,692,782,1370,104,23,369.78,4.0
"2011","Wakefield 014B","E01011886","Total",1475,715,760,1475,0,18,57.43,25.7
"2011","Wakefield 014C","E01011888","Total",1443,727,716,1430,13,24,27.91,51.7
"2011","Wakefield 014D","E01011890","Total",1269,640,629,1269,0,34,42.29,30.0
"2011","Wakefield 014E","E01011891","Total",1525,696,829,1493,32,14,69.91,21.8
"2011","Wakefield 015A","E01011834","Total",1587,761,826,1527,60,12,108.09,14.7
"2011","Wakefield 015B","E01011837","Total",1467,717,750,1438,29,19,56.84,25.8
"2011","Wakefield 015C","E01011838","Total",1958,1006,952,1935,23,11,54.14,36.2
"2011","Wakefield 015D","E01011841","Total",1522,769,753,1522,0,17,508.66,3.0
"2011","Wakefield 015E","E01011842","Total",1429,699,730,1424,5,11,37.38,38.2
"2011","Wakefield 016A","E01011813","Total",1621,763,858,1576,45,6,36.95,43.9
"2011","Wakefield 016B","E01011814","Total",1698,879,819,1698,0,6,69.21,24.5
"2011","Wakefield 016C","E01011815","Total",1523,754,769,1523,0,12,781.55,1.9
"2011","Wakefield 016D","E01011816","Total",1411,661,750,1392,19,7,40.17,35.1
"2011","Wakefield 016E","E01011819","Total",1567,772,795,1562,5,17,70.46,22.2
"2011","Wakefield 016F","E01011822","Total",1428,682,746,1428,0,9,22.02,64.9
"2011","Wakefield 017A","E01011884","Total",2339,1160,1179,2262,77,34,90.82,25.8
"2011","Wakefield 017B","E01011912","Total",1552,833,719,1543,9,9,36.95,42.0
"2011","Wakefield 017C","E01011913","Total",1660,843,817,1621,39,10,28.03,59.2
"2011","Wakefield 017D","E01011916","Total",2002,1147,855,1980,22,9,72.47,27.6
"2011","Wakefield 018A","E01011840","Total",1540,732,808,1540,0,12,41.08,37.5
"2011","Wakefield 018B","E01011850","Total",1522,718,804,1522,0,8,30.02,50.7
"2011","Wakefield 018C","E01011852","Total",1626,769,857,1626,0,15,164.16,9.9
"2011","Wakefield 018D","E01011853","Total",1461,694,767,1461,0,11,22.83,64.0
"2011","Wakefield 019A","E01011920","Total",2305,1539,766,1555,750,5,66.15,34.8
"2011","Wakefield 019B","E01011923","Total",1633,855,778,1633,0,28,53.53,30.5
"2011","Wakefield 019C","E01011924","Total",1536,768,768,1536,0,12,35.08,43.8
"2011","Wakefield 019D","E01011925","Total",1692,795,897,1692,0,8,22.09,76.6
"2011","Wakefield 020A","E01011909","Total",1404,692,712,1404,0,12,28.96,48.5
"2011","Wakefield 020B","E01011910","Total",1515,748,767,1481,34,9,33.40,45.4
"2011","Wakefield 020C","E01011911","Total",1526,739,787,1526,0,5,44.02,34.7
"2011","Wakefield 020D","E01011914","Total",1547,749,798,1547,0,10,39.06,39.6
"2011","Wakefield 020E","E01011915","Total",1611,772,839,1611,0,14,26.46,60.9
"2011","Wakefield 021A","E01011823","Total",1413,677,736,1350,63,13,146.07,9.7
"2011","Wakefield 021B","E01011824","Total",1520,717,803,1520,0,5,26.25,57.9
"2011","Wakefield 021C","E01011825","Total",1838,904,934,1838,0,25,338.63,5.4
"2011","Wakefield 021D","E01011826","Total",1434,688,746,1434,0,16,38.02,37.7
"2011","Wakefield 021E","E01011827","Total",1177,583,594,1177,0,9,107.22,11.0
"2011","Wakefield 021F","E01011828","Total",1427,703,724,1427,0,13,42.15,33.9
"2011","Wakefield 022A","E01011889","Total",1303,653,650,1303,0,11,191.39,6.8
"2011","Wakefield 022B","E01011892","Total",1801,876,925,1797,4,24,56.46,31.9
"2011","Wakefield 022C","E01011919","Total",1824,908,916,1824,0,4,38.14,47.8
"2011","Wakefield 022D","E01011921","Total",1468,715,753,1468,0,20,32.61,45.0
"2011","Wakefield 022E","E01011926","Total",1600,800,800,1598,2,12,23.55,67.9
"2011","Wakefield 022F","E01011927","Total",1353,634,719,1302,51,16,48.67,27.8
"2011","Wakefield 023A","E01011845","Total",1367,662,705,1367,0,29,107.20,12.8
"2011","Wakefield 023B","E01011846","Total",1362,661,701,1362,0,23,35.09,38.8
"2011","Wakefield 023C","E01011847","Total",1428,694,734,1428,0,22,42.32,33.7
"2011","Wakefield 023D","E01011848","Total",1469,695,774,1443,26,25,147.42,10.0
"2011","Wakefield 023E","E01011851","Total",1429,711,718,1429,0,15,28.83,49.6
"2011","Wakefield 024A","E01011775","Total",2867,1414,1453,2855,12,24,618.05,4.6
"2011","Wakefield 024B","E01011776","Total",1609,774,835,1546,63,11,283.56,5.7
"2011","Wakefield 024C","E01011777","Total",1352,665,687,1317,35,9,145.75,9.3
"2011","Wakefield 024D","E01011778","Total",1568,729,839,1550,18,10,49.93,31.4
"2011","Wakefield 024E","E01011817","Total",1332,649,683,1332,0,10,202.33,6.6
"2011","Wakefield 024F","E01011818","Total",1331,646,685,1331,0,10,282.38,4.7
"2011","Wakefield 025A","E01011829","Total",1426,687,739,1426,0,13,187.43,7.6
"2011","Wakefield 025B","E01011830","Total",1255,602,653,1254,1,7,37.53,33.4
"2011","Wakefield 025C","E01011831","Total",1708,851,857,1708,0,15,30.75,55.5
"2011","Wakefield 025D","E01011832","Total",1411,702,709,1393,18,20,33.20,42.5
"2011","Wakefield 025E","E01011833","Total",1507,729,778,1507,0,22,237.71,6.3
"2011","Wakefield 026A","E01011899","Total",1506,709,797,1506,0,5,56.82,26.5
"2011","Wakefield 026B","E01011900","Total",1531,736,795,1531,0,4,22.41,68.3
"2011","Wakefield 026C","E01011901","Total",1645,734,911,1645,0,4,25.23,65.2
"2011","Wakefield 026D","E01011904","Total",1427,692,735,1427,0,9,25.96,55.0
"2011","Wakefield 026E","E01011918","Total",1543,727,816,1543,0,13,79.50,19.4
"2011","Wakefield 026F","E01011922","Total",1452,695,757,1397,55,13,32.51,44.7
"2011","Wakefield 027A","E01011779","Total",1508,740,768,1508,0,6,151.17,10.0
"2011","Wakefield 027B","E01011780","Total",1832,870,962,1832,0,3,79.49,23.0
"2011","Wakefield 027C","E01011781","Total",1710,818,892,1703,7,3,182.61,9.4
"2011","Wakefield 027D","E01011782","Total",1490,717,773,1490,0,8,191.41,7.8
"2011","Wakefield 027E","E01011783","Total",1308,655,653,1303,5,6,87.89,14.9
"2011","Wakefield 028A","E01011902","Total",1390,680,710,1388,2,7,123.10,11.3
"2011","Wakefield 028B","E01011903","Total",1215,606,609,1214,1,14,70.63,17.2
"2011","Wakefield 028C","E01011905","Total",1618,786,832,1618,0,14,126.40,12.8
"2011","Wakefield 028D","E01011907","Total",1765,899,866,1764,1,18,96.07,18.4
"2011","Wakefield 029A","E01011793","Total",1621,796,825,1621,0,9,50.19,32.3
"2011","Wakefield 029B","E01011794","Total",1399,692,707,1399,0,7,107.24,13.0
"2011","Wakefield 029C","E01011795","Total",1278,618,660,1278,0,13,23.50,54.4
"2011","Wakefield 029D","E01011796","Total",1440,715,725,1440,0,15,32.72,44.0
"2011","Wakefield 029E","E01011799","Total",1590,728,862,1580,10,10,38.59,41.2
"2011","Wakefield 029F","E01011800","Total",1658,812,846,1658,0,8,84.43,19.6
"2011","Wakefield 030A","E01011898","Total",1456,743,713,1456,0,5,65.78,22.1
"2011","Wakefield 030B","E01011906","Total",1584,770,814,1584,0,5,60.98,26.0
"2011","Wakefield 030C","E01011908","Total",2215,1133,1082,2184,31,13,90.86,24.4
"2011","Wakefield 030D","E01011917","Total",1590,828,762,1590,0,3,99.12,16.0
"2011","Wakefield 030E","E01011944","Total",1389,708,681,1389,0,11,111.21,12.5
"2011","Wakefield 031A","E01011797","Total",1721,849,872,1717,4,25,73.32,23.5
"2011","Wakefield 031B","E01011798","Total",1301,611,690,1301,0,15,100.59,12.9
"2011","Wakefield 031C","E01011801","Total",1516,729,787,1514,2,9,103.17,14.7
"2011","Wakefield 031D","E01011802","Total",1508,712,796,1452,56,11,42.20,35.7
"2011","Wakefield 032A","E01011765","Total",1545,764,781,1545,0,13,74.78,20.7
"2011","Wakefield 032B","E01011766","Total",1523,750,773,1523,0,20,1032.39,1.5
"2011","Wakefield 032C","E01011773","Total",1490,740,750,1490,0,14,90.25,16.5
"2011","Wakefield 032D","E01011774","Total",1387,677,710,1387,0,9,323.24,4.3
"2011","Wakefield 033A","E01011939","Total",1483,719,764,1483,0,46,83.69,17.7
"2011","Wakefield 033B","E01011945","Total",1491,719,772,1444,47,35,87.51,17.0
"2011","Wakefield 033C","E01011947","Total",1580,772,808,1580,0,28,81.85,19.3
"2011","Wakefield 033D","E01011948","Total",1590,771,819,1590,0,43,153.75,10.3
"2011","Wakefield 034A","E01011767","Total",1768,867,901,1757,11,41,730.92,2.4
"2011","Wakefield 034B","E01011768","Total",1374,659,715,1374,0,17,46.38,29.6
"2011","Wakefield 034C","E01011769","Total",2133,1088,1045,2133,0,21,654.37,3.3
"2011","Wakefield 034D","E01011770","Total",1912,906,1006,1827,85,20,183.69,10.4
"2011","Wakefield 034E","E01011849","Total",1576,774,802,1570,6,30,1432.84,1.1
"2011","Wakefield 034F","E01011857","Total",1641,820,821,1641,0,26,1185.96,1.4
"2011","Wakefield 035A","E01011928","Total",1334,643,691,1334,0,11,50.25,26.5
"2011","Wakefield 035B","E01011931","Total",1506,741,765,1506,0,17,95.75,15.7
"2011","Wakefield 035C","E01011932","Total",1417,699,718,1417,0,17,383.00,3.7
"2011","Wakefield 035D","E01011938","Total",1706,693,1013,1391,315,18,852.05,2.0
"2011","Wakefield 036A","E01011929","Total",1601,783,818,1595,6,10,83.57,19.2
"2011","Wakefield 036B","E01011930","Total",1711,824,887,1711,0,16,99.78,17.1
"2011","Wakefield 036C","E01011933","Total",1604,784,820,1583,21,19,335.81,4.8
"2011","Wakefield 036D","E01011937","Total",1420,695,725,1420,0,22,239.58,5.9
"2011","Wakefield 037A","E01011934","Total",1459,753,706,1408,51,19,193.50,7.5
"2011","Wakefield 037B","E01011936","Total",1476,685,791,1476,0,14,123.53,11.9
"2011","Wakefield 037C","E01011940","Total",1439,728,711,1439,0,9,102.64,14.0
"2011","Wakefield 037D","E01011943","Total",1741,822,919,1741,0,15,44.50,39.1
"2011","Wakefield 038A","E01011935","Total",1798,881,917,1798,0,35,1867.99,1.0
"2011","Wakefield 038B","E01011941","Total",1449,673,776,1449,0,26,568.97,2.5
"2011","Wakefield 038C","E01011942","Total",1246,619,627,1246,0,23,1234.37,1.0
"2011","Wakefield 038D","E01011946","Total",1482,721,761,1440,42,29,99.42,14.9
"2011","Wakefield 039A","E01011785","Total",1558,755,803,1558,0,5,342.91,4.5
"2011","Wakefield 039B","E01011789","Total",1268,606,662,1183,85,4,109.66,11.6
"2011","Wakefield 039C","E01011791","Total",1503,753,750,1475,28,7,314.75,4.8
"2011","Wakefield 039D","E01011792","Total",1516,750,766,1516,0,9,204.05,7.4
"2011","Wakefield 040A","E01011771","Total",1301,604,697,1301,0,4,124.86,10.4
"2011","Wakefield 040B","E01011772","Total",1593,811,782,1566,27,11,114.19,14.0
"2011","Wakefield 040C","E01011784","Total",1817,889,928,1817,0,19,470.53,3.9
"2011","Wakefield 040D","E01011786","Total",1610,789,821,1610,0,11,460.79,3.5
"2011","Wakefield 041A","E01011854","Total",1228,619,609,1214,14,7,37.56,32.7
"2011","Wakefield 041B","E01011855","Total",1591,782,809,1591,0,23,120.71,13.2
"2011","Wakefield 041C","E01011856","Total",1425,712,713,1425,0,13,482.01,3.0
"2011","Wakefield 041D","E01011858","Total",1588,776,812,1588,0,15,690.64,2.3
"2011","Wakefield 042A","E01011787","Total",1710,856,854,1704,6,11,79.29,21.6
"2011","Wakefield 042B","E01011788","Total",1672,834,838,1672,0,12,425.20,3.9
"2011","Wakefield 042C","E01011790","Total",1629,816,813,1628,1,8,49.68,32.8
"2011","Wakefield 042D","E01011865","Total",1680,815,865,1676,4,9,114.32,14.7
"2011","Wakefield 042E","E01011867","Total",1643,769,874,1634,9,4,61.10,26.9
"2011","Wakefield 043A","E01011859","Total",1469,699,770,1461,8,9,56.73,25.9
"2011","Wakefield 043B","E01011869","Total",1435,719,716,1435,0,10,33.47,42.9
"2011","Wakefield 043C","E01011870","Total",1407,710,697,1407,0,13,55.96,25.1
"2011","Wakefield 043D","E01011871","Total",1561,782,779,1557,4,9,83.28,18.7
"2011","Wakefield 044A","E01011860","Total",1514,750,764,1514,0,11,300.53,5.0
"2011","Wakefield 044B","E01011861","Total",2017,994,1023,2017,0,16,112.98,17.9
"2011","Wakefield 044C","E01011862","Total",1480,751,729,1425,55,9,180.69,8.2
"2011","Wakefield 044D","E01011863","Total",1314,632,682,1307,7,5,28.63,45.9
"2011","Wakefield 045A","E01011864","Total",1642,804,838,1642,0,8,404.08,4.1
"2011","Wakefield 045B","E01011866","Total",1598,780,818,1567,31,12,189.84,8.4
"2011","Wakefield 045C","E01011868","Total",1912,923,989,1883,29,9,137.20,13.9
"2011","Wakefield 045D","E01011872","Total",1550,773,777,1550,0,6,40.80,38.0
"2011","Derby 001A","E01013461","Total",1635,805,830,1635,0,44,60.09,27.2
"2011","Derby 001B","E01013462","Total",1524,720,804,1524,0,20,62.23,24.5
"2011","Derby 001C","E01013463","Total",1524,753,771,1524,0,52,178.73,8.5
"2011","Derby 001D","E01013464","Total",1452,695,757,1452,0,22,33.99,42.7
"2011","Derby 002A","E01013465","Total",1661,829,832,1661,0,19,44.43,37.4
"2011","Derby 002B","E01013466","Total",1542,735,807,1542,0,33,41.42,37.2
"2011","Derby 002C","E01013467","Total",1389,671,718,1389,0,19,26.97,51.5
"2011","Derby 002D","E01013468","Total",1615,781,834,1614,1,31,164.36,9.8
"2011","Derby 002E","E01013469","Total",1280,609,671,1280,0,17,35.39,36.2
"2011","Derby 003A","E01013574","Total",1355,677,678,1355,0,30,45.98,29.5
"2011","Derby 003B","E01013575","Total",1404,695,709,1404,0,17,25.88,54.3
"2011","Derby 003C","E01013576","Total",1482,734,748,1461,21,13,28.07,52.8
"2011","Derby 003D","E01013577","Total",1583,792,791,1583,0,24,39.19,40.4
"2011","Derby 003E","E01013578","Total",1383,675,708,1383,0,24,27.71,49.9
"2011","Derby 003F","E01013579","Total",1456,733,723,1456,0,11,45.28,32.2
"2011","Derby 003G","E01013580","Total",1475,692,783,1448,27,3,25.71,57.4
"2011","Derby 004A","E01013530","Total",1530,758,772,1530,0,3,115.90,13.2
"2011","Derby 004B","E01013531","Total",1415,694,721,1415,0,5,28.50,49.6
"2011","Derby 004C","E01013532","Total",1491,717,774,1491,0,8,40.82,36.5
"2011","Derby 004D","E01013581","Total",1556,730,826,1556,0,1,22.94,67.8
"2011","Derby 005A","E01013526","Total",1610,801,809,1610,0,34,173.97,9.3
"2011","Derby 005B","E01013527","Total",1511,745,766,1474,37,41,53.96,28.0
"2011","Derby 005C","E01013528","Total",1648,780,868,1600,48,30,31.70,52.0
"2011","Derby 005D","E01013529","Total",2362,1148,1214,2285,77,23,62.54,37.8
"2011","Derby 006A","E01013505","Total",1508,740,768,1508,0,7,23.30,64.7
"2011","Derby 006B","E01013506","Total",1592,781,811,1592,0,2,58.58,27.2
"2011","Derby 006C","E01013513","Total",1292,620,672,1292,0,10,26.53,48.7
"2011","Derby 006D","E01013534","Total",1654,811,843,1654,0,6,26.59,62.2
"2011","Derby 006E","E01013582","Total",1565,739,826,1556,9,15,24.78,63.2
"2011","Derby 007A","E01013533","Total",1645,771,874,1645,0,7,24.50,67.1
"2011","Derby 007B","E01013535","Total",1615,764,851,1615,0,4,19.18,84.2
"2011","Derby 007C","E01013536","Total",1595,774,821,1571,24,11,91.82,17.4
"2011","Derby 007D","E01013537","Total",1635,812,823,1632,3,5,33.36,49.0
"2011","Derby 007E","E01013538","Total",1522,753,769,1458,64,8,132.88,11.5
"2011","Derby 008A","E01013522","Total",1736,932,804,1734,2,22,35.57,48.8
"2011","Derby 008B","E01013523","Total",1547,873,674,1541,6,15,43.43,35.6
"2011","Derby 008C","E01013524","Total",2497,1337,1160,1213,1284,41,22.61,110.4
"2011","Derby 008D","E01013525","Total",1986,1029,957,1986,0,23,91.54,21.7
"2011","Derby 009A","E01013548","Total",1511,724,787,1506,5,13,39.91,37.9
"2011","Derby 009B","E01013549","Total",1431,682,749,1431,0,2,47.78,29.9
"2011","Derby 009C","E01013552","Total",1671,764,907,1671,0,8,37.04,45.1
"2011","Derby 009D","E01013553","Total",1488,703,785,1488,0,10,33.03,45.0
"2011","Derby 009E","E01013555","Total",1532,750,782,1532,0,11,51.79,29.6
"2011","Derby 010A","E01013592","Total",1401,702,699,1401,0,7,30.90,45.3
"2011","Derby 010B","E01013594","Total",1353,672,681,1353,0,6,61.30,22.1
"2011","Derby 010C","E01013596","Total",1559,731,828,1526,33,18,89.32,17.5
"2011","Derby 010D","E01013599","Total",1388,708,680,1388,0,24,41.57,33.4
"2011","Derby 011A","E01013547","Total",1754,972,782,1725,29,5,19.47,90.1
"2011","Derby 011B","E01013550","Total",1279,626,653,1279,0,6,22.15,57.7
"2011","Derby 011C","E01013551","Total",1876,1017,859,1555,321,20,14.24,131.7
"2011","Derby 011D","E01013554","Total",1638,886,752,1630,8,4,20.62,79.4
"2011","Derby 012A","E01013507","Total",1527,757,770,1527,0,11,43.87,34.8
"2011","Derby 012B","E01013508","Total",1261,609,652,1261,0,10,36.35,34.7
"2011","Derby 012C","E01013509","Total",1673,822,851,1669,4,9,48.41,34.6
"2011","Derby 012D","E01013510","Total",1519,721,798,1509,10,6,25.33,60.0
"2011","Derby 012E","E01013511","Total",1561,795,766,1561,0,17,43.57,35.8
"2011","Derby 012F","E01013512","Total",1480,722,758,1451,29,5,82.98,17.8
"2011","Derby 013A","E01013453","Total",2358,1220,1138,2317,41,16,47.79,49.3
"2011","Derby 013B","E01013454","Total",1529,775,754,1236,293,19,21.89,69.8
"2011","Derby 013C","E01013456","Total",2042,1110,932,2042,0,8,22.47,90.9
"2011","Derby 013D","E01013457","Total",1838,889,949,1800,38,7,24.38,75.4
"2011","Derby 013E","E01013460","Total",2017,1048,969,1893,124,14,17.70,114.0
"2011","Derby 013F","E01013479","Total",2035,1192,843,1967,68,7,87.52,23.3
"2011","Derby 014A","E01013593","Total",1378,679,699,1378,0,4,34.23,40.3
"2011","Derby 014B","E01013595","Total",2320,1123,1197,2250,70,19,447.56,5.2
"2011","Derby 014C","E01013597","Total",1436,681,755,1436,0,5,33.67,42.6
"2011","Derby 014D","E01013598","Total",1542,768,774,1535,7,9,58.46,26.4
"2011","Derby 015A","E01013556","Total",1430,676,754,1430,0,21,28.11,50.9
"2011","Derby 015B","E01013557","Total",1384,670,714,1363,21,19,36.31,38.1
"2011","Derby 015C","E01013558","Total",2038,984,1054,2038,0,33,102.78,19.8
"2011","Derby 015D","E01013559","Total",1368,664,704,1368,0,24,22.83,59.9
"2011","Derby 015E","E01013564","Total",2000,973,1027,1981,19,46,101.91,19.6
"2011","Derby 016A","E01013480","Total",2050,1148,902,1961,89,8,34.08,60.2
"2011","Derby 016B","E01013483","Total",2119,1111,1008,2086,33,22,21.15,100.2
"2011","Derby 016C","E01013485","Total",2064,1035,1029,2063,1,19,12.81,161.1
"2011","Derby 016D","E01013565","Total",1719,875,844,1714,5,18,14.32,120.0
"2011","Derby 016E","E01013566","Total",2019,1078,941,2019,0,10,17.35,116.4
"2011","Derby 017A","E01013455","Total",1921,953,968,1862,59,14,63.71,30.2
"2011","Derby 017B","E01013458","Total",1633,802,831,1517,116,32,44.23,36.9
"2011","Derby 017C","E01013542","Total",1732,840,892,1683,49,24,108.05,16.0
"2011","Derby 017D","E01013546","Total",1679,827,852,1673,6,34,38.23,43.9
"2011","Derby 018A","E01013481","Total",1885,958,927,1885,0,9,23.72,79.5
"2011","Derby 018C","E01013484","Total",1956,1029,927,1956,0,6,19.90,98.3
"2011","Derby 018D","E01013486","Total",2004,1021,983,1962,42,12,24.58,81.5
"2011","Derby 018E","E01013487","Total",2254,1137,1117,2254,0,13,29.02,77.7
"2011","Derby 018F","E01033166","Total",1087,626,461,971,116,1,53.14,20.5
"2011","Derby 018G","E01033167","Total",1136,618,518,1136,0,3,34.89,32.6
"2011","Derby 019A","E01013540","Total",1558,752,806,1558,0,28,66.27,23.5
"2011","Derby 019B","E01013560","Total",1509,749,760,1509,0,36,42.16,35.8
"2011","Derby 019C","E01013561","Total",1554,764,790,1533,21,13,38.55,40.3
"2011","Derby 019D","E01013562","Total",1381,571,810,1327,54,16,40.30,34.3
"2011","Derby 019E","E01013563","Total",1358,672,686,1358,0,17,26.42,51.4
"2011","Derby 020A","E01013459","Total",1996,981,1015,1966,30,28,18.01,110.8
"2011","Derby 020B","E01013567","Total",2022,1030,992,2018,4,5,13.53,149.4
"2011","Derby 020C","E01013568","Total",2065,1050,1015,2065,0,11,29.35,70.4
"2011","Derby 020D","E01013569","Total",1581,804,777,1581,0,19,22.54,70.1
"2011","Derby 021A","E01013539","Total",2476,1238,1238,2476,0,82,43.23,57.3
"2011","Derby 021B","E01013541","Total",1625,759,866,1625,0,26,72.46,22.4
"2011","Derby 021C","E01013543","Total",1816,891,925,1785,31,46,56.83,32.0
"2011","Derby 021D","E01013544","Total",1844,922,922,1844,0,47,108.65,17.0
"2011","Derby 021E","E01013545","Total",1645,804,841,1627,18,26,53.89,30.5
"2011","Derby 022A","E01013488","Total",1563,772,791,1563,0,22,41.86,37.3
"2011","Derby 022B","E01013489","Total",1565,752,813,1527,38,24,38.64,40.5
"2011","Derby 022C","E01013490","Total",1521,695,826,1521,0,23,56.16,27.1
"2011","Derby 022D","E01013491","Total",1668,806,862,1637,31,23,32.03,52.1
"2011","Derby 023A","E01013570","Total",1964,966,998,1964,0,15,22.18,88.5
"2011","Derby 023B","E01013571","Total",1904,915,989,1782,122,4,41.65,45.7
"2011","Derby 023C","E01013572","Total",1724,815,909,1650,74,6,29.02,59.4
"2011","Derby 023D","E01013573","Total",2073,1025,1048,2073,0,15,36.36,57.0
"2011","Derby 024A","E01013470","Total",1470,731,739,1446,24,6,95.51,15.4
"2011","Derby 024B","E01013474","Total",1535,764,771,1495,40,15,30.48,50.4
"2011","Derby 024C","E01013476","Total",1447,719,728,1447,0,17,72.76,19.9
"2011","Derby 024E","E01033171","Total",1399,701,698,1399,0,3,117.18,11.9
"2011","Derby 024F","E01033172","Total",1557,827,730,1454,103,8,197.22,7.9
"2011","Derby 025A","E01013471","Total",1858,898,960,1858,0,14,21.74,85.5
"2011","Derby 025B","E01013473","Total",1516,733,783,1512,4,8,26.83,56.5
"2011","Derby 025C","E01013475","Total",1587,773,814,1587,0,14,21.43,74.1
"2011","Derby 025D","E01013477","Total",1793,922,871,1783,10,8,39.76,45.1
"2011","Derby 025E","E01013502","Total",1429,704,725,1429,0,12,30.12,47.4
"2011","Derby 025F","E01013503","Total",1525,779,746,1525,0,8,32.05,47.6
"2011","Derby 026A","E01013472","Total",2093,1006,1087,2093,0,3,80.26,26.1
"2011","Derby 026B","E01013497","Total",1533,722,811,1533,0,8,29.59,51.8
"2011","Derby 026C","E01013504","Total",1912,943,969,1908,4,6,33.85,56.5
"2011","Derby 026D","E01013583","Total",1663,803,860,1622,41,6,75.83,21.9
"2011","Derby 026E","E01013590","Total",1774,848,926,1774,0,14,45.82,38.7
"2011","Derby 026F","E01013591","Total",2035,997,1038,2035,0,7,25.43,80.0
"2011","Derby 027A","E01013492","Total",1595,764,831,1565,30,27,45.00,35.4
"2011","Derby 027B","E01013493","Total",1517,715,802,1517,0,21,23.41,64.8
"2011","Derby 027C","E01013494","Total",1860,873,987,1860,0,13,70.22,26.5
"2011","Derby 027D","E01013495","Total",1766,857,909,1766,0,15,28.60,61.7
"2011","Derby 028A","E01013496","Total",1545,710,835,1545,0,7,23.87,64.7
"2011","Derby 028B","E01013498","Total",1456,720,736,1439,17,5,49.36,29.5
"2011","Derby 028C","E01013499","Total",1384,668,716,1384,0,7,61.83,22.4
"2011","Derby 028D","E01013500","Total",1690,813,877,1690,0,9,29.61,57.1
"2011","Derby 028E","E01013501","Total",1400,675,725,1366,34,9,29.64,47.2
"2011","Derby 029A","E01013584","Total",1870,929,941,1870,0,14,186.26,10.0
"2011","Derby 029B","E01013585","Total",1751,832,919,1751,0,11,67.86,25.8
"2011","Derby 029C","E01013586","Total",1552,719,833,1514,38,14,20.72,74.9
"2011","Derby 029D","E01013587","Total",1528,762,766,1528,0,9,20.78,73.5
"2011","Derby 029E","E01013588","Total",1532,734,798,1532,0,10,214.09,7.2
"2011","Derby 029F","E01013589","Total",1423,722,701,1423,0,15,30.27,47.0
"2011","Derby 030B","E01013517","Total",1426,676,750,1389,37,9,50.38,28.3
"2011","Derby 030C","E01013518","Total",1416,687,729,1355,61,16,34.09,41.5
"2011","Derby 030D","E01013521","Total",1346,668,678,1346,0,14,25.87,52.0
"2011","Derby 030E","E01033168","Total",1350,671,679,1331,19,17,27.28,49.5
"2011","Derby 030F","E01033169","Total",1774,876,898,1774,0,15,111.21,16.0
"2011","Derby 030G","E01033170","Total",1232,596,636,1232,0,12,30.76,40.1
"2011","Derby 031A","E01013514","Total",1632,781,851,1632,0,34,37.30,43.8
"2011","Derby 031B","E01013515","Total",1842,883,959,1839,3,36,68.63,26.8
"2011","Derby 031C","E01013519","Total",1648,779,869,1648,0,9,68.90,23.9
"2011","Derby 031D","E01013520","Total",1532,755,777,1532,0,26,54.37,28.2
"2011","Leicester 001A","E01013615","Total",1526,764,762,1526,0,31,293.39,5.2
"2011","Leicester 001B","E01013616","Total",1597,751,846,1564,33,13,81.68,19.6
"2011","Leicester 001C","E01013618","Total",1564,785,779,1564,0,21,51.65,30.3
"2011","Leicester 001D","E01013619","Total",1744,881,863,1744,0,12,71.18,24.5
"2011","Leicester 002A","E01013733","Total",1625,820,805,1606,19,6,158.09,10.3
"2011","Leicester 002B","E01013734","Total",1484,743,741,1484,0,26,129.42,11.5
"2011","Leicester 002C","E01013735","Total",1328,652,676,1328,0,33,17.55,75.7
"2011","Leicester 002D","E01013736","Total",1708,821,887,1708,0,19,43.52,39.2
"2011","Leicester 002E","E01013737","Total",1437,703,734,1437,0,21,20.37,70.5
"2011","Leicester 003A","E01013600","Total",1921,902,1019,1921,0,6,52.63,36.5
"2011","Leicester 003B","E01013601","Total",1684,825,859,1684,0,7,33.22,50.7
"2011","Leicester 003C","E01013602","Total",1846,926,920,1774,72,4,90.41,20.4
"2011","Leicester 003D","E01013603","Total",1721,818,903,1712,9,11,45.68,37.7
"2011","Leicester 003E","E01013604","Total",1663,801,862,1629,34,6,31.18,53.3
"2011","Leicester 003F","E01013605","Total",1774,873,901,1774,0,7,54.08,32.8
"2011","Leicester 004A","E01013617","Total",2548,1280,1268,2504,44,26,180.14,14.1
"2011","Leicester 004B","E01013620","Total",1812,854,958,1812,0,13,29.04,62.4
"2011","Leicester 004C","E01013621","Total",1891,958,933,1891,0,10,47.85,39.5
"2011","Leicester 004D","E01013622","Total",1635,860,775,1617,18,15,18.75,87.2
"2011","Leicester 004E","E01013623","Total",2163,1087,1076,2160,3,27,115.66,18.7
"2011","Leicester 005A","E01013732","Total",2107,1029,1078,2107,0,8,30.88,68.2
"2011","Leicester 005B","E01013739","Total",1537,735,802,1460,77,22,26.62,57.7
"2011","Leicester 005C","E01013740","Total",1513,754,759,1513,0,26,34.80,43.5
"2011","Leicester 005D","E01013741","Total",1675,836,839,1675,0,27,32.76,51.1
"2011","Leicester 006A","E01013625","Total",1864,970,894,1790,74,18,16.49,113.0
"2011","Leicester 006B","E01013628","Total",1534,696,838,1479,55,16,31.04,49.4
"2011","Leicester 006C","E01013715","Total",1314,630,684,1314,0,25,9.18,143.1
"2011","Leicester 006D","E01013716","Total",1812,884,928,1812,0,24,26.04,69.6
"2011","Leicester 006E","E01013738","Total",1548,750,798,1548,0,25,51.17,30.3
"2011","Leicester 007A","E01013624","Total",1464,721,743,1464,0,11,25.02,58.5
"2011","Leicester 007B","E01013626","Total",1855,935,920,1844,11,24,9.31,199.2
"2011","Leicester 007C","E01013627","Total",1301,650,651,1301,0,23,14.55,89.4
"2011","Leicester 007D","E01013629","Total",1715,837,878,1715,0,21,26.35,65.1
"2011","Leicester 007E","E01013630","Total",1825,880,945,1825,0,35,10.27,177.7
"2011","Leicester 008A","E01013606","Total",1744,875,869,1744,0,18,31.72,55.0
"2011","Leicester 008B","E01013607","Total",2573,1344,1229,2573,0,32,184.83,13.9
"2011","Leicester 008C","E01013680","Total",2088,1038,1050,2088,0,15,41.26,50.6
"2011","Leicester 008D","E01013685","Total",1476,719,757,1476,0,9,25.42,58.1
"2011","Leicester 008E","E01013686","Total",1850,913,937,1850,0,20,32.61,56.7
"2011","Leicester 009A","E01013696","Total",2442,1181,1261,2442,0,30,51.89,47.1
"2011","Leicester 009B","E01013697","Total",2639,1334,1305,2544,95,25,181.39,14.5
"2011","Leicester 009C","E01013699","Total",1709,830,879,1709,0,20,44.75,38.2
"2011","Leicester 009E","E01032862","Total",2010,973,1037,2010,0,12,24.91,80.7
"2011","Leicester 009F","E01032863","Total",1708,853,855,1708,0,24,41.99,40.7
"2011","Leicester 009G","E01032865","Total",2120,1036,1084,2120,0,31,25.90,81.9
"2011","Leicester 010A","E01013713","Total",1543,788,755,1543,0,16,10.76,143.4
"2011","Leicester 010B","E01013714","Total",1724,835,889,1724,0,24,14.85,116.1
"2011","Leicester 010C","E01013717","Total",1569,774,795,1569,0,22,23.78,66.0
"2011","Leicester 010D","E01013718","Total",1587,742,845,1587,0,21,9.67,164.1
"2011","Leicester 010E","E01013719","Total",1562,784,778,1562,0,23,7.32,213.4
"2011","Leicester 010F","E01013720","Total",1346,589,757,1334,12,23,50.88,26.5
"2011","Leicester 011A","E01013651","Total",1716,868,848,1716,0,5,22.51,76.2
"2011","Leicester 011B","E01013652","Total",1791,867,924,1791,0,21,20.38,87.9
"2011","Leicester 011C","E01013653","Total",1899,912,987,1899,0,6,37.87,50.1
"2011","Leicester 011D","E01013655","Total",2039,1078,961,2003,36,8,31.55,64.6
"2011","Leicester 012A","E01013721","Total",1598,747,851,1563,35,18,49.80,32.1
"2011","Leicester 012B","E01013723","Total",1382,652,730,1379,3,8,20.35,67.9
"2011","Leicester 012C","E01013725","Total",1400,662,738,1400,0,4,30.51,45.9
"2011","Leicester 012D","E01013726","Total",1727,792,935,1708,19,13,62.69,27.5
"2011","Leicester 012E","E01013728","Total",1616,765,851,1616,0,6,20.17,80.1
"2011","Leicester 013A","E01013694","Total",1647,772,875,1647,0,4,33.41,49.3
"2011","Leicester 013B","E01013700","Total",1517,729,788,1485,32,22,29.48,51.5
"2011","Leicester 013C","E01013770","Total",1390,671,719,1376,14,4,26.39,52.7
"2011","Leicester 013D","E01013771","Total",1604,771,833,1588,16,26,27.17,59.0
"2011","Leicester 013E","E01013773","Total",1480,742,738,1480,0,9,28.66,51.6
"2011","Leicester 016A","E01013681","Total",1813,902,911,1813,0,12,22.69,79.9
"2011","Leicester 016B","E01013682","Total",1787,881,906,1787,0,2,13.83,129.2
"2011","Leicester 016C","E01013683","Total",2097,1096,1001,2078,19,10,15.49,135.4
"2011","Leicester 016D","E01013684","Total",1961,1017,944,1950,11,10,26.64,73.6
"2011","Leicester 017A","E01013654","Total",2199,1063,1136,2168,31,9,23.63,93.1
"2011","Leicester 017B","E01013656","Total",1828,916,912,1828,0,4,8.28,220.8
"2011","Leicester 017C","E01013657","Total",1819,899,920,1800,19,3,12.77,142.4
"2011","Leicester 017D","E01013658","Total",1870,993,877,1870,0,23,13.40,139.6
"2011","Leicester 017E","E01013659","Total",2008,1020,988,2001,7,11,10.32,194.6
"2011","Leicester 017F","E01013743","Total",1645,826,819,1620,25,18,5.83,282.2
"2011","Leicester 017G","E01013745","Total",1680,852,828,1674,6,12,22.98,73.1
"2011","Leicester 018A","E01013742","Total",1822,901,921,1822,0,3,6.93,262.9
"2011","Leicester 018B","E01013744","Total",1983,1012,971,1983,0,13,5.87,337.8
"2011","Leicester 018C","E01013746","Total",1857,988,869,1857,0,8,39.88,46.6
"2011","Leicester 018D","E01013748","Total",2017,1018,999,1991,26,12,10.41,193.8
"2011","Leicester 018E","E01013754","Total",2059,1016,1043,2058,1,11,20.41,100.9
"2011","Leicester 018F","E01013755","Total",2216,1051,1165,2216,0,16,12.91,171.6
"2011","Leicester 019A","E01013660","Total",1814,932,882,1814,0,16,31.40,57.8
"2011","Leicester 019B","E01013661","Total",1716,823,893,1635,81,13,24.48,70.1
"2011","Leicester 019C","E01013664","Total",1834,891,943,1830,4,18,24.67,74.3
"2011","Leicester 019D","E01013665","Total",1837,962,875,1835,2,14,30.74,59.8
"2011","Leicester 019E","E01013667","Total",1568,751,817,1568,0,11,36.80,42.6
"2011","Leicester 019F","E01013668","Total",1581,750,831,1548,33,14,74.43,21.2
"2011","Leicester 020A","E01013729","Total",1296,646,650,1296,0,2,91.56,14.2
"2011","Leicester 020B","E01013780","Total",1497,738,759,1497,0,37,30.24,49.5
"2011","Leicester 020C","E01013783","Total",1554,750,804,1554,0,29,25.53,60.9
"2011","Leicester 020D","E01013785","Total",1520,741,779,1436,84,30,100.42,15.1
"2011","Leicester 020E","E01013786","Total",1518,754,764,1518,0,11,28.64,53.0
"2011","Leicester 021A","E01013662","Total",1792,936,856,1792,0,12,28.26,63.4
"2011","Leicester 021B","E01013663","Total",1798,885,913,1798,0,24,22.60,79.6
"2011","Leicester 021C","E01013747","Total",1905,977,928,1891,14,25,37.62,50.6
"2011","Leicester 021D","E01013749","Total",1616,807,809,1616,0,20,25.35,63.7
"2011","Leicester 021E","E01013750","Total",1522,792,730,1522,0,25,9.91,153.6
"2011","Leicester 021F","E01013758","Total",1641,832,809,1641,0,20,14.86,110.4
"2011","Leicester 022A","E01013751","Total",1962,1006,956,1884,78,19,9.01,217.8
"2011","Leicester 022B","E01013752","Total",1570,809,761,1570,0,12,8.08,194.3
"2011","Leicester 022C","E01013753","Total",1717,882,835,1717,0,27,7.12,241.2
"2011","Leicester 022D","E01013760","Total",1963,1116,847,1888,75,13,11.41,172.0
"2011","Leicester 022E","E01013761","Total",2100,1065,1035,2094,6,18,7.34,286.1
"2011","Leicester 022F","E01013762","Total",1887,966,921,1873,14,28,9.87,191.2
"2011","Leicester 023A","E01013774","Total",1749,909,840,1749,0,22,12.27,142.5
"2011","Leicester 023B","E01013776","Total",1711,970,741,1670,41,13,14.54,117.7
"2011","Leicester 023C","E01013778","Total",2502,1204,1298,1998,504,24,37.79,66.2
"2011","Leicester 023D","E01013779","Total",1950,980,970,1928,22,28,13.29,146.7
"2011","Leicester 023E","E01013781","Total",1637,859,778,1555,82,13,13.28,123.3
"2011","Leicester 023F","E01013782","Total",1516,704,812,1456,60,13,21.50,70.5
"2011","Leicester 023G","E01013784","Total",1367,728,639,1342,25,20,13.39,102.1
"2011","Leicester 025A","E01013666","Total",1588,766,822,1588,0,34,40.26,39.4
"2011","Leicester 025B","E01013669","Total",1429,696,733,1429,0,31,45.84,31.2
"2011","Leicester 025C","E01013670","Total",1792,865,927,1757,35,36,137.28,13.1
"2011","Leicester 025D","E01013671","Total",1804,872,932,1751,53,38,34.97,51.6
"2011","Leicester 025E","E01013672","Total",1371,677,694,1371,0,29,59.30,23.1
"2011","Leicester 026A","E01013631","Total",1548,749,799,1548,0,4,87.11,17.8
"2011","Leicester 026B","E01013632","Total",1871,912,959,1871,0,15,34.61,54.1
"2011","Leicester 026C","E01013638","Total",1729,805,924,1729,0,22,53.80,32.1
"2011","Leicester 026D","E01013640","Total",1950,932,1018,1950,0,13,31.77,61.4
"2011","Leicester 027A","E01013756","Total",1935,976,959,1919,16,26,25.75,75.1
"2011","Leicester 027B","E01013757","Total",1664,818,846,1643,21,21,25.77,64.6
"2011","Leicester 027C","E01013759","Total",1965,955,1010,1956,9,30,23.37,84.1
"2011","Leicester 027D","E01013763","Total",2053,1095,958,2028,25,68,12.90,159.1
"2011","Leicester 027E","E01013764","Total",1636,799,837,1636,0,29,21.26,77.0
"2011","Leicester 027F","E01013765","Total",1698,929,769,1673,25,14,8.28,205.1
"2011","Leicester 027G","E01013766","Total",1848,923,925,1848,0,23,23.49,78.7
"2011","Leicester 028A","E01013633","Total",1650,786,864,1650,0,5,36.28,45.5
"2011","Leicester 028B","E01013634","Total",1533,714,819,1533,0,4,28.15,54.5
"2011","Leicester 028C","E01013637","Total",1968,955,1013,1821,147,5,36.73,53.6
"2011","Leicester 028D","E01013639","Total",1464,666,798,1464,0,13,27.88,52.5
"2011","Leicester 028E","E01013641","Total",1609,813,796,1609,0,10,19.45,82.7
"2011","Leicester 029A","E01013635","Total",1491,734,757,1487,4,12,36.81,40.5
"2011","Leicester 029B","E01013636","Total",1360,669,691,1354,6,18,45.88,29.6
"2011","Leicester 029C","E01013775","Total",2155,1119,1036,2155,0,20,50.26,42.9
"2011","Leicester 029D","E01013777","Total",1577,862,715,1575,2,7,16.15,97.6
"2011","Leicester 030A","E01013642","Total",1821,877,944,1791,30,17,22.72,80.1
"2011","Leicester 030B","E01013643","Total",1844,906,938,1844,0,32,16.30,113.1
"2011","Leicester 030C","E01013649","Total",1541,784,757,1301,240,6,121.83,12.6
"2011","Leicester 030D","E01013650","Total",1808,883,925,1808,0,19,11.40,158.6
"2011","Leicester 030E","E01013702","Total",1573,790,783,1573,0,26,31.98,49.2
"2011","Leicester 030F","E01013710","Total",1409,727,682,1389,20,19,22.03,64.0
"2011","Leicester 030G","E01013711","Total",1625,797,828,1428,197,18,32.72,49.7
"2011","Leicester 031A","E01013613","Total",1646,810,836,1619,27,9,25.34,65.0
"2011","Leicester 031B","E01013614","Total",1561,755,806,1552,9,11,25.46,61.3
"2011","Leicester 031C","E01013687","Total",1573,804,769,1529,44,11,51.03,30.8
"2011","Leicester 031D","E01013688","Total",1450,715,735,1450,0,8,52.73,27.5
"2011","Leicester 032A","E01013703","Total",1290,635,655,1285,5,35,38.66,33.4
"2011","Leicester 032B","E01013704","Total",1436,664,772,1362,74,35,32.21,44.6
"2011","Leicester 032C","E01013706","Total",1628,785,843,1628,0,44,64.49,25.2
"2011","Leicester 032D","E01013707","Total",1598,763,835,1598,0,36,41.99,38.1
"2011","Leicester 032E","E01013712","Total",1512,728,784,1263,249,54,33.69,44.9
"2011","Leicester 034A","E01013608","Total",1547,788,759,1547,0,9,33.05,46.8
"2011","Leicester 034B","E01013609","Total",1575,774,801,1560,15,11,113.57,13.9
"2011","Leicester 034C","E01013610","Total",1699,830,869,1662,37,19,33.90,50.1
"2011","Leicester 034D","E01013611","Total",1581,788,793,1482,99,14,54.92,28.8
"2011","Leicester 034E","E01013612","Total",1542,757,785,1486,56,20,95.15,16.2
"2011","Leicester 035A","E01013678","Total",1644,800,844,1626,18,10,71.98,22.8
"2011","Leicester 035B","E01013679","Total",1559,757,802,1559,0,4,23.08,67.5
"2011","Leicester 035C","E01013691","Total",1659,751,908,1659,0,6,25.07,66.2
"2011","Leicester 035D","E01013692","Total",1413,646,767,1413,0,8,24.55,57.6
"2011","Leicester 035E","E01013693","Total",1477,692,785,1477,0,3,18.32,80.6
"2011","Leicester 036A","E01013673","Total",1557,745,812,1517,40,6,24.78,62.8
"2011","Leicester 036B","E01013674","Total",1621,728,893,1621,0,9,31.22,51.9
"2011","Leicester 036C","E01013675","Total",1634,773,861,1634,0,6,24.45,66.8
"2011","Leicester 036D","E01013676","Total",1971,907,1064,1971,0,6,25.87,76.2
"2011","Leicester 036E","E01013677","Total",1534,748,786,1523,11,3,29.98,51.2
"2011","Leicester 037A","E01013695","Total",1525,694,831,1525,0,2,55.53,27.5
"2011","Leicester 037B","E01013698","Total",1537,748,789,1537,0,15,34.41,44.7
"2011","Leicester 037C","E01013767","Total",1537,735,802,1537,0,3,52.35,29.4
"2011","Leicester 037D","E01013768","Total",1544,752,792,1471,73,9,29.92,51.6
"2011","Leicester 037E","E01013772","Total",1601,784,817,1601,0,4,18.99,84.3
"2011","Leicester 037F","E01032597","Total",1440,680,760,1440,0,8,19.40,74.2
"2011","Leicester 038A","E01013689","Total",1837,869,968,1246,591,35,33.75,54.4
"2011","Leicester 038B","E01013690","Total",1540,769,771,1540,0,21,64.07,24.0
"2011","Leicester 038C","E01013705","Total",1579,766,813,1566,13,28,50.90,31.0
"2011","Leicester 038D","E01013709","Total",1576,779,797,1576,0,16,25.03,63.0
"2011","Leicester 038E","E01032599","Total",1579,772,807,1579,0,22,41.31,38.2
"2011","Leicester 039A","E01013722","Total",1753,828,925,1714,39,7,31.04,56.5
"2011","Leicester 039B","E01013727","Total",1491,722,769,1491,0,6,25.41,58.7
"2011","Leicester 039C","E01013730","Total",1574,769,805,1569,5,4,23.57,66.8
"2011","Leicester 039D","E01013731","Total",1619,764,855,1600,19,10,98.25,16.5
"2011","Leicester 039E","E01032602","Total",1672,814,858,1672,0,8,25.14,66.5
"2011","Leicester 040A","E01013646","Total",2760,1445,1315,2108,652,33,47.12,58.6
"2011","Leicester 040B","E01013647","Total",2504,1210,1294,1658,846,51,24.49,102.2
"2011","Leicester 040C","E01013648","Total",2688,1279,1409,2095,593,38,29.26,91.9
"2011","Leicester 040D","E01032875","Total",1903,835,1068,1034,869,34,15.37,123.8
"2011","Leicester 041A","E01032867","Total",1800,990,810,1350,450,19,70.30,25.6
"2011","Leicester 041B","E01032868","Total",1692,747,945,1029,663,24,21.66,78.1
"2011","Leicester 041C","E01032872","Total",1206,686,520,1206,0,2,12.30,98.0
"2011","Leicester 041D","E01032873","Total",1334,790,544,1330,4,6,20.58,64.8
"2011","Nottingham 001A","E01013887","Total",1534,762,772,1534,0,23,30.11,50.9
"2011","Nottingham 001B","E01013892","Total",1414,682,732,1414,0,12,28.75,49.2
"2011","Nottingham 001C","E01013893","Total",1349,627,722,1349,0,7,55.36,24.4
"2011","Nottingham 001D","E01013894","Total",1476,707,769,1474,2,14,43.20,34.2
"2011","Nottingham 002A","E01013879","Total",1293,588,705,1293,0,2,36.95,35.0
"2011","Nottingham 002B","E01013880","Total",1533,701,832,1490,43,5,130.06,11.8
"2011","Nottingham 002C","E01013881","Total",1505,689,816,1477,28,5,39.79,37.8
"2011","Nottingham 002D","E01013882","Total",1432,662,770,1377,55,5,46.33,30.9
"2011","Nottingham 002E","E01013885","Total",1662,803,859,1662,0,3,39.09,42.5
"2011","Nottingham 004A","E01013886","Total",1450,714,736,1450,0,12,53.49,27.1
"2011","Nottingham 004B","E01013888","Total",1507,745,762,1491,16,5,25.91,58.2
"2011","Nottingham 004C","E01013889","Total",1653,807,846,1646,7,14,45.37,36.4
"2011","Nottingham 004D","E01013890","Total",1546,750,796,1546,0,15,15.00,103.1
"2011","Nottingham 004E","E01013891","Total",1685,825,860,1634,51,13,34.17,49.3
"2011","Nottingham 005A","E01013875","Total",1371,709,662,1371,0,9,18.22,75.2
"2011","Nottingham 005B","E01013876","Total",1797,871,926,1726,71,3,74.29,24.2
"2011","Nottingham 005C","E01013877","Total",1394,632,762,1394,0,2,30.74,45.3
"2011","Nottingham 005D","E01013878","Total",1296,634,662,1296,0,8,41.07,31.6
"2011","Nottingham 005E","E01013883","Total",1524,712,812,1507,17,3,52.36,29.1
"2011","Nottingham 005F","E01013884","Total",1350,668,682,1350,0,3,27.56,49.0
"2011","Nottingham 006A","E01013853","Total",1475,726,749,1435,40,4,36.54,40.4
"2011","Nottingham 006B","E01013854","Total",1429,673,756,1429,0,3,31.21,45.8
"2011","Nottingham 006C","E01013855","Total",1602,754,848,1602,0,3,21.52,74.4
"2011","Nottingham 006D","E01013856","Total",1616,742,874,1597,19,7,30.39,53.2
"2011","Nottingham 006F","E01033397","Total",1770,856,914,1770,0,5,24.80,71.4
"2011","Nottingham 006G","E01033398","Total",1150,613,537,1150,0,3,16.31,70.5
"2011","Nottingham 007A","E01013963","Total",1569,736,833,1569,0,18,27.48,57.1
"2011","Nottingham 007B","E01013964","Total",1679,817,862,1679,0,30,40.79,41.2
"2011","Nottingham 007C","E01013965","Total",1483,673,810,1483,0,15,26.74,55.5
"2011","Nottingham 007D","E01013966","Total",1416,634,782,1416,0,12,24.04,58.9
"2011","Nottingham 007E","E01013967","Total",1811,1150,661,1141,670,17,66.94,27.1
"2011","Nottingham 008A","E01013827","Total",1481,709,772,1481,0,1,36.28,40.8
"2011","Nottingham 008B","E01013828","Total",1646,821,825,1640,6,8,31.03,53.0
"2011","Nottingham 008C","E01013834","Total",1600,728,872,1600,0,11,22.06,72.5
"2011","Nottingham 008D","E01013835","Total",1647,795,852,1593,54,10,27.13,60.7
"2011","Nottingham 008E","E01013836","Total",1876,915,961,1876,0,11,35.32,53.1
"2011","Nottingham 009A","E01013829","Total",1625,789,836,1625,0,10,38.41,42.3
"2011","Nottingham 009B","E01013830","Total",1669,819,850,1669,0,8,44.11,37.8
"2011","Nottingham 009C","E01013831","Total",1553,757,796,1553,0,19,37.67,41.2
"2011","Nottingham 009D","E01013832","Total",1769,879,890,1572,197,12,44.67,39.6
"2011","Nottingham 009E","E01013833","Total",1341,659,682,1341,0,12,61.65,21.8
"2011","Nottingham 010A","E01013935","Total",1526,767,759,1493,33,13,38.52,39.6
"2011","Nottingham 010B","E01013968","Total",1304,619,685,1249,55,19,53.00,24.6
"2011","Nottingham 010C","E01013969","Total",1610,820,790,1598,12,14,23.40,68.8
"2011","Nottingham 010D","E01013970","Total",1554,759,795,1554,0,22,15.52,100.1
"2011","Nottingham 010E","E01013971","Total",1533,830,703,1476,57,6,20.02,76.6
"2011","Nottingham 011A","E01013817","Total",1707,818,889,1707,0,4,21.69,78.7
"2011","Nottingham 011B","E01013818","Total",1774,805,969,1774,0,2,36.82,48.2
"2011","Nottingham 011C","E01013822","Total",1705,778,927,1705,0,4,22.21,76.8
"2011","Nottingham 011D","E01013825","Total",1850,888,962,1850,0,14,35.34,52.3
"2011","Nottingham 011E","E01013826","Total",1947,876,1071,1947,0,10,47.07,41.4
"2011","Nottingham 012A","E01013837","Total",1772,886,886,1772,0,17,34.72,51.0
"2011","Nottingham 012B","E01013838","Total",1800,888,912,1587,213,20,29.32,61.4
"2011","Nottingham 012C","E01013839","Total",1757,841,916,1747,10,7,21.15,83.1
"2011","Nottingham 012D","E01013840","Total",2195,1118,1077,2195,0,18,37.73,58.2
"2011","Nottingham 012E","E01013841","Total",1583,809,774,1580,3,4,23.39,67.7
"2011","Nottingham 013A","E01013819","Total",1720,810,910,1720,0,2,23.91,71.9
"2011","Nottingham 013B","E01013820","Total",1781,848,933,1781,0,10,26.41,67.4
"2011","Nottingham 013C","E01013821","Total",1679,784,895,1679,0,14,21.67,77.5
"2011","Nottingham 013D","E01013823","Total",1853,905,948,1853,0,12,26.66,69.5
"2011","Nottingham 013E","E01013824","Total",1606,763,843,1606,0,13,20.09,79.9
"2011","Nottingham 014A","E01013864","Total",1530,718,812,1524,6,12,92.74,16.5
"2011","Nottingham 014B","E01013865","Total",1552,733,819,1552,0,5,27.71,56.0
"2011","Nottingham 014C","E01013866","Total",1499,726,773,1482,17,10,37.39,40.1
"2011","Nottingham 014D","E01013867","Total",1594,746,848,1581,13,4,39.03,40.8
"2011","Nottingham 015A","E01013937","Total",1740,895,845,1690,50,33,44.73,38.9
"2011","Nottingham 015B","E01013938","Total",1548,789,759,1533,15,30,38.10,40.6
"2011","Nottingham 015C","E01013941","Total",1638,823,815,1473,165,24,33.62,48.7
"2011","Nottingham 015D","E01013943","Total",1820,992,828,1561,259,33,62.89,28.9
"2011","Nottingham 015E","E01013972","Total",1455,725,730,1424,31,11,21.09,69.0
"2011","Nottingham 016A","E01013936","Total",2165,1060,1105,2150,15,26,61.82,35.0
"2011","Nottingham 016B","E01013939","Total",1535,787,748,1524,11,17,30.61,50.1
"2011","Nottingham 016C","E01013940","Total",1761,904,857,1726,35,20,25.86,68.1
"2011","Nottingham 016D","E01013942","Total",2113,1055,1058,2083,30,10,25.02,84.5
"2011","Nottingham 017A","E01013843","Total",1597,862,735,1419,178,10,29.69,53.8
"2011","Nottingham 017B","E01013844","Total",1473,827,646,1473,0,4,11.30,130.4
"2011","Nottingham 017C","E01013845","Total",1688,876,812,1688,0,9,9.85,171.4
"2011","Nottingham 017D","E01013847","Total",1373,741,632,1373,0,15,12.21,112.4
"2011","Nottingham 018A","E01013810","Total",1657,837,820,1657,0,9,13.45,123.2
"2011","Nottingham 018B","E01013811","Total",1455,830,625,1455,0,12,12.80,113.7
"2011","Nottingham 018C","E01013812","Total",1624,849,775,1618,6,10,12.09,134.3
"2011","Nottingham 018D","E01013842","Total",1675,887,788,1673,2,8,22.54,74.3
"2011","Nottingham 018E","E01013846","Total",1738,882,856,1723,15,6,13.65,127.3
"2011","Nottingham 019A","E01013930","Total",1980,1021,959,1980,0,18,40.16,49.3
"2011","Nottingham 019B","E01013931","Total",1690,804,886,1690,0,22,79.42,21.3
"2011","Nottingham 019C","E01013932","Total",1744,868,876,1744,0,13,45.00,38.8
"2011","Nottingham 019D","E01013933","Total",1840,934,906,1840,0,4,35.13,52.4
"2011","Nottingham 019E","E01013934","Total",1531,770,761,1531,0,13,34.95,43.8
"2011","Nottingham 020A","E01013859","Total",1454,697,757,1454,0,9,34.01,42.8
"2011","Nottingham 020B","E01013861","Total",1520,711,809,1520,0,8,75.90,20.0
"2011","Nottingham 020C","E01013868","Total",1572,736,836,1530,42,8,33.53,46.9
"2011","Nottingham 020D","E01013929","Total",1917,914,1003,1812,105,26,69.62,27.5
"2011","Nottingham 021A","E01013954","Total",1339,660,679,1339,0,7,39.52,33.9
"2011","Nottingham 021B","E01013959","Total",1834,928,906,1834,0,4,19.70,93.1
"2011","Nottingham 021C","E01013960","Total",1569,785,784,1569,0,2,25.71,61.0
"2011","Nottingham 021D","E01013962","Total",1812,884,928,1808,4,4,26.59,68.1
"2011","Nottingham 022A","E01013813","Total",2199,1168,1031,1505,694,36,20.66,106.4
"2011","Nottingham 022B","E01013814","Total",2024,1129,895,1828,196,10,18.26,110.8
"2011","Nottingham 022C","E01013815","Total",1804,902,902,1559,245,5,56.70,31.8
"2011","Nottingham 022D","E01013816","Total",2558,1327,1231,1979,579,25,41.23,62.0
"2011","Nottingham 023C","E01013958","Total",1806,880,926,1806,0,8,21.32,84.7
"2011","Nottingham 023D","E01013961","Total",2303,1139,1164,2283,20,17,24.12,95.5
"2011","Nottingham 023E","E01033399","Total",2099,1067,1032,1059,1040,60,13.29,157.9
"2011","Nottingham 023F","E01033401","Total",1059,616,443,1021,38,11,17.89,59.2
"2011","Nottingham 023G","E01033405","Total",1300,764,536,1026,274,13,13.72,94.8
"2011","Nottingham 023H","E01033409","Total",1537,837,700,909,628,26,11.96,128.5
"2011","Nottingham 023I","E01033411","Total",1066,577,489,1066,0,4,16.64,64.1
"2011","Nottingham 024A","E01013913","Total",1762,898,864,1762,0,9,30.87,57.1
"2011","Nottingham 024B","E01013914","Total",1755,868,887,1738,17,11,26.96,65.1
"2011","Nottingham 024C","E01013915","Total",1560,740,820,1560,0,4,85.57,18.2
"2011","Nottingham 024D","E01013916","Total",1503,730,773,1503,0,4,19.38,77.6
"2011","Nottingham 024E","E01013917","Total",1752,880,872,1752,0,3,84.29,20.8
"2011","Nottingham 025A","E01013858","Total",1457,692,765,1457,0,9,36.35,40.1
"2011","Nottingham 025B","E01013860","Total",1577,759,818,1577,0,4,62.56,25.2
"2011","Nottingham 025C","E01013862","Total",1573,738,835,1573,0,23,33.58,46.8
"2011","Nottingham 025D","E01013863","Total",1464,714,750,1464,0,8,39.17,37.4
"2011","Nottingham 026A","E01013944","Total",1728,893,835,1728,0,19,24.03,71.9
"2011","Nottingham 026B","E01013945","Total",1843,991,852,1558,285,22,16.73,110.2
"2011","Nottingham 026D","E01013947","Total",2000,1111,889,1928,72,16,18.72,106.8
"2011","Nottingham 026E","E01013948","Total",1281,777,504,1281,0,4,11.43,112.1
"2011","Nottingham 026F","E01013953","Total",3298,1646,1652,1728,1570,33,16.48,200.1
"2011","Nottingham 026G","E01033395","Total",2172,1092,1080,1138,1034,37,22.78,95.3
"2011","Nottingham 026H","E01033396","Total",1097,612,485,1097,0,12,15.41,71.2
"2011","Nottingham 027A","E01013977","Total",1891,960,931,1879,12,26,137.17,13.8
"2011","Nottingham 027B","E01013978","Total",1682,838,844,1682,0,24,25.15,66.9
"2011","Nottingham 027C","E01013979","Total",1600,820,780,1600,0,30,80.49,19.9
"2011","Nottingham 027D","E01013981","Total",1672,802,870,1672,0,48,51.53,32.4
"2011","Nottingham 028E","E01032520","Total",2092,1153,939,2092,0,31,36.52,57.3
"2011","Nottingham 028F","E01032522","Total",2046,1183,863,2012,34,16,51.09,40.0
"2011","Nottingham 028G","E01033404","Total",3857,2093,1764,3855,2,43,28.46,135.5
"2011","Nottingham 029A","E01013918","Total",1932,1016,916,1932,0,15,12.40,155.8
"2011","Nottingham 029B","E01013919","Total",2048,1119,929,2039,9,21,15.08,135.8
"2011","Nottingham 029C","E01013920","Total",2241,1261,980,2226,15,9,227.40,9.9
"2011","Nottingham 029D","E01013921","Total",2201,1172,1029,2199,2,18,13.55,162.4
"2011","Nottingham 029E","E01013957","Total",1592,779,813,1552,40,8,23.38,68.1
"2011","Nottingham 030A","E01013980","Total",1629,796,833,1629,0,40,38.46,42.4
"2011","Nottingham 030B","E01013982","Total",1591,775,816,1591,0,43,122.19,13.0
"2011","Nottingham 030C","E01013983","Total",1419,717,702,1419,0,13,28.82,49.2
"2011","Nottingham 030D","E01013984","Total",1459,680,779,1459,0,31,35.69,40.9
"2011","Nottingham 030E","E01013985","Total",1798,879,919,1798,0,37,34.78,51.7
"2011","Nottingham 031C","E01013924","Total",1648,988,660,1648,0,12,8.49,194.1
"2011","Nottingham 031E","E01013926","Total",1661,921,740,1661,0,13,44.09,37.7
"2011","Nottingham 031G","E01013928","Total",1582,879,703,1568,14,7,319.69,4.9
"2011","Nottingham 031H","E01033408","Total",3356,1780,1576,3157,199,32,27.04,124.1
"2011","Nottingham 031I","E01033410","Total",2673,1454,1219,2657,16,14,121.96,21.9
"2011","Nottingham 032A","E01013973","Total",3880,1878,2002,776,3104,84,98.57,39.4
"2011","Nottingham 032B","E01013974","Total",2071,1091,980,1549,522,41,70.39,29.4
"2011","Nottingham 032C","E01013975","Total",2387,1212,1175,1099,1288,65,92.77,25.7
"2011","Nottingham 032D","E01013976","Total",1614,814,800,1614,0,8,26.01,62.1
"2011","Nottingham 034A","E01013895","Total",1507,728,779,1507,0,16,45.54,33.1
"2011","Nottingham 034B","E01013896","Total",1307,648,659,1268,39,8,51.66,25.3
"2011","Nottingham 034C","E01013901","Total",1458,750,708,1458,0,29,59.11,24.7
"2011","Nottingham 034D","E01013902","Total",1463,708,755,1463,0,16,48.41,30.2
"2011","Nottingham 035A","E01013897","Total",1505,709,796,1432,73,8,24.20,62.2
"2011","Nottingham 035B","E01013898","Total",1626,808,818,989,637,34,51.49,31.6
"2011","Nottingham 035C","E01013899","Total",1271,593,678,1271,0,6,19.05,66.7
"2011","Nottingham 035D","E01013900","Total",1502,738,764,1473,29,11,91.03,16.5
"2011","Nottingham 035E","E01013903","Total",1249,630,619,1249,0,4,69.95,17.9
"2011","Nottingham 035F","E01013907","Total",1467,716,751,1467,0,11,30.03,48.9
"2011","Nottingham 036A","E01013905","Total",1548,766,782,1548,0,14,25.95,59.7
"2011","Nottingham 036B","E01013908","Total",1685,773,912,1685,0,7,23.61,71.4
"2011","Nottingham 036C","E01013909","Total",1529,729,800,1529,0,9,101.92,15.0
"2011","Nottingham 036D","E01013912","Total",1581,792,789,1572,9,23,125.36,12.6
"2011","Nottingham 037A","E01013904","Total",1550,750,800,1550,0,3,23.88,64.9
"2011","Nottingham 037B","E01013906","Total",1611,765,846,1611,0,4,26.82,60.1
"2011","Nottingham 037C","E01013910","Total",1456,715,741,1456,0,5,26.12,55.7
"2011","Nottingham 037D","E01013911","Total",1520,756,764,1520,0,3,51.37,29.6
"2011","Nottingham 038A","E01013849","Total",1541,700,841,1541,0,5,25.99,59.3
"2011","Nottingham 038B","E01013850","Total",1462,714,748,1462,0,10,25.88,56.5
"2011","Nottingham 038C","E01013851","Total",1571,715,856,1571,0,12,26.51,59.3
"2011","Nottingham 038D","E01013852","Total",1550,771,779,1550,0,6,24.98,62.0
"2011","Nottingham 038E","E01032621","Total",1587,758,829,1540,47,8,29.98,52.9
"2011","Nottingham 039A","E01013874","Total",1476,774,702,1470,6,11,69.20,21.3
"2011","Nottingham 039B","E01033400","Total",1309,683,626,1309,0,5,46.79,28.0
"2011","Nottingham 039C","E01033402","Total",1063,643,420,1015,48,5,56.68,18.8
"2011","Nottingham 039D","E01033403","Total",1083,652,431,1052,31,6,11.94,90.7
"2011","Nottingham 039E","E01033406","Total",1049,635,414,1049,0,8,17.35,60.5
"2011","Nottingham 039F","E01033407","Total",1070,642,428,1070,0,8,9.03,118.5
"2011","Nottingham 040A","E01013870","Total",2018,1059,959,2018,0,9,168.90,11.9
"2011","Nottingham 040B","E01013871","Total",1711,893,818,1711,0,5,37.12,46.1
"2011","Nottingham 040C","E01013872","Total",1798,963,835,1798,0,9,22.81,78.8
"2011","Nottingham 040D","E01013873","Total",2092,1093,999,1676,416,13,12.25,170.8
"2011","Rutland 001A","E01013788","Total",2646,1364,1282,2447,199,66,2681.00,1.0
"2011","Rutland 001B","E01013789","Total",1404,703,701,1367,37,39,4987.07,0.3
"2011","Rutland 001C","E01013790","Total",2064,1443,621,1201,863,20,4284.23,0.5
"2011","Rutland 001D","E01013796","Total",1698,948,750,1360,338,32,2466.54,0.7
"2011","Rutland 002A","E01013793","Total",1371,662,709,1371,0,30,1181.61,1.2
"2011","Rutland 002B","E01013800","Total",1536,751,785,1536,0,17,307.56,5.0
"2011","Rutland 002C","E01013801","Total",1691,820,871,1633,58,10,466.09,3.6
"2011","Rutland 002D","E01013809","Total",1253,610,643,1253,0,46,1630.20,0.8
"2011","Rutland 003A","E01013798","Total",1424,694,730,1424,0,32,69.02,20.6
"2011","Rutland 003B","E01013799","Total",1689,801,888,1276,413,43,59.46,28.4
"2011","Rutland 003C","E01013802","Total",2530,1194,1336,2511,19,52,175.01,14.5
"2011","Rutland 003D","E01013803","Total",2259,1099,1160,2259,0,48,234.23,9.6
"2011","Rutland 004A","E01013791","Total",1145,572,573,1100,45,24,1003.29,1.1
"2011","Rutland 004B","E01013792","Total",1684,819,865,1638,46,47,2143.15,0.8
"2011","Rutland 004C","E01013797","Total",1675,827,848,1675,0,43,1650.40,1.0
"2011","Rutland 004D","E01013804","Total",1544,747,797,1544,0,32,1185.73,1.3
"2011","Rutland 004E","E01013805","Total",1336,692,644,1283,53,27,2446.67,0.5
"2011","Rutland 005A","E01013787","Total",1283,627,656,1269,14,51,4586.06,0.3
"2011","Rutland 005B","E01013794","Total",1274,625,649,1274,0,54,3459.05,0.4
"2011","Rutland 005C","E01013795","Total",1118,537,581,1068,50,31,2357.08,0.5
"2011","Rutland 005D","E01013806","Total",2050,1093,957,1078,972,42,468.95,4.4
"2011","Rutland 005E","E01013807","Total",1397,682,715,1387,10,34,152.78,9.1
"2011","Rutland 005F","E01013808","Total",1298,605,693,1298,0,22,156.33,8.3
"2011","Amber Valley 001A","E01019400","Total",1590,809,781,1590,0,9,79.48,20.0
"2011","Amber Valley 001B","E01019401","Total",1659,797,862,1588,71,19,198.99,8.3
"2011","Amber Valley 001C","E01019402","Total",1580,791,789,1580,0,10,56.47,28.0
"2011","Amber Valley 001D","E01019404","Total",1630,809,821,1602,28,13,89.86,18.1
"2011","Amber Valley 002A","E01019406","Total",1027,487,540,1025,2,30,822.84,1.2
"2011","Amber Valley 002B","E01019423","Total",1209,595,614,1209,0,21,918.36,1.3
"2011","Amber Valley 002C","E01019424","Total",1192,600,592,1181,11,11,269.80,4.4
"2011","Amber Valley 002D","E01019477","Total",2202,1077,1125,2177,25,26,2011.25,1.1
"2011","Amber Valley 003A","E01019403","Total",1512,701,811,1459,53,3,32.19,47.0
"2011","Amber Valley 003B","E01019444","Total",1365,668,697,1331,34,5,121.24,11.3
"2011","Amber Valley 003C","E01019468","Total",1538,767,771,1538,0,4,340.09,4.5
"2011","Amber Valley 003D","E01019469","Total",1654,809,845,1654,0,6,32.02,51.7
"2011","Amber Valley 003E","E01019471","Total",1405,658,747,1405,0,5,157.68,8.9
"2011","Amber Valley 004A","E01019443","Total",1519,722,797,1519,0,11,80.43,18.9
"2011","Amber Valley 004B","E01019470","Total",1658,850,808,1658,0,8,63.71,26.0
"2011","Amber Valley 004C","E01019473","Total",1317,662,655,1317,0,25,135.13,9.7
"2011","Amber Valley 004D","E01019474","Total",1225,606,619,1193,32,25,29.21,41.9
"2011","Amber Valley 004E","E01019475","Total",1176,571,605,1176,0,11,75.00,15.7
"2011","Amber Valley 004F","E01019476","Total",1366,678,688,1366,0,19,247.57,5.5
"2011","Amber Valley 005A","E01019420","Total",1363,650,713,1292,71,9,266.34,5.1
"2011","Amber Valley 005B","E01019442","Total",1537,780,757,1537,0,8,343.11,4.5
"2011","Amber Valley 005C","E01019445","Total",1400,720,680,1400,0,5,62.96,22.2
"2011","Amber Valley 005D","E01019455","Total",1374,686,688,1323,51,10,75.66,18.2
"2011","Amber Valley 005E","E01019456","Total",1815,869,946,1774,41,23,255.67,7.1
"2011","Amber Valley 005F","E01019457","Total",1335,677,658,1335,0,8,55.94,23.9
"2011","Amber Valley 006A","E01019429","Total",1590,806,784,1590,0,17,720.08,2.2
"2011","Amber Valley 006B","E01019454","Total",1422,674,748,1422,0,20,73.98,19.2
"2011","Amber Valley 006C","E01019460","Total",1625,794,831,1625,0,17,106.13,15.3
"2011","Amber Valley 006D","E01019461","Total",1431,675,756,1410,21,7,30.69,46.6
"2011","Amber Valley 006E","E01019462","Total",1258,627,631,1213,45,11,71.85,17.5
"2011","Amber Valley 007A","E01019405","Total",1458,751,707,1419,39,39,4500.31,0.3
"2011","Amber Valley 007B","E01019414","Total",1594,783,811,1594,0,31,498.61,3.2
"2011","Amber Valley 007C","E01019428","Total",1497,727,770,1465,32,12,214.89,7.0
"2011","Amber Valley 007D","E01019430","Total",1926,989,937,1926,0,25,318.89,6.0
"2011","Amber Valley 008A","E01019421","Total",1931,977,954,1928,3,13,48.57,39.8
"2011","Amber Valley 008B","E01019422","Total",1553,781,772,1553,0,9,216.76,7.2
"2011","Amber Valley 008C","E01019432","Total",1982,973,1009,1979,3,9,159.40,12.4
"2011","Amber Valley 008D","E01019458","Total",1538,786,752,1538,0,9,68.46,22.5
"2011","Amber Valley 008E","E01019459","Total",1368,636,732,1368,0,16,30.70,44.6
"2011","Amber Valley 008F","E01019463","Total",1547,754,793,1544,3,9,33.26,46.5
"2011","Amber Valley 009A","E01019408","Total",1500,755,745,1500,0,17,51.30,29.2
"2011","Amber Valley 009B","E01019409","Total",1744,866,878,1744,0,23,34.57,50.4
"2011","Amber Valley 009C","E01019412","Total",1570,767,803,1570,0,44,99.83,15.7
"2011","Amber Valley 009D","E01019413","Total",1423,705,718,1423,0,13,20.21,70.4
"2011","Amber Valley 009E","E01019416","Total",1433,718,715,1433,0,19,123.85,11.6
"2011","Amber Valley 010A","E01019407","Total",2094,1006,1088,2020,74,13,65.88,31.8
"2011","Amber Valley 010B","E01019415","Total",1817,880,937,1742,75,15,104.64,17.4
"2011","Amber Valley 010C","E01019417","Total",1958,925,1033,1933,25,21,69.35,28.2
"2011","Amber Valley 010D","E01019419","Total",1928,941,987,1878,50,20,416.09,4.6
"2011","Amber Valley 011A","E01019410","Total",1469,734,735,1469,0,22,28.25,52.0
"2011","Amber Valley 011B","E01019411","Total",1516,756,760,1516,0,11,43.69,34.7
"2011","Amber Valley 011C","E01019418","Total",1777,883,894,1777,0,15,183.89,9.7
"2011","Amber Valley 011D","E01019447","Total",1538,734,804,1482,56,14,352.28,4.4
"2011","Amber Valley 011E","E01019449","Total",1744,862,882,1744,0,17,295.22,5.9
"2011","Amber Valley 012A","E01019431","Total",1507,747,760,1507,0,4,47.04,32.0
"2011","Amber Valley 012B","E01019433","Total",1846,908,938,1846,0,6,72.19,25.6
"2011","Amber Valley 012C","E01019438","Total",1705,864,841,1690,15,11,28.48,59.9
"2011","Amber Valley 012D","E01019451","Total",1943,963,980,1943,0,11,510.37,3.8
"2011","Amber Valley 012E","E01019464","Total",2015,973,1042,1969,46,32,546.10,3.7
"2011","Amber Valley 013A","E01019434","Total",1196,591,605,1196,0,10,32.98,36.3
"2011","Amber Valley 013B","E01019435","Total",1644,827,817,1644,0,16,61.04,26.9
"2011","Amber Valley 013C","E01019436","Total",1310,658,652,1307,3,19,43.32,30.2
"2011","Amber Valley 013D","E01019439","Total",1358,674,684,1308,50,13,49.97,27.2
"2011","Amber Valley 013E","E01019440","Total",1521,756,765,1499,22,5,39.62,38.4
"2011","Amber Valley 015A","E01019446","Total",1222,581,641,1222,0,8,29.73,41.1
"2011","Amber Valley 015B","E01019448","Total",1705,846,859,1705,0,19,961.92,1.8
"2011","Amber Valley 015C","E01019450","Total",1478,703,775,1436,42,24,48.36,30.6
"2011","Amber Valley 015D","E01019465","Total",1142,556,586,1142,0,10,246.68,4.6
"2011","Amber Valley 015E","E01019467","Total",1478,733,745,1472,6,25,736.11,2.0
"2011","Amber Valley 016A","E01019425","Total",1639,790,849,1639,0,53,130.92,12.5
"2011","Amber Valley 016B","E01019426","Total",1551,715,836,1491,60,50,381.26,4.1
"2011","Amber Valley 016C","E01019427","Total",1856,931,925,1856,0,62,273.76,6.8
"2011","Amber Valley 016D","E01019472","Total",2671,1351,1320,2643,28,79,5037.50,0.5
"2011","Amber Valley 017A","E01019437","Total",1483,717,766,1483,0,8,38.54,38.5
"2011","Amber Valley 017B","E01019441","Total",1483,711,772,1483,0,13,30.44,48.7
"2011","Amber Valley 017C","E01019452","Total",1630,785,845,1630,0,11,44.62,36.5
"2011","Amber Valley 017D","E01019453","Total",1832,898,934,1832,0,9,162.03,11.3
"2011","Amber Valley 017E","E01032613","Total",1215,610,605,1190,25,8,1182.87,1.0
"2011","Bolsover 001A","E01019478","Total",1541,764,777,1541,0,16,1185.50,1.3
"2011","Bolsover 001B","E01019479","Total",1720,854,866,1720,0,24,169.11,10.2
"2011","Bolsover 001C","E01019491","Total",2232,1126,1106,2231,1,12,255.70,8.7
"2011","Bolsover 001D","E01019493","Total",1573,781,792,1573,0,20,55.36,28.4
"2011","Bolsover 001E","E01019494","Total",2026,998,1028,1971,55,24,447.47,4.5
"2011","Bolsover 002A","E01019492","Total",1759,831,928,1740,19,4,57.05,30.8
"2011","Bolsover 002B","E01019495","Total",1616,799,817,1616,0,5,917.72,1.8
"2011","Bolsover 002C","E01019524","Total",1364,676,688,1360,4,15,1163.95,1.2
"2011","Bolsover 002D","E01019525","Total",1482,740,742,1479,3,13,283.97,5.2
"2011","Bolsover 003A","E01019496","Total",1392,699,693,1355,37,9,583.71,2.4
"2011","Bolsover 003B","E01019497","Total",1414,687,727,1390,24,4,121.56,11.6
"2011","Bolsover 003C","E01019498","Total",1791,859,932,1791,0,7,102.52,17.5
"2011","Bolsover 003D","E01019523","Total",1054,513,541,1018,36,10,69.53,15.2
"2011","Bolsover 004A","E01019483","Total",2097,1036,1061,2097,0,10,123.21,17.0
"2011","Bolsover 004B","E01019484","Total",1950,975,975,1950,0,17,891.76,2.2
"2011","Bolsover 004C","E01019485","Total",1194,561,633,1169,25,5,520.66,2.3
"2011","Bolsover 004D","E01019488","Total",1446,744,702,1446,0,7,96.65,15.0
"2011","Bolsover 005A","E01019486","Total",1099,513,586,1057,42,11,51.45,21.4
"2011","Bolsover 005B","E01019487","Total",1553,735,818,1544,9,7,76.09,20.4
"2011","Bolsover 005C","E01019489","Total",1204,568,636,1177,27,4,40.07,30.0
"2011","Bolsover 005D","E01019490","Total",1130,565,565,1130,0,12,30.56,37.0
"2011","Bolsover 005E","E01019502","Total",1503,728,775,1503,0,14,313.47,4.8
"2011","Bolsover 005F","E01019504","Total",1292,641,651,1292,0,11,539.56,2.4
"2011","Bolsover 006A","E01019508","Total",1957,967,990,1957,0,8,66.26,29.5
"2011","Bolsover 006B","E01019509","Total",1215,576,639,1185,30,2,69.14,17.6
"2011","Bolsover 006C","E01019510","Total",1283,602,681,1257,26,3,41.16,31.2
"2011","Bolsover 006D","E01019512","Total",2590,1267,1323,2590,0,21,141.02,18.4
"2011","Bolsover 007A","E01019503","Total",2305,1131,1174,2304,1,16,730.91,3.2
"2011","Bolsover 007B","E01019505","Total",1526,768,758,1481,45,7,52.76,28.9
"2011","Bolsover 007C","E01019506","Total",1345,669,676,1345,0,15,1657.62,0.8
"2011","Bolsover 007D","E01019507","Total",1683,812,871,1683,0,4,75.64,22.3
"2011","Bolsover 007E","E01019511","Total",2157,1055,1102,2117,40,6,351.98,6.1
"2011","Bolsover 008A","E01019480","Total",1536,760,776,1490,46,8,467.45,3.3
"2011","Bolsover 008B","E01019482","Total",1492,736,756,1492,0,9,121.06,12.3
"2011","Bolsover 008C","E01019520","Total",1762,871,891,1762,0,17,2401.00,0.7
"2011","Bolsover 008D","E01019521","Total",1547,766,781,1547,0,12,231.30,6.7
"2011","Bolsover 008E","E01019522","Total",1531,732,799,1503,28,14,96.96,15.8
"2011","Bolsover 009A","E01019481","Total",1361,668,693,1342,19,5,114.66,11.9
"2011","Bolsover 009B","E01019514","Total",1564,794,770,1564,0,15,27.27,57.4
"2011","Bolsover 009C","E01019515","Total",1642,837,805,1642,0,2,32.22,51.0
"2011","Bolsover 009D","E01019516","Total",1465,725,740,1465,0,6,341.77,4.3
"2011","Bolsover 009E","E01019519","Total",1845,897,948,1822,23,9,42.13,43.8
"2011","Bolsover 010A","E01019499","Total",1296,655,641,1296,0,5,175.31,7.4
"2011","Bolsover 010B","E01019500","Total",1439,726,713,1422,17,6,195.08,7.4
"2011","Bolsover 010C","E01019501","Total",1467,738,729,1461,6,9,114.81,12.8
"2011","Bolsover 010D","E01019513","Total",1291,636,655,1262,29,12,207.71,6.2
"2011","Bolsover 010E","E01019517","Total",1551,785,766,1528,23,17,54.88,28.3
"2011","Bolsover 010F","E01019518","Total",1584,822,762,1584,0,11,126.31,12.5
"2011","Chesterfield 001A","E01019526","Total",1387,691,696,1382,5,3,52.71,26.3
"2011","Chesterfield 001B","E01019528","Total",1559,754,805,1559,0,18,166.90,9.3
"2011","Chesterfield 001C","E01019572","Total",1322,652,670,1322,0,9,55.88,23.7
"2011","Chesterfield 001D","E01019573","Total",1520,747,773,1438,82,8,366.48,4.1
"2011","Chesterfield 001E","E01019574","Total",1339,657,682,1339,0,7,122.88,10.9
"2011","Chesterfield 002A","E01019563","Total",1692,817,875,1682,10,9,263.19,6.4
"2011","Chesterfield 002B","E01019564","Total",1523,757,766,1483,40,13,366.03,4.2
"2011","Chesterfield 002C","E01019565","Total",1422,692,730,1422,0,3,202.08,7.0
"2011","Chesterfield 002D","E01019566","Total",1634,806,828,1634,0,23,203.26,8.0
"2011","Chesterfield 002E","E01019568","Total",1531,766,765,1531,0,9,26.01,58.9
"2011","Chesterfield 003A","E01019527","Total",1465,709,756,1465,0,7,778.57,1.9
"2011","Chesterfield 003B","E01019529","Total",1492,766,726,1484,8,6,38.10,39.2
"2011","Chesterfield 003C","E01019530","Total",1443,728,715,1443,0,9,35.69,40.4
"2011","Chesterfield 003D","E01019531","Total",1487,719,768,1436,51,7,79.45,18.7
"2011","Chesterfield 003E","E01019553","Total",1788,891,897,1788,0,9,47.52,37.6
"2011","Chesterfield 004A","E01019541","Total",1553,745,808,1524,29,11,96.90,16.0
"2011","Chesterfield 004B","E01019542","Total",1629,798,831,1629,0,10,62.30,26.1
"2011","Chesterfield 004C","E01019543","Total",1557,785,772,1557,0,9,232.60,6.7
"2011","Chesterfield 004D","E01019544","Total",1564,741,823,1559,5,13,54.29,28.8
"2011","Chesterfield 004E","E01019571","Total",1511,691,820,1463,48,13,35.74,42.3
"2011","Chesterfield 005A","E01019532","Total",1219,584,635,1219,0,12,94.25,12.9
"2011","Chesterfield 005B","E01019533","Total",1403,695,708,1403,0,29,199.12,7.0
"2011","Chesterfield 005C","E01019534","Total",1451,694,757,1316,135,13,154.64,9.4
"2011","Chesterfield 005D","E01019535","Total",1442,707,735,1442,0,15,105.49,13.7
"2011","Chesterfield 005E","E01019536","Total",1746,803,943,1720,26,14,63.78,27.4
"2011","Chesterfield 006A","E01019549","Total",1368,661,707,1351,17,9,352.68,3.9
"2011","Chesterfield 006B","E01019550","Total",1633,792,841,1633,0,9,38.08,42.9
"2011","Chesterfield 006C","E01019551","Total",1576,776,800,1576,0,10,98.84,15.9
"2011","Chesterfield 006D","E01019552","Total",1328,659,669,1286,42,8,90.18,14.7
"2011","Chesterfield 006E","E01019567","Total",1727,822,905,1708,19,14,105.71,16.3
"2011","Chesterfield 007A","E01019537","Total",1477,704,773,1473,4,31,43.31,34.1
"2011","Chesterfield 007B","E01019569","Total",1585,867,718,1584,1,9,70.31,22.5
"2011","Chesterfield 007C","E01019570","Total",1263,604,659,1241,22,15,37.25,33.9
"2011","Chesterfield 007D","E01019580","Total",1451,722,729,1451,0,5,36.67,39.6
"2011","Chesterfield 007E","E01019581","Total",1410,717,693,1387,23,6,32.33,43.6
"2011","Chesterfield 008A","E01019557","Total",1477,727,750,1477,0,45,57.58,25.7
"2011","Chesterfield 008B","E01019558","Total",1433,701,732,1433,0,26,83.18,17.2
"2011","Chesterfield 008C","E01019559","Total",1167,575,592,1167,0,31,46.88,24.9
"2011","Chesterfield 008D","E01019560","Total",1384,689,695,1384,0,17,42.90,32.3
"2011","Chesterfield 008E","E01019561","Total",1324,640,684,1281,43,10,29.20,45.3
"2011","Chesterfield 008F","E01019562","Total",1207,584,623,1207,0,13,39.29,30.7
"2011","Chesterfield 009A","E01019539","Total",1646,803,843,1623,23,27,36.71,44.8
"2011","Chesterfield 009B","E01019540","Total",1416,695,721,1411,5,14,35.56,39.8
"2011","Chesterfield 009C","E01019555","Total",1536,725,811,1536,0,15,28.39,54.1
"2011","Chesterfield 009D","E01019590","Total",1818,890,928,1818,0,19,62.96,28.9
"2011","Chesterfield 009E","E01019591","Total",1557,741,816,1524,33,35,34.18,45.6
"2011","Chesterfield 010A","E01019538","Total",1667,863,804,1623,44,25,41.35,40.3
"2011","Chesterfield 010B","E01019554","Total",1377,702,675,1377,0,10,25.50,54.0
"2011","Chesterfield 010C","E01019556","Total",1464,739,725,1464,0,5,53.12,27.6
"2011","Chesterfield 010D","E01019579","Total",1702,870,832,1646,56,12,75.78,22.5
"2011","Chesterfield 010F","E01033387","Total",1171,617,554,1148,23,9,96.47,12.1
"2011","Chesterfield 010G","E01033388","Total",1367,666,701,1367,0,8,48.72,28.1
"2011","Chesterfield 011A","E01019586","Total",1349,684,665,1349,0,6,30.51,44.2
"2011","Chesterfield 011B","E01019587","Total",1498,737,761,1498,0,37,51.80,28.9
"2011","Chesterfield 011C","E01019588","Total",1424,708,716,1424,0,52,40.64,35.0
"2011","Chesterfield 011D","E01019589","Total",1397,642,755,1353,44,15,43.95,31.8
"2011","Chesterfield 011E","E01019592","Total",1668,761,907,1615,53,50,126.27,13.2
"2011","Chesterfield 011F","E01019593","Total",1101,548,553,1101,0,17,39.90,27.6
"2011","Chesterfield 012A","E01019545","Total",1388,680,708,1388,0,20,31.53,44.0
"2011","Chesterfield 012B","E01019546","Total",1483,718,765,1438,45,17,28.11,52.8
"2011","Chesterfield 012C","E01019547","Total",1425,659,766,1393,32,15,49.19,29.0
"2011","Chesterfield 012D","E01019548","Total",2319,1118,1201,2282,37,29,100.94,23.0
"2011","Chesterfield 012E","E01019582","Total",1429,703,726,1429,0,9,52.97,27.0
"2011","Chesterfield 012F","E01019583","Total",1430,681,749,1430,0,14,45.44,31.5
"2011","Chesterfield 012G","E01019585","Total",2257,1173,1084,2155,102,37,162.94,13.9
"2011","Chesterfield 013A","E01019575","Total",1687,794,893,1687,0,12,27.80,60.7
"2011","Chesterfield 013B","E01019576","Total",1574,781,793,1574,0,14,51.94,30.3
"2011","Chesterfield 013C","E01019577","Total",1545,771,774,1545,0,12,48.15,32.1
"2011","Chesterfield 013D","E01019578","Total",1604,796,808,1604,0,3,24.45,65.6
"2011","Derbyshire Dales 001A","E01019602","Total",1843,916,927,1839,4,28,2420.33,0.8
"2011","Derbyshire Dales 001B","E01019614","Total",1713,890,823,1701,12,67,1186.88,1.4
"2011","Derbyshire Dales 001C","E01019615","Total",2183,1001,1182,2134,49,39,3934.64,0.6
"2011","Derbyshire Dales 001D","E01019631","Total",1827,901,926,1826,1,28,1837.26,1.0
"2011","Derbyshire Dales 002A","E01019600","Total",1655,798,857,1590,65,37,2037.00,0.8
"2011","Derbyshire Dales 002B","E01019604","Total",1801,864,937,1770,31,42,1529.41,1.2
"2011","Derbyshire Dales 002C","E01019606","Total",1670,793,877,1664,6,44,5238.77,0.3
"2011","Derbyshire Dales 002D","E01019618","Total",1636,823,813,1636,0,60,3131.21,0.5
"2011","Derbyshire Dales 003A","E01019599","Total",1469,681,788,1444,25,39,1782.71,0.8
"2011","Derbyshire Dales 003B","E01019601","Total",1639,717,922,1500,139,25,106.50,15.4
"2011","Derbyshire Dales 003C","E01019613","Total",1682,833,849,1662,20,29,6892.20,0.2
"2011","Derbyshire Dales 003D","E01019617","Total",1595,772,823,1552,43,22,3928.42,0.4
"2011","Derbyshire Dales 004A","E01019608","Total",1694,809,885,1674,20,18,153.61,11.0
"2011","Derbyshire Dales 004B","E01019610","Total",1550,751,799,1550,0,26,927.23,1.7
"2011","Derbyshire Dales 004C","E01019630","Total",1874,907,967,1872,2,37,1686.99,1.1
"2011","Derbyshire Dales 005A","E01019609","Total",2169,1051,1118,2083,86,28,636.72,3.4
"2011","Derbyshire Dales 005B","E01019621","Total",1258,622,636,1258,0,38,357.06,3.5
"2011","Derbyshire Dales 005C","E01019622","Total",1554,794,760,1550,4,22,81.45,19.1
"2011","Derbyshire Dales 005D","E01019624","Total",1217,608,609,1215,2,32,77.60,15.7
"2011","Derbyshire Dales 005E","E01019627","Total",1197,612,585,1180,17,33,488.71,2.4
"2011","Derbyshire Dales 005F","E01019628","Total",1163,557,606,1104,59,15,127.14,9.1
"2011","Derbyshire Dales 006A","E01019619","Total",1433,717,716,1433,0,22,761.61,1.9
"2011","Derbyshire Dales 006B","E01019620","Total",1556,785,771,1529,27,32,1142.55,1.4
"2011","Derbyshire Dales 006C","E01019623","Total",1293,625,668,1261,32,18,216.13,6.0
"2011","Derbyshire Dales 006D","E01019625","Total",1592,764,828,1592,0,15,36.68,43.4
"2011","Derbyshire Dales 006E","E01019626","Total",1466,713,753,1463,3,22,518.44,2.8
"2011","Derbyshire Dales 006F","E01019632","Total",1710,837,873,1669,41,33,2217.30,0.8
"2011","Derbyshire Dales 007A","E01019633","Total",1552,794,758,1536,16,28,389.30,4.0
"2011","Derbyshire Dales 007B","E01019634","Total",1505,752,753,1505,0,16,856.10,1.8
"2011","Derbyshire Dales 007C","E01019635","Total",1213,600,613,1213,0,21,287.71,4.2
"2011","Derbyshire Dales 007D","E01019636","Total",1543,764,779,1542,1,20,112.47,13.7
"2011","Derbyshire Dales 008A","E01019595","Total",2055,1016,1039,2025,30,61,884.69,2.3
"2011","Derbyshire Dales 008B","E01019605","Total",1879,963,916,1877,2,36,6605.60,0.3
"2011","Derbyshire Dales 008C","E01019611","Total",1733,873,860,1714,19,40,6309.05,0.3
"2011","Derbyshire Dales 008D","E01019616","Total",1780,872,908,1774,6,29,2891.86,0.6
"2011","Derbyshire Dales 009A","E01019594","Total",1778,853,925,1778,0,17,100.64,17.7
"2011","Derbyshire Dales 009B","E01019596","Total",1605,768,837,1570,35,31,66.56,24.1
"2011","Derbyshire Dales 009C","E01019597","Total",1480,729,751,1477,3,30,114.88,12.9
"2011","Derbyshire Dales 009D","E01019598","Total",1719,834,885,1687,32,20,67.20,25.6
"2011","Derbyshire Dales 010A","E01019603","Total",1677,793,884,1647,30,26,3866.74,0.4
"2011","Derbyshire Dales 010B","E01019607","Total",1826,895,931,1817,9,56,4551.74,0.4
"2011","Derbyshire Dales 010C","E01019612","Total",2632,1590,1042,1949,683,29,3244.46,0.8
"2011","Derbyshire Dales 010D","E01019629","Total",1700,834,866,1700,0,34,5441.66,0.3
"2011","Erewash 001A","E01019644","Total",1451,697,754,1451,0,2,23.70,61.2
"2011","Erewash 001B","E01019646","Total",1523,735,788,1523,0,3,47.78,31.9
"2011","Erewash 001C","E01019663","Total",1499,702,797,1469,30,3,95.14,15.8
"2011","Erewash 001D","E01019664","Total",1298,637,661,1298,0,8,37.95,34.2
"2011","Erewash 001E","E01019665","Total",1377,669,708,1376,1,7,37.10,37.1
"2011","Erewash 003A","E01019657","Total",1755,843,912,1755,0,12,35.24,49.8
"2011","Erewash 003B","E01019660","Total",1866,923,943,1866,0,4,54.85,34.0
"2011","Erewash 003C","E01019661","Total",1309,659,650,1309,0,4,89.04,14.7
"2011","Erewash 003D","E01019662","Total",1532,811,721,1532,0,3,28.04,54.6
"2011","Erewash 003E","E01019672","Total",1714,835,879,1585,129,7,60.92,28.1
"2011","Erewash 003F","E01019690","Total",1219,627,592,1219,0,6,18.25,66.8
"2011","Erewash 004A","E01019670","Total",1821,895,926,1821,0,50,364.15,5.0
"2011","Erewash 004B","E01019671","Total",1795,865,930,1750,45,32,1568.59,1.1
"2011","Erewash 004C","E01019701","Total",2100,1027,1073,2089,11,21,487.69,4.3
"2011","Erewash 005A","E01019673","Total",1324,652,672,1257,67,9,113.34,11.7
"2011","Erewash 005B","E01019702","Total",1926,927,999,1845,81,37,86.60,22.2
"2011","Erewash 005C","E01019703","Total",1579,764,815,1551,28,15,142.50,11.1
"2011","Erewash 005D","E01019704","Total",1475,716,759,1475,0,20,1453.90,1.0
"2011","Erewash 006A","E01019658","Total",1856,947,909,1856,0,12,130.58,14.2
"2011","Erewash 006B","E01019659","Total",1745,858,887,1745,0,13,77.04,22.7
"2011","Erewash 006C","E01019674","Total",1183,596,587,1183,0,8,27.00,43.8
"2011","Erewash 006D","E01019688","Total",1481,736,745,1466,15,7,31.34,47.3
"2011","Erewash 006E","E01019689","Total",1495,727,768,1495,0,10,36.14,41.4
"2011","Erewash 007A","E01019666","Total",1513,729,784,1513,0,6,77.87,19.4
"2011","Erewash 007B","E01019667","Total",1645,798,847,1645,0,8,67.24,24.5
"2011","Erewash 007C","E01019668","Total",1495,683,812,1419,76,1,35.89,41.7
"2011","Erewash 007D","E01019669","Total",1563,771,792,1563,0,10,82.13,19.0
"2011","Erewash 008A","E01019656","Total",1216,572,644,1145,71,17,1318.09,0.9
"2011","Erewash 008B","E01019691","Total",1598,768,830,1598,0,12,207.05,7.7
"2011","Erewash 008C","E01019692","Total",1523,727,796,1505,18,6,73.72,20.7
"2011","Erewash 008D","E01019693","Total",1835,894,941,1835,0,13,31.87,57.6
"2011","Erewash 008E","E01019694","Total",1186,597,589,1186,0,20,40.05,29.6
"2011","Erewash 008F","E01019696","Total",1330,641,689,1303,27,13,49.94,26.6
"2011","Erewash 009A","E01019683","Total",1287,630,657,1287,0,31,134.87,9.5
"2011","Erewash 009B","E01019684","Total",1677,814,863,1637,40,11,72.58,23.1
"2011","Erewash 009C","E01019685","Total",1463,692,771,1451,12,13,86.30,17.0
"2011","Erewash 009D","E01019686","Total",1401,659,742,1364,37,23,524.46,2.7
"2011","Erewash 009E","E01019687","Total",1507,721,786,1497,10,14,38.99,38.7
"2011","Erewash 010A","E01019648","Total",1545,771,774,1545,0,4,33.34,46.3
"2011","Erewash 010B","E01019649","Total",1759,869,890,1759,0,4,23.40,75.2
"2011","Erewash 010C","E01019650","Total",1646,787,859,1645,1,12,42.90,38.4
"2011","Erewash 010D","E01019651","Total",1451,709,742,1451,0,15,25.91,56.0
"2011","Erewash 010E","E01019695","Total",1417,678,739,1376,41,13,42.24,33.5
"2011","Erewash 011A","E01019641","Total",1405,680,725,1405,0,27,156.20,9.0
"2011","Erewash 011B","E01019652","Total",1697,847,850,1555,142,29,44.92,37.8
"2011","Erewash 011C","E01019653","Total",1404,674,730,1366,38,22,49.47,28.4
"2011","Erewash 011D","E01019707","Total",1473,736,737,1473,0,17,29.86,49.3
"2011","Erewash 011E","E01019708","Total",1635,813,822,1635,0,31,62.57,26.1
"2011","Erewash 012A","E01019647","Total",1900,930,970,1889,11,8,56.87,33.4
"2011","Erewash 012B","E01019675","Total",1570,795,775,1570,0,1,34.12,46.0
"2011","Erewash 012C","E01019679","Total",1715,875,840,1711,4,11,45.99,37.3
"2011","Erewash 012D","E01019682","Total",1520,762,758,1498,22,11,39.84,38.2
"2011","Erewash 013A","E01019642","Total",1445,684,761,1408,37,22,242.25,6.0
"2011","Erewash 013B","E01019643","Total",1605,793,812,1584,21,23,407.02,3.9
"2011","Erewash 013C","E01019654","Total",1551,784,767,1551,0,14,357.97,4.3
"2011","Erewash 013D","E01019655","Total",1539,757,782,1539,0,17,229.49,6.7
"2011","Erewash 014A","E01019676","Total",1461,713,748,1452,9,9,26.73,54.7
"2011","Erewash 014B","E01019677","Total",1428,703,725,1424,4,8,32.70,43.7
"2011","Erewash 014C","E01019678","Total",1594,813,781,1594,0,12,59.06,27.0
"2011","Erewash 014D","E01019680","Total",1549,764,785,1509,40,13,41.96,36.9
"2011","Erewash 014E","E01019681","Total",1493,752,741,1485,8,11,364.17,4.1
"2011","Erewash 014F","E01019698","Total",1364,675,689,1357,7,23,137.63,9.9
"2011","Erewash 015A","E01019697","Total",1495,740,755,1495,0,20,65.18,22.9
"2011","Erewash 015B","E01019699","Total",1512,707,805,1512,0,3,34.13,44.3
"2011","Erewash 015C","E01019700","Total",2258,1094,1164,2258,0,18,89.11,25.3
"2011","Erewash 015D","E01019705","Total",1789,886,903,1789,0,9,29.76,60.1
"2011","Erewash 015E","E01019706","Total",1243,616,627,1243,0,7,20.37,61.0
"2011","Erewash 015F","E01019709","Total",1259,629,630,1259,0,20,61.34,20.5
"2011","Erewash 016A","E01019638","Total",1356,661,695,1302,54,18,31.11,43.6
"2011","Erewash 016B","E01019639","Total",1103,550,553,1098,5,8,35.05,31.5
"2011","Erewash 016C","E01019640","Total",1481,741,740,1481,0,6,71.26,20.8
"2011","Erewash 016D","E01019645","Total",1556,763,793,1556,0,8,32.23,48.3
"2011","Erewash 016E","E01032614","Total",1301,639,662,1301,0,19,18.85,69.0
"2011","High Peak 001A","E01019733","Total",1511,734,777,1474,37,9,35.96,42.0
"2011","High Peak 001B","E01019752","Total",1319,642,677,1319,0,9,29.39,44.9
"2011","High Peak 001C","E01019753","Total",1477,727,750,1475,2,20,146.00,10.1
"2011","High Peak 001D","E01019763","Total",2101,1036,1065,2090,11,25,4802.99,0.4
"2011","High Peak 002A","E01019728","Total",1221,554,667,1221,0,10,18.29,66.8
"2011","High Peak 002B","E01019729","Total",1310,637,673,1310,0,6,66.58,19.7
"2011","High Peak 002C","E01019730","Total",2003,958,1045,1935,68,22,66.84,30.0
"2011","High Peak 002D","E01019731","Total",1305,648,657,1305,0,23,34.49,37.8
"2011","High Peak 002E","E01019732","Total",1486,736,750,1486,0,15,94.20,15.8
"2011","High Peak 003A","E01019738","Total",1364,656,708,1364,0,19,42.13,32.4
"2011","High Peak 003B","E01019739","Total",1615,780,835,1592,23,10,41.37,39.0
"2011","High Peak 003C","E01019740","Total",1192,624,568,1177,15,14,17.06,69.9
"2011","High Peak 003D","E01019750","Total",1256,577,679,1256,0,15,90.78,13.8
"2011","High Peak 003E","E01019751","Total",2240,1129,1111,2240,0,32,47.89,46.8
"2011","High Peak 003F","E01019768","Total",2199,1088,1111,2199,0,10,135.67,16.2
"2011","High Peak 004A","E01019727","Total",1731,848,883,1703,28,43,215.18,8.0
"2011","High Peak 004B","E01019749","Total",1252,622,630,1252,0,44,46.19,27.1
"2011","High Peak 004C","E01019754","Total",1781,864,917,1781,0,38,6454.24,0.3
"2011","High Peak 004D","E01019756","Total",1828,927,901,1828,0,34,50.29,36.3
"2011","High Peak 004E","E01019757","Total",1340,634,706,1340,0,20,58.48,22.9
"2011","High Peak 004F","E01019758","Total",1559,786,773,1504,55,27,108.65,14.3
"2011","High Peak 005A","E01019746","Total",1587,810,777,1587,0,25,63.38,25.0
"2011","High Peak 005B","E01019747","Total",1180,575,605,1178,2,21,313.62,3.8
"2011","High Peak 005C","E01019748","Total",1462,751,711,1462,0,22,110.23,13.3
"2011","High Peak 005D","E01019755","Total",2006,1002,1004,1968,38,40,1647.39,1.2
"2011","High Peak 005E","E01019766","Total",1443,716,727,1443,0,16,377.58,3.8
"2011","High Peak 006A","E01019711","Total",1322,667,655,1322,0,13,450.02,2.9
"2011","High Peak 006B","E01019734","Total",2056,1019,1037,2054,2,33,2434.81,0.8
"2011","High Peak 006C","E01019743","Total",1376,658,718,1376,0,11,41.42,33.2
"2011","High Peak 006D","E01019744","Total",1467,702,765,1441,26,11,653.12,2.2
"2011","High Peak 006E","E01019745","Total",1096,543,553,1069,27,13,41.41,26.5
"2011","High Peak 008A","E01019712","Total",1474,737,737,1467,7,40,1204.54,1.2
"2011","High Peak 008B","E01019713","Total",1124,531,593,1054,70,19,1590.11,0.7
"2011","High Peak 008C","E01019764","Total",1593,788,805,1593,0,28,725.05,2.2
"2011","High Peak 008D","E01019765","Total",1790,897,893,1790,0,31,145.82,12.3
"2011","High Peak 008E","E01019767","Total",1629,813,816,1621,8,26,161.72,10.1
"2011","High Peak 010A","E01019710","Total",1945,969,976,1917,28,20,199.05,9.8
"2011","High Peak 010B","E01019715","Total",1535,746,789,1476,59,21,14.34,107.0
"2011","High Peak 010C","E01019717","Total",1375,693,682,1121,254,28,33.05,41.6
"2011","High Peak 010D","E01019722","Total",1859,910,949,1859,0,41,740.55,2.5
"2011","High Peak 010E","E01019723","Total",1826,852,974,1664,162,52,139.69,13.1
"2011","High Peak 011A","E01019716","Total",1278,645,633,1275,3,15,35.26,36.2
"2011","High Peak 011B","E01019724","Total",1221,610,611,1221,0,13,60.66,20.1
"2011","High Peak 011C","E01019759","Total",1506,726,780,1506,0,6,200.38,7.5
"2011","High Peak 011D","E01019760","Total",1461,721,740,1461,0,10,18.38,79.5
"2011","High Peak 011E","E01019761","Total",1606,775,831,1606,0,16,44.58,36.0
"2011","High Peak 012A","E01019714","Total",2540,1266,1274,2536,4,49,5361.80,0.5
"2011","High Peak 012B","E01019725","Total",1406,695,711,1406,0,14,639.10,2.2
"2011","High Peak 012C","E01019726","Total",1339,679,660,1339,0,13,195.04,6.9
"2011","High Peak 012D","E01019762","Total",1789,865,924,1764,25,45,180.49,9.9
"2011","High Peak 013E","E01019718","Total",2238,1087,1151,2233,5,35,1371.51,1.6
"2011","High Peak 013F","E01019719","Total",1555,752,803,1518,37,13,67.78,22.9
"2011","High Peak 013G","E01019720","Total",1457,727,730,1457,0,16,37.46,38.9
"2011","High Peak 013H","E01019721","Total",1148,570,578,1143,5,27,198.93,5.8
"2011","High Peak 013A","E01019735","Total",1531,751,780,1527,4,32,1363.50,1.1
"2011","High Peak 013B","E01019736","Total",1181,582,599,1163,18,29,16227.09,0.1
"2011","High Peak 013C","E01019737","Total",1168,558,610,1168,0,20,1315.95,0.9
"2011","High Peak 013I","E01019741","Total",1113,587,526,1113,0,8,454.05,2.5
"2011","High Peak 013D","E01019742","Total",1120,592,528,1118,2,4,2453.16,0.5
"2011","North East Derbyshire 001A","E01019801","Total",1096,560,536,1096,0,9,174.85,6.3
"2011","North East Derbyshire 001B","E01019802","Total",1363,662,701,1308,55,15,29.68,45.9
"2011","North East Derbyshire 001C","E01019803","Total",1280,621,659,1280,0,3,127.01,10.1
"2011","North East Derbyshire 001D","E01019804","Total",1333,675,658,1333,0,11,20.78,64.1
"2011","North East Derbyshire 001E","E01019805","Total",1382,677,705,1382,0,12,199.22,6.9
"2011","North East Derbyshire 001F","E01019806","Total",1492,719,773,1492,0,14,50.62,29.5
"2011","North East Derbyshire 001G","E01019807","Total",1499,738,761,1499,0,11,26.33,56.9
"2011","North East Derbyshire 002A","E01019778","Total",1697,838,859,1697,0,21,161.06,10.5
"2011","North East Derbyshire 002B","E01019779","Total",1587,771,816,1587,0,18,74.86,21.2
"2011","North East Derbyshire 002C","E01019790","Total",1952,981,971,1952,0,12,161.97,12.1
"2011","North East Derbyshire 002D","E01019816","Total",1750,852,898,1750,0,20,1537.33,1.1
"2011","North East Derbyshire 004A","E01019780","Total",1433,679,754,1429,4,6,30.50,47.0
"2011","North East Derbyshire 004B","E01019781","Total",1428,667,761,1371,57,17,81.04,17.6
"2011","North East Derbyshire 004C","E01019782","Total",1281,611,670,1244,37,17,128.92,9.9
"2011","North East Derbyshire 004D","E01019786","Total",1520,736,784,1518,2,14,60.59,25.1
"2011","North East Derbyshire 004E","E01019827","Total",1876,943,933,1876,0,21,1044.75,1.8
"2011","North East Derbyshire 005A","E01019770","Total",1891,928,963,1891,0,26,3982.14,0.5
"2011","North East Derbyshire 005B","E01019787","Total",1774,861,913,1774,0,13,251.23,7.1
"2011","North East Derbyshire 005C","E01019788","Total",1661,809,852,1621,40,30,199.38,8.3
"2011","North East Derbyshire 005D","E01019794","Total",1416,700,716,1416,0,20,49.78,28.4
"2011","North East Derbyshire 006A","E01019783","Total",1259,622,637,1259,0,20,25.96,48.5
"2011","North East Derbyshire 006B","E01019784","Total",1257,611,646,1257,0,17,49.34,25.5
"2011","North East Derbyshire 006C","E01019785","Total",1292,659,633,1292,0,17,107.67,12.0
"2011","North East Derbyshire 006D","E01019793","Total",1441,691,750,1441,0,25,104.88,13.7
"2011","North East Derbyshire 006E","E01019795","Total",2215,1078,1137,2215,0,34,71.25,31.1
"2011","North East Derbyshire 007A","E01019798","Total",1401,682,719,1401,0,14,563.79,2.5
"2011","North East Derbyshire 007B","E01019821","Total",1376,655,721,1348,28,16,382.02,3.6
"2011","North East Derbyshire 007C","E01019822","Total",1582,775,807,1582,0,9,1463.20,1.1
"2011","North East Derbyshire 007D","E01019823","Total",1118,543,575,1118,0,9,51.52,21.7
"2011","North East Derbyshire 008A","E01019771","Total",2131,1029,1102,2088,43,40,2613.84,0.8
"2011","North East Derbyshire 008B","E01019772","Total",1545,788,757,1545,0,44,1526.46,1.0
"2011","North East Derbyshire 008C","E01019828","Total",1412,681,731,1412,0,22,126.85,11.1
"2011","North East Derbyshire 008D","E01019829","Total",1437,707,730,1437,0,27,103.80,13.8
"2011","North East Derbyshire 009A","E01019796","Total",1111,535,576,1111,0,12,78.64,14.1
"2011","North East Derbyshire 009B","E01019797","Total",1338,661,677,1338,0,3,44.09,30.3
"2011","North East Derbyshire 009C","E01019799","Total",1965,981,984,1937,28,11,744.79,2.6
"2011","North East Derbyshire 009D","E01019800","Total",1767,890,877,1719,48,11,117.84,15.0
"2011","North East Derbyshire 009E","E01019808","Total",1593,757,836,1593,0,5,194.30,8.2
"2011","North East Derbyshire 009F","E01019826","Total",1417,715,702,1417,0,8,58.26,24.3
"2011","North East Derbyshire 010A","E01019769","Total",1905,937,968,1867,38,44,3867.71,0.5
"2011","North East Derbyshire 010B","E01019774","Total",1567,758,809,1539,28,15,607.70,2.6
"2011","North East Derbyshire 010C","E01019824","Total",1175,581,594,1175,0,10,183.98,6.4
"2011","North East Derbyshire 010D","E01019830","Total",1261,618,643,1261,0,24,158.15,8.0
"2011","North East Derbyshire 010E","E01019831","Total",1375,664,711,1375,0,26,92.19,14.9
"2011","North East Derbyshire 011A","E01019809","Total",1135,564,571,1135,0,10,130.71,8.7
"2011","North East Derbyshire 011B","E01019810","Total",1434,717,717,1418,16,4,60.92,23.5
"2011","North East Derbyshire 011C","E01019811","Total",1564,769,795,1552,12,17,62.09,25.2
"2011","North East Derbyshire 011D","E01019812","Total",1783,892,891,1783,0,16,452.00,3.9
"2011","North East Derbyshire 011E","E01019813","Total",1704,835,869,1704,0,11,178.61,9.5
"2011","North East Derbyshire 011F","E01019825","Total",1400,683,717,1370,30,18,151.34,9.3
"2011","North East Derbyshire 012A","E01019773","Total",2378,1190,1188,2363,15,18,100.85,23.6
"2011","North East Derbyshire 012B","E01019775","Total",1762,865,897,1738,24,15,192.51,9.2
"2011","North East Derbyshire 012C","E01019776","Total",1366,679,687,1328,38,10,114.24,12.0
"2011","North East Derbyshire 012D","E01019777","Total",2381,1168,1213,2381,0,14,124.21,19.2
"2011","North East Derbyshire 013A","E01019814","Total",1720,824,896,1664,56,19,999.03,1.7
"2011","North East Derbyshire 013B","E01019817","Total",1211,581,630,1211,0,3,118.36,10.2
"2011","North East Derbyshire 013C","E01019818","Total",1541,735,806,1541,0,9,209.97,7.3
"2011","North East Derbyshire 013D","E01019819","Total",1423,725,698,1423,0,17,1638.03,0.9
"2011","North East Derbyshire 013E","E01019820","Total",1417,698,719,1414,3,14,251.39,5.6
"2011","North East Derbyshire 014A","E01019791","Total",1760,833,927,1707,53,16,467.25,3.8
"2011","North East Derbyshire 014B","E01019792","Total",2031,977,1054,1967,64,7,91.83,22.1
"2011","North East Derbyshire 014C","E01019815","Total",2719,1388,1331,2655,64,15,368.08,7.4
"2011","North East Derbyshire 014D","E01032586","Total",1643,795,848,1643,0,10,118.34,13.9
"2011","South Derbyshire 001A","E01019839","Total",1865,956,909,1758,107,44,2448.80,0.8
"2011","South Derbyshire 001B","E01019845","Total",1324,649,675,1324,0,8,97.55,13.6
"2011","South Derbyshire 001C","E01019846","Total",1239,612,627,1239,0,6,47.38,26.2
"2011","South Derbyshire 001D","E01019866","Total",2387,1118,1269,2202,185,42,5089.49,0.5
"2011","South Derbyshire 002A","E01019840","Total",1624,802,822,1586,38,25,205.68,7.9
"2011","South Derbyshire 002B","E01019841","Total",1522,757,765,1491,31,38,1207.96,1.3
"2011","South Derbyshire 002C","E01019847","Total",1356,661,695,1356,0,17,206.20,6.6
"2011","South Derbyshire 002D","E01019848","Total",2126,1066,1060,2126,0,37,155.57,13.7
"2011","South Derbyshire 002F","E01033532","Total",1463,725,738,1463,0,17,708.92,2.1
"2011","South Derbyshire 002G","E01033533","Total",1696,844,852,1696,0,6,25.53,66.4
"2011","South Derbyshire 002H","E01033534","Total",1073,556,517,1073,0,11,17.03,63.0
"2011","South Derbyshire 003A","E01019873","Total",1461,739,722,1461,0,7,689.72,2.1
"2011","South Derbyshire 003B","E01019874","Total",1449,726,723,1449,0,14,25.87,56.0
"2011","South Derbyshire 003C","E01019875","Total",1418,714,704,1418,0,22,23.48,60.4
"2011","South Derbyshire 003D","E01019881","Total",1359,652,707,1343,16,25,445.96,3.0
"2011","South Derbyshire 003E","E01019882","Total",1565,772,793,1565,0,7,480.39,3.3
"2011","South Derbyshire 004A","E01019832","Total",1713,859,854,1687,26,19,1308.15,1.3
"2011","South Derbyshire 004B","E01019833","Total",1826,891,935,1820,6,24,562.93,3.2
"2011","South Derbyshire 004C","E01019834","Total",1506,747,759,1506,0,47,1852.08,0.8
"2011","South Derbyshire 004D","E01019835","Total",1621,818,803,1621,0,20,536.51,3.0
"2011","South Derbyshire 005A","E01019867","Total",1552,756,796,1408,144,28,1622.77,1.0
"2011","South Derbyshire 005B","E01019868","Total",1723,831,892,1611,112,37,2605.66,0.7
"2011","South Derbyshire 005C","E01019869","Total",1662,873,789,1229,433,42,490.52,3.4
"2011","South Derbyshire 005D","E01019880","Total",1607,827,780,1607,0,35,272.97,5.9
"2011","South Derbyshire 006A","E01019843","Total",1540,736,804,1495,45,25,2514.03,0.6
"2011","South Derbyshire 006B","E01019853","Total",1543,794,749,1543,0,31,311.32,5.0
"2011","South Derbyshire 006C","E01019854","Total",1741,832,909,1741,0,35,103.78,16.8
"2011","South Derbyshire 006D","E01019855","Total",1559,765,794,1544,15,42,1056.84,1.5
"2011","South Derbyshire 007A","E01019844","Total",1548,749,799,1548,0,14,168.73,9.2
"2011","South Derbyshire 007B","E01019856","Total",1496,734,762,1496,0,8,26.26,57.0
"2011","South Derbyshire 007C","E01019857","Total",1275,641,634,1268,7,9,50.19,25.4
"2011","South Derbyshire 007D","E01019858","Total",1621,780,841,1621,0,8,30.82,52.6
"2011","South Derbyshire 007E","E01019859","Total",1674,826,848,1674,0,27,44.52,37.6
"2011","South Derbyshire 008A","E01019860","Total",1322,663,659,1322,0,19,24.24,54.5
"2011","South Derbyshire 008B","E01019861","Total",1783,904,879,1783,0,6,50.40,35.4
"2011","South Derbyshire 008C","E01019862","Total",1480,707,773,1452,28,11,478.59,3.1
"2011","South Derbyshire 008D","E01019863","Total",1593,773,820,1593,0,6,31.35,50.8
"2011","South Derbyshire 008E","E01019864","Total",1492,760,732,1492,0,6,73.06,20.4
"2011","South Derbyshire 008F","E01019865","Total",1318,643,675,1308,10,11,35.35,37.3
"2011","South Derbyshire 009A","E01019876","Total",1928,975,953,1928,0,15,52.20,36.9
"2011","South Derbyshire 009B","E01019877","Total",1570,803,767,1543,27,6,62.42,25.2
"2011","South Derbyshire 009C","E01019878","Total",1551,769,782,1530,21,17,29.75,52.1
"2011","South Derbyshire 009D","E01019879","Total",1851,951,900,1851,0,26,95.67,19.3
"2011","South Derbyshire 011A","E01019850","Total",1562,796,766,1554,8,24,1810.22,0.9
"2011","South Derbyshire 011B","E01019851","Total",1639,799,840,1614,25,15,208.29,7.9
"2011","South Derbyshire 011C","E01019852","Total",1792,892,900,1792,0,15,378.00,4.7
"2011","South Derbyshire 011D","E01019870","Total",1596,770,826,1497,99,9,1887.20,0.8
"2011","South Derbyshire 011E","E01019871","Total",1768,863,905,1768,0,22,1797.77,1.0
"2011","South Derbyshire 011F","E01019872","Total",1898,934,964,1868,30,11,399.63,4.7
"2011","South Derbyshire 012A","E01019837","Total",1931,924,1007,1910,21,10,117.98,16.4
"2011","South Derbyshire 012B","E01019838","Total",1669,839,830,1653,16,6,36.21,46.1
"2011","South Derbyshire 012C","E01033531","Total",1596,827,769,1596,0,18,92.86,17.2
"2011","South Derbyshire 012D","E01033536","Total",1648,834,814,1648,0,13,75.01,22.0
"2011","South Derbyshire 012E","E01033537","Total",1685,823,862,1663,22,11,92.97,18.1
"2011","South Derbyshire 013A","E01019842","Total",1712,854,858,1712,0,17,341.56,5.0
"2011","South Derbyshire 013B","E01019883","Total",2845,1409,1436,2845,0,21,106.63,26.7
"2011","South Derbyshire 013C","E01019885","Total",1701,853,848,1701,0,11,67.01,25.4
"2011","South Derbyshire 013D","E01033535","Total",1547,790,757,1541,6,18,34.08,45.4
"2011","Blaby 002A","E01025631","Total",1212,596,616,1212,0,7,39.36,30.8
"2011","Blaby 002B","E01025632","Total",1457,726,731,1457,0,46,28.47,51.2
"2011","Blaby 002C","E01025633","Total",1718,830,888,1716,2,24,56.99,30.1
"2011","Blaby 002D","E01025635","Total",1253,606,647,1169,84,25,32.66,38.4
"2011","Blaby 003A","E01025634","Total",1488,715,773,1422,66,19,108.69,13.7
"2011","Blaby 003B","E01025638","Total",1442,696,746,1442,0,18,269.36,5.4
"2011","Blaby 003C","E01025639","Total",1244,584,660,1228,16,20,199.85,6.2
"2011","Blaby 003D","E01025640","Total",1572,735,837,1557,15,37,232.77,6.8
"2011","Blaby 003E","E01025645","Total",1145,569,576,1145,0,20,1532.28,0.7
"2011","Blaby 004A","E01025666","Total",1466,702,764,1466,0,7,29.06,50.4
"2011","Blaby 004B","E01025667","Total",1180,564,616,1180,0,7,37.94,31.1
"2011","Blaby 004C","E01025668","Total",2359,1213,1146,2359,0,20,37.45,63.0
"2011","Blaby 004D","E01025669","Total",2101,1073,1028,2101,0,30,140.98,14.9
"2011","Blaby 005A","E01025636","Total",1341,657,684,1341,0,11,35.26,38.0
"2011","Blaby 005B","E01025637","Total",1310,656,654,1310,0,11,38.73,33.8
"2011","Blaby 005C","E01025652","Total",1345,651,694,1345,0,17,44.06,30.5
"2011","Blaby 005D","E01025653","Total",1568,787,781,1568,0,11,31.16,50.3
"2011","Blaby 005E","E01025654","Total",1270,620,650,1270,0,11,45.03,28.2
"2011","Blaby 005F","E01025655","Total",1571,783,788,1561,10,21,29.24,53.7
"2011","Blaby 005G","E01025656","Total",1339,665,674,1339,0,14,27.03,49.5
"2011","Blaby 006A","E01025625","Total",1229,573,656,1229,0,8,34.12,36.0
"2011","Blaby 006B","E01025626","Total",1254,616,638,1244,10,9,852.91,1.5
"2011","Blaby 006C","E01025627","Total",2209,1059,1150,2158,51,14,314.73,7.0
"2011","Blaby 006D","E01025651","Total",1622,830,792,1602,20,18,27.10,59.9
"2011","Blaby 006E","E01025657","Total",1861,902,959,1861,0,31,139.58,13.3
"2011","Blaby 006F","E01025660","Total",1678,825,853,1661,17,38,46.54,36.1
"2011","Blaby 007A","E01025641","Total",1766,881,885,1766,0,15,132.91,13.3
"2011","Blaby 007B","E01025642","Total",1941,939,1002,1941,0,19,107.89,18.0
"2011","Blaby 007C","E01025643","Total",1594,797,797,1590,4,26,74.25,21.5
"2011","Blaby 007D","E01025649","Total",1573,781,792,1571,2,30,108.89,14.4
"2011","Blaby 007E","E01025650","Total",1574,772,802,1574,0,33,148.62,10.6
"2011","Blaby 008A","E01025610","Total",1564,759,805,1564,0,18,41.95,37.3
"2011","Blaby 008B","E01025611","Total",1532,741,791,1532,0,14,46.69,32.8
"2011","Blaby 008C","E01025612","Total",1609,790,819,1609,0,17,173.58,9.3
"2011","Blaby 008D","E01025658","Total",2347,1423,924,1826,521,22,86.43,27.2
"2011","Blaby 008E","E01025659","Total",1792,847,945,1758,34,19,249.72,7.2
"2011","Blaby 009A","E01025615","Total",1602,796,806,1602,0,26,642.03,2.5
"2011","Blaby 009B","E01025646","Total",1665,776,889,1629,36,20,134.96,12.3
"2011","Blaby 009C","E01025647","Total",1586,759,827,1586,0,16,61.16,25.9
"2011","Blaby 009D","E01025648","Total",2060,1005,1055,2048,12,34,37.45,55.0
"2011","Blaby 010A","E01025613","Total",1410,670,740,1410,0,24,761.32,1.9
"2011","Blaby 010B","E01025614","Total",1749,846,903,1749,0,32,68.39,25.6
"2011","Blaby 010C","E01025620","Total",1097,518,579,1097,0,17,134.81,8.1
"2011","Blaby 010D","E01025621","Total",1051,537,514,1051,0,5,1041.22,1.0
"2011","Blaby 010E","E01025644","Total",1418,678,740,1401,17,22,151.28,9.4
"2011","Blaby 011A","E01025616","Total",1642,816,826,1642,0,36,185.78,8.8
"2011","Blaby 011B","E01025617","Total",1696,830,866,1696,0,28,1149.94,1.5
"2011","Blaby 011C","E01025618","Total",1666,795,871,1666,0,16,55.65,29.9
"2011","Blaby 011D","E01025619","Total",1643,797,846,1610,33,20,80.67,20.4
"2011","Blaby 012A","E01025661","Total",1764,864,900,1762,2,20,236.66,7.5
"2011","Blaby 012B","E01025662","Total",1535,757,778,1508,27,12,588.89,2.6
"2011","Blaby 012C","E01025663","Total",1436,704,732,1436,0,20,355.41,4.0
"2011","Blaby 012D","E01025664","Total",1226,611,615,1226,0,20,1189.51,1.0
"2011","Blaby 012E","E01025665","Total",1500,735,765,1479,21,8,82.48,18.2
"2011","Blaby 013A","E01025622","Total",1653,817,836,1653,0,20,88.19,18.7
"2011","Blaby 013B","E01025623","Total",1550,791,759,1547,3,19,97.41,15.9
"2011","Blaby 013C","E01025624","Total",1798,890,908,1798,0,25,162.82,11.0
"2011","Blaby 013D","E01025629","Total",1508,733,775,1508,0,7,32.79,46.0
"2011","Blaby 013E","E01025630","Total",1714,861,853,1696,18,30,83.37,20.6
"2011","Blaby 013F","E01032603","Total",1420,679,741,1420,0,17,42.19,33.7
"2011","Charnwood 001B","E01025692","Total",1996,986,1010,1996,0,37,116.94,17.1
"2011","Charnwood 001C","E01025693","Total",1866,919,947,1859,7,20,707.94,2.6
"2011","Charnwood 001E","E01033386","Total",2199,1109,1090,2199,0,37,42.31,52.0
"2011","Charnwood 002A","E01025699","Total",1403,747,656,1397,6,5,21.55,65.1
"2011","Charnwood 002B","E01025700","Total",1786,932,854,1786,0,9,248.17,7.2
"2011","Charnwood 002C","E01025701","Total",1585,827,758,1566,19,23,21.90,72.4
"2011","Charnwood 002D","E01025703","Total",2000,1061,939,1943,57,23,33.66,59.4
"2011","Charnwood 002E","E01025704","Total",1443,744,699,1324,119,9,245.00,5.9
"2011","Charnwood 002F","E01025705","Total",1372,679,693,1326,46,13,65.28,21.0
"2011","Charnwood 002G","E01025706","Total",1689,853,836,1671,18,23,135.77,12.4
"2011","Charnwood 003A","E01025720","Total",2088,1194,894,1807,281,36,50.28,41.5
"2011","Charnwood 003B","E01025721","Total",1724,866,858,1621,103,29,35.46,48.6
"2011","Charnwood 003C","E01025722","Total",1026,498,528,1026,0,21,27.31,37.6
"2011","Charnwood 003D","E01025723","Total",2158,1211,947,1752,406,21,35.35,61.0
"2011","Charnwood 003E","E01025724","Total",1570,846,724,1542,28,18,14.30,109.8
"2011","Charnwood 003F","E01025725","Total",1316,642,674,1316,0,4,25.46,51.7
"2011","Charnwood 004A","E01025695","Total",1492,783,709,1492,0,40,184.20,8.1
"2011","Charnwood 004B","E01025696","Total",1402,706,696,1402,0,22,103.08,13.6
"2011","Charnwood 004C","E01025697","Total",1358,649,709,1318,40,19,28.52,47.6
"2011","Charnwood 004D","E01025698","Total",1577,798,779,1554,23,27,48.43,32.6
"2011","Charnwood 005A","E01025744","Total",1913,977,936,1898,15,20,338.77,5.6
"2011","Charnwood 005B","E01025745","Total",1430,691,739,1430,0,13,103.99,13.8
"2011","Charnwood 005C","E01025746","Total",1804,860,944,1748,56,32,430.75,4.2
"2011","Charnwood 005D","E01025747","Total",1839,892,947,1830,9,14,38.43,47.9
"2011","Charnwood 006A","E01025740","Total",1499,760,739,1454,45,23,564.49,2.7
"2011","Charnwood 006B","E01025741","Total",1543,763,780,1529,14,28,35.30,43.7
"2011","Charnwood 006C","E01025742","Total",1636,797,839,1538,98,18,34.52,47.4
"2011","Charnwood 006D","E01025743","Total",1841,883,958,1794,47,20,264.96,6.9
"2011","Charnwood 007A","E01025689","Total",2598,1427,1171,1954,644,31,66.74,38.9
"2011","Charnwood 007B","E01025690","Total",3889,2234,1655,1444,2445,81,51.61,75.4
"2011","Charnwood 007C","E01025707","Total",1795,1019,776,1418,377,59,38.65,46.4
"2011","Charnwood 007D","E01025709","Total",2380,1360,1020,1249,1131,59,63.92,37.2
"2011","Charnwood 008A","E01025760","Total",1347,665,682,1347,0,30,2110.30,0.6
"2011","Charnwood 008B","E01025761","Total",1808,886,922,1789,19,43,2370.52,0.8
"2011","Charnwood 008C","E01025768","Total",1440,699,741,1421,19,23,1924.94,0.7
"2011","Charnwood 008D","E01025769","Total",1561,784,777,1466,95,36,1467.26,1.1
"2011","Charnwood 009A","E01025702","Total",1230,602,628,1230,0,14,60.64,20.3
"2011","Charnwood 009B","E01025715","Total",1522,740,782,1522,0,11,39.22,38.8
"2011","Charnwood 009C","E01025716","Total",1568,763,805,1568,0,15,34.26,45.8
"2011","Charnwood 009D","E01025717","Total",2200,1074,1126,2200,0,22,132.32,16.6
"2011","Charnwood 009E","E01025718","Total",1383,689,694,1323,60,15,49.88,27.7
"2011","Charnwood 009F","E01025719","Total",1530,755,775,1526,4,40,34.83,43.9
"2011","Charnwood 010A","E01025708","Total",1265,650,615,1265,0,34,294.31,4.3
"2011","Charnwood 010B","E01025710","Total",1251,618,633,1206,45,40,345.08,3.6
"2011","Charnwood 010C","E01025711","Total",1573,765,808,1573,0,34,54.65,28.8
"2011","Charnwood 010D","E01025712","Total",1353,646,707,1353,0,26,111.62,12.1
"2011","Charnwood 010E","E01025713","Total",1520,769,751,1232,288,31,50.60,30.0
"2011","Charnwood 010F","E01025714","Total",2126,1043,1083,2126,0,40,100.36,21.2
"2011","Charnwood 011A","E01025674","Total",1543,740,803,1517,26,22,363.44,4.2
"2011","Charnwood 011B","E01025675","Total",1508,757,751,1508,0,26,109.54,13.8
"2011","Charnwood 011C","E01025676","Total",2126,1015,1111,2126,0,37,602.89,3.5
"2011","Charnwood 011D","E01025677","Total",1357,635,722,1357,0,17,54.79,24.8
"2011","Charnwood 012A","E01025732","Total",1605,787,818,1569,36,38,369.25,4.3
"2011","Charnwood 012B","E01025733","Total",1498,726,772,1498,0,29,82.13,18.2
"2011","Charnwood 012C","E01025734","Total",1562,755,807,1545,17,30,322.75,4.8
"2011","Charnwood 012D","E01025735","Total",1828,886,942,1780,48,23,334.60,5.5
"2011","Charnwood 013A","E01025748","Total",2153,1066,1087,2126,27,24,160.80,13.4
"2011","Charnwood 013B","E01025749","Total",1596,772,824,1574,22,20,459.21,3.5
"2011","Charnwood 013C","E01025750","Total",1421,714,707,1421,0,23,79.95,17.8
"2011","Charnwood 013D","E01025751","Total",2087,1033,1054,2075,12,16,105.96,19.7
"2011","Charnwood 014A","E01025726","Total",1860,895,965,1846,14,17,48.96,38.0
"2011","Charnwood 014B","E01025727","Total",1585,769,816,1556,29,11,44.53,35.6
"2011","Charnwood 014C","E01025728","Total",1848,921,927,1847,1,21,58.48,31.6
"2011","Charnwood 014D","E01025729","Total",1614,814,800,1614,0,25,42.03,38.4
"2011","Charnwood 014E","E01025737","Total",1865,911,954,1865,0,39,242.70,7.7
"2011","Charnwood 014F","E01025739","Total",1403,675,728,1399,4,23,251.91,5.6
"2011","Charnwood 015A","E01025685","Total",1406,671,735,1349,57,23,28.39,49.5
"2011","Charnwood 015B","E01025686","Total",1460,712,748,1460,0,21,159.32,9.2
"2011","Charnwood 015C","E01025730","Total",1488,713,775,1488,0,26,3059.34,0.5
"2011","Charnwood 015D","E01025731","Total",1530,742,788,1530,0,24,226.52,6.8
"2011","Charnwood 016A","E01025687","Total",1575,762,813,1575,0,47,3045.03,0.5
"2011","Charnwood 016B","E01025688","Total",1847,967,880,1526,321,46,616.92,3.0
"2011","Charnwood 016C","E01025736","Total",1466,719,747,1460,6,27,312.59,4.7
"2011","Charnwood 016D","E01025738","Total",1454,720,734,1423,31,61,946.70,1.5
"2011","Charnwood 017A","E01025756","Total",1894,933,961,1871,23,25,97.58,19.4
"2011","Charnwood 017B","E01025757","Total",1486,734,752,1486,0,14,24.52,60.6
"2011","Charnwood 017C","E01025758","Total",1796,839,957,1767,29,34,331.11,5.4
"2011","Charnwood 017D","E01025759","Total",1385,668,717,1366,19,19,62.24,22.3
"2011","Charnwood 018A","E01025752","Total",1958,987,971,1951,7,20,95.37,20.5
"2011","Charnwood 018B","E01025753","Total",1520,694,826,1520,0,8,33.17,45.8
"2011","Charnwood 018C","E01025754","Total",1270,632,638,1270,0,14,21.89,58.0
"2011","Charnwood 018D","E01025755","Total",1495,749,746,1491,4,21,26.23,57.0
"2011","Charnwood 019A","E01025679","Total",2501,1181,1320,2501,0,43,436.29,5.7
"2011","Charnwood 019B","E01025680","Total",1666,823,843,1666,0,30,27.61,60.3
"2011","Charnwood 019C","E01025681","Total",1597,779,818,1579,18,31,61.64,25.9
"2011","Charnwood 019D","E01025682","Total",1457,696,761,1457,0,15,87.38,16.7
"2011","Charnwood 020A","E01025678","Total",1735,835,900,1735,0,42,45.62,38.0
"2011","Charnwood 020B","E01025683","Total",1687,805,882,1687,0,9,24.86,67.9
"2011","Charnwood 020C","E01025684","Total",1878,915,963,1878,0,23,33.77,55.6
"2011","Charnwood 021A","E01025762","Total",1462,721,741,1444,18,8,62.73,23.3
"2011","Charnwood 021B","E01025763","Total",1657,804,853,1620,37,14,100.63,16.5
"2011","Charnwood 021C","E01025764","Total",1395,701,694,1391,4,18,27.85,50.1
"2011","Charnwood 021D","E01025765","Total",1604,774,830,1604,0,36,32.85,48.8
"2011","Charnwood 021E","E01025766","Total",2083,1019,1064,2083,0,7,122.63,17.0
"2011","Charnwood 021F","E01025767","Total",1467,749,718,1467,0,21,119.94,12.2
"2011","Charnwood 022A","E01025670","Total",1312,636,676,1312,0,11,42.40,30.9
"2011","Charnwood 022B","E01025671","Total",1847,904,943,1847,0,10,107.51,17.2
"2011","Charnwood 022C","E01025672","Total",1771,843,928,1771,0,18,197.47,9.0
"2011","Charnwood 022D","E01025673","Total",1598,754,844,1591,7,18,149.83,10.7
"2011","Harborough 002A","E01025770","Total",1863,910,953,1863,0,59,6292.60,0.3
"2011","Harborough 002B","E01025809","Total",2308,1122,1186,2275,33,80,5842.22,0.4
"2011","Harborough 002C","E01025815","Total",2030,1021,1009,2030,0,79,9697.91,0.2
"2011","Harborough 003A","E01025781","Total",1572,756,816,1572,0,31,1213.74,1.3
"2011","Harborough 003B","E01025782","Total",1303,599,704,1303,0,27,38.90,33.5
"2011","Harborough 003C","E01025783","Total",1483,725,758,1483,0,46,2272.52,0.7
"2011","Harborough 003D","E01025785","Total",2156,1030,1126,2125,31,34,733.29,2.9
"2011","Harborough 003E","E01025786","Total",1592,741,851,1592,0,22,63.39,25.1
"2011","Harborough 003F","E01025787","Total",1693,826,867,1654,39,45,805.10,2.1
"2011","Harborough 004A","E01025772","Total",2324,1151,1173,2324,0,25,76.78,30.3
"2011","Harborough 004B","E01025773","Total",1512,755,757,1512,0,23,87.17,17.3
"2011","Harborough 004C","E01025774","Total",1328,680,648,1328,0,34,142.63,9.3
"2011","Harborough 004D","E01025775","Total",1772,883,889,1772,0,19,325.57,5.4
"2011","Harborough 004E","E01025776","Total",2004,1008,996,1971,33,30,366.91,5.5
"2011","Harborough 005A","E01025771","Total",2557,1251,1306,2508,49,53,3991.83,0.6
"2011","Harborough 005B","E01025778","Total",1953,961,992,1946,7,28,373.77,5.2
"2011","Harborough 005C","E01025779","Total",1609,809,800,1609,0,22,56.36,28.5
"2011","Harborough 005D","E01025780","Total",1332,667,665,1332,0,22,82.79,16.1
"2011","Harborough 005E","E01025784","Total",1382,677,705,1330,52,36,2428.26,0.6
"2011","Harborough 005F","E01025788","Total",1212,589,623,1157,55,36,3039.81,0.4
"2011","Harborough 006A","E01025777","Total",2200,1117,1083,2200,0,47,2949.85,0.7
"2011","Harborough 006B","E01025808","Total",2587,1325,1262,2559,28,75,5087.21,0.5
"2011","Harborough 006C","E01025810","Total",2348,1163,1185,2333,15,56,4404.20,0.5
"2011","Harborough 006D","E01025816","Total",2281,1147,1134,2238,43,32,2336.88,1.0
"2011","Harborough 007A","E01025789","Total",1737,1186,551,1096,641,16,1060.03,1.6
"2011","Harborough 007B","E01025794","Total",1863,909,954,1848,15,39,237.96,7.8
"2011","Harborough 007C","E01025797","Total",1688,790,898,1688,0,31,835.03,2.0
"2011","Harborough 007D","E01025802","Total",1330,645,685,1330,0,32,73.64,18.1
"2011","Harborough 007E","E01025803","Total",1556,777,779,1556,0,55,46.81,33.2
"2011","Harborough 007F","E01025805","Total",1546,777,769,1546,0,13,85.13,18.2
"2011","Harborough 008A","E01025795","Total",1800,922,878,1680,120,24,41.72,43.1
"2011","Harborough 008B","E01025796","Total",1945,928,1017,1929,16,23,84.13,23.1
"2011","Harborough 008C","E01025801","Total",1269,614,655,1197,72,5,30.57,41.5
"2011","Harborough 008D","E01025806","Total",1518,714,804,1509,9,12,37.68,40.3
"2011","Harborough 009A","E01025798","Total",1764,852,912,1764,0,18,227.71,7.7
"2011","Harborough 009B","E01025799","Total",2137,1079,1058,2137,0,38,156.65,13.6
"2011","Harborough 009C","E01025800","Total",1154,553,601,1154,0,16,27.92,41.3
"2011","Harborough 009D","E01025804","Total",1939,943,996,1906,33,27,57.89,33.5
"2011","Harborough 009E","E01025807","Total",1402,668,734,1385,17,17,33.42,42.0
"2011","Harborough 010A","E01025790","Total",2328,1167,1161,2328,0,54,82.92,28.1
"2011","Harborough 010B","E01025791","Total",2227,1101,1126,2194,33,29,531.37,4.2
"2011","Harborough 010C","E01025792","Total",2297,1117,1180,2297,0,25,215.22,10.7
"2011","Harborough 010D","E01025793","Total",2501,1262,1239,2501,0,35,272.19,9.2
"2011","Harborough 011A","E01025812","Total",1729,813,916,1696,33,29,746.90,2.3
"2011","Harborough 011B","E01025813","Total",1604,796,808,1604,0,52,273.31,5.9
"2011","Harborough 011C","E01025814","Total",1524,759,765,1524,0,42,772.55,2.0
"2011","Harborough 011D","E01032598","Total",2123,1068,1055,2123,0,33,537.31,4.0
"2011","Hinckley and Bosworth 001A","E01025868","Total",1482,735,747,1467,15,16,73.54,20.2
"2011","Hinckley and Bosworth 001B","E01025869","Total",1478,702,776,1478,0,21,36.93,40.0
"2011","Hinckley and Bosworth 001C","E01025870","Total",1516,715,801,1462,54,30,321.01,4.7
"2011","Hinckley and Bosworth 001D","E01025871","Total",1205,609,596,1205,0,14,1093.65,1.1
"2011","Hinckley and Bosworth 001E","E01025878","Total",2605,1293,1312,2605,0,27,1746.44,1.5
"2011","Hinckley and Bosworth 002A","E01025846","Total",2029,992,1037,2029,0,28,65.51,31.0
"2011","Hinckley and Bosworth 002B","E01025847","Total",1658,810,848,1658,0,27,78.47,21.1
"2011","Hinckley and Bosworth 002C","E01025848","Total",1512,733,779,1512,0,12,636.07,2.4
"2011","Hinckley and Bosworth 003A","E01025845","Total",1597,791,806,1597,0,36,51.09,31.3
"2011","Hinckley and Bosworth 003B","E01025877","Total",1627,795,832,1627,0,15,312.47,5.2
"2011","Hinckley and Bosworth 003C","E01025879","Total",1246,592,654,1246,0,10,446.24,2.8
"2011","Hinckley and Bosworth 003D","E01025880","Total",1595,765,830,1595,0,20,116.47,13.7
"2011","Hinckley and Bosworth 004A","E01025819","Total",1650,801,849,1650,0,27,1452.89,1.1
"2011","Hinckley and Bosworth 004B","E01025820","Total",1600,812,788,1600,0,22,285.64,5.6
"2011","Hinckley and Bosworth 004C","E01025837","Total",2013,1017,996,2013,0,63,2781.98,0.7
"2011","Hinckley and Bosworth 004D","E01025838","Total",1479,705,774,1418,61,31,912.37,1.6
"2011","Hinckley and Bosworth 004E","E01025882","Total",1631,789,842,1631,0,28,4005.35,0.4
"2011","Hinckley and Bosworth 005A","E01025872","Total",1494,745,749,1494,0,23,369.97,4.0
"2011","Hinckley and Bosworth 005B","E01025873","Total",1564,772,792,1563,1,34,2370.19,0.7
"2011","Hinckley and Bosworth 005C","E01025874","Total",1552,762,790,1552,0,16,130.97,11.9
"2011","Hinckley and Bosworth 005D","E01025875","Total",1518,727,791,1506,12,6,439.25,3.5
"2011","Hinckley and Bosworth 005E","E01025876","Total",1881,919,962,1802,79,35,1082.00,1.7
"2011","Hinckley and Bosworth 006A","E01025839","Total",1647,824,823,1615,32,11,36.00,45.8
"2011","Hinckley and Bosworth 006B","E01025840","Total",1513,745,768,1513,0,7,52.10,29.0
"2011","Hinckley and Bosworth 006C","E01025841","Total",1700,841,859,1700,0,12,306.77,5.5
"2011","Hinckley and Bosworth 006D","E01025842","Total",1835,886,949,1835,0,17,247.80,7.4
"2011","Hinckley and Bosworth 006E","E01025843","Total",1613,787,826,1573,40,7,117.10,13.8
"2011","Hinckley and Bosworth 006F","E01025844","Total",1739,866,873,1716,23,8,60.64,28.7
"2011","Hinckley and Bosworth 007A","E01025821","Total",1697,834,863,1654,43,12,47.22,35.9
"2011","Hinckley and Bosworth 007B","E01025822","Total",1424,682,742,1424,0,5,28.11,50.7
"2011","Hinckley and Bosworth 007C","E01025823","Total",1551,778,773,1551,0,12,58.46,26.5
"2011","Hinckley and Bosworth 007D","E01025824","Total",1489,719,770,1447,42,13,139.72,10.7
"2011","Hinckley and Bosworth 007E","E01025825","Total",1454,719,735,1454,0,7,392.55,3.7
"2011","Hinckley and Bosworth 007F","E01025826","Total",1407,702,705,1397,10,22,187.26,7.5
"2011","Hinckley and Bosworth 008A","E01025817","Total",1965,983,982,1964,1,38,809.00,2.4
"2011","Hinckley and Bosworth 008B","E01025818","Total",1490,765,725,1343,147,19,4084.39,0.4
"2011","Hinckley and Bosworth 008C","E01025864","Total",1591,810,781,1591,0,10,344.66,4.6
"2011","Hinckley and Bosworth 008D","E01025881","Total",1373,681,692,1373,0,24,1573.36,0.9
"2011","Hinckley and Bosworth 009A","E01025859","Total",1386,672,714,1383,3,30,67.58,20.5
"2011","Hinckley and Bosworth 009B","E01025860","Total",1429,717,712,1429,0,30,147.12,9.7
"2011","Hinckley and Bosworth 009C","E01025861","Total",1687,844,843,1679,8,28,50.60,33.3
"2011","Hinckley and Bosworth 009D","E01025862","Total",1451,702,749,1451,0,15,176.52,8.2
"2011","Hinckley and Bosworth 010A","E01025850","Total",1428,707,721,1369,59,19,27.11,52.7
"2011","Hinckley and Bosworth 010B","E01025852","Total",1683,903,780,1642,41,16,48.31,34.8
"2011","Hinckley and Bosworth 010C","E01025858","Total",1852,951,901,1807,45,13,41.41,44.7
"2011","Hinckley and Bosworth 010D","E01025863","Total",1646,785,861,1645,1,10,34.81,47.3
"2011","Hinckley and Bosworth 010E","E01025865","Total",1766,880,886,1765,1,12,27.62,63.9
"2011","Hinckley and Bosworth 011A","E01025853","Total",2790,1371,1419,2787,3,23,274.49,10.2
"2011","Hinckley and Bosworth 011B","E01025854","Total",1749,886,863,1749,0,14,36.35,48.1
"2011","Hinckley and Bosworth 011C","E01025855","Total",1410,692,718,1409,1,12,32.02,44.0
"2011","Hinckley and Bosworth 011D","E01025866","Total",1592,775,817,1582,10,5,44.50,35.8
"2011","Hinckley and Bosworth 011E","E01025867","Total",1531,756,775,1522,9,11,29.63,51.7
"2011","Hinckley and Bosworth 012A","E01025849","Total",1633,818,815,1633,0,7,54.54,29.9
"2011","Hinckley and Bosworth 012B","E01025851","Total",1297,647,650,1297,0,12,36.29,35.7
"2011","Hinckley and Bosworth 012C","E01025856","Total",1307,619,688,1292,15,7,28.76,45.4
"2011","Hinckley and Bosworth 012D","E01025857","Total",1453,726,727,1453,0,15,26.74,54.3
"2011","Hinckley and Bosworth 013A","E01025827","Total",1408,657,751,1408,0,14,49.81,28.3
"2011","Hinckley and Bosworth 013B","E01025828","Total",1420,694,726,1420,0,14,192.19,7.4
"2011","Hinckley and Bosworth 013C","E01025829","Total",1442,688,754,1442,0,11,35.30,40.8
"2011","Hinckley and Bosworth 013D","E01025830","Total",1436,694,742,1396,40,9,60.07,23.9
"2011","Hinckley and Bosworth 014A","E01025831","Total",1292,634,658,1292,0,16,22.21,58.2
"2011","Hinckley and Bosworth 014B","E01025832","Total",1585,812,773,1585,0,46,144.39,11.0
"2011","Hinckley and Bosworth 014C","E01025833","Total",1608,765,843,1603,5,15,474.48,3.4
"2011","Hinckley and Bosworth 014D","E01025834","Total",1497,731,766,1497,0,25,69.58,21.5
"2011","Hinckley and Bosworth 014E","E01025835","Total",1585,754,831,1583,2,16,187.14,8.5
"2011","Hinckley and Bosworth 014F","E01025836","Total",1295,617,678,1295,0,12,21.70,59.7
"2011","Melton 001A","E01025885","Total",1831,896,935,1831,0,40,2476.86,0.7
"2011","Melton 001B","E01025886","Total",1756,842,914,1756,0,21,222.84,7.9
"2011","Melton 001C","E01025887","Total",1803,885,918,1803,0,57,7589.53,0.2
"2011","Melton 001D","E01025890","Total",1265,646,619,1265,0,25,1715.12,0.7
"2011","Melton 001E","E01025891","Total",1312,641,671,1312,0,23,1510.63,0.9
"2011","Melton 001F","E01025892","Total",1649,799,850,1649,0,22,2799.14,0.6
"2011","Melton 002A","E01025901","Total",1720,826,894,1697,23,17,159.40,10.8
"2011","Melton 002B","E01025902","Total",1622,787,835,1622,0,28,185.56,8.7
"2011","Melton 002C","E01025903","Total",1750,876,874,1750,0,18,149.58,11.7
"2011","Melton 002D","E01025904","Total",2026,984,1042,2026,0,21,302.07,6.7
"2011","Melton 002E","E01025906","Total",1788,871,917,1755,33,18,37.28,48.0
"2011","Melton 003A","E01025883","Total",1568,761,807,1568,0,20,321.79,4.9
"2011","Melton 003B","E01025884","Total",1718,826,892,1718,0,11,736.45,2.3
"2011","Melton 003C","E01025888","Total",1776,873,903,1757,19,40,4915.06,0.4
"2011","Melton 003D","E01025909","Total",1934,921,1013,1896,38,38,3467.21,0.6
"2011","Melton 004A","E01025896","Total",1624,813,811,1624,0,16,316.57,5.1
"2011","Melton 004B","E01025897","Total",2037,975,1062,2026,11,11,92.52,22.0
"2011","Melton 004C","E01025898","Total",1341,647,694,1287,54,4,238.20,5.6
"2011","Melton 004D","E01025899","Total",1155,589,566,1089,66,12,43.46,26.6
"2011","Melton 004E","E01025900","Total",1499,709,790,1499,0,4,74.92,20.0
"2011","Melton 004F","E01025905","Total",1727,837,890,1727,0,8,28.81,59.9
"2011","Melton 005A","E01025893","Total",2067,1031,1036,2067,0,29,230.57,9.0
"2011","Melton 005B","E01025894","Total",1508,758,750,1503,5,16,95.86,15.7
"2011","Melton 005C","E01025895","Total",1712,850,862,1712,0,13,90.03,19.0
"2011","Melton 005D","E01025907","Total",1781,879,902,1741,40,20,174.10,10.2
"2011","Melton 005E","E01025908","Total",1801,881,920,1741,60,34,87.26,20.6
"2011","Melton 006A","E01025889","Total",1747,874,873,1747,0,38,4513.95,0.4
"2011","Melton 006B","E01025910","Total",1756,902,854,1719,37,53,4511.83,0.4
"2011","Melton 006C","E01025911","Total",1575,744,831,1501,74,31,3026.31,0.5
"2011","Melton 006D","E01025912","Total",1528,795,733,1528,0,38,8024.77,0.2
"2011","North West Leicestershire 001A","E01025924","Total",1029,509,520,1029,0,27,1717.00,0.6
"2011","North West Leicestershire 001B","E01025925","Total",2533,1295,1238,2476,57,25,1718.12,1.5
"2011","North West Leicestershire 001C","E01025926","Total",1577,797,780,1567,10,25,606.43,2.6
"2011","North West Leicestershire 001D","E01025927","Total",1619,816,803,1619,0,16,368.06,4.4
"2011","North West Leicestershire 001E","E01025928","Total",1525,771,754,1524,1,30,36.54,41.7
"2011","North West Leicestershire 002A","E01025923","Total",1370,676,694,1370,0,32,1732.28,0.8
"2011","North West Leicestershire 002B","E01025944","Total",1511,755,756,1487,24,31,1699.64,0.9
"2011","North West Leicestershire 002C","E01025945","Total",1533,743,790,1522,11,23,87.40,17.5
"2011","North West Leicestershire 002D","E01025946","Total",1681,808,873,1655,26,16,314.46,5.3
"2011","North West Leicestershire 003A","E01025915","Total",1293,654,639,1242,51,27,56.56,22.9
"2011","North West Leicestershire 003B","E01025916","Total",1469,739,730,1467,2,26,54.29,27.1
"2011","North West Leicestershire 003C","E01025917","Total",2042,1035,1007,2042,0,24,895.78,2.3
"2011","North West Leicestershire 003D","E01025918","Total",1559,740,819,1553,6,24,34.30,45.5
"2011","North West Leicestershire 004A","E01025960","Total",1473,744,729,1455,18,14,51.30,28.7
"2011","North West Leicestershire 004B","E01025961","Total",1473,726,747,1473,0,14,132.43,11.1
"2011","North West Leicestershire 004C","E01025962","Total",1421,683,738,1389,32,6,74.10,19.2
"2011","North West Leicestershire 004D","E01025965","Total",1270,659,611,1270,0,12,469.03,2.7
"2011","North West Leicestershire 005A","E01025955","Total",1369,676,693,1369,0,28,1597.91,0.9
"2011","North West Leicestershire 005B","E01025956","Total",1153,549,604,1125,28,15,428.62,2.7
"2011","North West Leicestershire 005C","E01025963","Total",1538,773,765,1538,0,26,1288.13,1.2
"2011","North West Leicestershire 005D","E01025964","Total",1652,812,840,1652,0,43,1710.27,1.0
"2011","North West Leicestershire 006A","E01025914","Total",1386,694,692,1386,0,37,117.93,11.8
"2011","North West Leicestershire 006B","E01025919","Total",1520,727,793,1446,74,27,152.78,9.9
"2011","North West Leicestershire 006C","E01025920","Total",1641,792,849,1624,17,25,103.93,15.8
"2011","North West Leicestershire 006D","E01025921","Total",1620,763,857,1577,43,23,608.33,2.7
"2011","North West Leicestershire 007A","E01025966","Total",1557,775,782,1557,0,24,155.52,10.0
"2011","North West Leicestershire 007B","E01025967","Total",1659,793,866,1652,7,17,195.08,8.5
"2011","North West Leicestershire 007C","E01025968","Total",1852,929,923,1852,0,26,68.29,27.1
"2011","North West Leicestershire 007D","E01025969","Total",1799,866,933,1780,19,17,106.94,16.8
"2011","North West Leicestershire 008A","E01025950","Total",1683,836,847,1683,0,13,537.14,3.1
"2011","North West Leicestershire 008B","E01025951","Total",1789,875,914,1769,20,28,446.19,4.0
"2011","North West Leicestershire 008C","E01025952","Total",1450,697,753,1450,0,10,314.58,4.6
"2011","North West Leicestershire 008D","E01025953","Total",1121,552,569,1121,0,8,281.44,4.0
"2011","North West Leicestershire 008E","E01025954","Total",1516,761,755,1516,0,20,453.39,3.3
"2011","North West Leicestershire 009A","E01025932","Total",1491,728,763,1454,37,2,31.28,47.7
"2011","North West Leicestershire 009B","E01025933","Total",1360,698,662,1352,8,5,27.85,48.8
"2011","North West Leicestershire 009C","E01025934","Total",1615,780,835,1576,39,16,1437.07,1.1
"2011","North West Leicestershire 009D","E01025935","Total",1172,555,617,1172,0,8,80.86,14.5
"2011","North West Leicestershire 009E","E01025936","Total",1269,604,665,1262,7,16,57.98,21.9
"2011","North West Leicestershire 010A","E01025929","Total",2145,1073,1072,2106,39,25,54.95,39.0
"2011","North West Leicestershire 010B","E01025930","Total",1655,836,819,1584,71,11,91.44,18.1
"2011","North West Leicestershire 010C","E01025931","Total",1734,854,880,1734,0,7,30.05,57.7
"2011","North West Leicestershire 010D","E01025957","Total",1859,900,959,1846,13,11,89.54,20.8
"2011","North West Leicestershire 011B","E01025937","Total",1565,757,808,1565,0,18,191.36,8.2
"2011","North West Leicestershire 011C","E01025958","Total",1622,802,820,1622,0,17,75.12,21.6
"2011","North West Leicestershire 011D","E01025959","Total",2116,1053,1063,2116,0,16,211.05,10.0
"2011","North West Leicestershire 011E","E01033102","Total",1621,827,794,1621,0,11,527.33,3.1
"2011","North West Leicestershire 011F","E01033103","Total",1752,870,882,1752,0,20,73.38,23.9
"2011","North West Leicestershire 012A","E01025913","Total",2252,1183,1069,2204,48,62,3510.51,0.6
"2011","North West Leicestershire 012B","E01025947","Total",1799,908,891,1799,0,19,284.42,6.3
"2011","North West Leicestershire 012C","E01025948","Total",1736,895,841,1736,0,17,343.46,5.1
"2011","North West Leicestershire 012D","E01025949","Total",1674,838,836,1674,0,9,79.25,21.1
"2011","North West Leicestershire 013A","E01025938","Total",1239,614,625,1239,0,16,216.70,5.7
"2011","North West Leicestershire 013B","E01025939","Total",1988,977,1011,1977,11,13,422.71,4.7
"2011","North West Leicestershire 013C","E01025940","Total",1957,986,971,1957,0,22,584.19,3.3
"2011","North West Leicestershire 013D","E01025941","Total",1512,764,748,1512,0,7,528.34,2.9
"2011","North West Leicestershire 013E","E01025942","Total",1782,895,887,1782,0,33,90.11,19.8
"2011","North West Leicestershire 013F","E01025943","Total",1870,918,952,1818,52,11,279.71,6.7
"2011","Oadby and Wigston 003A","E01025970","Total",1414,674,740,1414,0,20,110.91,12.7
"2011","Oadby and Wigston 003B","E01025971","Total",1248,588,660,1226,22,31,27.12,46.0
"2011","Oadby and Wigston 003C","E01025972","Total",1291,608,683,1228,63,33,63.30,20.4
"2011","Oadby and Wigston 003D","E01025976","Total",1359,652,707,1352,7,18,47.01,28.9
"2011","Oadby and Wigston 003E","E01025977","Total",1351,644,707,1333,18,17,118.79,11.4
"2011","Oadby and Wigston 003F","E01025978","Total",1515,720,795,1510,5,22,33.67,45.0
"2011","Oadby and Wigston 005A","E01025992","Total",1569,684,885,1465,104,6,48.39,32.4
"2011","Oadby and Wigston 005B","E01025994","Total",1536,768,768,1536,0,10,60.79,25.3
"2011","Oadby and Wigston 005C","E01025997","Total",1477,682,795,1447,30,7,23.45,63.0
"2011","Oadby and Wigston 005D","E01025999","Total",1426,705,721,1426,0,17,28.54,50.0
"2011","Oadby and Wigston 005E","E01026005","Total",1766,823,943,1670,96,10,27.32,64.6
"2011","Oadby and Wigston 006A","E01025985","Total",1312,631,681,1312,0,10,49.52,26.5
"2011","Oadby and Wigston 006B","E01025986","Total",1479,712,767,1409,70,10,32.00,46.2
"2011","Oadby and Wigston 006C","E01025987","Total",1488,731,757,1441,47,11,48.76,30.5
"2011","Oadby and Wigston 006D","E01025988","Total",1567,748,819,1567,0,6,104.71,15.0
"2011","Oadby and Wigston 006E","E01025989","Total",1644,790,854,1644,0,5,81.08,20.3
"2011","Oadby and Wigston 007A","E01025990","Total",1352,640,712,1352,0,15,45.71,29.6
"2011","Oadby and Wigston 007B","E01025991","Total",1475,728,747,1475,0,20,142.04,10.4
"2011","Oadby and Wigston 007C","E01025993","Total",1503,722,781,1503,0,23,27.81,54.0
"2011","Oadby and Wigston 007D","E01025998","Total",1772,871,901,1766,6,28,396.92,4.5
"2011","Oadby and Wigston 007E","E01026000","Total",1321,660,661,1321,0,22,50.36,26.2
"2011","Oadby and Wigston 007F","E01026001","Total",1379,688,691,1379,0,15,29.44,46.8
"2011","Oadby and Wigston 008A","E01025995","Total",1495,738,757,1495,0,15,34.54,43.3
"2011","Oadby and Wigston 008B","E01026003","Total",1622,774,848,1603,19,16,38.69,41.9
"2011","Oadby and Wigston 008C","E01026004","Total",1731,856,875,1731,0,32,39.28,44.1
"2011","Oadby and Wigston 008D","E01032600","Total",1954,939,1015,1954,0,30,36.23,53.9
"2011","Oadby and Wigston 008E","E01032601","Total",1453,707,746,1453,0,10,25.14,57.8
"2011","Oadby and Wigston 009A","E01025973","Total",2816,1396,1420,1742,1074,88,127.07,22.2
"2011","Oadby and Wigston 009B","E01025974","Total",2320,1145,1175,1476,844,56,62.89,36.9
"2011","Oadby and Wigston 009C","E01025975","Total",1471,729,742,1471,0,40,103.85,14.2
"2011","Oadby and Wigston 009E","E01025979","Total",1400,671,729,1400,0,25,22.16,63.2
"2011","Oadby and Wigston 009D","E01025980","Total",1399,679,720,1399,0,32,58.61,23.9
"2011","Oadby and Wigston 009F","E01025981","Total",1624,807,817,1624,0,52,36.07,45.0
"2011","Oadby and Wigston 009G","E01025982","Total",1934,966,968,1934,0,76,112.18,17.2
"2011","Oadby and Wigston 009H","E01025983","Total",1226,584,642,1226,0,38,22.85,53.7
"2011","Oadby and Wigston 009I","E01025984","Total",1481,709,772,1481,0,39,35.13,42.2
"2011","Boston 001A","E01026007","Total",1106,549,557,1106,0,18,676.66,1.6
"2011","Boston 001B","E01026008","Total",1502,909,593,1171,331,11,2120.71,0.7
"2011","Boston 001C","E01026009","Total",1269,649,620,1269,0,14,2481.51,0.5
"2011","Boston 001D","E01026023","Total",1397,695,702,1375,22,13,2752.73,0.5
"2011","Boston 001E","E01026024","Total",2022,973,1049,2022,0,30,2405.05,0.8
"2011","Boston 002A","E01026010","Total",1478,702,776,1478,0,7,41.42,35.7
"2011","Boston 002B","E01026011","Total",2990,1443,1547,2990,0,12,137.77,21.7
"2011","Boston 002C","E01026030","Total",2200,1052,1148,2176,24,14,42.94,51.2
"2011","Boston 002D","E01026032","Total",2031,1008,1023,2031,0,9,40.37,50.3
"2011","Boston 002E","E01026037","Total",1322,638,684,1322,0,7,30.39,43.5
"2011","Boston 003A","E01026006","Total",2558,1308,1250,2540,18,17,71.98,35.5
"2011","Boston 003B","E01026021","Total",1763,851,912,1730,33,24,101.70,17.3
"2011","Boston 003C","E01026025","Total",2182,1079,1103,2127,55,20,92.88,23.5
"2011","Boston 003D","E01026036","Total",1628,813,815,1581,47,11,55.23,29.5
"2011","Boston 004A","E01026012","Total",1150,540,610,1150,0,4,51.56,22.3
"2011","Boston 004B","E01026015","Total",1460,714,746,1447,13,13,72.29,20.2
"2011","Boston 004C","E01026026","Total",1954,912,1042,1954,0,7,41.34,47.3
"2011","Boston 004D","E01026027","Total",1847,894,953,1836,11,16,44.16,41.8
"2011","Boston 004E","E01026028","Total",1818,840,978,1800,18,17,35.74,50.9
"2011","Boston 006A","E01026016","Total",2312,1153,1159,2312,0,26,3256.94,0.7
"2011","Boston 006B","E01026033","Total",1987,992,995,1987,0,30,7913.19,0.3
"2011","Boston 006C","E01026034","Total",1786,876,910,1786,0,11,1022.08,1.7
"2011","Boston 007A","E01026017","Total",1571,773,798,1571,0,15,2750.56,0.6
"2011","Boston 007B","E01026018","Total",1671,830,841,1646,25,16,2997.63,0.6
"2011","Boston 007C","E01026019","Total",2754,1290,1464,2754,0,32,1529.25,1.8
"2011","Boston 007D","E01026020","Total",2245,1088,1157,2195,50,27,779.50,2.9
"2011","Boston 007E","E01026041","Total",1300,605,695,1300,0,7,168.89,7.7
"2011","Boston 008A","E01026013","Total",1446,696,750,1446,0,31,774.11,1.9
"2011","Boston 008B","E01026014","Total",1944,914,1030,1904,40,31,1171.54,1.7
"2011","Boston 008C","E01026022","Total",2104,994,1110,2071,33,43,521.04,4.0
"2011","Boston 008D","E01026038","Total",1256,577,679,1256,0,14,149.33,8.4
"2011","Boston 008E","E01026040","Total",1253,624,629,1242,11,15,850.06,1.5
"2011","Boston 009A","E01026029","Total",2617,1278,1339,2517,100,33,276.38,9.5
"2011","Boston 009B","E01026031","Total",1457,699,758,1387,70,12,40.90,35.6
"2011","Boston 009C","E01026035","Total",2063,981,1082,2063,0,28,119.85,17.2
"2011","Boston 009D","E01026039","Total",1194,597,597,1194,0,16,536.09,2.2
"2011","East Lindsey 001A","E01026045","Total",1831,900,931,1813,18,27,6801.38,0.3
"2011","East Lindsey 001B","E01026061","Total",1201,595,606,1201,0,22,206.43,5.8
"2011","East Lindsey 001C","E01026062","Total",1227,598,629,1227,0,13,314.20,3.9
"2011","East Lindsey 001D","E01026063","Total",1263,634,629,1263,0,20,92.68,13.6
"2011","East Lindsey 001E","E01026080","Total",1933,935,998,1933,0,32,3841.94,0.5
"2011","East Lindsey 001F","E01026106","Total",1194,563,631,1164,30,24,146.59,8.1
"2011","East Lindsey 001G","E01026107","Total",1255,621,634,1177,78,28,3231.26,0.4
"2011","East Lindsey 002A","E01026058","Total",2181,1083,1098,2181,0,24,2849.45,0.8
"2011","East Lindsey 002B","E01026076","Total",2194,1082,1112,2194,0,31,5846.67,0.4
"2011","East Lindsey 002C","E01026079","Total",1963,965,998,1963,0,14,3877.05,0.5
"2011","East Lindsey 003A","E01026077","Total",1133,544,589,1133,0,13,302.87,3.7
"2011","East Lindsey 003B","E01026078","Total",1141,556,585,1107,34,8,31.80,35.9
"2011","East Lindsey 003C","E01026087","Total",1183,552,631,1183,0,5,33.96,34.8
"2011","East Lindsey 003D","E01026088","Total",1347,633,714,1255,92,23,34.88,38.6
"2011","East Lindsey 003E","E01026090","Total",1345,630,715,1307,38,17,111.50,12.1
"2011","East Lindsey 003F","E01026091","Total",1080,517,563,1080,0,20,103.39,10.4
"2011","East Lindsey 003G","E01026108","Total",2404,1141,1263,2404,0,34,51.03,47.1
"2011","East Lindsey 004A","E01026081","Total",2350,1128,1222,2325,25,31,62.00,37.9
"2011","East Lindsey 004C","E01026089","Total",2005,948,1057,1987,18,38,342.00,5.9
"2011","East Lindsey 004D","E01032986","Total",1131,575,556,1106,25,16,35.10,32.2
"2011","East Lindsey 004E","E01032987","Total",1300,615,685,1279,21,19,29.60,43.9
"2011","East Lindsey 005A","E01026072","Total",1983,926,1057,1863,120,9,294.29,6.7
"2011","East Lindsey 005B","E01026073","Total",2005,973,1032,1975,30,8,66.09,30.3
"2011","East Lindsey 005C","E01026074","Total",2028,982,1046,2010,18,17,726.89,2.8
"2011","East Lindsey 005D","E01026099","Total",2066,1041,1025,2042,24,30,6267.96,0.3
"2011","East Lindsey 006A","E01026103","Total",2087,971,1116,1965,122,17,275.53,7.6
"2011","East Lindsey 006B","E01026104","Total",2269,1055,1214,2264,5,17,439.39,5.2
"2011","East Lindsey 006C","E01026109","Total",2159,1063,1096,2156,3,3,819.37,2.6
"2011","East Lindsey 007A","E01026071","Total",2128,1060,1068,2127,1,31,11410.36,0.2
"2011","East Lindsey 007B","E01026082","Total",2270,1113,1157,2230,40,44,12253.84,0.2
"2011","East Lindsey 007C","E01026121","Total",2469,1195,1274,2463,6,22,4541.81,0.5
"2011","East Lindsey 008A","E01026042","Total",1530,708,822,1502,28,6,651.19,2.3
"2011","East Lindsey 008B","E01026043","Total",1635,776,859,1607,28,20,174.70,9.4
"2011","East Lindsey 008C","E01026044","Total",1366,665,701,1337,29,18,3321.53,0.4
"2011","East Lindsey 008D","E01026113","Total",2027,1025,1002,2020,7,16,6986.22,0.3
"2011","East Lindsey 008E","E01026117","Total",1826,916,910,1795,31,35,7826.47,0.2
"2011","East Lindsey 009A","E01026060","Total",1321,637,684,1275,46,23,3484.93,0.4
"2011","East Lindsey 009B","E01026068","Total",2107,1043,1064,2090,17,34,9762.70,0.2
"2011","East Lindsey 009C","E01026070","Total",1891,939,952,1891,0,32,13466.55,0.1
"2011","East Lindsey 009D","E01026105","Total",2196,1084,1112,2162,34,39,11483.32,0.2
"2011","East Lindsey 010A","E01026048","Total",1517,738,779,1486,31,7,247.57,6.1
"2011","East Lindsey 010B","E01026049","Total",1556,780,776,1537,19,8,2117.89,0.7
"2011","East Lindsey 010C","E01026050","Total",1601,759,842,1601,0,7,126.95,12.6
"2011","East Lindsey 010D","E01026069","Total",2392,1199,1193,1989,403,5,1602.72,1.5
"2011","East Lindsey 011A","E01026064","Total",1455,728,727,1455,0,12,185.40,7.8
"2011","East Lindsey 011B","E01026065","Total",1816,855,961,1763,53,25,162.30,11.2
"2011","East Lindsey 011C","E01026066","Total",1892,896,996,1892,0,10,705.10,2.7
"2011","East Lindsey 011D","E01026067","Total",1910,930,980,1874,36,18,81.67,23.4
"2011","East Lindsey 012A","E01026084","Total",1598,763,835,1550,48,4,72.03,22.2
"2011","East Lindsey 012B","E01026085","Total",2226,1039,1187,2192,34,3,298.49,7.5
"2011","East Lindsey 012C","E01026115","Total",1755,846,909,1684,71,15,332.67,5.3
"2011","East Lindsey 012D","E01026116","Total",1700,795,905,1670,30,28,89.19,19.1
"2011","East Lindsey 013A","E01026046","Total",1141,542,599,1135,6,10,1572.70,0.7
"2011","East Lindsey 013B","E01026047","Total",1199,581,618,1190,9,14,206.99,5.8
"2011","East Lindsey 013C","E01026055","Total",1117,568,549,1117,0,24,2644.54,0.4
"2011","East Lindsey 013D","E01026059","Total",1174,589,585,1081,93,16,2065.02,0.6
"2011","East Lindsey 013E","E01026100","Total",1782,840,942,1782,0,11,284.68,6.3
"2011","East Lindsey 013F","E01026101","Total",1263,590,673,1210,53,4,215.71,5.9
"2011","East Lindsey 014A","E01026092","Total",1431,711,720,1407,24,8,51.87,27.6
"2011","East Lindsey 014B","E01026093","Total",1741,899,842,1628,113,14,72.07,24.2
"2011","East Lindsey 014C","E01026095","Total",1207,575,632,1078,129,16,59.88,20.2
"2011","East Lindsey 014D","E01026114","Total",1482,731,751,1416,66,8,49.83,29.7
"2011","East Lindsey 015A","E01026083","Total",1770,837,933,1770,0,9,93.64,18.9
"2011","East Lindsey 015B","E01026094","Total",1668,766,902,1668,0,6,234.05,7.1
"2011","East Lindsey 015C","E01026096","Total",1512,701,811,1462,50,32,190.84,7.9
"2011","East Lindsey 015D","E01026097","Total",1489,688,801,1487,2,12,90.95,16.4
"2011","East Lindsey 016A","E01026051","Total",1244,637,607,1244,0,10,575.64,2.2
"2011","East Lindsey 016B","E01026052","Total",1496,752,744,1496,0,16,837.83,1.8
"2011","East Lindsey 016C","E01026053","Total",2042,1004,1038,2042,0,29,1761.43,1.2
"2011","East Lindsey 016D","E01026054","Total",2161,1245,916,1597,564,10,188.14,11.5
"2011","East Lindsey 016E","E01026118","Total",1687,826,861,1682,5,24,990.23,1.7
"2011","East Lindsey 016F","E01026119","Total",1164,570,594,1076,88,28,927.55,1.3
"2011","East Lindsey 016G","E01026120","Total",1447,679,768,1404,43,27,155.63,9.3
"2011","East Lindsey 017A","E01026056","Total",1171,595,576,1171,0,12,3684.49,0.3
"2011","East Lindsey 017B","E01026110","Total",1439,704,735,1439,0,20,1757.16,0.8
"2011","East Lindsey 017C","E01026111","Total",1563,775,788,1563,0,11,3501.75,0.4
"2011","East Lindsey 017D","E01026112","Total",1190,564,626,1149,41,6,2240.44,0.5
"2011","East Lindsey 018A","E01026057","Total",1920,966,954,1920,0,37,7393.31,0.3
"2011","East Lindsey 018B","E01026075","Total",2123,1034,1089,2123,0,30,7947.35,0.3
"2011","East Lindsey 018C","E01026098","Total",1979,981,998,1979,0,34,2216.49,0.9
"2011","East Lindsey 018D","E01026102","Total",2357,1162,1195,2335,22,30,5394.47,0.4
"2011","Lincoln 001A","E01026149","Total",1631,783,848,1631,0,10,32.30,50.5
"2011","Lincoln 001B","E01026150","Total",1464,713,751,1418,46,9,34.39,42.6
"2011","Lincoln 001C","E01026166","Total",1219,570,649,1194,25,11,26.53,45.9
"2011","Lincoln 001D","E01026168","Total",1422,658,764,1422,0,5,24.09,59.0
"2011","Lincoln 002A","E01026153","Total",2471,1200,1271,2392,79,29,53.38,46.3
"2011","Lincoln 002B","E01026155","Total",1611,773,838,1611,0,18,32.55,49.5
"2011","Lincoln 002C","E01026157","Total",1353,635,718,1335,18,3,34.61,39.1
"2011","Lincoln 002D","E01026165","Total",1376,638,738,1376,0,4,60.68,22.7
"2011","Lincoln 003A","E01026125","Total",1564,1005,559,1070,494,15,60.03,26.1
"2011","Lincoln 003B","E01026144","Total",1503,782,721,1500,3,23,67.94,22.1
"2011","Lincoln 003C","E01026147","Total",2301,1140,1161,2255,46,33,342.72,6.7
"2011","Lincoln 003D","E01026148","Total",1767,843,924,1753,14,8,27.42,64.4
"2011","Lincoln 003E","E01026151","Total",1842,892,950,1832,10,15,55.57,33.1
"2011","Lincoln 003F","E01026164","Total",1460,646,814,1243,217,37,50.33,29.0
"2011","Lincoln 003G","E01026167","Total",1517,724,793,1460,57,40,66.00,23.0
"2011","Lincoln 004A","E01026122","Total",1890,983,907,1547,343,30,47.77,39.6
"2011","Lincoln 004B","E01026123","Total",2291,1107,1184,2291,0,16,213.91,10.7
"2011","Lincoln 004C","E01026124","Total",1527,777,750,1527,0,12,39.63,38.5
"2011","Lincoln 004D","E01026126","Total",1678,961,717,1607,71,13,28.05,59.8
"2011","Lincoln 004E","E01026152","Total",1543,722,821,1543,0,7,22.20,69.5
"2011","Lincoln 004F","E01026154","Total",1408,681,727,1408,0,7,30.57,46.1
"2011","Lincoln 004G","E01026156","Total",1263,592,671,1263,0,14,22.64,55.8
"2011","Lincoln 005A","E01026132","Total",2756,1289,1467,1305,1451,49,108.46,25.4
"2011","Lincoln 005B","E01026143","Total",2213,1062,1151,1636,577,43,38.48,57.5
"2011","Lincoln 005C","E01026145","Total",1528,745,783,1521,7,24,23.31,65.6
"2011","Lincoln 005D","E01026146","Total",1976,913,1063,1577,399,32,15.93,124.0
"2011","Lincoln 006A","E01026134","Total",1533,752,781,1484,49,7,18.90,81.1
"2011","Lincoln 006B","E01026176","Total",1672,853,819,1656,16,9,220.03,7.6
"2011","Lincoln 006C","E01026177","Total",1884,934,950,1855,29,17,12.19,154.6
"2011","Lincoln 006D","E01026178","Total",1670,873,797,1634,36,13,90.50,18.5
"2011","Lincoln 007A","E01026127","Total",1386,677,709,1386,0,10,19.66,70.5
"2011","Lincoln 007B","E01026128","Total",2646,1290,1356,2646,0,20,94.36,28.0
"2011","Lincoln 007C","E01026129","Total",1771,828,943,1771,0,9,45.43,39.0
"2011","Lincoln 007D","E01026131","Total",1389,673,716,1389,0,12,30.36,45.8
"2011","Lincoln 008A","E01026133","Total",3431,1710,1721,2164,1267,55,184.51,18.6
"2011","Lincoln 008B","E01026135","Total",1657,837,820,1631,26,16,76.45,21.7
"2011","Lincoln 008C","E01026136","Total",1434,705,729,1434,0,10,251.33,5.7
"2011","Lincoln 008D","E01026174","Total",1396,678,718,1334,62,15,68.24,20.5
"2011","Lincoln 009A","E01026130","Total",1328,648,680,1312,16,14,54.88,24.2
"2011","Lincoln 009B","E01026158","Total",1468,693,775,1431,37,3,82.76,17.7
"2011","Lincoln 009C","E01026159","Total",1491,695,796,1452,39,9,30.76,48.5
"2011","Lincoln 009D","E01026160","Total",1352,642,710,1352,0,11,32.60,41.5
"2011","Lincoln 009E","E01026162","Total",1485,728,757,1430,55,17,110.26,13.5
"2011","Lincoln 009F","E01026163","Total",1362,706,656,1362,0,17,70.19,19.4
"2011","Lincoln 010A","E01026161","Total",1382,661,721,1339,43,3,31.21,44.3
"2011","Lincoln 010B","E01026170","Total",1449,687,762,1449,0,12,48.37,30.0
"2011","Lincoln 010C","E01026172","Total",1423,708,715,1423,0,11,24.72,57.6
"2011","Lincoln 010D","E01026173","Total",1562,772,790,1562,0,13,37.55,41.6
"2011","Lincoln 010E","E01026175","Total",1823,912,911,1780,43,10,31.60,57.7
"2011","Lincoln 011A","E01026137","Total",1225,594,631,1192,33,10,19.47,62.9
"2011","Lincoln 011B","E01026138","Total",1479,737,742,1479,0,22,44.64,33.1
"2011","Lincoln 011C","E01026139","Total",1180,556,624,1180,0,27,65.60,18.0
"2011","Lincoln 011D","E01026140","Total",1260,604,656,1260,0,10,21.63,58.3
"2011","Lincoln 011E","E01026141","Total",1490,714,776,1452,38,22,51.73,28.8
"2011","Lincoln 011F","E01026142","Total",1269,632,637,1269,0,8,32.65,38.9
"2011","Lincoln 011G","E01026169","Total",1628,761,867,1628,0,23,53.38,30.5
"2011","Lincoln 011H","E01026171","Total",1442,679,763,1427,15,15,53.35,27.0
"2011","North Kesteven 001A","E01026186","Total",1556,757,799,1556,0,29,267.09,5.8
"2011","North Kesteven 001B","E01026187","Total",1932,958,974,1932,0,34,151.59,12.7
"2011","North Kesteven 001C","E01026189","Total",1754,837,917,1753,1,24,155.59,11.3
"2011","North Kesteven 001D","E01026203","Total",1769,863,906,1745,24,22,1093.20,1.6
"2011","North Kesteven 001E","E01026204","Total",1665,830,835,1665,0,21,53.04,31.4
"2011","North Kesteven 001F","E01026206","Total",1892,914,978,1892,0,25,108.36,17.5
"2011","North Kesteven 003B","E01026182","Total",1425,692,733,1399,26,24,1236.20,1.2
"2011","North Kesteven 003C","E01026193","Total",1439,723,716,1402,37,25,2816.04,0.5
"2011","North Kesteven 003D","E01026199","Total",2310,1115,1195,2275,35,31,4803.63,0.5
"2011","North Kesteven 003E","E01026225","Total",1606,794,812,1606,0,10,1041.68,1.5
"2011","North Kesteven 003F","E01026226","Total",1859,894,965,1775,84,15,285.88,6.5
"2011","North Kesteven 003G","E01032990","Total",2346,1147,1199,2346,0,27,745.90,3.1
"2011","North Kesteven 003H","E01032994","Total",1295,627,668,1295,0,19,1737.75,0.7
"2011","North Kesteven 004A","E01026184","Total",1872,1065,807,1487,385,32,568.16,3.3
"2011","North Kesteven 004B","E01026185","Total",1800,852,948,1734,66,18,436.53,4.1
"2011","North Kesteven 004C","E01026188","Total",2168,1038,1130,2168,0,14,71.41,30.4
"2011","North Kesteven 004D","E01026190","Total",1491,703,788,1450,41,13,1198.23,1.2
"2011","North Kesteven 004E","E01026237","Total",1107,518,589,1101,6,18,50.09,22.1
"2011","North Kesteven 004F","E01026238","Total",1343,645,698,1343,0,25,287.00,4.7
"2011","North Kesteven 005A","E01026191","Total",1689,827,862,1689,0,40,2955.99,0.6
"2011","North Kesteven 005B","E01026205","Total",1461,690,771,1434,27,11,1473.10,1.0
"2011","North Kesteven 005C","E01026211","Total",1923,949,974,1843,80,47,4763.95,0.4
"2011","North Kesteven 005D","E01026212","Total",1578,765,813,1577,1,22,1332.39,1.2
"2011","North Kesteven 005E","E01026213","Total",1693,805,888,1664,29,21,67.07,25.2
"2011","North Kesteven 006A","E01026192","Total",1196,588,608,1169,27,19,3401.24,0.4
"2011","North Kesteven 006B","E01026194","Total",1887,883,1004,1840,47,21,679.13,2.8
"2011","North Kesteven 006C","E01026195","Total",1930,942,988,1930,0,47,3748.50,0.5
"2011","North Kesteven 006D","E01026196","Total",1514,731,783,1466,48,37,4029.45,0.4
"2011","North Kesteven 007A","E01026180","Total",1464,737,727,1437,27,27,3650.49,0.4
"2011","North Kesteven 007B","E01026183","Total",2559,1240,1319,2519,40,22,2225.91,1.1
"2011","North Kesteven 007C","E01026210","Total",2261,1097,1164,2223,38,28,7154.06,0.3
"2011","North Kesteven 007D","E01026224","Total",1721,821,900,1712,9,13,908.67,1.9
"2011","North Kesteven 008A","E01026179","Total",1331,711,620,1175,156,25,2191.63,0.6
"2011","North Kesteven 008B","E01026197","Total",1372,681,691,1372,0,24,3236.96,0.4
"2011","North Kesteven 008C","E01026198","Total",1455,790,665,1279,176,26,507.71,2.9
"2011","North Kesteven 008D","E01026223","Total",2089,1026,1063,2089,0,30,302.30,6.9
"2011","North Kesteven 009A","E01026209","Total",2110,1001,1109,2080,30,27,3564.12,0.6
"2011","North Kesteven 009B","E01026221","Total",2324,1135,1189,2321,3,48,10741.94,0.2
"2011","North Kesteven 009C","E01026222","Total",1827,880,947,1820,7,30,387.86,4.7
"2011","North Kesteven 010A","E01026227","Total",1392,678,714,1392,0,8,33.93,41.0
"2011","North Kesteven 010B","E01026230","Total",1231,609,622,1231,0,9,290.11,4.2
"2011","North Kesteven 010C","E01026231","Total",2629,1301,1328,2627,2,45,382.66,6.9
"2011","North Kesteven 010D","E01026232","Total",2218,1029,1189,2125,93,23,144.89,15.3
"2011","North Kesteven 010E","E01026235","Total",1594,757,837,1573,21,13,44.44,35.9
"2011","North Kesteven 011A","E01026228","Total",1489,729,760,1485,4,19,75.57,19.7
"2011","North Kesteven 011B","E01026229","Total",1543,762,781,1543,0,29,326.70,4.7
"2011","North Kesteven 011C","E01026233","Total",1717,811,906,1717,0,29,44.65,38.5
"2011","North Kesteven 011D","E01026234","Total",2700,1307,1393,2691,9,70,337.91,8.0
"2011","North Kesteven 011E","E01026236","Total",1158,566,592,1158,0,10,157.29,7.4
"2011","North Kesteven 012A","E01026200","Total",1566,776,790,1566,0,22,2006.10,0.8
"2011","North Kesteven 012B","E01026201","Total",2000,979,1021,2000,0,26,4652.34,0.4
"2011","North Kesteven 012C","E01026202","Total",1787,865,922,1751,36,26,135.31,13.2
"2011","North Kesteven 012D","E01026207","Total",1216,623,593,1191,25,8,4300.51,0.3
"2011","North Kesteven 012E","E01026208","Total",1629,793,836,1597,32,20,3954.01,0.4
"2011","North Kesteven 013A","E01026220","Total",2293,1107,1186,2239,54,15,120.76,19.0
"2011","North Kesteven 013B","E01032988","Total",1389,677,712,1369,20,8,158.01,8.8
"2011","North Kesteven 013C","E01032989","Total",1358,662,696,1352,6,13,38.66,35.1
"2011","North Kesteven 013D","E01032993","Total",1433,697,736,1433,0,13,54.08,26.5
"2011","North Kesteven 014A","E01026214","Total",1157,551,606,1157,0,13,24.28,47.7
"2011","North Kesteven 014B","E01026215","Total",1103,509,594,1101,2,12,30.18,36.5
"2011","North Kesteven 014C","E01026218","Total",1150,563,587,1150,0,9,63.92,18.0
"2011","North Kesteven 014D","E01026219","Total",1221,607,614,1221,0,7,24.13,50.6
"2011","North Kesteven 014E","E01032991","Total",1433,705,728,1433,0,3,298.44,4.8
"2011","North Kesteven 014F","E01032992","Total",1347,669,678,1315,32,13,115.56,11.7
"2011","South Holland 001A","E01026242","Total",1470,733,737,1470,0,15,2086.16,0.7
"2011","South Holland 001B","E01026243","Total",1335,625,710,1335,0,14,273.88,4.9
"2011","South Holland 001C","E01026244","Total",1339,653,686,1310,29,18,1676.73,0.8
"2011","South Holland 001D","E01026247","Total",1927,926,1001,1860,67,9,1548.82,1.2
"2011","South Holland 001E","E01026276","Total",2369,1189,1180,2369,0,27,3531.58,0.7
"2011","South Holland 002A","E01026246","Total",2351,1176,1175,2304,47,26,5071.80,0.5
"2011","South Holland 002B","E01026248","Total",2270,1119,1151,2233,37,25,7098.61,0.3
"2011","South Holland 002C","E01026257","Total",1886,899,987,1886,0,10,391.12,4.8
"2011","South Holland 003A","E01026250","Total",1788,854,934,1777,11,9,49.85,35.9
"2011","South Holland 003B","E01026251","Total",1817,878,939,1790,27,18,127.39,14.3
"2011","South Holland 003C","E01026252","Total",1741,822,919,1719,22,13,138.61,12.6
"2011","South Holland 003D","E01026253","Total",1764,874,890,1764,0,17,87.86,20.1
"2011","South Holland 004A","E01026281","Total",1317,653,664,1317,0,15,2209.74,0.6
"2011","South Holland 004B","E01026282","Total",1737,842,895,1712,25,22,2044.36,0.8
"2011","South Holland 004C","E01026283","Total",1726,864,862,1726,0,21,2629.55,0.7
"2011","South Holland 004D","E01026285","Total",1439,696,743,1439,0,17,2305.93,0.6
"2011","South Holland 004E","E01026286","Total",1273,648,625,1273,0,9,1186.73,1.1
"2011","South Holland 005A","E01026241","Total",1961,1001,960,1957,4,20,6684.56,0.3
"2011","South Holland 005B","E01026258","Total",1751,864,887,1751,0,24,1152.41,1.5
"2011","South Holland 005C","E01026259","Total",1712,831,881,1710,2,27,4023.66,0.4
"2011","South Holland 005D","E01026260","Total",1992,970,1022,1966,26,16,393.88,5.1
"2011","South Holland 006B","E01026266","Total",2002,993,1009,1988,14,30,52.57,38.1
"2011","South Holland 006C","E01026273","Total",1688,827,861,1651,37,23,49.35,34.2
"2011","South Holland 006D","E01026274","Total",1932,930,1002,1932,0,32,93.31,20.7
"2011","South Holland 006E","E01026275","Total",2008,973,1035,1977,31,5,44.22,45.4
"2011","South Holland 006F","E01032995","Total",1391,676,715,1384,7,15,62.96,22.1
"2011","South Holland 006G","E01032996","Total",1358,668,690,1353,5,26,179.68,7.6
"2011","South Holland 007A","E01026268","Total",1971,935,1036,1958,13,17,850.21,2.3
"2011","South Holland 007B","E01026269","Total",2190,1048,1142,2157,33,29,132.21,16.6
"2011","South Holland 007C","E01026270","Total",1902,941,961,1902,0,19,651.78,2.9
"2011","South Holland 007D","E01026271","Total",1779,871,908,1774,5,7,31.77,56.0
"2011","South Holland 007E","E01026272","Total",1238,614,624,1238,0,14,33.92,36.5
"2011","South Holland 008A","E01026254","Total",1776,855,921,1776,0,15,2318.86,0.8
"2011","South Holland 008B","E01026255","Total",1972,947,1025,1867,105,17,236.67,8.3
"2011","South Holland 008C","E01026256","Total",1626,777,849,1626,0,9,1843.05,0.9
"2011","South Holland 008D","E01026277","Total",1663,829,834,1663,0,7,101.78,16.3
"2011","South Holland 008E","E01026278","Total",1407,695,712,1407,0,15,3952.35,0.4
"2011","South Holland 008F","E01026279","Total",1384,675,709,1352,32,4,520.46,2.7
"2011","South Holland 009A","E01026262","Total",1539,742,797,1539,0,21,468.66,3.3
"2011","South Holland 009B","E01026263","Total",1994,955,1039,1956,38,18,132.22,15.1
"2011","South Holland 009C","E01026264","Total",1546,750,796,1546,0,11,28.03,55.2
"2011","South Holland 009D","E01026265","Total",1362,661,701,1243,119,13,304.80,4.5
"2011","South Holland 009E","E01026267","Total",2822,1371,1451,2822,0,26,58.10,48.6
"2011","South Holland 010A","E01026245","Total",2136,1020,1116,2062,74,29,2775.32,0.8
"2011","South Holland 010B","E01026249","Total",1871,928,943,1844,27,19,3082.04,0.6
"2011","South Holland 010C","E01026280","Total",2539,1269,1270,2539,0,25,4272.31,0.6
"2011","South Holland 011A","E01026239","Total",1792,853,939,1768,24,15,5289.17,0.3
"2011","South Holland 011B","E01026240","Total",2419,1222,1197,2419,0,25,149.77,16.2
"2011","South Holland 011C","E01026284","Total",1998,977,1021,1998,0,31,1809.51,1.1
"2011","South Kesteven 001A","E01026313","Total",1536,747,789,1536,0,37,3626.32,0.4
"2011","South Kesteven 001B","E01026314","Total",1294,630,664,1294,0,17,174.94,7.4
"2011","South Kesteven 001C","E01026329","Total",1887,918,969,1857,30,25,3237.61,0.6
"2011","South Kesteven 001D","E01026333","Total",2522,1233,1289,2522,0,66,5551.20,0.5
"2011","South Kesteven 002A","E01026291","Total",1952,954,998,1933,19,34,1435.88,1.4
"2011","South Kesteven 002B","E01026340","Total",2200,1070,1130,2200,0,31,1088.85,2.0
"2011","South Kesteven 002C","E01026355","Total",2383,1132,1251,2369,14,48,3351.59,0.7
"2011","South Kesteven 002D","E01026365","Total",2309,1133,1176,2309,0,53,4345.31,0.5
"2011","South Kesteven 003A","E01026325","Total",1515,723,792,1515,0,9,34.11,44.4
"2011","South Kesteven 003B","E01026326","Total",1542,741,801,1489,53,18,49.86,30.9
"2011","South Kesteven 003C","E01026327","Total",1336,625,711,1336,0,17,40.10,33.3
"2011","South Kesteven 003D","E01026328","Total",1459,664,795,1459,0,6,36.31,40.2
"2011","South Kesteven 003E","E01026352","Total",1260,620,640,1247,13,23,59.25,21.3
"2011","South Kesteven 003F","E01026353","Total",1605,732,873,1536,69,27,48.72,32.9
"2011","South Kesteven 003G","E01026354","Total",1191,579,612,1191,0,34,33.59,35.5
"2011","South Kesteven 004A","E01026320","Total",1783,848,935,1661,122,48,121.78,14.6
"2011","South Kesteven 004B","E01026321","Total",1306,623,683,1265,41,28,35.77,36.5
"2011","South Kesteven 004C","E01026322","Total",1104,537,567,1104,0,18,29.48,37.4
"2011","South Kesteven 004D","E01026323","Total",1842,904,938,1825,17,17,85.53,21.5
"2011","South Kesteven 004E","E01026324","Total",2242,1100,1142,2242,0,32,92.18,24.3
"2011","South Kesteven 005A","E01026308","Total",1484,732,752,1484,0,14,122.68,12.1
"2011","South Kesteven 005B","E01026309","Total",1567,755,812,1567,0,6,36.54,42.9
"2011","South Kesteven 005C","E01026310","Total",1235,611,624,1235,0,9,22.33,55.3
"2011","South Kesteven 005D","E01026311","Total",1637,778,859,1636,1,10,24.13,67.8
"2011","South Kesteven 005E","E01026312","Total",1409,662,747,1409,0,11,18.88,74.6
"2011","South Kesteven 006A","E01026317","Total",2062,1020,1042,2053,9,20,77.16,26.7
"2011","South Kesteven 006B","E01026318","Total",1926,930,996,1926,0,15,60.73,31.7
"2011","South Kesteven 006C","E01026319","Total",2088,1027,1061,2088,0,24,295.37,7.1
"2011","South Kesteven 006D","E01026343","Total",1808,898,910,1808,0,16,46.39,39.0
"2011","South Kesteven 006E","E01026344","Total",1503,752,751,1503,0,17,86.30,17.4
"2011","South Kesteven 006F","E01026345","Total",1576,751,825,1460,116,21,114.86,13.7
"2011","South Kesteven 007A","E01026292","Total",1422,708,714,1422,0,9,28.10,50.6
"2011","South Kesteven 007B","E01026293","Total",2057,1027,1030,2041,16,39,1497.51,1.4
"2011","South Kesteven 007C","E01026294","Total",1654,820,834,1648,6,26,48.25,34.3
"2011","South Kesteven 007D","E01026316","Total",2417,1176,1241,2417,0,78,10009.06,0.2
"2011","South Kesteven 007E","E01026332","Total",2224,1085,1139,2224,0,58,8810.76,0.3
"2011","South Kesteven 008A","E01026290","Total",2258,1114,1144,2211,47,52,7385.75,0.3
"2011","South Kesteven 008B","E01026341","Total",1479,706,773,1479,0,30,566.82,2.6
"2011","South Kesteven 008C","E01026342","Total",1459,727,732,1459,0,26,2444.46,0.6
"2011","South Kesteven 008D","E01026361","Total",2633,1241,1392,2604,29,32,3231.18,0.8
"2011","South Kesteven 009A","E01026315","Total",2084,1016,1068,2084,0,26,5924.31,0.4
"2011","South Kesteven 009B","E01026331","Total",2424,1226,1198,2424,0,42,5438.98,0.4
"2011","South Kesteven 009C","E01026338","Total",1237,618,619,1237,0,29,2806.98,0.4
"2011","South Kesteven 009D","E01026339","Total",1207,583,624,1206,1,7,541.35,2.2
"2011","South Kesteven 010A","E01026299","Total",1694,798,896,1667,27,27,39.01,43.4
"2011","South Kesteven 010B","E01026300","Total",1516,754,762,1516,0,35,492.27,3.1
"2011","South Kesteven 010C","E01026301","Total",1631,762,869,1547,84,31,268.36,6.1
"2011","South Kesteven 010D","E01026302","Total",1214,606,608,1214,0,28,25.90,46.9
"2011","South Kesteven 011B","E01026296","Total",1549,765,784,1549,0,36,2757.41,0.6
"2011","South Kesteven 011C","E01026297","Total",1347,635,712,1326,21,20,41.63,32.4
"2011","South Kesteven 011D","E01026298","Total",1816,859,957,1759,57,17,282.84,6.4
"2011","South Kesteven 011E","E01032997","Total",1231,577,654,1214,17,26,96.56,12.7
"2011","South Kesteven 011F","E01032998","Total",1289,628,661,1289,0,17,34.60,37.3
"2011","South Kesteven 011G","E01032999","Total",1169,531,638,1169,0,23,48.91,23.9
"2011","South Kesteven 012A","E01026330","Total",2235,1091,1144,2170,65,85,6870.14,0.3
"2011","South Kesteven 012B","E01026360","Total",2153,1100,1053,2153,0,49,1591.54,1.4
"2011","South Kesteven 012C","E01026362","Total",1758,882,876,1758,0,48,1118.38,1.6
"2011","South Kesteven 012D","E01026363","Total",1322,625,697,1285,37,29,2362.29,0.6
"2011","South Kesteven 012E","E01026364","Total",1731,831,900,1731,0,47,1439.08,1.2
"2011","South Kesteven 013A","E01026334","Total",1586,767,819,1586,0,64,533.13,3.0
"2011","South Kesteven 013B","E01026335","Total",1555,717,838,1502,53,30,47.88,32.5
"2011","South Kesteven 013C","E01026336","Total",1588,790,798,1579,9,20,637.76,2.5
"2011","South Kesteven 013D","E01026337","Total",1534,754,780,1531,3,30,52.79,29.1
"2011","South Kesteven 014A","E01026303","Total",1393,671,722,1393,0,26,23.57,59.1
"2011","South Kesteven 014B","E01026304","Total",1454,721,733,1454,0,33,1382.77,1.1
"2011","South Kesteven 014C","E01026305","Total",1373,655,718,1361,12,16,60.85,22.6
"2011","South Kesteven 014D","E01026306","Total",1543,698,845,1538,5,26,100.60,15.3
"2011","South Kesteven 014E","E01026307","Total",1288,626,662,1283,5,16,37.52,34.3
"2011","South Kesteven 015A","E01026287","Total",1448,720,728,1448,0,19,36.00,40.2
"2011","South Kesteven 015B","E01026288","Total",1632,755,877,1629,3,16,26.10,62.5
"2011","South Kesteven 015C","E01026289","Total",2033,989,1044,2033,0,34,50.01,40.7
"2011","South Kesteven 015D","E01026346","Total",1183,572,611,1183,0,18,74.38,15.9
"2011","South Kesteven 015E","E01026347","Total",1657,719,938,1575,82,20,38.92,42.6
"2011","South Kesteven 015F","E01026348","Total",1179,579,600,1179,0,14,55.34,21.3
"2011","South Kesteven 016A","E01026349","Total",1564,704,860,1564,0,13,35.67,43.8
"2011","South Kesteven 016B","E01026350","Total",1621,724,897,1492,129,40,160.36,10.1
"2011","South Kesteven 016C","E01026351","Total",1475,739,736,1416,59,25,42.35,34.8
"2011","South Kesteven 016D","E01026356","Total",1463,719,744,1458,5,33,45.21,32.4
"2011","South Kesteven 016E","E01026357","Total",1426,686,740,1426,0,20,26.48,53.9
"2011","South Kesteven 016F","E01026358","Total",1421,668,753,1402,19,41,32.31,44.0
"2011","South Kesteven 016G","E01026359","Total",1599,763,836,1599,0,33,173.27,9.2
"2011","West Lindsey 001A","E01026367","Total",1641,821,820,1577,64,29,5950.33,0.3
"2011","West Lindsey 001B","E01026368","Total",1593,772,821,1593,0,27,400.38,4.0
"2011","West Lindsey 001C","E01026387","Total",2664,1322,1342,2664,0,62,7926.32,0.3
"2011","West Lindsey 001D","E01026416","Total",1306,638,668,1277,29,35,4870.88,0.3
"2011","West Lindsey 001G","E01032683","Total",2221,1082,1139,2221,0,40,3479.26,0.6
"2011","West Lindsey 002A","E01026380","Total",1832,899,933,1832,0,23,86.40,21.2
"2011","West Lindsey 002B","E01026401","Total",1578,760,818,1521,57,27,1975.71,0.8
"2011","West Lindsey 002C","E01026402","Total",1825,900,925,1811,14,17,748.61,2.4
"2011","West Lindsey 002D","E01026403","Total",1361,669,692,1321,40,25,4417.36,0.3
"2011","West Lindsey 002E","E01026407","Total",1383,669,714,1362,21,17,2761.00,0.5
"2011","West Lindsey 002F","E01026408","Total",1325,632,693,1266,59,13,342.94,3.9
"2011","West Lindsey 003A","E01026389","Total",1681,832,849,1574,107,20,71.17,23.6
"2011","West Lindsey 003B","E01026390","Total",1815,900,915,1815,0,9,1698.09,1.1
"2011","West Lindsey 003C","E01026391","Total",1921,933,988,1841,80,47,7155.73,0.3
"2011","West Lindsey 003D","E01026392","Total",2978,1438,1540,2953,25,50,7005.93,0.4
"2011","West Lindsey 003E","E01026415","Total",1057,528,529,975,82,20,4661.10,0.2
"2011","West Lindsey 004A","E01026378","Total",1702,817,885,1702,0,14,28.49,59.7
"2011","West Lindsey 004B","E01026379","Total",1643,802,841,1641,2,25,74.68,22.0
"2011","West Lindsey 004C","E01026381","Total",1683,796,887,1671,12,15,53.67,31.4
"2011","West Lindsey 004D","E01026382","Total",1665,822,843,1631,34,5,353.15,4.7
"2011","West Lindsey 004E","E01026383","Total",1185,649,536,1161,24,9,24.24,48.9
"2011","West Lindsey 004F","E01026384","Total",1767,859,908,1764,3,6,55.92,31.6
"2011","West Lindsey 005A","E01026385","Total",1154,572,582,1154,0,20,4818.22,0.2
"2011","West Lindsey 005B","E01026386","Total",1373,694,679,1318,55,14,3514.18,0.4
"2011","West Lindsey 005C","E01026399","Total",1477,734,743,1451,26,25,3576.28,0.4
"2011","West Lindsey 005D","E01026411","Total",2452,1233,1219,2452,0,36,7816.05,0.3
"2011","West Lindsey 006A","E01026374","Total",1449,707,742,1449,0,7,63.60,22.8
"2011","West Lindsey 006B","E01026375","Total",1585,745,840,1548,37,1,101.35,15.6
"2011","West Lindsey 006C","E01026376","Total",1802,832,970,1750,52,16,79.69,22.6
"2011","West Lindsey 006D","E01026377","Total",2195,1070,1125,2177,18,12,49.17,44.6
"2011","West Lindsey 007A","E01026388","Total",2140,1013,1127,2118,22,33,2818.09,0.8
"2011","West Lindsey 007B","E01026404","Total",2222,1091,1131,2220,2,50,3328.55,0.7
"2011","West Lindsey 007C","E01026409","Total",1168,598,570,1168,0,16,2002.73,0.6
"2011","West Lindsey 007D","E01026410","Total",1622,780,842,1584,38,15,2347.05,0.7
"2011","West Lindsey 008A","E01026372","Total",2464,1207,1257,2438,26,38,3000.57,0.8
"2011","West Lindsey 008B","E01026412","Total",1670,787,883,1649,21,31,987.80,1.7
"2011","West Lindsey 008C","E01026413","Total",2248,1082,1166,2248,0,62,65.51,34.3
"2011","West Lindsey 008D","E01026414","Total",1686,818,868,1686,0,24,4861.38,0.3
"2011","West Lindsey 009A","E01026396","Total",1229,574,655,1221,8,19,65.93,18.6
"2011","West Lindsey 009B","E01026397","Total",2358,1183,1175,2267,91,42,4201.59,0.6
"2011","West Lindsey 009C","E01026398","Total",1489,727,762,1489,0,10,843.97,1.8
"2011","West Lindsey 009D","E01026400","Total",1719,866,853,1718,1,33,2777.44,0.6
"2011","West Lindsey 010A","E01026393","Total",1428,675,753,1428,0,22,406.68,3.5
"2011","West Lindsey 010B","E01026394","Total",1865,889,976,1738,127,29,1767.74,1.1
"2011","West Lindsey 010C","E01026395","Total",1417,657,760,1417,0,28,104.94,13.5
"2011","West Lindsey 010D","E01026405","Total",1380,661,719,1359,21,30,1177.65,1.2
"2011","West Lindsey 010E","E01026406","Total",1268,610,658,1268,0,28,170.69,7.4
"2011","West Lindsey 011A","E01026366","Total",2057,972,1085,2029,28,15,3714.77,0.6
"2011","West Lindsey 011B","E01026369","Total",1096,506,590,1051,45,11,304.76,3.6
"2011","West Lindsey 011C","E01026370","Total",2092,1014,1078,2092,0,23,350.39,6.0
"2011","West Lindsey 011D","E01026371","Total",1233,619,614,1233,0,17,490.67,2.5
"2011","West Lindsey 011E","E01026373","Total",2086,1035,1051,1957,129,15,5622.93,0.4
"2011","Corby 001A","E01026971","Total",1727,861,866,1724,3,22,41.34,41.8
"2011","Corby 001B","E01026979","Total",1398,691,707,1377,21,25,1825.55,0.8
"2011","Corby 001C","E01026980","Total",1579,765,814,1560,19,34,1866.76,0.8
"2011","Corby 001D","E01026982","Total",1972,933,1039,1972,0,10,209.53,9.4
"2011","Corby 002A","E01026969","Total",1644,793,851,1644,0,7,59.68,27.5
"2011","Corby 002B","E01026970","Total",1704,851,853,1704,0,14,28.01,60.8
"2011","Corby 002C","E01026972","Total",1828,869,959,1828,0,15,31.67,57.7
"2011","Corby 002D","E01026976","Total",1347,669,678,1347,0,9,22.98,58.6
"2011","Corby 002E","E01026981","Total",1203,606,597,1147,56,12,53.41,22.5
"2011","Corby 002F","E01026983","Total",1107,569,538,1107,0,3,14.67,75.5
"2011","Corby 003A","E01026957","Total",1542,792,750,1486,56,2,301.96,5.1
"2011","Corby 003B","E01026958","Total",1813,918,895,1796,17,11,417.84,4.3
"2011","Corby 003C","E01026977","Total",1909,931,978,1896,13,23,1042.52,1.8
"2011","Corby 003D","E01026978","Total",1442,731,711,1442,0,21,908.59,1.6
"2011","Corby 004A","E01026962","Total",1391,657,734,1391,0,10,22.83,60.9
"2011","Corby 004B","E01026973","Total",1422,691,731,1422,0,12,39.43,36.1
"2011","Corby 004C","E01026974","Total",1139,557,582,1139,0,16,33.45,34.1
"2011","Corby 004D","E01026975","Total",1356,645,711,1356,0,9,29.27,46.3
"2011","Corby 004E","E01026984","Total",1715,840,875,1704,11,20,38.67,44.3
"2011","Corby 004F","E01026985","Total",1484,728,756,1484,0,26,64.00,23.2
"2011","Corby 005A","E01026949","Total",1300,672,628,1300,0,9,91.63,14.2
"2011","Corby 005B","E01026950","Total",1550,764,786,1550,0,6,34.70,44.7
"2011","Corby 005C","E01026951","Total",1270,617,653,1270,0,6,25.37,50.1
"2011","Corby 005D","E01026952","Total",1179,579,600,1166,13,15,48.82,24.1
"2011","Corby 006A","E01026959","Total",1415,674,741,1415,0,17,23.91,59.2
"2011","Corby 006B","E01026960","Total",1506,735,771,1506,0,1,25.39,59.3
"2011","Corby 006C","E01026961","Total",1292,656,636,1292,0,7,39.03,33.1
"2011","Corby 006D","E01026965","Total",1034,506,528,1034,0,5,23.05,44.9
"2011","Corby 006E","E01026966","Total",1393,689,704,1393,0,13,70.67,19.7
"2011","Corby 006F","E01026967","Total",1724,846,878,1720,4,18,37.68,45.8
"2011","Corby 006G","E01026968","Total",1374,640,734,1374,0,9,26.10,52.6
"2011","Corby 008A","E01026953","Total",1345,678,667,1345,0,13,51.30,26.2
"2011","Corby 008B","E01026954","Total",1367,662,705,1365,2,13,22.59,60.5
"2011","Corby 008C","E01026955","Total",1453,725,728,1453,0,33,121.43,12.0
"2011","Corby 008D","E01026956","Total",1947,949,998,1947,0,26,95.26,20.4
"2011","Corby 009A","E01026963","Total",1326,630,696,1326,0,2,26.34,50.3
"2011","Corby 009B","E01032963","Total",1579,788,791,1575,4,16,46.30,34.1
"2011","Corby 009C","E01032964","Total",1721,867,854,1675,46,21,35.34,48.7
"2011","Corby 009D","E01032965","Total",1371,698,673,1371,0,13,33.96,40.4
"2011","Corby 009E","E01032966","Total",1703,843,860,1703,0,10,40.16,42.4
"2011","Corby 009F","E01032967","Total",1684,832,852,1684,0,9,57.09,29.5
"2011","Daventry 001A","E01027005","Total",2100,1046,1054,2044,56,54,5845.48,0.4
"2011","Daventry 001B","E01027026","Total",1969,977,992,1921,48,63,4392.66,0.4
"2011","Daventry 001C","E01027030","Total",1775,895,880,1755,20,57,5070.52,0.4
"2011","Daventry 002A","E01027000","Total",1505,699,806,1461,44,29,326.74,4.6
"2011","Daventry 002B","E01027001","Total",1523,773,750,1523,0,48,389.87,3.9
"2011","Daventry 002C","E01027002","Total",1721,891,830,1622,99,56,4094.72,0.4
"2011","Daventry 002D","E01027003","Total",1435,715,720,1401,34,25,30.88,46.5
"2011","Daventry 002E","E01027022","Total",1796,884,912,1796,0,32,2580.76,0.7
"2011","Daventry 003A","E01026994","Total",1009,488,521,1009,0,35,2294.17,0.4
"2011","Daventry 003D","E01026999","Total",1759,862,897,1759,0,24,1318.26,1.3
"2011","Daventry 003E","E01027006","Total",1886,959,927,1877,9,48,2199.25,0.9
"2011","Daventry 003F","E01032968","Total",3304,2171,1133,2187,1117,40,1731.34,1.9
"2011","Daventry 004A","E01026998","Total",1749,862,887,1749,0,53,3675.15,0.5
"2011","Daventry 004B","E01027015","Total",1269,617,652,1269,0,26,216.23,5.9
"2011","Daventry 004C","E01027016","Total",1513,771,742,1513,0,44,1465.99,1.0
"2011","Daventry 004D","E01027021","Total",1844,912,932,1844,0,69,3465.83,0.5
"2011","Daventry 004E","E01027027","Total",2410,1148,1262,2371,39,59,2002.77,1.2
"2011","Daventry 005A","E01026997","Total",1783,825,958,1700,83,36,1129.09,1.6
"2011","Daventry 005B","E01027018","Total",1464,721,743,1464,0,19,858.23,1.7
"2011","Daventry 005C","E01027019","Total",1521,734,787,1414,107,33,699.02,2.2
"2011","Daventry 005D","E01027020","Total",1210,572,638,1174,36,19,114.62,10.6
"2011","Daventry 005E","E01027023","Total",2047,1009,1038,2047,0,48,2781.77,0.7
"2011","Daventry 006A","E01026987","Total",1201,595,606,1201,0,17,59.95,20.0
"2011","Daventry 006B","E01026989","Total",1451,725,726,1451,0,16,31.51,46.0
"2011","Daventry 006C","E01026990","Total",2629,1325,1304,2629,0,28,224.05,11.7
"2011","Daventry 006D","E01027012","Total",1747,866,881,1747,0,17,182.47,9.6
"2011","Daventry 006E","E01027014","Total",2214,1067,1147,2214,0,21,123.02,18.0
"2011","Daventry 007A","E01026986","Total",2898,1449,1449,2898,0,19,72.25,40.1
"2011","Daventry 007B","E01026988","Total",1572,755,817,1572,0,9,27.66,56.8
"2011","Daventry 007C","E01026991","Total",1569,760,809,1557,12,8,64.83,24.2
"2011","Daventry 007D","E01026992","Total",1906,931,975,1775,131,20,50.58,37.7
"2011","Daventry 007E","E01027010","Total",1177,598,579,1177,0,13,52.52,22.4
"2011","Daventry 008A","E01027007","Total",1409,680,729,1371,38,11,130.48,10.8
"2011","Daventry 008B","E01027008","Total",1948,977,971,1948,0,25,65.71,29.6
"2011","Daventry 008C","E01027009","Total",1496,741,755,1496,0,9,178.59,8.4
"2011","Daventry 008D","E01027013","Total",1809,879,930,1809,0,14,205.85,8.8
"2011","Daventry 009A","E01027011","Total",1899,925,974,1899,0,46,3096.60,0.6
"2011","Daventry 009B","E01027017","Total",1451,719,732,1451,0,13,1286.46,1.1
"2011","Daventry 009C","E01027024","Total",1721,856,865,1721,0,38,2684.50,0.6
"2011","Daventry 009D","E01027025","Total",1640,791,849,1640,0,14,180.15,9.1
"2011","Daventry 010A","E01026993","Total",1952,960,992,1915,37,63,3990.45,0.5
"2011","Daventry 010B","E01027004","Total",1853,910,943,1827,26,54,3867.45,0.5
"2011","Daventry 010C","E01027028","Total",2129,1064,1065,2108,21,48,2762.99,0.8
"2011","Daventry 010D","E01027029","Total",1580,795,785,1580,0,17,237.59,6.7
"2011","East Northamptonshire 001A","E01027033","Total",1810,893,917,1810,0,43,3652.60,0.5
"2011","East Northamptonshire 001B","E01027043","Total",1981,977,1004,1930,51,42,6494.56,0.3
"2011","East Northamptonshire 001C","E01027050","Total",1912,970,942,1912,0,43,4605.86,0.4
"2011","East Northamptonshire 002A","E01027031","Total",2123,1046,1077,2077,46,82,7631.52,0.3
"2011","East Northamptonshire 002B","E01027044","Total",2059,1049,1010,2004,55,62,5261.43,0.4
"2011","East Northamptonshire 002C","E01027046","Total",1296,621,675,1296,0,52,131.10,9.9
"2011","East Northamptonshire 002D","E01027047","Total",1286,653,633,1286,0,29,50.87,25.3
"2011","East Northamptonshire 002E","E01027048","Total",2158,1116,1042,1330,828,62,518.51,4.2
"2011","East Northamptonshire 002F","E01027049","Total",995,472,523,922,73,24,200.55,5.0
"2011","East Northamptonshire 003A","E01027032","Total",1869,932,937,1840,29,48,4949.80,0.4
"2011","East Northamptonshire 003B","E01027045","Total",1898,949,949,1898,0,40,5512.98,0.3
"2011","East Northamptonshire 003C","E01027075","Total",2101,1049,1052,2101,0,21,134.48,15.6
"2011","East Northamptonshire 003D","E01027076","Total",2157,1052,1105,2157,0,24,95.21,22.7
"2011","East Northamptonshire 003E","E01027077","Total",1981,1001,980,1981,0,36,334.99,5.9
"2011","East Northamptonshire 004A","E01027057","Total",1743,876,867,1697,46,30,1524.85,1.1
"2011","East Northamptonshire 004B","E01027074","Total",2183,1072,1111,2146,37,37,1390.36,1.6
"2011","East Northamptonshire 004C","E01027078","Total",2116,1062,1054,2086,30,43,1890.84,1.1
"2011","East Northamptonshire 005A","E01027051","Total",1755,870,885,1733,22,17,46.00,38.2
"2011","East Northamptonshire 005B","E01027052","Total",1422,713,709,1422,0,19,43.20,32.9
"2011","East Northamptonshire 005C","E01027053","Total",1525,766,759,1503,22,25,1321.58,1.2
"2011","East Northamptonshire 005D","E01027054","Total",1243,624,619,1213,30,16,252.76,4.9
"2011","East Northamptonshire 005E","E01027055","Total",1139,570,569,1139,0,13,66.67,17.1
"2011","East Northamptonshire 005F","E01027056","Total",1557,760,797,1518,39,8,78.11,19.9
"2011","East Northamptonshire 006A","E01027038","Total",1622,811,811,1584,38,15,578.39,2.8
"2011","East Northamptonshire 006B","E01027039","Total",1805,884,921,1718,87,13,222.28,8.1
"2011","East Northamptonshire 006C","E01027040","Total",1617,823,794,1617,0,17,29.74,54.4
"2011","East Northamptonshire 006D","E01027041","Total",1617,787,830,1617,0,11,75.35,21.5
"2011","East Northamptonshire 006E","E01027042","Total",1874,946,928,1874,0,17,272.85,6.9
"2011","East Northamptonshire 007A","E01027034","Total",1652,752,900,1605,47,10,116.63,14.2
"2011","East Northamptonshire 007B","E01027035","Total",1386,680,706,1378,8,18,1742.98,0.8
"2011","East Northamptonshire 007D","E01027037","Total",2205,1111,1094,2189,16,23,111.10,19.8
"2011","East Northamptonshire 007E","E01033244","Total",2397,1227,1170,2397,0,26,75.49,31.8
"2011","East Northamptonshire 007F","E01033245","Total",1009,502,507,1009,0,16,18.46,54.7
"2011","East Northamptonshire 008A","E01027061","Total",1777,854,923,1777,0,15,136.07,13.1
"2011","East Northamptonshire 008B","E01027062","Total",2245,1065,1180,2192,53,20,52.59,42.7
"2011","East Northamptonshire 008C","E01027063","Total",1820,918,902,1799,21,28,291.75,6.2
"2011","East Northamptonshire 008D","E01027064","Total",1612,811,801,1537,75,8,63.52,25.4
"2011","East Northamptonshire 008E","E01027072","Total",1649,798,851,1649,0,10,27.55,59.9
"2011","East Northamptonshire 008F","E01027073","Total",2033,968,1065,2033,0,17,37.57,54.1
"2011","East Northamptonshire 009A","E01027058","Total",1498,742,756,1498,0,13,231.83,6.5
"2011","East Northamptonshire 009B","E01027059","Total",1732,882,850,1691,41,16,27.00,64.1
"2011","East Northamptonshire 009C","E01027060","Total",1778,876,902,1712,66,7,34.55,51.5
"2011","East Northamptonshire 009D","E01027065","Total",1753,870,883,1735,18,10,31.70,55.3
"2011","East Northamptonshire 009E","E01027069","Total",1541,757,784,1523,18,12,29.96,51.4
"2011","East Northamptonshire 010A","E01027066","Total",2218,1095,1123,2181,37,24,413.62,5.4
"2011","East Northamptonshire 010B","E01027067","Total",1584,765,819,1562,22,21,54.61,29.0
"2011","East Northamptonshire 010C","E01027068","Total",2907,1441,1466,2907,0,42,62.88,46.2
"2011","East Northamptonshire 010D","E01027070","Total",1641,842,799,1641,0,6,30.26,54.2
"2011","East Northamptonshire 010E","E01027071","Total",1484,758,726,1484,0,9,21.24,69.9
"2011","Kettering 001A","E01027090","Total",1462,726,736,1401,61,33,4952.81,0.3
"2011","Kettering 001B","E01027103","Total",1629,784,845,1629,0,20,1993.37,0.8
"2011","Kettering 001C","E01027129","Total",2185,1076,1109,2165,20,54,5838.90,0.4
"2011","Kettering 002B","E01027094","Total",1552,752,800,1481,71,16,215.55,7.2
"2011","Kettering 002C","E01027095","Total",1451,741,710,1451,0,25,222.04,6.5
"2011","Kettering 002D","E01027107","Total",1269,627,642,1269,0,10,37.99,33.4
"2011","Kettering 002E","E01027108","Total",1313,639,674,1273,40,20,50.06,26.2
"2011","Kettering 002F","E01027109","Total",1268,630,638,1259,9,15,101.98,12.4
"2011","Kettering 002G","E01032969","Total",1287,627,660,1287,0,8,114.15,11.3
"2011","Kettering 002H","E01032970","Total",1482,710,772,1482,0,14,201.43,7.4
"2011","Kettering 002I","E01032971","Total",1075,525,550,1047,28,5,24.33,44.2
"2011","Kettering 003A","E01027123","Total",1595,762,833,1595,0,18,260.17,6.1
"2011","Kettering 003B","E01027124","Total",2182,1060,1122,2176,6,20,472.15,4.6
"2011","Kettering 003C","E01027125","Total",1807,910,897,1807,0,25,383.28,4.7
"2011","Kettering 003D","E01027126","Total",2110,1020,1090,2110,0,20,256.57,8.2
"2011","Kettering 004A","E01027079","Total",1755,843,912,1738,17,30,31.69,55.4
"2011","Kettering 004B","E01027080","Total",1962,975,987,1910,52,30,31.10,63.1
"2011","Kettering 004C","E01027087","Total",1180,584,596,1180,0,16,19.99,59.0
"2011","Kettering 004D","E01027088","Total",1288,641,647,1288,0,31,37.51,34.3
"2011","Kettering 004E","E01027089","Total",2081,993,1088,2015,66,29,55.66,37.4
"2011","Kettering 005A","E01027081","Total",1450,689,761,1450,0,10,22.63,64.1
"2011","Kettering 005B","E01027082","Total",1593,803,790,1593,0,6,21.33,74.7
"2011","Kettering 005C","E01027083","Total",1415,716,699,1415,0,4,49.87,28.4
"2011","Kettering 005D","E01027127","Total",1869,902,967,1869,0,13,69.67,26.8
"2011","Kettering 005E","E01027128","Total",1720,865,855,1720,0,14,56.83,30.3
"2011","Kettering 006A","E01027105","Total",2103,1111,992,2056,47,13,27.81,75.6
"2011","Kettering 006B","E01027106","Total",1935,1013,922,1931,4,5,17.80,108.7
"2011","Kettering 006C","E01027111","Total",2097,1046,1051,2009,88,20,28.37,73.9
"2011","Kettering 006D","E01027112","Total",2116,1072,1044,2116,0,13,29.82,71.0
"2011","Kettering 007A","E01027104","Total",2335,1162,1173,2303,32,11,50.41,46.3
"2011","Kettering 007B","E01027110","Total",1731,817,914,1731,0,6,57.77,30.0
"2011","Kettering 007C","E01027113","Total",2172,1038,1134,2054,118,39,44.14,49.2
"2011","Kettering 007D","E01027115","Total",1175,566,609,1156,19,17,99.23,11.8
"2011","Kettering 007E","E01027116","Total",2178,1112,1066,2178,0,34,75.75,28.8
"2011","Kettering 007F","E01027117","Total",1401,686,715,1300,101,25,143.76,9.7
"2011","Kettering 008A","E01027096","Total",1192,571,621,1192,0,10,46.26,25.8
"2011","Kettering 008B","E01027097","Total",1367,674,693,1367,0,17,111.04,12.3
"2011","Kettering 008C","E01027098","Total",1218,588,630,1218,0,14,28.06,43.4
"2011","Kettering 008D","E01027099","Total",1464,673,791,1464,0,16,62.28,23.5
"2011","Kettering 008E","E01027122","Total",1182,594,588,1182,0,18,40.34,29.3
"2011","Kettering 009A","E01027100","Total",1600,773,827,1580,20,25,35.71,44.8
"2011","Kettering 009B","E01027114","Total",1595,788,807,1595,0,24,42.98,37.1
"2011","Kettering 009C","E01027130","Total",1825,921,904,1825,0,17,86.47,21.1
"2011","Kettering 009D","E01027131","Total",2012,984,1028,1950,62,12,166.70,12.1
"2011","Kettering 010A","E01027084","Total",1462,733,729,1455,7,14,62.59,23.4
"2011","Kettering 010B","E01027085","Total",1287,609,678,1246,41,18,92.08,14.0
"2011","Kettering 010C","E01027086","Total",1669,806,863,1669,0,39,48.12,34.7
"2011","Kettering 010D","E01027120","Total",1342,676,666,1342,0,37,20.94,64.1
"2011","Kettering 010E","E01027121","Total",1455,746,709,1455,0,50,115.29,12.6
"2011","Kettering 011A","E01027091","Total",1867,898,969,1855,12,17,196.39,9.5
"2011","Kettering 011B","E01027092","Total",1502,721,781,1482,20,19,108.91,13.8
"2011","Kettering 011C","E01027101","Total",2422,1160,1262,2422,0,33,759.09,3.2
"2011","Kettering 011D","E01027102","Total",1658,807,851,1658,0,11,62.38,26.6
"2011","Kettering 011F","E01027119","Total",1708,819,889,1708,0,33,1720.10,1.0
"2011","Kettering 011G","E01032972","Total",1439,713,726,1426,13,28,1080.91,1.3
"2011","Kettering 011H","E01032973","Total",1699,821,878,1699,0,20,85.56,19.9
"2011","Kettering 011I","E01032974","Total",1287,598,689,1287,0,32,2281.12,0.6
"2011","Northampton 001A","E01027145","Total",1402,686,716,1402,0,18,32.54,43.1
"2011","Northampton 001B","E01027148","Total",1453,717,736,1453,0,15,34.68,41.9
"2011","Northampton 001C","E01027149","Total",1457,732,725,1422,35,15,24.47,59.5
"2011","Northampton 001D","E01027232","Total",2540,1126,1414,1454,1086,65,83.23,30.5
"2011","Northampton 002A","E01027218","Total",1563,746,817,1540,23,14,169.02,9.2
"2011","Northampton 002B","E01027219","Total",1703,795,908,1683,20,17,53.08,32.1
"2011","Northampton 002C","E01027221","Total",1744,840,904,1729,15,21,90.98,19.2
"2011","Northampton 002D","E01027222","Total",1267,643,624,1261,6,14,27.07,46.8
"2011","Northampton 003A","E01027143","Total",1295,637,658,1237,58,10,33.99,38.1
"2011","Northampton 003B","E01027144","Total",1504,725,779,1504,0,21,35.56,42.3
"2011","Northampton 003C","E01027146","Total",1495,721,774,1495,0,22,39.59,37.8
"2011","Northampton 003D","E01027147","Total",1671,819,852,1643,28,10,41.01,40.7
"2011","Northampton 004A","E01027195","Total",1575,802,773,1552,23,18,43.28,36.4
"2011","Northampton 004B","E01027245","Total",1619,799,820,1573,46,15,48.59,33.3
"2011","Northampton 004C","E01027247","Total",1565,757,808,1565,0,11,34.58,45.3
"2011","Northampton 004D","E01027248","Total",1534,697,837,1534,0,10,69.26,22.1
"2011","Northampton 004E","E01027249","Total",1826,906,920,1801,25,15,29.27,62.4
"2011","Northampton 005A","E01027174","Total",1317,660,657,1317,0,25,41.57,31.7
"2011","Northampton 005B","E01027175","Total",1539,726,813,1539,0,17,27.68,55.6
"2011","Northampton 005C","E01027178","Total",2047,962,1085,2047,0,18,31.08,65.9
"2011","Northampton 005D","E01027200","Total",1466,691,775,1466,0,7,32.35,45.3
"2011","Northampton 005E","E01027246","Total",1854,861,993,1854,0,15,40.01,46.3
"2011","Northampton 006A","E01027171","Total",1438,649,789,1438,0,20,39.13,36.7
"2011","Northampton 006B","E01027172","Total",1579,762,817,1546,33,15,35.03,45.1
"2011","Northampton 006C","E01027182","Total",1428,676,752,1428,0,13,50.61,28.2
"2011","Northampton 006D","E01027183","Total",1366,677,689,1357,9,22,55.98,24.4
"2011","Northampton 007A","E01027196","Total",1538,729,809,1538,0,19,38.59,39.9
"2011","Northampton 007B","E01027197","Total",1402,676,726,1402,0,5,25.44,55.1
"2011","Northampton 007C","E01027198","Total",1561,783,778,1561,0,20,56.06,27.8
"2011","Northampton 007D","E01027199","Total",1400,666,734,1400,0,11,27.78,50.4
"2011","Northampton 008A","E01027190","Total",1531,709,822,1531,0,16,76.27,20.1
"2011","Northampton 008B","E01027191","Total",1781,923,858,1774,7,9,55.60,32.0
"2011","Northampton 008C","E01027193","Total",1434,699,735,1430,4,21,57.69,24.9
"2011","Northampton 008D","E01027194","Total",1347,663,684,1347,0,14,30.76,43.8
"2011","Northampton 009A","E01027192","Total",1388,676,712,1388,0,17,16.14,86.0
"2011","Northampton 009B","E01027229","Total",1565,739,826,1560,5,11,26.98,58.0
"2011","Northampton 009C","E01027230","Total",1542,716,826,1542,0,7,18.30,84.3
"2011","Northampton 009D","E01027231","Total",1791,861,930,1783,8,10,64.94,27.6
"2011","Northampton 010A","E01027179","Total",1867,912,955,1867,0,20,31.03,60.2
"2011","Northampton 010B","E01027180","Total",1542,739,803,1542,0,25,37.78,40.8
"2011","Northampton 010C","E01027181","Total",1654,790,864,1605,49,8,50.48,32.8
"2011","Northampton 011A","E01027140","Total",1242,587,655,1241,1,15,331.51,3.7
"2011","Northampton 011B","E01027142","Total",1367,661,706,1367,0,14,39.65,34.5
"2011","Northampton 011C","E01027176","Total",1508,734,774,1462,46,19,31.98,47.2
"2011","Northampton 011D","E01027177","Total",1543,716,827,1543,0,13,30.33,50.9
"2011","Northampton 012A","E01027168","Total",1668,825,843,1668,0,7,36.54,45.6
"2011","Northampton 012B","E01027169","Total",1644,833,811,1626,18,27,24.82,66.2
"2011","Northampton 012C","E01027170","Total",1558,746,812,1558,0,16,20.72,75.2
"2011","Northampton 012D","E01027173","Total",1611,788,823,1595,16,10,26.10,61.7
"2011","Northampton 013A","E01027136","Total",1843,901,942,1707,136,24,21.86,84.3
"2011","Northampton 013B","E01027186","Total",1760,913,847,1760,0,36,21.63,81.4
"2011","Northampton 013C","E01027188","Total",1809,848,961,1809,0,15,44.13,41.0
"2011","Northampton 013D","E01027220","Total",1320,646,674,1292,28,8,39.25,33.6
"2011","Northampton 014A","E01027208","Total",1465,724,741,1463,2,10,32.76,44.7
"2011","Northampton 014B","E01027209","Total",1195,580,615,1195,0,12,17.90,66.8
"2011","Northampton 014C","E01027211","Total",1380,662,718,1380,0,11,25.96,53.2
"2011","Northampton 014D","E01027212","Total",1408,690,718,1408,0,25,23.40,60.2
"2011","Northampton 015A","E01027184","Total",1561,749,812,1358,203,17,20.96,74.5
"2011","Northampton 015B","E01027185","Total",1500,698,802,1283,217,29,31.83,47.1
"2011","Northampton 015C","E01027187","Total",1325,689,636,1292,33,10,73.69,18.0
"2011","Northampton 015D","E01027189","Total",1621,805,816,1593,28,13,22.86,70.9
"2011","Northampton 016A","E01027137","Total",1369,647,722,1369,0,7,21.31,64.2
"2011","Northampton 016B","E01027138","Total",1488,706,782,1481,7,17,45.60,32.6
"2011","Northampton 016C","E01027139","Total",1484,773,711,1484,0,13,60.09,24.7
"2011","Northampton 016D","E01027141","Total",1456,700,756,1456,0,28,63.20,23.0
"2011","Northampton 016E","E01027259","Total",1568,770,798,1568,0,23,40.23,39.0
"2011","Northampton 017A","E01027239","Total",1687,815,872,1687,0,10,38.53,43.8
"2011","Northampton 017B","E01027241","Total",1741,884,857,1741,0,10,23.92,72.8
"2011","Northampton 017C","E01027242","Total",1575,746,829,1575,0,4,57.86,27.2
"2011","Northampton 017D","E01027243","Total",1546,715,831,1546,0,9,129.06,12.0
"2011","Northampton 017E","E01027244","Total",1624,774,850,1624,0,6,27.33,59.4
"2011","Northampton 018A","E01027213","Total",1541,770,771,1499,42,22,29.45,52.3
"2011","Northampton 018B","E01027214","Total",1545,733,812,1545,0,7,38.29,40.3
"2011","Northampton 018C","E01027216","Total",1614,800,814,1614,0,13,54.31,29.7
"2011","Northampton 018D","E01027240","Total",1329,598,731,1269,60,18,213.76,6.2
"2011","Northampton 019A","E01027207","Total",1373,694,679,1373,0,12,37.17,36.9
"2011","Northampton 019B","E01027210","Total",1141,546,595,1141,0,9,20.95,54.5
"2011","Northampton 019C","E01027215","Total",1461,707,754,1461,0,10,52.14,28.0
"2011","Northampton 019D","E01027217","Total",2133,1010,1123,2095,38,26,64.34,33.2
"2011","Northampton 020A","E01027255","Total",1347,662,685,1347,0,21,48.05,28.0
"2011","Northampton 020B","E01027256","Total",1493,708,785,1443,50,39,90.65,16.5
"2011","Northampton 020C","E01027258","Total",1431,749,682,1431,0,45,47.85,29.9
"2011","Northampton 020D","E01027260","Total",1422,706,716,1419,3,45,63.69,22.3
"2011","Northampton 021B","E01027152","Total",1738,894,844,1738,0,5,19.04,91.3
"2011","Northampton 021C","E01027153","Total",2007,1095,912,1769,238,9,33.86,59.3
"2011","Northampton 021D","E01027154","Total",1757,910,847,1757,0,5,20.14,87.2
"2011","Northampton 021E","E01032978","Total",1375,737,638,1375,0,3,31.80,43.2
"2011","Northampton 021F","E01032979","Total",1300,711,589,1299,1,7,109.74,11.8
"2011","Northampton 022A","E01027132","Total",2023,1017,1006,2016,7,15,15.32,132.0
"2011","Northampton 022B","E01027133","Total",1708,882,826,1706,2,10,24.17,70.7
"2011","Northampton 022C","E01027134","Total",1766,874,892,1757,9,19,13.57,130.1
"2011","Northampton 022D","E01027135","Total",1788,934,854,1751,37,30,40.46,44.2
"2011","Northampton 023A","E01027155","Total",2191,1195,996,2191,0,21,20.24,108.3
"2011","Northampton 023B","E01027225","Total",1653,868,785,1652,1,10,13.49,122.5
"2011","Northampton 023C","E01027227","Total",1577,821,756,1577,0,9,13.51,116.7
"2011","Northampton 023D","E01027228","Total",1906,975,931,1906,0,11,19.56,97.4
"2011","Northampton 024A","E01027151","Total",1623,864,759,1609,14,2,25.09,64.7
"2011","Northampton 024B","E01027236","Total",1583,743,840,1457,126,8,30.85,51.3
"2011","Northampton 024C","E01027237","Total",2012,957,1055,1976,36,14,143.04,14.1
"2011","Northampton 024D","E01027238","Total",1948,1001,947,1948,0,9,39.13,49.8
"2011","Northampton 025A","E01027223","Total",1983,1054,929,1949,34,15,71.20,27.9
"2011","Northampton 025B","E01027224","Total",1724,899,825,1724,0,12,80.22,21.5
"2011","Northampton 025C","E01027226","Total",1777,883,894,1734,43,8,17.28,102.8
"2011","Northampton 025D","E01027257","Total",1567,839,728,1090,477,29,95.44,16.4
"2011","Northampton 026A","E01027233","Total",1324,615,709,1324,0,10,68.95,19.2
"2011","Northampton 026B","E01027234","Total",1400,673,727,1400,0,12,45.75,30.6
"2011","Northampton 026C","E01027235","Total",1462,667,795,1456,6,10,44.01,33.2
"2011","Northampton 026D","E01027252","Total",1547,719,828,1547,0,14,53.89,28.7
"2011","Northampton 027A","E01027156","Total",1257,605,652,1257,0,9,27.03,46.5
"2011","Northampton 027B","E01027159","Total",1273,638,635,1273,0,11,77.52,16.4
"2011","Northampton 027C","E01027160","Total",1826,922,904,1826,0,12,43.51,42.0
"2011","Northampton 027D","E01027161","Total",1557,729,828,1542,15,6,44.67,34.9
"2011","Northampton 028B","E01027158","Total",1464,734,730,1464,0,17,41.01,35.7
"2011","Northampton 028C","E01027201","Total",2083,1004,1079,2083,0,18,78.44,26.6
"2011","Northampton 028D","E01027202","Total",1554,770,784,1554,0,27,864.44,1.8
"2011","Northampton 028E","E01032980","Total",1437,763,674,1437,0,4,20.62,69.7
"2011","Northampton 028F","E01032981","Total",1515,765,750,1506,9,11,196.81,7.7
"2011","Northampton 029A","E01027250","Total",1371,679,692,1371,0,19,82.69,16.6
"2011","Northampton 029C","E01027253","Total",1829,898,931,1829,0,37,112.74,16.2
"2011","Northampton 029D","E01027254","Total",1766,864,902,1766,0,47,177.94,9.9
"2011","Northampton 029E","E01032975","Total",1720,868,852,1706,14,11,75.26,22.9
"2011","Northampton 029F","E01032976","Total",1251,575,676,1221,30,5,193.17,6.5
"2011","Northampton 029G","E01032977","Total",1780,872,908,1780,0,10,299.94,5.9
"2011","Northampton 030A","E01027162","Total",1556,782,774,1556,0,18,42.69,36.4
"2011","Northampton 030B","E01027163","Total",1407,699,708,1401,6,22,92.20,15.3
"2011","Northampton 030C","E01027164","Total",1513,748,765,1513,0,19,38.69,39.1
"2011","Northampton 030D","E01027165","Total",1333,674,659,1333,0,29,69.77,19.1
"2011","Northampton 030E","E01027166","Total",1613,798,815,1613,0,24,22.08,73.1
"2011","Northampton 030F","E01027167","Total",1406,666,740,1406,0,28,43.18,32.6
"2011","Northampton 031A","E01027203","Total",1619,767,852,1619,0,26,24.70,65.5
"2011","Northampton 031B","E01027204","Total",1708,823,885,1684,24,20,40.75,41.9
"2011","Northampton 031C","E01027205","Total",2259,1136,1123,2259,0,40,44.25,51.1
"2011","Northampton 031D","E01027206","Total",2947,1461,1486,2878,69,48,189.18,15.6
"2011","South Northamptonshire 001A","E01027282","Total",1634,796,838,1634,0,27,205.51,8.0
"2011","South Northamptonshire 001B","E01027283","Total",1602,776,826,1560,42,45,1403.59,1.1
"2011","South Northamptonshire 001C","E01027285","Total",1709,841,868,1709,0,27,980.45,1.7
"2011","South Northamptonshire 001D","E01027286","Total",1546,765,781,1546,0,21,832.77,1.9
"2011","South Northamptonshire 001E","E01027287","Total",1637,776,861,1637,0,25,849.45,1.9
"2011","South Northamptonshire 002A","E01027273","Total",1753,844,909,1753,0,35,2157.77,0.8
"2011","South Northamptonshire 002B","E01027274","Total",1574,780,794,1574,0,35,2417.67,0.7
"2011","South Northamptonshire 002C","E01027275","Total",1436,718,718,1436,0,25,652.29,2.2
"2011","South Northamptonshire 002D","E01027308","Total",1595,771,824,1591,4,38,3125.53,0.5
"2011","South Northamptonshire 003A","E01027263","Total",1785,866,919,1785,0,14,761.15,2.3
"2011","South Northamptonshire 003C","E01027279","Total",1643,780,863,1643,0,17,299.47,5.5
"2011","South Northamptonshire 003D","E01027284","Total",1996,1004,992,1933,63,54,2056.54,1.0
"2011","South Northamptonshire 003E","E01027294","Total",1875,944,931,1853,22,32,905.18,2.1
"2011","South Northamptonshire 003F","E01032982","Total",1277,625,652,1215,62,10,100.24,12.7
"2011","South Northamptonshire 003G","E01032983","Total",1527,763,764,1527,0,26,30.96,49.3
"2011","South Northamptonshire 003H","E01032984","Total",1600,805,795,1600,0,21,86.92,18.4
"2011","South Northamptonshire 003I","E01032985","Total",1552,758,794,1528,24,35,1492.69,1.0
"2011","South Northamptonshire 004A","E01027262","Total",1609,805,804,1601,8,64,4370.26,0.4
"2011","South Northamptonshire 004B","E01027277","Total",1833,919,914,1833,0,48,1600.13,1.1
"2011","South Northamptonshire 004C","E01027289","Total",1675,816,859,1640,35,49,1372.33,1.2
"2011","South Northamptonshire 004D","E01027300","Total",1406,703,703,1406,0,34,41.97,33.5
"2011","South Northamptonshire 004E","E01027303","Total",1461,745,716,1459,2,39,1572.99,0.9
"2011","South Northamptonshire 005A","E01027297","Total",1681,846,835,1681,0,48,2293.06,0.7
"2011","South Northamptonshire 005B","E01027298","Total",1302,662,640,1302,0,27,407.78,3.2
"2011","South Northamptonshire 005C","E01027299","Total",1488,719,769,1457,31,16,27.75,53.6
"2011","South Northamptonshire 005D","E01027301","Total",2155,1072,1083,2154,1,26,97.55,22.1
"2011","South Northamptonshire 005E","E01027302","Total",1440,687,753,1440,0,11,30.95,46.5
"2011","South Northamptonshire 006A","E01027291","Total",1484,712,772,1452,32,27,1209.94,1.2
"2011","South Northamptonshire 006B","E01027292","Total",1149,571,578,1149,0,13,55.90,20.6
"2011","South Northamptonshire 006C","E01027293","Total",1199,567,632,1199,0,25,209.29,5.7
"2011","South Northamptonshire 006D","E01027304","Total",1743,886,857,1743,0,50,3520.82,0.5
"2011","South Northamptonshire 006E","E01027305","Total",1886,903,983,1807,79,52,3663.22,0.5
"2011","South Northamptonshire 007A","E01027261","Total",2028,991,1037,2004,24,42,3997.47,0.5
"2011","South Northamptonshire 007B","E01027295","Total",2176,1109,1067,2155,21,40,757.32,2.9
"2011","South Northamptonshire 007C","E01027306","Total",1716,839,877,1702,14,69,4826.80,0.4
"2011","South Northamptonshire 008A","E01027276","Total",2517,1280,1237,2516,1,39,1122.82,2.2
"2011","South Northamptonshire 008B","E01027280","Total",2416,1180,1236,2415,1,43,1813.30,1.3
"2011","South Northamptonshire 008C","E01027281","Total",1696,842,854,1696,0,19,79.96,21.2
"2011","South Northamptonshire 008D","E01027307","Total",2042,1034,1008,2040,2,46,2260.14,0.9
"2011","South Northamptonshire 009A","E01027265","Total",1481,714,767,1481,0,18,52.36,28.3
"2011","South Northamptonshire 009B","E01027266","Total",1355,673,682,1320,35,44,178.82,7.6
"2011","South Northamptonshire 009C","E01027270","Total",1656,821,835,1656,0,41,64.61,25.6
"2011","South Northamptonshire 009D","E01027271","Total",1568,774,794,1568,0,32,148.03,10.6
"2011","South Northamptonshire 009E","E01027272","Total",1581,791,790,1581,0,20,28.47,55.5
"2011","South Northamptonshire 010A","E01027264","Total",1466,714,752,1424,42,20,103.00,14.2
"2011","South Northamptonshire 010B","E01027267","Total",1183,586,597,1122,61,21,35.75,33.1
"2011","South Northamptonshire 010C","E01027268","Total",1265,647,618,1262,3,25,41.84,30.2
"2011","South Northamptonshire 010D","E01027269","Total",1463,756,707,1458,5,10,34.79,42.1
"2011","South Northamptonshire 011A","E01027288","Total",2116,1020,1096,2116,0,46,1664.56,1.3
"2011","South Northamptonshire 011B","E01027290","Total",2214,1103,1111,2136,78,66,3185.50,0.7
"2011","South Northamptonshire 011C","E01027296","Total",1998,999,999,1998,0,54,4174.19,0.5
"2011","Wellingborough 001A","E01027326","Total",1485,746,739,1485,0,9,918.87,1.6
"2011","Wellingborough 001B","E01027327","Total",1480,742,738,1473,7,13,517.24,2.9
"2011","Wellingborough 001C","E01027328","Total",1344,665,679,1344,0,16,45.65,29.4
"2011","Wellingborough 001D","E01027338","Total",2263,1118,1145,2263,0,45,2940.19,0.8
"2011","Wellingborough 002A","E01027330","Total",1667,795,872,1667,0,13,75.79,22.0
"2011","Wellingborough 002B","E01027331","Total",1392,677,715,1392,0,3,26.10,53.3
"2011","Wellingborough 002C","E01027332","Total",1496,723,773,1496,0,17,50.21,29.8
"2011","Wellingborough 002D","E01027333","Total",2342,1176,1166,2342,0,41,87.63,26.7
"2011","Wellingborough 002E","E01027334","Total",1375,649,726,1375,0,14,146.21,9.4
"2011","Wellingborough 003A","E01027343","Total",1480,726,754,1476,4,9,40.02,37.0
"2011","Wellingborough 003B","E01027344","Total",1379,660,719,1375,4,22,44.78,30.8
"2011","Wellingborough 003C","E01027345","Total",1371,691,680,1366,5,21,35.54,38.6
"2011","Wellingborough 003D","E01027346","Total",1477,756,721,1477,0,32,216.87,6.8
"2011","Wellingborough 003E","E01027347","Total",1940,948,992,1936,4,43,37.64,51.5
"2011","Wellingborough 004A","E01027313","Total",1634,803,831,1627,7,21,14.46,113.0
"2011","Wellingborough 004B","E01027314","Total",1931,1006,925,1886,45,17,56.54,34.2
"2011","Wellingborough 004C","E01027315","Total",2255,1141,1114,2227,28,21,421.32,5.4
"2011","Wellingborough 004D","E01027316","Total",1501,750,751,1501,0,18,69.84,21.5
"2011","Wellingborough 005A","E01027339","Total",1347,635,712,1347,0,2,229.90,5.9
"2011","Wellingborough 005B","E01027340","Total",1484,697,787,1484,0,5,33.18,44.7
"2011","Wellingborough 005C","E01027341","Total",1530,737,793,1530,0,13,37.16,41.2
"2011","Wellingborough 005D","E01027342","Total",1457,685,772,1412,45,14,29.36,49.6
"2011","Wellingborough 006A","E01027349","Total",1583,825,758,1539,44,11,52.40,30.2
"2011","Wellingborough 006B","E01027350","Total",1453,715,738,1416,37,24,46.96,30.9
"2011","Wellingborough 006C","E01027351","Total",1561,756,805,1559,2,8,56.81,27.5
"2011","Wellingborough 006D","E01027352","Total",1450,709,741,1390,60,33,20.91,69.3
"2011","Wellingborough 007A","E01027309","Total",1497,720,777,1497,0,10,38.26,39.1
"2011","Wellingborough 007B","E01027310","Total",1505,708,797,1505,0,10,23.81,63.2
"2011","Wellingborough 007C","E01027311","Total",1323,627,696,1261,62,24,27.41,48.3
"2011","Wellingborough 007D","E01027312","Total",1418,668,750,1418,0,9,29.17,48.6
"2011","Wellingborough 008A","E01027317","Total",1509,694,815,1491,18,21,72.66,20.8
"2011","Wellingborough 008B","E01027318","Total",1487,709,778,1487,0,6,25.68,57.9
"2011","Wellingborough 008C","E01027319","Total",1530,758,772,1530,0,12,38.89,39.3
"2011","Wellingborough 008D","E01027320","Total",2137,1173,964,1863,274,17,141.07,15.1
"2011","Wellingborough 008E","E01027321","Total",1576,787,789,1576,0,16,39.42,40.0
"2011","Wellingborough 009A","E01027322","Total",1161,572,589,1161,0,29,166.56,7.0
"2011","Wellingborough 009B","E01027323","Total",1482,721,761,1462,20,15,252.70,5.9
"2011","Wellingborough 009C","E01027324","Total",1186,580,606,1186,0,26,206.02,5.8
"2011","Wellingborough 009D","E01027325","Total",1558,745,813,1558,0,22,307.49,5.1
"2011","Wellingborough 009E","E01027329","Total",1747,877,870,1747,0,22,1080.41,1.6
"2011","Wellingborough 009F","E01027353","Total",1731,847,884,1725,6,30,2435.63,0.7
"2011","Wellingborough 010A","E01027335","Total",1474,741,733,1474,0,15,253.69,5.8
"2011","Wellingborough 010B","E01027336","Total",1481,708,773,1403,78,18,698.64,2.1
"2011","Wellingborough 010C","E01027337","Total",1790,892,898,1783,7,14,175.89,10.2
"2011","Wellingborough 010D","E01027348","Total",2052,1012,1040,2036,16,18,1781.32,1.2
"2011","Wellingborough 010E","E01027354","Total",2378,1173,1205,2378,0,40,1988.22,1.2
"2011","Wellingborough 010F","E01027355","Total",1657,833,824,1657,0,23,269.42,6.2
"2011","Ashfield 001A","E01027979","Total",1516,711,805,1512,4,9,131.64,11.5
"2011","Ashfield 001B","E01027980","Total",1555,760,795,1555,0,9,70.86,21.9
"2011","Ashfield 001C","E01027981","Total",1560,788,772,1559,1,12,1340.59,1.2
"2011","Ashfield 001D","E01027983","Total",1515,757,758,1515,0,7,37.11,40.8
"2011","Ashfield 002A","E01027970","Total",1406,694,712,1406,0,10,28.77,48.9
"2011","Ashfield 002B","E01027971","Total",1387,709,678,1387,0,8,42.65,32.5
"2011","Ashfield 002C","E01027982","Total",1441,702,739,1408,33,6,29.90,48.2
"2011","Ashfield 002D","E01027984","Total",1494,740,754,1494,0,11,36.26,41.2
"2011","Ashfield 003A","E01027966","Total",1406,683,723,1366,40,11,58.21,24.2
"2011","Ashfield 003B","E01027986","Total",1338,683,655,1333,5,1,214.80,6.2
"2011","Ashfield 003C","E01027987","Total",1813,870,943,1813,0,14,73.89,24.5
"2011","Ashfield 003D","E01027990","Total",1831,897,934,1831,0,14,149.32,12.3
"2011","Ashfield 004A","E01027967","Total",1668,858,810,1668,0,12,22.45,74.3
"2011","Ashfield 004B","E01027972","Total",2239,1083,1156,2239,0,14,158.11,14.2
"2011","Ashfield 004C","E01027977","Total",1930,957,973,1867,63,9,78.44,24.6
"2011","Ashfield 004D","E01027978","Total",1838,942,896,1811,27,8,27.73,66.3
"2011","Ashfield 004E","E01027985","Total",1856,909,947,1837,19,10,83.85,22.1
"2011","Ashfield 005A","E01027964","Total",1547,728,819,1472,75,7,56.23,27.5
"2011","Ashfield 005B","E01027965","Total",1445,638,807,1317,128,7,32.25,44.8
"2011","Ashfield 005C","E01027968","Total",1248,587,661,1200,48,3,36.20,34.5
"2011","Ashfield 005D","E01027974","Total",1670,830,840,1670,0,7,33.88,49.3
"2011","Ashfield 005E","E01027976","Total",1608,778,830,1584,24,8,45.33,35.5
"2011","Ashfield 006A","E01027969","Total",1405,698,707,1366,39,8,28.12,50.0
"2011","Ashfield 006B","E01027975","Total",1663,819,844,1659,4,12,32.90,50.5
"2011","Ashfield 006C","E01027988","Total",1588,775,813,1588,0,10,53.39,29.7
"2011","Ashfield 006D","E01027989","Total",1598,798,800,1598,0,13,36.69,43.6
"2011","Ashfield 006E","E01027991","Total",1253,643,610,1253,0,6,47.82,26.2
"2011","Ashfield 006F","E01027992","Total",2220,1105,1115,2220,0,21,131.81,16.8
"2011","Ashfield 007A","E01027949","Total",1559,722,837,1535,24,9,44.40,35.1
"2011","Ashfield 007B","E01027951","Total",1595,767,828,1595,0,6,110.73,14.4
"2011","Ashfield 007C","E01027953","Total",1496,742,754,1495,1,19,163.05,9.2
"2011","Ashfield 007D","E01027954","Total",1647,825,822,1604,43,8,148.01,11.1
"2011","Ashfield 007E","E01027973","Total",1715,866,849,1618,97,20,1006.25,1.7
"2011","Ashfield 008A","E01027952","Total",1875,941,934,1811,64,10,64.38,29.1
"2011","Ashfield 008B","E01027955","Total",1265,634,631,1229,36,7,16.24,77.9
"2011","Ashfield 008C","E01027956","Total",1500,707,793,1500,0,10,32.43,46.3
"2011","Ashfield 008D","E01027958","Total",1432,700,732,1432,0,7,25.78,55.5
"2011","Ashfield 009A","E01027947","Total",1683,813,870,1674,9,18,554.05,3.0
"2011","Ashfield 009B","E01027948","Total",1867,913,954,1853,14,8,102.05,18.3
"2011","Ashfield 009C","E01027950","Total",1999,999,1000,1987,12,11,395.40,5.1
"2011","Ashfield 009D","E01027957","Total",1263,626,637,1263,0,16,237.59,5.3
"2011","Ashfield 009E","E01027959","Total",1491,756,735,1491,0,30,64.92,23.0
"2011","Ashfield 010A","E01027995","Total",1574,766,808,1557,17,12,1213.71,1.3
"2011","Ashfield 010B","E01027996","Total",2037,1020,1017,2017,20,8,338.10,6.0
"2011","Ashfield 010C","E01027997","Total",1664,824,840,1664,0,6,115.71,14.4
"2011","Ashfield 010D","E01027998","Total",1834,890,944,1834,0,12,38.76,47.3
"2011","Ashfield 011A","E01027960","Total",1649,811,838,1635,14,8,279.39,5.9
"2011","Ashfield 011B","E01027961","Total",1849,928,921,1849,0,9,187.72,9.8
"2011","Ashfield 011C","E01027962","Total",1498,746,752,1498,0,5,67.65,22.1
"2011","Ashfield 011D","E01027963","Total",1757,844,913,1683,74,7,55.60,31.6
"2011","Ashfield 012A","E01027945","Total",1707,835,872,1688,19,6,151.23,11.3
"2011","Ashfield 012B","E01027946","Total",1451,717,734,1451,0,14,218.39,6.6
"2011","Ashfield 012C","E01027993","Total",1526,749,777,1526,0,18,532.18,2.9
"2011","Ashfield 012D","E01027994","Total",1427,686,741,1427,0,11,57.34,24.9
"2011","Ashfield 013A","E01027929","Total",2416,1152,1264,2392,24,16,194.99,12.4
"2011","Ashfield 013B","E01027931","Total",2015,1012,1003,1960,55,15,175.91,11.5
"2011","Ashfield 013C","E01027934","Total",1379,693,686,1379,0,19,34.68,39.8
"2011","Ashfield 013D","E01027935","Total",1275,629,646,1234,41,11,50.05,25.5
"2011","Ashfield 013E","E01027936","Total",1485,690,795,1485,0,16,40.91,36.3
"2011","Ashfield 014A","E01027927","Total",2055,992,1063,1997,58,10,37.22,55.2
"2011","Ashfield 014B","E01027928","Total",1878,878,1000,1853,25,12,31.66,59.3
"2011","Ashfield 014C","E01027932","Total",2164,1077,1087,2152,12,9,48.97,44.2
"2011","Ashfield 014D","E01027933","Total",1479,725,754,1479,0,6,22.69,65.2
"2011","Ashfield 014E","E01027937","Total",1348,648,700,1348,0,5,23.78,56.7
"2011","Ashfield 015A","E01027925","Total",1862,926,936,1827,35,13,58.15,32.0
"2011","Ashfield 015B","E01027938","Total",1325,666,659,1325,0,15,108.95,12.2
"2011","Ashfield 015C","E01027940","Total",1329,662,667,1329,0,15,19.72,67.4
"2011","Ashfield 015D","E01027943","Total",1380,662,718,1380,0,12,257.00,5.4
"2011","Ashfield 015E","E01027944","Total",1531,738,793,1531,0,11,87.98,17.4
"2011","Ashfield 016A","E01027926","Total",1450,715,735,1450,0,10,29.13,49.8
"2011","Ashfield 016B","E01027930","Total",1561,790,771,1543,18,15,54.25,28.8
"2011","Ashfield 016C","E01027939","Total",1516,710,806,1464,52,8,38.50,39.4
"2011","Ashfield 016D","E01027941","Total",1298,648,650,1288,10,8,28.29,45.9
"2011","Ashfield 016E","E01027942","Total",1353,683,670,1353,0,11,272.60,5.0
"2011","Bassetlaw 001A","E01028000","Total",2232,1119,1113,2155,77,39,2721.09,0.8
"2011","Bassetlaw 001B","E01028024","Total",1839,893,946,1819,20,17,212.94,8.6
"2011","Bassetlaw 001C","E01028025","Total",1510,727,783,1510,0,5,37.40,40.4
"2011","Bassetlaw 001D","E01028026","Total",1530,757,773,1530,0,12,42.86,35.7
"2011","Bassetlaw 001E","E01028027","Total",1480,711,769,1439,41,5,373.80,4.0
"2011","Bassetlaw 001F","E01028028","Total",1589,795,794,1582,7,4,56.94,27.9
"2011","Bassetlaw 002A","E01027999","Total",2285,1138,1147,2252,33,44,2847.05,0.8
"2011","Bassetlaw 002B","E01028005","Total",1892,944,948,1892,0,28,3330.45,0.6
"2011","Bassetlaw 002C","E01028031","Total",1093,555,538,1085,8,13,310.86,3.5
"2011","Bassetlaw 002D","E01028032","Total",1374,681,693,1374,0,19,1716.15,0.8
"2011","Bassetlaw 002E","E01028035","Total",2289,1113,1176,2289,0,44,4813.40,0.5
"2011","Bassetlaw 003A","E01028023","Total",2283,1142,1141,2274,9,70,6231.15,0.4
"2011","Bassetlaw 003B","E01028034","Total",2417,1181,1236,2346,71,50,2102.37,1.1
"2011","Bassetlaw 003C","E01028036","Total",3109,2061,1048,1973,1136,50,5017.67,0.6
"2011","Bassetlaw 004A","E01028001","Total",1292,600,692,1292,0,6,184.47,7.0
"2011","Bassetlaw 004B","E01028002","Total",1422,690,732,1387,35,10,33.47,42.5
"2011","Bassetlaw 004C","E01028003","Total",1380,673,707,1380,0,10,216.43,6.4
"2011","Bassetlaw 004D","E01028004","Total",1529,713,816,1529,0,22,1440.30,1.1
"2011","Bassetlaw 004E","E01028029","Total",1176,581,595,1170,6,8,1606.86,0.7
"2011","Bassetlaw 004F","E01028030","Total",1296,652,644,1296,0,3,43.76,29.6
"2011","Bassetlaw 005A","E01028013","Total",1823,847,976,1744,79,22,77.15,23.6
"2011","Bassetlaw 005B","E01028014","Total",1512,733,779,1512,0,6,107.25,14.1
"2011","Bassetlaw 005C","E01028015","Total",1491,755,736,1491,0,30,96.69,15.4
"2011","Bassetlaw 005D","E01028016","Total",1336,640,696,1336,0,11,105.58,12.7
"2011","Bassetlaw 006A","E01028046","Total",1557,758,799,1547,10,17,52.24,29.8
"2011","Bassetlaw 006B","E01028047","Total",2209,1121,1088,2143,66,40,203.82,10.8
"2011","Bassetlaw 006C","E01028048","Total",1663,824,839,1663,0,21,39.69,41.9
"2011","Bassetlaw 006D","E01028049","Total",1714,830,884,1714,0,9,39.44,43.5
"2011","Bassetlaw 006E","E01028050","Total",1907,966,941,1907,0,20,36.17,52.7
"2011","Bassetlaw 008A","E01028008","Total",1396,619,777,1307,89,13,22.54,61.9
"2011","Bassetlaw 008B","E01028009","Total",1399,715,684,1399,0,26,475.56,2.9
"2011","Bassetlaw 008C","E01028010","Total",1371,685,686,1363,8,47,303.26,4.5
"2011","Bassetlaw 008D","E01028011","Total",1592,789,803,1556,36,19,40.32,39.5
"2011","Bassetlaw 008E","E01028012","Total",1357,653,704,1338,19,16,65.03,20.9
"2011","Bassetlaw 008F","E01028022","Total",1507,751,756,1507,0,18,39.57,38.1
"2011","Bassetlaw 009A","E01028055","Total",1514,755,759,1451,63,7,124.76,12.1
"2011","Bassetlaw 009B","E01028056","Total",1251,608,643,1251,0,5,505.06,2.5
"2011","Bassetlaw 009C","E01028058","Total",1816,896,920,1804,12,22,196.10,9.3
"2011","Bassetlaw 009D","E01028059","Total",1822,918,904,1822,0,29,32.05,56.8
"2011","Bassetlaw 010A","E01028017","Total",1300,653,647,1300,0,2,87.35,14.9
"2011","Bassetlaw 010B","E01028018","Total",1470,716,754,1470,0,18,182.01,8.1
"2011","Bassetlaw 010C","E01028019","Total",1445,710,735,1445,0,12,28.72,50.3
"2011","Bassetlaw 010D","E01028020","Total",1843,930,913,1793,50,19,65.05,28.3
"2011","Bassetlaw 010E","E01028021","Total",1508,721,787,1508,0,17,186.78,8.1
"2011","Bassetlaw 012A","E01028057","Total",1250,627,623,1248,2,3,23.26,53.7
"2011","Bassetlaw 012B","E01028065","Total",1732,793,939,1732,0,4,26.84,64.5
"2011","Bassetlaw 012C","E01028066","Total",1702,855,847,1674,28,4,48.51,35.1
"2011","Bassetlaw 012D","E01028068","Total",1807,881,926,1693,114,9,69.33,26.1
"2011","Bassetlaw 013A","E01028060","Total",1697,840,857,1685,12,36,253.84,6.7
"2011","Bassetlaw 013B","E01028061","Total",1487,726,761,1487,0,16,86.06,17.3
"2011","Bassetlaw 013C","E01028062","Total",1937,910,1027,1882,55,14,66.99,28.9
"2011","Bassetlaw 013D","E01028067","Total",1513,744,769,1513,0,4,44.84,33.7
"2011","Bassetlaw 014A","E01028040","Total",1020,498,522,1020,0,13,4537.94,0.2
"2011","Bassetlaw 014B","E01028041","Total",1072,514,558,1029,43,7,2282.22,0.5
"2011","Bassetlaw 014C","E01028043","Total",1450,691,759,1450,0,14,1334.18,1.1
"2011","Bassetlaw 014D","E01028063","Total",1779,895,884,1779,0,29,1235.47,1.4
"2011","Bassetlaw 014E","E01028064","Total",1478,768,710,1313,165,10,1226.95,1.2
"2011","Bassetlaw 015A","E01028006","Total",1371,738,633,1226,145,31,4358.28,0.3
"2011","Bassetlaw 015B","E01028007","Total",1114,553,561,1114,0,23,1138.60,1.0
"2011","Bassetlaw 015C","E01028033","Total",2296,1250,1046,1992,304,38,4374.62,0.5
"2011","Bassetlaw 015D","E01028037","Total",1661,830,831,1637,24,23,2485.02,0.7
"2011","Bassetlaw 015E","E01028038","Total",1450,708,742,1450,0,14,90.91,15.9
"2011","Bassetlaw 015F","E01028039","Total",1163,570,593,1163,0,21,3381.59,0.3
"2011","Bassetlaw 016E","E01028042","Total",1436,726,710,1436,0,12,40.16,35.8
"2011","Bassetlaw 016F","E01028044","Total",1526,732,794,1523,3,7,36.92,41.3
"2011","Bassetlaw 016G","E01028045","Total",1913,925,988,1913,0,8,43.29,44.2
"2011","Bassetlaw 016A","E01028051","Total",1524,689,835,1477,47,11,30.41,50.1
"2011","Bassetlaw 016B","E01028052","Total",1664,789,875,1664,0,13,45.83,36.3
"2011","Bassetlaw 016C","E01028053","Total",1514,719,795,1514,0,10,30.29,50.0
"2011","Bassetlaw 016D","E01028054","Total",1487,734,753,1420,67,31,43.12,34.5
"2011","Broxtowe 001A","E01028092","Total",1321,630,691,1286,35,8,186.42,7.1
"2011","Broxtowe 001B","E01028093","Total",1006,499,507,1006,0,6,204.57,4.9
"2011","Broxtowe 001C","E01028107","Total",1565,808,757,1565,0,29,738.62,2.1
"2011","Broxtowe 001D","E01028108","Total",1485,729,756,1485,0,5,40.22,36.9
"2011","Broxtowe 001E","E01028114","Total",1515,721,794,1434,81,13,27.41,55.3
"2011","Broxtowe 002A","E01028110","Total",1461,725,736,1433,28,5,81.29,18.0
"2011","Broxtowe 002B","E01028111","Total",1428,683,745,1403,25,5,49.25,29.0
"2011","Broxtowe 002C","E01028112","Total",1547,768,779,1536,11,10,39.70,39.0
"2011","Broxtowe 002D","E01028113","Total",1491,732,759,1491,0,6,25.07,59.5
"2011","Broxtowe 003A","E01028109","Total",1697,849,848,1697,0,11,38.25,44.4
"2011","Broxtowe 003B","E01028115","Total",1501,719,782,1478,23,12,194.73,7.7
"2011","Broxtowe 003C","E01028116","Total",1559,781,778,1559,0,5,94.98,16.4
"2011","Broxtowe 003D","E01028117","Total",1534,786,748,1534,0,8,35.63,43.1
"2011","Broxtowe 003E","E01028118","Total",1639,800,839,1639,0,13,532.12,3.1
"2011","Broxtowe 004A","E01028102","Total",1370,666,704,1370,0,15,51.12,26.8
"2011","Broxtowe 004B","E01028103","Total",1147,573,574,1146,1,12,37.19,30.8
"2011","Broxtowe 004C","E01028104","Total",1446,709,737,1446,0,30,38.36,37.7
"2011","Broxtowe 004D","E01028122","Total",1584,752,832,1584,0,10,55.58,28.5
"2011","Broxtowe 004E","E01028123","Total",1901,926,975,1901,0,37,571.98,3.3
"2011","Broxtowe 004F","E01028124","Total",1528,762,766,1512,16,20,122.71,12.5
"2011","Broxtowe 007A","E01028087","Total",1598,794,804,1574,24,36,205.55,7.8
"2011","Broxtowe 007B","E01028088","Total",1472,726,746,1472,0,22,83.04,17.7
"2011","Broxtowe 007C","E01028089","Total",1341,675,666,1341,0,31,55.59,24.1
"2011","Broxtowe 007D","E01028090","Total",1382,661,721,1382,0,23,66.06,20.9
"2011","Broxtowe 007E","E01028091","Total",1477,732,745,1477,0,29,48.43,30.5
"2011","Broxtowe 008A","E01028125","Total",1632,805,827,1632,0,4,85.17,19.2
"2011","Broxtowe 008B","E01028126","Total",1444,689,755,1444,0,12,44.25,32.6
"2011","Broxtowe 008C","E01028127","Total",1696,848,848,1696,0,3,23.96,70.8
"2011","Broxtowe 008D","E01028134","Total",1466,708,758,1466,0,10,21.51,68.2
"2011","Broxtowe 009A","E01028076","Total",1239,610,629,1239,0,17,29.42,42.1
"2011","Broxtowe 009B","E01028077","Total",1456,732,724,1456,0,12,34.46,42.3
"2011","Broxtowe 009C","E01028078","Total",1593,802,791,1593,0,30,27.79,57.3
"2011","Broxtowe 009D","E01028079","Total",1365,695,670,1364,1,4,22.70,60.1
"2011","Broxtowe 009E","E01028084","Total",1797,880,917,1797,0,28,30.05,59.8
"2011","Broxtowe 010A","E01028128","Total",1742,866,876,1742,0,34,55.85,31.2
"2011","Broxtowe 010B","E01028129","Total",1499,711,788,1471,28,23,53.13,28.2
"2011","Broxtowe 010C","E01028130","Total",1757,891,866,1757,0,13,44.96,39.1
"2011","Broxtowe 010D","E01028131","Total",1491,742,749,1491,0,9,44.48,33.5
"2011","Broxtowe 010E","E01028132","Total",1057,507,550,1057,0,8,20.36,51.9
"2011","Broxtowe 010F","E01028133","Total",1457,718,739,1457,0,13,34.41,42.3
"2011","Broxtowe 011A","E01028073","Total",1528,745,783,1472,56,10,27.98,54.6
"2011","Broxtowe 011B","E01028074","Total",1610,844,766,1583,27,16,37.69,42.7
"2011","Broxtowe 011C","E01028075","Total",1661,849,812,1661,0,19,23.38,71.0
"2011","Broxtowe 011D","E01028085","Total",2025,1040,985,1985,40,20,51.90,39.0
"2011","Broxtowe 011E","E01028086","Total",1515,719,796,1478,37,14,31.35,48.3
"2011","Broxtowe 012A","E01028080","Total",1786,905,881,1701,85,18,43.54,41.0
"2011","Broxtowe 012B","E01028081","Total",1168,584,584,1168,0,6,115.23,10.1
"2011","Broxtowe 012C","E01028082","Total",1257,631,626,1257,0,9,54.55,23.0
"2011","Broxtowe 012D","E01028083","Total",1305,666,639,1298,7,5,39.04,33.4
"2011","Broxtowe 013A","E01028097","Total",1446,719,727,1446,0,31,28.89,50.1
"2011","Broxtowe 013B","E01028098","Total",1759,860,899,1759,0,38,84.64,20.8
"2011","Broxtowe 013C","E01028099","Total",1508,802,706,1353,155,9,37.85,39.8
"2011","Broxtowe 013D","E01028100","Total",1683,792,891,1683,0,24,40.06,42.0
"2011","Broxtowe 013E","E01028101","Total",1427,670,757,1427,0,10,51.05,28.0
"2011","Broxtowe 014A","E01028069","Total",1183,591,592,1183,0,10,83.71,14.1
"2011","Broxtowe 014B","E01028070","Total",1145,564,581,1105,40,19,333.71,3.4
"2011","Broxtowe 014C","E01028094","Total",1772,841,931,1712,60,20,33.89,52.3
"2011","Broxtowe 014D","E01028095","Total",1452,734,718,1452,0,36,28.92,50.2
"2011","Broxtowe 014E","E01028096","Total",1817,885,932,1729,88,28,50.87,35.7
"2011","Broxtowe 015A","E01028135","Total",1403,673,730,1403,0,28,208.13,6.7
"2011","Broxtowe 015B","E01028136","Total",1714,843,871,1714,0,19,31.41,54.6
"2011","Broxtowe 015C","E01028137","Total",2473,1205,1268,2473,0,45,66.94,36.9
"2011","Broxtowe 015D","E01028138","Total",1205,569,636,1167,38,8,34.54,34.9
"2011","Broxtowe 015E","E01028139","Total",1443,721,722,1443,0,23,44.82,32.2
"2011","Broxtowe 016A","E01028105","Total",1238,606,632,1238,0,15,75.21,16.5
"2011","Broxtowe 016B","E01028106","Total",1458,721,737,1453,5,10,500.43,2.9
"2011","Broxtowe 016C","E01028119","Total",2175,1114,1061,2175,0,27,765.54,2.8
"2011","Broxtowe 016D","E01028120","Total",1589,792,797,1588,1,17,54.04,29.4
"2011","Broxtowe 016E","E01028121","Total",1474,739,735,1474,0,25,30.82,47.8
"2011","Broxtowe 016F","E01033412","Total",2378,1158,1220,2378,0,42,654.62,3.6
"2011","Broxtowe 016G","E01033413","Total",2204,1126,1078,2199,5,13,148.72,14.8
"2011","Gedling 001A","E01028189","Total",2300,1155,1145,2280,20,32,2216.16,1.0
"2011","Gedling 001B","E01028198","Total",1397,669,728,1397,0,27,139.50,10.0
"2011","Gedling 001C","E01028199","Total",1457,704,753,1457,0,28,111.50,13.1
"2011","Gedling 001D","E01028200","Total",1616,785,831,1613,3,43,1144.29,1.4
"2011","Gedling 001E","E01028201","Total",1159,579,580,1159,0,20,35.14,33.0
"2011","Gedling 002A","E01028150","Total",1355,643,712,1355,0,6,189.50,7.2
"2011","Gedling 002B","E01028151","Total",1166,556,610,1125,41,19,133.47,8.7
"2011","Gedling 002C","E01028152","Total",1538,729,809,1513,25,23,1442.26,1.1
"2011","Gedling 002D","E01028153","Total",1295,604,691,1295,0,10,52.83,24.5
"2011","Gedling 002E","E01028154","Total",1722,840,882,1722,0,14,99.39,17.3
"2011","Gedling 002F","E01028213","Total",1872,968,904,1872,0,49,787.78,2.4
"2011","Gedling 004A","E01028143","Total",1293,624,669,1293,0,16,25.79,50.1
"2011","Gedling 004B","E01028205","Total",1266,615,651,1266,0,24,101.60,12.5
"2011","Gedling 004C","E01028206","Total",1462,716,746,1462,0,11,23.16,63.1
"2011","Gedling 004D","E01028207","Total",1320,617,703,1320,0,11,53.16,24.8
"2011","Gedling 004E","E01028208","Total",1110,528,582,1084,26,11,21.20,52.4
"2011","Gedling 005A","E01028173","Total",1033,449,584,1001,32,2,82.50,12.5
"2011","Gedling 005B","E01028174","Total",1562,749,813,1547,15,7,32.21,48.5
"2011","Gedling 005C","E01028175","Total",1798,864,934,1798,0,23,42.14,42.7
"2011","Gedling 005D","E01028209","Total",1444,688,756,1444,0,6,26.04,55.5
"2011","Gedling 006A","E01028144","Total",1579,728,851,1508,71,5,26.12,60.5
"2011","Gedling 006B","E01028165","Total",1473,706,767,1473,0,4,25.13,58.6
"2011","Gedling 006C","E01028166","Total",1705,834,871,1701,4,7,34.85,48.9
"2011","Gedling 006D","E01028167","Total",1836,917,919,1828,8,10,39.87,46.0
"2011","Gedling 007A","E01028179","Total",1451,700,751,1436,15,16,25.15,57.7
"2011","Gedling 007B","E01028180","Total",1474,719,755,1474,0,21,69.44,21.2
"2011","Gedling 007C","E01028181","Total",1362,640,722,1362,0,24,36.20,37.6
"2011","Gedling 007D","E01028182","Total",1593,797,796,1593,0,16,29.96,53.2
"2011","Gedling 007E","E01028183","Total",1252,587,665,1252,0,12,45.39,27.6
"2011","Gedling 008A","E01028148","Total",1990,968,1022,1979,11,29,928.12,2.1
"2011","Gedling 008B","E01028149","Total",1623,776,847,1623,0,19,175.47,9.2
"2011","Gedling 008C","E01028178","Total",2164,1058,1106,2099,65,25,902.05,2.4
"2011","Gedling 009A","E01028176","Total",1542,751,791,1524,18,22,47.14,32.7
"2011","Gedling 009B","E01028177","Total",1552,722,830,1552,0,26,31.42,49.4
"2011","Gedling 009C","E01028214","Total",1464,723,741,1464,0,24,28.64,51.1
"2011","Gedling 009D","E01028215","Total",1347,660,687,1347,0,32,29.57,45.6
"2011","Gedling 009E","E01028216","Total",1290,632,658,1290,0,28,25.29,51.0
"2011","Gedling 009F","E01028217","Total",1337,649,688,1263,74,32,38.69,34.6
"2011","Gedling 009G","E01028218","Total",1502,745,757,1502,0,19,36.69,40.9
"2011","Gedling 010A","E01028193","Total",1354,645,709,1354,0,19,92.76,14.6
"2011","Gedling 010B","E01028194","Total",1488,733,755,1461,27,11,25.37,58.7
"2011","Gedling 010C","E01028195","Total",1396,678,718,1396,0,18,27.00,51.7
"2011","Gedling 010D","E01028196","Total",1428,705,723,1428,0,16,27.05,52.8
"2011","Gedling 010E","E01028197","Total",1379,703,676,1375,4,13,30.68,44.9
"2011","Gedling 010F","E01028204","Total",1339,675,664,1339,0,5,25.61,52.3
"2011","Gedling 011A","E01028172","Total",1142,557,585,1142,0,17,306.51,3.7
"2011","Gedling 011B","E01028190","Total",1594,777,817,1594,0,10,26.23,60.8
"2011","Gedling 011C","E01028202","Total",1456,711,745,1456,0,13,27.37,53.2
"2011","Gedling 011D","E01028203","Total",1391,686,705,1391,0,3,29.85,46.6
"2011","Gedling 011E","E01028212","Total",1626,781,845,1589,37,14,33.22,48.9
"2011","Gedling 012A","E01028168","Total",1321,649,672,1280,41,9,47.35,27.9
"2011","Gedling 012B","E01028169","Total",1456,698,758,1456,0,19,84.97,17.1
"2011","Gedling 012C","E01028170","Total",1438,700,738,1417,21,23,33.55,42.9
"2011","Gedling 012D","E01028171","Total",1460,702,758,1348,112,22,28.78,50.7
"2011","Gedling 012E","E01028191","Total",1824,929,895,1824,0,12,28.34,64.4
"2011","Gedling 012F","E01028192","Total",1556,779,777,1544,12,3,24.21,64.3
"2011","Gedling 013A","E01028160","Total",1519,746,773,1519,0,11,24.18,62.8
"2011","Gedling 013B","E01028161","Total",1496,724,772,1469,27,8,19.51,76.7
"2011","Gedling 013C","E01028162","Total",1496,754,742,1496,0,6,25.32,59.1
"2011","Gedling 013D","E01028163","Total",1482,764,718,1482,0,17,31.08,47.7
"2011","Gedling 013E","E01028211","Total",1372,692,680,1361,11,8,37.85,36.2
"2011","Gedling 014A","E01028155","Total",1414,715,699,1414,0,5,26.75,52.9
"2011","Gedling 014B","E01028156","Total",1308,682,626,1308,0,12,33.26,39.3
"2011","Gedling 014C","E01028157","Total",1299,662,637,1299,0,15,30.55,42.5
"2011","Gedling 014D","E01028158","Total",1559,769,790,1559,0,16,30.68,50.8
"2011","Gedling 014E","E01028159","Total",1301,612,689,1301,0,6,24.21,53.7
"2011","Gedling 014F","E01028164","Total",1285,639,646,1285,0,3,19.34,66.4
"2011","Gedling 014G","E01028210","Total",1382,650,732,1382,0,12,30.89,44.7
"2011","Gedling 015A","E01028184","Total",1166,570,596,1166,0,8,40.76,28.6
"2011","Gedling 015B","E01028185","Total",1852,892,960,1852,0,10,48.59,38.1
"2011","Gedling 015C","E01028186","Total",1515,756,759,1515,0,3,20.73,73.1
"2011","Gedling 015D","E01028187","Total",1420,671,749,1420,0,10,194.25,7.3
"2011","Gedling 015E","E01028188","Total",1445,706,739,1445,0,4,21.15,68.3
"2011","Gedling 016A","E01028142","Total",1969,956,1013,1905,64,12,928.12,2.1
"2011","Gedling 016B","E01028146","Total",1503,738,765,1503,0,11,31.52,47.7
"2011","Gedling 016C","E01028147","Total",1057,479,578,1057,0,13,13.81,76.5
"2011","Gedling 016D","E01032622","Total",1354,669,685,1354,0,9,131.42,10.3
"2011","Mansfield 001A","E01028224","Total",1466,710,756,1466,0,12,859.55,1.7
"2011","Mansfield 001B","E01028257","Total",1625,799,826,1625,0,5,238.35,6.8
"2011","Mansfield 001C","E01028258","Total",1651,825,826,1651,0,9,174.12,9.5
"2011","Mansfield 001D","E01028259","Total",1495,737,758,1493,2,8,541.08,2.8
"2011","Mansfield 002A","E01028223","Total",1035,507,528,965,70,10,37.02,28.0
"2011","Mansfield 002B","E01028225","Total",1581,775,806,1558,23,10,50.64,31.2
"2011","Mansfield 002C","E01028226","Total",1484,700,784,1484,0,16,27.74,53.5
"2011","Mansfield 002D","E01028260","Total",1662,826,836,1662,0,9,953.86,1.7
"2011","Mansfield 003A","E01028251","Total",1645,828,817,1645,0,14,53.50,30.7
"2011","Mansfield 003B","E01028252","Total",1944,950,994,1944,0,29,181.42,10.7
"2011","Mansfield 003C","E01028253","Total",1684,828,856,1684,0,27,35.06,48.0
"2011","Mansfield 003D","E01028277","Total",1207,593,614,1199,8,13,82.20,14.7
"2011","Mansfield 003E","E01028278","Total",1411,694,717,1411,0,19,40.42,34.9
"2011","Mansfield 004A","E01028271","Total",1669,852,817,1669,0,12,56.93,29.3
"2011","Mansfield 004B","E01028279","Total",1382,684,698,1382,0,10,231.15,6.0
"2011","Mansfield 004C","E01028280","Total",1340,664,676,1340,0,1,107.40,12.5
"2011","Mansfield 004D","E01028281","Total",1474,695,779,1466,8,4,25.64,57.5
"2011","Mansfield 004E","E01028283","Total",1853,926,927,1826,27,14,128.62,14.4
"2011","Mansfield 005A","E01028242","Total",1504,775,729,1504,0,9,171.23,8.8
"2011","Mansfield 005B","E01028250","Total",1471,716,755,1471,0,17,26.88,54.7
"2011","Mansfield 005C","E01028272","Total",1666,811,855,1597,69,25,46.82,35.6
"2011","Mansfield 005D","E01028273","Total",1483,731,752,1483,0,16,67.95,21.8
"2011","Mansfield 006A","E01028229","Total",1442,704,738,1442,0,6,26.83,53.7
"2011","Mansfield 006B","E01028232","Total",1513,738,775,1513,0,2,40.37,37.5
"2011","Mansfield 006E","E01028267","Total",1947,944,1003,1947,0,11,54.11,36.0
"2011","Mansfield 006F","E01028282","Total",1140,526,614,1140,0,10,46.51,24.5
"2011","Mansfield 006G","E01033392","Total",2240,1099,1141,2164,76,23,524.45,4.3
"2011","Mansfield 007A","E01028237","Total",1561,754,807,1544,17,21,143.74,10.9
"2011","Mansfield 007B","E01028238","Total",1584,789,795,1582,2,6,131.83,12.0
"2011","Mansfield 007C","E01028239","Total",1598,759,839,1598,0,12,37.67,42.4
"2011","Mansfield 007D","E01028240","Total",1479,740,739,1479,0,17,30.51,48.5
"2011","Mansfield 007E","E01028241","Total",2283,1097,1186,2283,0,37,68.95,33.1
"2011","Mansfield 007F","E01028243","Total",1843,863,980,1792,51,15,47.13,39.1
"2011","Mansfield 008A","E01028227","Total",1365,654,711,1329,36,4,34.15,40.0
"2011","Mansfield 008B","E01028228","Total",1189,572,617,1154,35,8,35.69,33.3
"2011","Mansfield 008C","E01028247","Total",1683,882,801,1683,0,4,18.86,89.2
"2011","Mansfield 008D","E01028268","Total",1758,926,832,1639,119,10,81.32,21.6
"2011","Mansfield 008E","E01028269","Total",1451,720,731,1418,33,9,39.68,36.6
"2011","Mansfield 008F","E01028284","Total",1664,827,837,1579,85,20,63.73,26.1
"2011","Mansfield 009A","E01028233","Total",1883,917,966,1816,67,13,26.63,70.7
"2011","Mansfield 009B","E01028234","Total",1726,796,930,1726,0,4,36.01,47.9
"2011","Mansfield 009C","E01028274","Total",1400,731,669,1333,67,9,63.47,22.1
"2011","Mansfield 009D","E01028275","Total",1604,782,822,1604,0,10,47.23,34.0
"2011","Mansfield 009E","E01028276","Total",1558,783,775,1558,0,14,41.88,37.2
"2011","Mansfield 010A","E01028230","Total",1432,705,727,1432,0,3,30.58,46.8
"2011","Mansfield 010B","E01028231","Total",1430,644,786,1430,0,8,27.65,51.7
"2011","Mansfield 010C","E01028244","Total",1486,735,751,1486,0,8,77.87,19.1
"2011","Mansfield 010D","E01028245","Total",1312,635,677,1312,0,5,22.28,58.9
"2011","Mansfield 010E","E01028246","Total",1684,848,836,1684,0,20,46.87,35.9
"2011","Mansfield 010F","E01028248","Total",1476,710,766,1476,0,14,43.78,33.7
"2011","Mansfield 010G","E01028249","Total",1354,651,703,1354,0,14,29.88,45.3
"2011","Mansfield 011A","E01028235","Total",1572,789,783,1572,0,19,36.94,42.6
"2011","Mansfield 011B","E01028236","Total",1724,857,867,1715,9,13,35.81,48.1
"2011","Mansfield 011C","E01028262","Total",1496,746,750,1496,0,16,43.03,34.8
"2011","Mansfield 011D","E01028264","Total",1911,942,969,1911,0,18,42.00,45.5
"2011","Mansfield 012A","E01028254","Total",1378,686,692,1322,56,13,129.89,10.6
"2011","Mansfield 012B","E01028256","Total",1606,828,778,1591,15,14,289.64,5.5
"2011","Mansfield 012C","E01028261","Total",1732,852,880,1708,24,17,199.86,8.7
"2011","Mansfield 012D","E01028263","Total",1607,783,824,1584,23,10,142.25,11.3
"2011","Mansfield 013A","E01028219","Total",1389,667,722,1354,35,16,80.25,17.3
"2011","Mansfield 013B","E01028220","Total",1791,912,879,1769,22,20,36.73,48.8
"2011","Mansfield 013D","E01028222","Total",1562,738,824,1562,0,24,211.62,7.4
"2011","Mansfield 013E","E01028255","Total",1316,643,673,1316,0,20,94.23,14.0
"2011","Mansfield 013F","E01028270","Total",1509,721,788,1509,0,30,168.46,9.0
"2011","Mansfield 013G","E01033389","Total",1329,642,687,1329,0,11,25.31,52.5
"2011","Mansfield 013H","E01033390","Total",1548,764,784,1548,0,20,30.03,51.5
"2011","Mansfield 013I","E01033391","Total",1179,581,598,1179,0,20,48.36,24.4
"2011","Newark and Sherwood 001A","E01028301","Total",1928,963,965,1904,24,16,344.53,5.6
"2011","Newark and Sherwood 001B","E01028302","Total",1583,777,806,1543,40,17,166.67,9.5
"2011","Newark and Sherwood 001C","E01028338","Total",1599,751,848,1599,0,7,34.19,46.8
"2011","Newark and Sherwood 001D","E01028339","Total",1795,896,899,1781,14,18,2491.91,0.7
"2011","Newark and Sherwood 001E","E01028340","Total",1501,723,778,1501,0,8,86.35,17.4
"2011","Newark and Sherwood 001F","E01028341","Total",1617,810,807,1578,39,16,356.05,4.5
"2011","Newark and Sherwood 002A","E01028313","Total",1991,948,1043,1927,64,27,1055.05,1.9
"2011","Newark and Sherwood 002B","E01028314","Total",2674,1307,1367,2674,0,22,574.13,4.7
"2011","Newark and Sherwood 002C","E01028321","Total",1574,759,815,1533,41,8,1021.16,1.5
"2011","Newark and Sherwood 002D","E01028322","Total",1964,955,1009,1960,4,12,700.02,2.8
"2011","Newark and Sherwood 002E","E01028323","Total",1650,817,833,1612,38,16,43.11,38.3
"2011","Newark and Sherwood 003A","E01028303","Total",1527,775,752,1527,0,14,1008.93,1.5
"2011","Newark and Sherwood 003B","E01028312","Total",2255,1114,1141,2242,13,71,8721.42,0.3
"2011","Newark and Sherwood 003C","E01028337","Total",1529,747,782,1524,5,28,1930.87,0.8
"2011","Newark and Sherwood 003D","E01028349","Total",1504,729,775,1494,10,40,3806.15,0.4
"2011","Newark and Sherwood 003E","E01028350","Total",1171,581,590,1171,0,24,411.67,2.8
"2011","Newark and Sherwood 004A","E01028315","Total",1448,714,734,1419,29,23,849.19,1.7
"2011","Newark and Sherwood 004B","E01028316","Total",1484,715,769,1466,18,23,1822.46,0.8
"2011","Newark and Sherwood 004C","E01028317","Total",1639,830,809,1612,27,17,4427.01,0.4
"2011","Newark and Sherwood 004D","E01028353","Total",2771,1353,1418,2731,40,45,3143.31,0.9
"2011","Newark and Sherwood 005A","E01028295","Total",2005,1024,981,1970,35,27,3836.41,0.5
"2011","Newark and Sherwood 005B","E01028297","Total",1934,959,975,1934,0,5,142.44,13.6
"2011","Newark and Sherwood 005C","E01028327","Total",1599,792,807,1599,0,32,3276.36,0.5
"2011","Newark and Sherwood 005D","E01028328","Total",1700,828,872,1700,0,39,127.33,13.4
"2011","Newark and Sherwood 005E","E01028329","Total",1688,820,868,1609,79,56,3208.13,0.5
"2011","Newark and Sherwood 006A","E01028296","Total",1330,681,649,1290,40,5,604.65,2.2
"2011","Newark and Sherwood 006B","E01028298","Total",1598,769,829,1559,39,13,454.27,3.5
"2011","Newark and Sherwood 006C","E01028299","Total",1281,650,631,1281,0,7,163.83,7.8
"2011","Newark and Sherwood 006D","E01028300","Total",1578,759,819,1555,23,10,627.09,2.5
"2011","Newark and Sherwood 006E","E01028342","Total",1508,729,779,1508,0,9,23.19,65.0
"2011","Newark and Sherwood 006F","E01028343","Total",2057,976,1081,2046,11,13,549.45,3.7
"2011","Newark and Sherwood 006G","E01028344","Total",1420,698,722,1420,0,20,25.75,55.1
"2011","Newark and Sherwood 007A","E01028294","Total",1731,861,870,1731,0,8,26.63,65.0
"2011","Newark and Sherwood 007B","E01028304","Total",1466,753,713,1451,15,7,156.56,9.4
"2011","Newark and Sherwood 007C","E01028305","Total",1374,671,703,1336,38,8,34.88,39.4
"2011","Newark and Sherwood 007D","E01028306","Total",1614,807,807,1614,0,16,117.99,13.7
"2011","Newark and Sherwood 007E","E01028307","Total",1264,627,637,1264,0,19,35.89,35.2
"2011","Newark and Sherwood 007F","E01028310","Total",1683,883,800,1673,10,10,183.70,9.2
"2011","Newark and Sherwood 007G","E01028311","Total",1515,763,752,1493,22,16,187.35,8.1
"2011","Newark and Sherwood 008A","E01028345","Total",2153,988,1165,2096,57,57,938.14,2.3
"2011","Newark and Sherwood 008B","E01028346","Total",2133,1036,1097,2133,0,53,102.54,20.8
"2011","Newark and Sherwood 008C","E01028347","Total",1534,748,786,1531,3,43,65.08,23.6
"2011","Newark and Sherwood 008D","E01028348","Total",1477,646,831,1172,305,37,1290.38,1.1
"2011","Newark and Sherwood 009A","E01028292","Total",2324,1131,1193,2293,31,43,148.29,15.7
"2011","Newark and Sherwood 009B","E01028293","Total",1906,926,980,1906,0,18,68.15,28.0
"2011","Newark and Sherwood 009C","E01028333","Total",1344,644,700,1311,33,17,51.73,26.0
"2011","Newark and Sherwood 009D","E01028334","Total",1583,764,819,1570,13,10,55.20,28.7
"2011","Newark and Sherwood 009E","E01028335","Total",1715,855,860,1695,20,13,45.18,38.0
"2011","Newark and Sherwood 010A","E01028308","Total",1608,758,850,1605,3,17,60.57,26.5
"2011","Newark and Sherwood 010B","E01028309","Total",1402,715,687,1402,0,15,94.45,14.8
"2011","Newark and Sherwood 010C","E01028318","Total",1568,737,831,1537,31,16,29.67,52.8
"2011","Newark and Sherwood 010D","E01028319","Total",1919,902,1017,1919,0,4,35.30,54.4
"2011","Newark and Sherwood 010E","E01028320","Total",1684,783,901,1660,24,8,30.41,55.4
"2011","Newark and Sherwood 011A","E01028285","Total",1226,597,629,1226,0,10,56.31,21.8
"2011","Newark and Sherwood 011B","E01028286","Total",1250,619,631,1250,0,6,297.72,4.2
"2011","Newark and Sherwood 011C","E01028287","Total",1450,688,762,1450,0,12,37.48,38.7
"2011","Newark and Sherwood 011D","E01028288","Total",1501,712,789,1501,0,13,39.81,37.7
"2011","Newark and Sherwood 011E","E01028289","Total",1326,672,654,1326,0,17,41.32,32.1
"2011","Newark and Sherwood 011F","E01028290","Total",1455,698,757,1455,0,16,59.65,24.4
"2011","Newark and Sherwood 011G","E01028291","Total",1549,749,800,1549,0,15,144.54,10.7
"2011","Newark and Sherwood 012B","E01028325","Total",1205,603,602,1196,9,28,3124.98,0.4
"2011","Newark and Sherwood 012C","E01028326","Total",1274,626,648,1274,0,16,138.22,9.2
"2011","Newark and Sherwood 012D","E01028336","Total",1122,552,570,1104,18,34,2601.05,0.4
"2011","Newark and Sherwood 012E","E01028352","Total",1214,599,615,1214,0,35,1315.51,0.9
"2011","Newark and Sherwood 012F","E01033393","Total",2190,1112,1078,2128,62,28,822.93,2.7
"2011","Newark and Sherwood 012G","E01033394","Total",1278,598,680,1242,36,19,1537.60,0.8
"2011","Newark and Sherwood 013A","E01028330","Total",1630,789,841,1619,11,34,726.98,2.2
"2011","Newark and Sherwood 013B","E01028331","Total",2251,1527,724,1394,857,27,1858.95,1.2
"2011","Newark and Sherwood 013C","E01028332","Total",1733,855,878,1709,24,41,871.97,2.0
"2011","Newark and Sherwood 013D","E01028351","Total",1264,613,651,1228,36,40,1665.66,0.8
"2011","Rushcliffe 001A","E01028371","Total",2768,1764,1004,1911,857,26,1593.76,1.7
"2011","Rushcliffe 001B","E01028403","Total",2190,1042,1148,2173,17,54,2384.61,0.9
"2011","Rushcliffe 001C","E01028411","Total",2077,1043,1034,2077,0,55,4625.23,0.4
"2011","Rushcliffe 002A","E01028357","Total",1488,737,751,1488,0,34,634.08,2.3
"2011","Rushcliffe 002B","E01028358","Total",1329,633,696,1298,31,18,39.91,33.3
"2011","Rushcliffe 002C","E01028359","Total",1696,812,884,1696,0,23,84.45,20.1
"2011","Rushcliffe 002D","E01028360","Total",1799,880,919,1799,0,21,577.39,3.1
"2011","Rushcliffe 002E","E01028361","Total",1404,672,732,1404,0,23,25.81,54.4
"2011","Rushcliffe 002F","E01028362","Total",1415,684,731,1415,0,11,26.04,54.3
"2011","Rushcliffe 003A","E01028393","Total",1137,553,584,1137,0,27,139.12,8.2
"2011","Rushcliffe 003B","E01028394","Total",1491,681,810,1464,27,26,286.42,5.2
"2011","Rushcliffe 003C","E01028395","Total",1440,719,721,1440,0,25,194.35,7.4
"2011","Rushcliffe 003D","E01028413","Total",1669,773,896,1649,20,19,33.86,49.3
"2011","Rushcliffe 003E","E01028414","Total",1582,763,819,1503,79,23,75.18,21.0
"2011","Rushcliffe 003F","E01028415","Total",1559,780,779,1558,1,28,1470.17,1.1
"2011","Rushcliffe 004A","E01028354","Total",1555,783,772,1555,0,37,32.06,48.5
"2011","Rushcliffe 004B","E01028355","Total",1516,739,777,1516,0,14,32.26,47.0
"2011","Rushcliffe 004C","E01028384","Total",1728,867,861,1714,14,29,21.81,79.2
"2011","Rushcliffe 004D","E01028385","Total",1751,890,861,1751,0,39,26.18,66.9
"2011","Rushcliffe 004E","E01028386","Total",1642,841,801,1616,26,36,60.33,27.2
"2011","Rushcliffe 005A","E01028396","Total",1537,744,793,1521,16,46,25.74,59.7
"2011","Rushcliffe 005B","E01028398","Total",1440,694,746,1440,0,7,18.57,77.5
"2011","Rushcliffe 005C","E01028399","Total",1378,681,697,1369,9,42,23.29,59.2
"2011","Rushcliffe 005D","E01028416","Total",1565,832,733,1558,7,20,50.86,30.8
"2011","Rushcliffe 005E","E01028417","Total",1565,807,758,1523,42,17,28.98,54.0
"2011","Rushcliffe 005F","E01028418","Total",1506,768,738,1445,61,13,16.61,90.7
"2011","Rushcliffe 006A","E01028356","Total",1493,714,779,1493,0,29,41.59,35.9
"2011","Rushcliffe 006B","E01028375","Total",1798,874,924,1798,0,21,156.60,11.5
"2011","Rushcliffe 006C","E01028376","Total",1584,779,805,1534,50,27,719.69,2.2
"2011","Rushcliffe 006D","E01028377","Total",1955,961,994,1955,0,44,54.63,35.8
"2011","Rushcliffe 006E","E01028397","Total",1743,850,893,1743,0,44,41.68,41.8
"2011","Rushcliffe 007A","E01028363","Total",1489,757,732,1489,0,54,40.52,36.7
"2011","Rushcliffe 007B","E01028364","Total",1787,867,920,1731,56,44,45.12,39.6
"2011","Rushcliffe 007C","E01028365","Total",1658,842,816,1658,0,42,139.93,11.8
"2011","Rushcliffe 007D","E01028391","Total",1965,948,1017,1965,0,44,82.14,23.9
"2011","Rushcliffe 007E","E01028392","Total",1947,869,1078,1947,0,20,63.48,30.7
"2011","Rushcliffe 008A","E01028372","Total",1188,574,614,1188,0,25,46.55,25.5
"2011","Rushcliffe 008B","E01028373","Total",1404,697,707,1404,0,41,238.00,5.9
"2011","Rushcliffe 008C","E01028374","Total",1316,603,713,1289,27,19,40.51,32.5
"2011","Rushcliffe 008D","E01028400","Total",1612,823,789,1612,0,49,38.04,42.4
"2011","Rushcliffe 008E","E01028401","Total",1308,655,653,1308,0,38,40.81,32.1
"2011","Rushcliffe 009A","E01028366","Total",1327,635,692,1327,0,7,22.84,58.1
"2011","Rushcliffe 009B","E01028367","Total",1474,709,765,1355,119,13,1256.53,1.2
"2011","Rushcliffe 009C","E01028368","Total",1491,743,748,1491,0,18,135.77,11.0
"2011","Rushcliffe 009D","E01028369","Total",1467,707,760,1467,0,10,21.01,69.8
"2011","Rushcliffe 009E","E01028370","Total",1444,708,736,1444,0,14,41.08,35.2
"2011","Rushcliffe 010A","E01028402","Total",1888,950,938,1888,0,41,3867.77,0.5
"2011","Rushcliffe 010B","E01028419","Total",2438,1219,1219,2392,46,46,1379.28,1.8
"2011","Rushcliffe 010C","E01028420","Total",1379,674,705,1378,1,25,3374.82,0.4
"2011","Rushcliffe 011A","E01028404","Total",1598,758,840,1532,66,45,215.99,7.4
"2011","Rushcliffe 011B","E01028405","Total",1943,923,1020,1935,8,17,590.56,3.3
"2011","Rushcliffe 011C","E01028406","Total",1650,820,830,1629,21,25,181.20,9.1
"2011","Rushcliffe 011D","E01028407","Total",2025,994,1031,1999,26,43,166.84,12.1
"2011","Rushcliffe 012A","E01028379","Total",1637,824,813,1637,0,37,193.36,8.5
"2011","Rushcliffe 012B","E01028412","Total",1883,944,939,1883,0,30,1102.93,1.7
"2011","Rushcliffe 012C","E01028421","Total",2221,1097,1124,2159,62,57,3783.12,0.6
"2011","Rushcliffe 013A","E01028380","Total",1238,602,636,1238,0,3,41.77,29.6
"2011","Rushcliffe 013B","E01028381","Total",1342,648,694,1342,0,23,393.59,3.4
"2011","Rushcliffe 013C","E01028382","Total",1435,690,745,1435,0,19,39.80,36.1
"2011","Rushcliffe 013D","E01028383","Total",1081,511,570,1081,0,20,89.02,12.1
"2011","Rushcliffe 014A","E01028378","Total",1994,971,1023,1994,0,24,2236.05,0.9
"2011","Rushcliffe 014B","E01028387","Total",1746,845,901,1746,0,17,437.70,4.0
"2011","Rushcliffe 014C","E01028408","Total",2639,1213,1426,2060,579,54,1876.67,1.4
"2011","Rushcliffe 015A","E01028388","Total",1677,833,844,1652,25,41,741.33,2.3
"2011","Rushcliffe 015B","E01028389","Total",1447,676,771,1447,0,18,235.06,6.2
"2011","Rushcliffe 015C","E01028390","Total",1610,766,844,1610,0,23,250.66,6.4
"2011","Rushcliffe 015D","E01028409","Total",1301,626,675,1269,32,31,1887.80,0.7
"2011","Rushcliffe 015E","E01028410","Total",1280,622,658,1280,0,42,2044.73,0.6
"2011","Herefordshire 001A","E01013998","Total",1329,647,682,1329,0,44,2717.32,0.5
"2011","Herefordshire 001B","E01014051","Total",1715,848,867,1704,11,49,4320.93,0.4
"2011","Herefordshire 001C","E01014052","Total",1496,754,742,1496,0,61,11638.03,0.1
"2011","Herefordshire 001D","E01014096","Total",1503,737,766,1493,10,35,4200.32,0.4
"2011","Herefordshire 002A","E01014041","Total",1515,728,787,1472,43,12,40.41,37.5
"2011","Herefordshire 002B","E01014042","Total",1662,808,854,1653,9,8,168.65,9.9
"2011","Herefordshire 002C","E01014043","Total",1125,535,590,1109,16,6,68.11,16.5
"2011","Herefordshire 002D","E01014044","Total",1473,721,752,1473,0,18,424.05,3.5
"2011","Herefordshire 003A","E01014045","Total",1571,768,803,1555,16,17,1381.84,1.1
"2011","Herefordshire 003B","E01014046","Total",1450,722,728,1445,5,11,1350.73,1.1
"2011","Herefordshire 003C","E01014047","Total",1439,695,744,1437,2,5,40.37,35.6
"2011","Herefordshire 003D","E01014048","Total",1456,718,738,1410,46,11,59.88,24.3
"2011","Herefordshire 004A","E01013999","Total",1488,743,745,1394,94,37,3216.62,0.5
"2011","Herefordshire 004B","E01014017","Total",1475,720,755,1475,0,25,3934.79,0.4
"2011","Herefordshire 004C","E01014024","Total",1286,631,655,1286,0,17,5318.16,0.2
"2011","Herefordshire 004D","E01014025","Total",1410,689,721,1396,14,28,3331.93,0.4
"2011","Herefordshire 004E","E01014055","Total",1583,802,781,1583,0,27,3326.08,0.5
"2011","Herefordshire 004F","E01014097","Total",1315,650,665,1315,0,37,3919.29,0.3
"2011","Herefordshire 005A","E01014000","Total",1396,705,691,1352,44,36,4927.61,0.3
"2011","Herefordshire 005B","E01014001","Total",1434,718,716,1433,1,47,4077.63,0.4
"2011","Herefordshire 005C","E01014002","Total",1397,644,753,1319,78,17,1202.77,1.2
"2011","Herefordshire 005D","E01014003","Total",1512,770,742,1445,67,14,1196.23,1.3
"2011","Herefordshire 005E","E01014004","Total",1419,701,718,1395,24,29,4998.07,0.3
"2011","Herefordshire 005F","E01014005","Total",1552,777,775,1542,10,14,67.57,23.0
"2011","Herefordshire 005G","E01014015","Total",1639,800,839,1636,3,43,4875.10,0.3
"2011","Herefordshire 006A","E01014008","Total",1596,802,794,1594,2,32,5020.48,0.3
"2011","Herefordshire 006B","E01014009","Total",1498,745,753,1498,0,25,6091.84,0.2
"2011","Herefordshire 006C","E01014033","Total",1729,826,903,1698,31,36,3536.76,0.5
"2011","Herefordshire 006D","E01014034","Total",1511,708,803,1480,31,17,48.84,30.9
"2011","Herefordshire 006E","E01014056","Total",1541,770,771,1450,91,29,6307.38,0.2
"2011","Herefordshire 007A","E01014006","Total",1579,786,793,1579,0,37,1521.87,1.0
"2011","Herefordshire 007B","E01014012","Total",1676,811,865,1599,77,33,1472.63,1.1
"2011","Herefordshire 007C","E01014013","Total",1936,991,945,1841,95,31,485.58,4.0
"2011","Herefordshire 007D","E01014016","Total",1510,714,796,1510,0,25,3002.01,0.5
"2011","Herefordshire 007E","E01014100","Total",1547,758,789,1538,9,29,2961.74,0.5
"2011","Herefordshire 007F","E01014101","Total",1075,533,542,1075,0,35,5040.54,0.2
"2011","Herefordshire 008A","E01014022","Total",2051,1046,1005,2030,21,52,1027.08,2.0
"2011","Herefordshire 008B","E01014023","Total",1760,889,871,1740,20,22,1737.84,1.0
"2011","Herefordshire 008C","E01014081","Total",1441,717,724,1440,1,38,1823.89,0.8
"2011","Herefordshire 008D","E01014082","Total",1892,946,946,1707,185,32,760.70,2.5
"2011","Herefordshire 009A","E01014027","Total",1253,620,633,1215,38,33,2784.59,0.4
"2011","Herefordshire 009B","E01014028","Total",1445,704,741,1391,54,45,2577.88,0.6
"2011","Herefordshire 009C","E01014029","Total",1514,703,811,1418,96,42,1228.15,1.2
"2011","Herefordshire 009D","E01014030","Total",1388,689,699,1388,0,33,1277.71,1.1
"2011","Herefordshire 010A","E01014083","Total",1606,786,820,1597,9,25,219.11,7.3
"2011","Herefordshire 010B","E01014084","Total",1542,756,786,1537,5,14,206.24,7.5
"2011","Herefordshire 010C","E01014085","Total",1420,715,705,1415,5,19,28.92,49.1
"2011","Herefordshire 010D","E01014087","Total",1471,778,693,1467,4,15,32.68,45.0
"2011","Herefordshire 010E","E01014088","Total",1414,701,713,1414,0,7,33.76,41.9
"2011","Herefordshire 010F","E01014089","Total",1476,696,780,1473,3,20,42.50,34.7
"2011","Herefordshire 011A","E01013987","Total",1627,789,838,1555,72,29,124.54,13.1
"2011","Herefordshire 011B","E01013988","Total",1864,893,971,1797,67,43,77.94,23.9
"2011","Herefordshire 011C","E01014007","Total",1730,839,891,1658,72,46,1216.31,1.4
"2011","Herefordshire 011D","E01014095","Total",1494,703,791,1494,0,13,18.98,78.7
"2011","Herefordshire 012A","E01013986","Total",1702,841,861,1702,0,13,27.19,62.6
"2011","Herefordshire 012B","E01013989","Total",1566,793,773,1437,129,8,30.65,51.1
"2011","Herefordshire 012C","E01014010","Total",1626,905,721,1566,60,12,97.04,16.8
"2011","Herefordshire 012D","E01014011","Total",1513,733,780,1469,44,20,33.58,45.1
"2011","Herefordshire 012E","E01014086","Total",1448,729,719,1439,9,6,29.03,49.9
"2011","Herefordshire 012F","E01014092","Total",1808,904,904,1800,8,32,102.50,17.6
"2011","Herefordshire 013A","E01014075","Total",1703,829,874,1650,53,39,95.33,17.9
"2011","Herefordshire 013B","E01014076","Total",2181,1095,1086,2178,3,25,29.18,74.7
"2011","Herefordshire 013C","E01014077","Total",1555,770,785,1555,0,12,110.22,14.1
"2011","Herefordshire 013D","E01014078","Total",1461,744,717,1461,0,12,34.46,42.4
"2011","Herefordshire 014A","E01014090","Total",1499,727,772,1499,0,34,46.57,32.2
"2011","Herefordshire 014B","E01014091","Total",1498,720,778,1473,25,48,51.74,29.0
"2011","Herefordshire 014C","E01014093","Total",1441,667,774,1365,76,37,61.24,23.5
"2011","Herefordshire 014D","E01014094","Total",1525,738,787,1525,0,29,37.29,40.9
"2011","Herefordshire 015A","E01014068","Total",1472,728,744,1472,0,10,27.68,53.2
"2011","Herefordshire 015B","E01014070","Total",2247,1111,1136,2245,2,28,43.02,52.2
"2011","Herefordshire 015C","E01014072","Total",2061,1018,1043,2061,0,13,132.10,15.6
"2011","Herefordshire 015D","E01014073","Total",1938,951,987,1899,39,17,29.46,65.8
"2011","Herefordshire 015E","E01014074","Total",1594,813,781,1582,12,10,65.47,24.3
"2011","Herefordshire 016A","E01013996","Total",1545,768,777,1544,1,19,37.30,41.4
"2011","Herefordshire 016B","E01013997","Total",1983,1014,969,1983,0,22,112.85,17.6
"2011","Herefordshire 016C","E01014079","Total",1614,787,827,1614,0,33,2834.19,0.6
"2011","Herefordshire 016D","E01014080","Total",1382,690,692,1352,30,14,699.25,2.0
"2011","Herefordshire 017A","E01013992","Total",1434,733,701,1434,0,13,53.18,27.0
"2011","Herefordshire 017B","E01013993","Total",1598,757,841,1598,0,5,29.02,55.1
"2011","Herefordshire 017C","E01013994","Total",1568,724,844,1568,0,3,28.68,54.7
"2011","Herefordshire 017D","E01013995","Total",1709,812,897,1709,0,13,25.55,66.9
"2011","Herefordshire 017E","E01014071","Total",1448,717,731,1448,0,8,27.93,51.8
"2011","Herefordshire 018A","E01013990","Total",1750,831,919,1654,96,29,2497.07,0.7
"2011","Herefordshire 018B","E01013991","Total",1332,654,678,1315,17,32,2624.93,0.5
"2011","Herefordshire 018C","E01014014","Total",1811,929,882,1803,8,62,5488.19,0.3
"2011","Herefordshire 018D","E01014054","Total",1354,684,670,1351,3,55,4635.64,0.3
"2011","Herefordshire 019A","E01014035","Total",1741,840,901,1695,46,19,48.97,35.6
"2011","Herefordshire 019B","E01014036","Total",1573,746,827,1489,84,29,3748.71,0.4
"2011","Herefordshire 019C","E01014037","Total",1467,667,800,1467,0,17,43.83,33.5
"2011","Herefordshire 019D","E01014038","Total",1465,729,736,1465,0,13,57.25,25.6
"2011","Herefordshire 019E","E01014039","Total",1791,873,918,1791,0,12,40.61,44.1
"2011","Herefordshire 019F","E01014040","Total",1599,789,810,1591,8,20,667.11,2.4
"2011","Herefordshire 020A","E01014018","Total",1497,730,767,1497,0,35,6677.07,0.2
"2011","Herefordshire 020B","E01014019","Total",1560,776,784,1560,0,32,4084.41,0.4
"2011","Herefordshire 020C","E01014020","Total",1568,800,768,1560,8,49,11929.97,0.1
"2011","Herefordshire 020D","E01014021","Total",1448,705,743,1430,18,26,4916.97,0.3
"2011","Herefordshire 021A","E01014026","Total",2116,1082,1034,2106,10,34,5324.39,0.4
"2011","Herefordshire 021B","E01014059","Total",2008,1005,1003,1950,58,48,6574.25,0.3
"2011","Herefordshire 021C","E01014060","Total",1597,779,818,1583,14,37,2827.43,0.6
"2011","Herefordshire 021D","E01014069","Total",1859,913,946,1844,15,15,45.44,40.9
"2011","Herefordshire 021E","E01014098","Total",1569,780,789,1569,0,36,2286.31,0.7
"2011","Herefordshire 021F","E01014099","Total",1803,900,903,1772,31,42,5496.73,0.3
"2011","Herefordshire 022A","E01014061","Total",1548,720,828,1505,43,36,521.11,3.0
"2011","Herefordshire 022B","E01014062","Total",1622,773,849,1595,27,18,49.05,33.1
"2011","Herefordshire 022C","E01014063","Total",1777,829,948,1702,75,19,53.80,33.0
"2011","Herefordshire 022D","E01014064","Total",1600,815,785,1600,0,9,34.38,46.5
"2011","Herefordshire 022E","E01014065","Total",1464,707,757,1460,4,22,57.45,25.5
"2011","Herefordshire 022F","E01014066","Total",1123,527,596,1089,34,22,87.36,12.9
"2011","Herefordshire 022G","E01014067","Total",1448,697,751,1448,0,22,91.45,15.8
"2011","Herefordshire 023A","E01014031","Total",1567,746,821,1472,95,30,1949.19,0.8
"2011","Herefordshire 023B","E01014032","Total",1638,843,795,1585,53,38,2453.93,0.7
"2011","Herefordshire 023C","E01014049","Total",1598,757,841,1540,58,26,2233.45,0.7
"2011","Herefordshire 023D","E01014050","Total",1759,879,880,1739,20,43,4601.24,0.4
"2011","Herefordshire 023E","E01014053","Total",1790,894,896,1734,56,42,4982.27,0.4
"2011","Herefordshire 023F","E01014057","Total",1701,848,853,1675,26,33,2239.95,0.8
"2011","Herefordshire 023G","E01014058","Total",1589,792,797,1586,3,38,2160.65,0.7
"2011","Shropshire 025A","E01028853","Total",1503,739,764,1503,0,11,47.01,32.0
"2011","Shropshire 025B","E01028854","Total",1519,743,776,1490,29,27,135.27,11.2
"2011","Shropshire 025C","E01028855","Total",1511,749,762,1511,0,37,2140.08,0.7
"2011","Shropshire 025D","E01028856","Total",1241,623,618,1240,1,24,43.84,28.3
"2011","Shropshire 025E","E01028857","Total",1724,857,867,1712,12,17,3581.96,0.5
"2011","Shropshire 027A","E01028826","Total",1655,811,844,1650,5,34,1339.83,1.2
"2011","Shropshire 027B","E01028827","Total",1537,721,816,1537,0,12,32.13,47.8
"2011","Shropshire 027C","E01028844","Total",1993,1315,678,1307,686,24,1921.58,1.0
"2011","Shropshire 027D","E01028845","Total",1939,936,1003,1926,13,33,1306.93,1.5
"2011","Shropshire 029A","E01028838","Total",1440,703,737,1427,13,18,86.90,16.6
"2011","Shropshire 029B","E01028839","Total",1323,661,662,1318,5,21,544.24,2.4
"2011","Shropshire 029C","E01028840","Total",1304,639,665,1304,0,20,119.95,10.9
"2011","Shropshire 029D","E01028841","Total",1542,753,789,1534,8,12,2521.25,0.6
"2011","Shropshire 029E","E01028850","Total",2233,1115,1118,2218,15,50,6436.49,0.3
"2011","Shropshire 029F","E01028851","Total",1654,777,877,1647,7,35,4643.07,0.4
"2011","Shropshire 029G","E01028852","Total",1654,787,867,1596,58,22,1039.39,1.6
"2011","Shropshire 031A","E01028830","Total",1457,725,732,1457,0,28,141.61,10.3
"2011","Shropshire 031B","E01028831","Total",1531,732,799,1486,45,31,292.27,5.2
"2011","Shropshire 031C","E01028836","Total",1485,735,750,1485,0,19,24.26,61.2
"2011","Shropshire 031D","E01028837","Total",1468,729,739,1468,0,17,25.51,57.5
"2011","Shropshire 033A","E01028832","Total",1643,812,831,1626,17,22,89.78,18.3
"2011","Shropshire 033B","E01028833","Total",1473,690,783,1406,67,23,79.17,18.6
"2011","Shropshire 033C","E01028834","Total",1561,774,787,1517,44,31,360.22,4.3
"2011","Shropshire 033D","E01028835","Total",1461,730,731,1461,0,23,56.01,26.1
"2011","Shropshire 034A","E01028828","Total",1686,851,835,1642,44,22,4414.41,0.4
"2011","Shropshire 034B","E01028829","Total",1311,649,662,1311,0,25,91.46,14.3
"2011","Shropshire 034C","E01028842","Total",1620,795,825,1620,0,44,3325.63,0.5
"2011","Shropshire 034D","E01028847","Total",1469,739,730,1459,10,38,4269.36,0.3
"2011","Shropshire 034E","E01028859","Total",1657,811,846,1575,82,41,4114.65,0.4
"2011","Shropshire 035A","E01028843","Total",1732,855,877,1661,71,24,6075.40,0.3
"2011","Shropshire 035B","E01028846","Total",1751,902,849,1751,0,29,4796.99,0.4
"2011","Shropshire 035C","E01028848","Total",1644,808,836,1644,0,21,220.96,7.4
"2011","Shropshire 035D","E01028849","Total",1961,958,1003,1961,0,21,416.64,4.7
"2011","Shropshire 035E","E01028858","Total",2123,1095,1028,2005,118,36,8582.75,0.2
"2011","Shropshire 001A","E01028891","Total",1701,851,850,1701,0,7,56.77,30.0
"2011","Shropshire 001B","E01028892","Total",1397,687,710,1359,38,16,1008.95,1.4
"2011","Shropshire 001C","E01028894","Total",1534,767,767,1528,6,20,32.90,46.6
"2011","Shropshire 001D","E01028895","Total",1707,851,856,1636,71,22,752.26,2.3
"2011","Shropshire 001E","E01028896","Total",2072,1021,1051,2034,38,23,469.77,4.4
"2011","Shropshire 001F","E01028897","Total",1460,693,767,1460,0,15,60.77,24.0
"2011","Shropshire 002A","E01028880","Total",1633,807,826,1601,32,23,1395.46,1.2
"2011","Shropshire 002B","E01028881","Total",1262,625,637,1262,0,32,1942.97,0.6
"2011","Shropshire 002C","E01028882","Total",1554,784,770,1523,31,26,6666.60,0.2
"2011","Shropshire 002D","E01028893","Total",1533,761,772,1491,42,25,3560.59,0.4
"2011","Shropshire 002E","E01028899","Total",1521,758,763,1521,0,36,2473.61,0.6
"2011","Shropshire 004A","E01028864","Total",1477,727,750,1450,27,32,3147.14,0.5
"2011","Shropshire 004B","E01028865","Total",1726,833,893,1716,10,29,105.89,16.3
"2011","Shropshire 004C","E01028866","Total",1333,648,685,1303,30,25,1891.46,0.7
"2011","Shropshire 004D","E01028867","Total",1297,625,672,1297,0,13,58.30,22.2
"2011","Shropshire 004E","E01028872","Total",1630,860,770,1408,222,35,5418.52,0.3
"2011","Shropshire 005A","E01028873","Total",1793,887,906,1766,27,7,60.14,29.8
"2011","Shropshire 005B","E01028874","Total",1326,619,707,1326,0,15,93.47,14.2
"2011","Shropshire 005C","E01028875","Total",2501,1216,1285,2453,48,24,84.97,29.4
"2011","Shropshire 005D","E01028876","Total",1733,840,893,1727,6,22,39.03,44.4
"2011","Shropshire 005E","E01028877","Total",1298,628,670,1298,0,12,56.85,22.8
"2011","Shropshire 005F","E01028878","Total",1565,775,790,1565,0,21,93.04,16.8
"2011","Shropshire 005G","E01028879","Total",1557,785,772,1557,0,16,33.88,46.0
"2011","Shropshire 008A","E01028886","Total",1688,809,879,1682,6,6,66.27,25.5
"2011","Shropshire 008B","E01028887","Total",1380,629,751,1348,32,17,91.75,15.0
"2011","Shropshire 008C","E01028889","Total",1401,658,743,1306,95,27,138.90,10.1
"2011","Shropshire 008D","E01028890","Total",1401,709,692,1395,6,26,69.91,20.0
"2011","Shropshire 009A","E01028868","Total",1563,762,801,1490,73,34,2667.86,0.6
"2011","Shropshire 009B","E01028869","Total",1445,752,693,1443,2,29,2386.48,0.6
"2011","Shropshire 009C","E01028871","Total",1210,604,606,1204,6,22,3117.83,0.4
"2011","Shropshire 009D","E01028885","Total",2890,1804,1086,2151,739,35,2876.60,1.0
"2011","Shropshire 010A","E01028860","Total",1887,928,959,1809,78,47,1472.29,1.3
"2011","Shropshire 010B","E01028862","Total",1587,784,803,1587,0,30,2978.55,0.5
"2011","Shropshire 010C","E01028863","Total",1403,716,687,1272,131,36,3931.63,0.4
"2011","Shropshire 010D","E01028888","Total",1641,818,823,1615,26,43,4996.83,0.3
"2011","Shropshire 010E","E01028898","Total",1424,708,716,1424,0,31,2905.66,0.5
"2011","Shropshire 013A","E01028861","Total",1238,629,609,1238,0,20,1456.03,0.9
"2011","Shropshire 013B","E01028870","Total",1561,774,787,1506,55,35,5208.35,0.3
"2011","Shropshire 013C","E01028883","Total",1652,932,720,1348,304,29,3918.39,0.4
"2011","Shropshire 013D","E01028884","Total",1522,733,789,1522,0,21,130.03,11.7
"2011","Shropshire 003A","E01028910","Total",1542,790,752,1191,351,22,2729.11,0.6
"2011","Shropshire 003B","E01028911","Total",1295,643,652,1293,2,14,419.54,3.1
"2011","Shropshire 003C","E01028912","Total",1179,554,625,1145,34,10,41.86,28.2
"2011","Shropshire 003D","E01028920","Total",1279,622,657,1276,3,14,1029.45,1.2
"2011","Shropshire 003E","E01028921","Total",1577,789,788,1566,11,25,181.62,8.7
"2011","Shropshire 003F","E01028925","Total",1465,628,837,1255,210,29,914.71,1.6
"2011","Shropshire 003G","E01028926","Total",1385,676,709,1380,5,11,119.55,11.6
"2011","Shropshire 006C","E01028902","Total",1097,523,574,1084,13,14,62.33,17.6
"2011","Shropshire 006D","E01028903","Total",1271,577,694,1267,4,11,25.64,49.6
"2011","Shropshire 006E","E01028904","Total",1486,715,771,1482,4,11,121.83,12.2
"2011","Shropshire 006F","E01028905","Total",1749,831,918,1749,0,11,31.70,55.2
"2011","Shropshire 006G","E01028909","Total",1427,684,743,1427,0,12,49.30,28.9
"2011","Shropshire 006H","E01033528","Total",2545,1219,1326,2517,28,25,107.75,23.6
"2011","Shropshire 007A","E01028906","Total",1243,651,592,1190,53,12,39.06,31.8
"2011","Shropshire 007B","E01028907","Total",1733,795,938,1681,52,42,112.67,15.4
"2011","Shropshire 007C","E01028908","Total",1499,770,729,1499,0,10,16.32,91.9
"2011","Shropshire 007D","E01028916","Total",1544,725,819,1515,29,25,270.77,5.7
"2011","Shropshire 007E","E01028917","Total",1511,786,725,1413,98,21,44.65,33.8
"2011","Shropshire 007F","E01028924","Total",1638,821,817,1601,37,19,224.51,7.3
"2011","Shropshire 011A","E01028913","Total",1546,761,785,1546,0,28,3738.83,0.4
"2011","Shropshire 011B","E01028918","Total",1475,712,763,1439,36,23,2453.40,0.6
"2011","Shropshire 011C","E01028919","Total",1379,711,668,1245,134,35,1956.76,0.7
"2011","Shropshire 011D","E01028927","Total",1056,528,528,1043,13,17,999.21,1.1
"2011","Shropshire 011E","E01028928","Total",1536,750,786,1536,0,19,1434.48,1.1
"2011","Shropshire 012A","E01028914","Total",1079,551,528,1077,2,9,1969.08,0.5
"2011","Shropshire 012B","E01028915","Total",1363,662,701,1359,4,16,626.01,2.2
"2011","Shropshire 012C","E01028922","Total",1287,650,637,1249,38,20,3203.90,0.4
"2011","Shropshire 012D","E01028923","Total",1579,779,800,1579,0,37,2683.74,0.6
"2011","Shropshire 014A","E01028929","Total",1464,722,742,1464,0,15,535.40,2.7
"2011","Shropshire 014B","E01028969","Total",1482,695,787,1418,64,40,3600.68,0.4
"2011","Shropshire 014C","E01028970","Total",1336,637,699,1223,113,37,2422.80,0.6
"2011","Shropshire 014D","E01028971","Total",2118,1044,1074,2097,21,26,3458.92,0.6
"2011","Shropshire 014E","E01028978","Total",1539,751,788,1532,7,38,5071.14,0.3
"2011","Shropshire 014F","E01028979","Total",1235,618,617,1233,2,16,2740.94,0.5
"2011","Shropshire 015A","E01028933","Total",1611,774,837,1611,0,7,46.06,35.0
"2011","Shropshire 015B","E01028934","Total",1615,786,829,1615,0,5,29.84,54.1
"2011","Shropshire 015C","E01028956","Total",1538,757,781,1538,0,13,67.94,22.6
"2011","Shropshire 015D","E01028957","Total",1637,817,820,1637,0,6,25.03,65.4
"2011","Shropshire 015E","E01028958","Total",1839,894,945,1832,7,13,262.56,7.0
"2011","Shropshire 016A","E01028932","Total",1898,962,936,1891,7,17,233.88,8.1
"2011","Shropshire 016B","E01028981","Total",1621,799,822,1621,0,15,48.81,33.2
"2011","Shropshire 016C","E01028982","Total",1612,791,821,1612,0,8,28.32,56.9
"2011","Shropshire 016D","E01028983","Total",2011,999,1012,2011,0,10,92.24,21.8
"2011","Shropshire 017A","E01028930","Total",1670,800,870,1608,62,16,45.68,36.6
"2011","Shropshire 017B","E01028931","Total",2003,981,1022,1895,108,23,77.67,25.8
"2011","Shropshire 017C","E01028944","Total",1663,831,832,1663,0,10,46.80,35.5
"2011","Shropshire 017D","E01028945","Total",2045,1003,1042,2045,0,17,37.75,54.2
"2011","Shropshire 018A","E01028965","Total",1437,683,754,1382,55,7,31.63,45.4
"2011","Shropshire 018B","E01028966","Total",1264,649,615,1264,0,24,77.65,16.3
"2011","Shropshire 018C","E01028967","Total",1573,758,815,1573,0,9,29.14,54.0
"2011","Shropshire 018D","E01028968","Total",1363,632,731,1363,0,11,65.26,20.9
"2011","Shropshire 018E","E01028988","Total",1664,791,873,1664,0,25,32.71,50.9
"2011","Shropshire 018F","E01028989","Total",1721,845,876,1711,10,26,72.25,23.8
"2011","Shropshire 019A","E01028946","Total",2309,1394,915,1938,371,33,86.60,26.7
"2011","Shropshire 019B","E01028972","Total",1711,833,878,1707,4,59,94.27,18.1
"2011","Shropshire 019C","E01028973","Total",1945,942,1003,1888,57,44,67.55,28.8
"2011","Shropshire 019D","E01028987","Total",2071,1050,1021,1969,102,34,62.88,32.9
"2011","Shropshire 020A","E01028941","Total",1889,852,1037,1786,103,34,182.25,10.4
"2011","Shropshire 020B","E01028942","Total",1480,751,729,1442,38,38,81.68,18.1
"2011","Shropshire 020C","E01028943","Total",2122,1056,1066,2073,49,17,52.51,40.4
"2011","Shropshire 020D","E01028951","Total",1528,757,771,1528,0,33,145.44,10.5
"2011","Shropshire 020E","E01028953","Total",1501,722,779,1501,0,41,48.82,30.7
"2011","Shropshire 021A","E01028947","Total",1444,689,755,1396,48,27,120.37,12.0
"2011","Shropshire 021B","E01028948","Total",1463,718,745,1461,2,16,110.10,13.3
"2011","Shropshire 021C","E01028949","Total",1489,744,745,1477,12,38,84.23,17.7
"2011","Shropshire 021D","E01028985","Total",1314,625,689,1314,0,21,39.20,33.5
"2011","Shropshire 022A","E01028938","Total",1662,813,849,1625,37,27,30.70,54.1
"2011","Shropshire 022B","E01028939","Total",1540,755,785,1540,0,34,55.46,27.8
"2011","Shropshire 022C","E01028984","Total",1390,659,731,1371,19,13,45.07,30.8
"2011","Shropshire 022D","E01028986","Total",1515,744,771,1515,0,26,170.69,8.9
"2011","Shropshire 023A","E01028940","Total",1610,755,855,1585,25,32,69.67,23.1
"2011","Shropshire 023B","E01028952","Total",1717,801,916,1681,36,37,48.41,35.5
"2011","Shropshire 023C","E01028962","Total",1665,831,834,1665,0,15,37.18,44.8
"2011","Shropshire 023D","E01028963","Total",1673,792,881,1631,42,41,93.40,17.9
"2011","Shropshire 023E","E01028964","Total",1673,806,867,1633,40,45,96.68,17.3
"2011","Shropshire 023F","E01028974","Total",1755,1071,684,1203,552,92,89.80,19.5
"2011","Shropshire 024A","E01028935","Total",1489,737,752,1489,0,26,114.45,13.0
"2011","Shropshire 024B","E01028936","Total",2086,1030,1056,2027,59,49,614.54,3.4
"2011","Shropshire 024C","E01028937","Total",1504,721,783,1504,0,25,135.04,11.1
"2011","Shropshire 024D","E01028959","Total",2533,1283,1250,2509,24,61,6502.68,0.4
"2011","Shropshire 026A","E01028954","Total",1266,645,621,1266,0,40,1843.82,0.7
"2011","Shropshire 026B","E01028955","Total",1090,527,563,1085,5,22,467.01,2.3
"2011","Shropshire 026C","E01028975","Total",1777,884,893,1750,27,22,1025.76,1.7
"2011","Shropshire 026D","E01028976","Total",1769,900,869,1682,87,55,3110.95,0.6
"2011","Shropshire 026E","E01028977","Total",1937,941,996,1908,29,32,1399.59,1.4
"2011","Shropshire 028A","E01028950","Total",2318,1106,1212,2285,33,47,4794.12,0.5
"2011","Shropshire 028B","E01028960","Total",1322,657,665,1314,8,35,6986.88,0.2
"2011","Shropshire 028C","E01028961","Total",1691,871,820,1341,350,47,5243.73,0.3
"2011","Shropshire 028D","E01028980","Total",2175,1066,1109,2172,3,39,6829.93,0.3
"2011","Shropshire 030A","E01028991","Total",1238,617,621,1224,14,28,9989.95,0.1
"2011","Shropshire 030B","E01028992","Total",1585,762,823,1476,109,19,203.36,7.8
"2011","Shropshire 030D","E01033529","Total",1042,531,511,1034,8,14,3521.81,0.3
"2011","Shropshire 030E","E01033530","Total",2007,1044,963,2004,3,41,8684.58,0.2
"2011","Shropshire 032A","E01028990","Total",1207,609,598,1206,1,28,5346.56,0.2
"2011","Shropshire 032B","E01028997","Total",2283,1072,1211,2223,60,39,1140.48,2.0
"2011","Shropshire 032C","E01028998","Total",2388,1137,1251,2314,74,39,1992.05,1.2
"2011","Shropshire 036A","E01028993","Total",1540,742,798,1532,8,30,6660.59,0.2
"2011","Shropshire 036B","E01029004","Total",1045,520,525,1002,43,31,6229.88,0.2
"2011","Shropshire 036C","E01029013","Total",1675,852,823,1675,0,19,3089.17,0.5
"2011","Shropshire 036D","E01029014","Total",1217,604,613,1211,6,7,38.21,31.9
"2011","Shropshire 036E","E01029015","Total",1399,726,673,1399,0,49,8307.48,0.2
"2011","Shropshire 037A","E01028994","Total",1305,652,653,1212,93,22,3698.73,0.4
"2011","Shropshire 037B","E01029003","Total",2317,1172,1145,2309,8,41,19161.99,0.1
"2011","Shropshire 037C","E01029005","Total",1247,628,619,1247,0,28,7155.87,0.2
"2011","Shropshire 037D","E01029016","Total",1373,670,703,1373,0,36,4129.37,0.3
"2011","Shropshire 038A","E01029006","Total",1619,760,859,1561,58,18,42.38,38.2
"2011","Shropshire 038B","E01029007","Total",1139,526,613,1139,0,18,27.38,41.6
"2011","Shropshire 038D","E01029009","Total",1144,549,595,1144,0,11,52.88,21.6
"2011","Shropshire 038E","E01029010","Total",1390,698,692,1390,0,15,27.98,49.7
"2011","Shropshire 038F","E01029011","Total",1473,718,755,1457,16,19,53.19,27.7
"2011","Shropshire 038G","E01029012","Total",1918,958,960,1918,0,19,905.57,2.1
"2011","Shropshire 038H","E01033526","Total",1011,497,514,993,18,8,23.82,42.4
"2011","Shropshire 038I","E01033527","Total",1245,584,661,1196,49,27,196.29,6.3
"2011","Shropshire 039A","E01028995","Total",1560,773,787,1557,3,16,1110.00,1.4
"2011","Shropshire 039B","E01028996","Total",1318,630,688,1286,32,46,2537.30,0.5
"2011","Shropshire 039C","E01028999","Total",1560,781,779,1560,0,16,2584.05,0.6
"2011","Shropshire 039D","E01029000","Total",1141,588,553,1108,33,17,2667.46,0.4
"2011","Shropshire 039E","E01029001","Total",1968,973,995,1968,0,48,3115.15,0.6
"2011","Shropshire 039F","E01029002","Total",1320,667,653,1320,0,7,32.75,40.3
"2011","Stoke-on-Trent 001A","E01014257","Total",1472,736,736,1472,0,4,113.44,13.0
"2011","Stoke-on-Trent 001B","E01014258","Total",1517,753,764,1517,0,27,63.40,23.9
"2011","Stoke-on-Trent 001C","E01014259","Total",1462,687,775,1415,47,5,49.40,29.6
"2011","Stoke-on-Trent 001D","E01014260","Total",1338,649,689,1338,0,3,63.84,21.0
"2011","Stoke-on-Trent 001E","E01014264","Total",1925,960,965,1891,34,18,119.45,16.1
"2011","Stoke-on-Trent 002A","E01014357","Total",1572,728,844,1449,123,7,109.22,14.4
"2011","Stoke-on-Trent 002B","E01014358","Total",1417,695,722,1405,12,4,172.13,8.2
"2011","Stoke-on-Trent 002C","E01014359","Total",1829,913,916,1829,0,11,54.09,33.8
"2011","Stoke-on-Trent 002D","E01014360","Total",2011,966,1045,2011,0,8,83.66,24.0
"2011","Stoke-on-Trent 003A","E01014261","Total",1404,666,738,1404,0,1,22.75,61.7
"2011","Stoke-on-Trent 003B","E01014262","Total",1359,660,699,1359,0,5,43.47,31.3
"2011","Stoke-on-Trent 003C","E01014263","Total",1699,795,904,1699,0,3,32.99,51.5
"2011","Stoke-on-Trent 003D","E01014333","Total",1460,718,742,1448,12,9,42.86,34.1
"2011","Stoke-on-Trent 003E","E01014334","Total",1428,662,766,1428,0,4,29.34,48.7
"2011","Stoke-on-Trent 004A","E01014331","Total",1538,772,766,1538,0,9,35.74,43.0
"2011","Stoke-on-Trent 004B","E01014332","Total",1673,792,881,1673,0,5,53.03,31.5
"2011","Stoke-on-Trent 004C","E01014335","Total",1721,840,881,1699,22,13,181.92,9.5
"2011","Stoke-on-Trent 004D","E01014336","Total",1611,802,809,1611,0,6,70.17,23.0
"2011","Stoke-on-Trent 004E","E01014337","Total",1715,819,896,1715,0,10,220.11,7.8
"2011","Stoke-on-Trent 005A","E01014354","Total",1772,836,936,1757,15,12,66.51,26.6
"2011","Stoke-on-Trent 005B","E01014355","Total",1921,952,969,1909,12,6,42.53,45.2
"2011","Stoke-on-Trent 005C","E01014356","Total",1765,857,908,1765,0,6,118.91,14.8
"2011","Stoke-on-Trent 005D","E01014361","Total",1588,804,784,1588,0,5,19.27,82.4
"2011","Stoke-on-Trent 006A","E01014241","Total",1601,780,821,1528,73,8,33.48,47.8
"2011","Stoke-on-Trent 006B","E01014242","Total",1465,729,736,1465,0,5,41.52,35.3
"2011","Stoke-on-Trent 006C","E01014243","Total",1415,690,725,1400,15,11,59.12,23.9
"2011","Stoke-on-Trent 006D","E01014244","Total",1573,749,824,1573,0,10,52.26,30.1
"2011","Stoke-on-Trent 006E","E01014245","Total",1749,875,874,1731,18,10,21.25,82.3
"2011","Stoke-on-Trent 006F","E01014248","Total",1474,756,718,1474,0,8,18.04,81.7
"2011","Stoke-on-Trent 007A","E01014214","Total",1455,727,728,1452,3,22,70.39,20.7
"2011","Stoke-on-Trent 007B","E01014215","Total",1520,757,763,1520,0,17,26.57,57.2
"2011","Stoke-on-Trent 007C","E01014216","Total",1406,666,740,1406,0,8,54.40,25.8
"2011","Stoke-on-Trent 007D","E01014265","Total",1538,754,784,1538,0,11,44.92,34.2
"2011","Stoke-on-Trent 007E","E01014267","Total",2383,1180,1203,2333,50,22,111.69,21.3
"2011","Stoke-on-Trent 007F","E01014272","Total",1448,703,745,1448,0,15,57.53,25.2
"2011","Stoke-on-Trent 008A","E01014246","Total",1604,789,815,1591,13,8,35.55,45.1
"2011","Stoke-on-Trent 008B","E01014266","Total",1214,581,633,1214,0,3,14.66,82.8
"2011","Stoke-on-Trent 008C","E01014268","Total",2093,995,1098,2084,9,12,68.44,30.6
"2011","Stoke-on-Trent 008D","E01014270","Total",1541,777,764,1541,0,11,30.88,49.9
"2011","Stoke-on-Trent 008E","E01014271","Total",1525,733,792,1525,0,18,41.95,36.4
"2011","Stoke-on-Trent 009A","E01014247","Total",1737,891,846,1676,61,14,38.02,45.7
"2011","Stoke-on-Trent 009B","E01014250","Total",1137,605,532,1137,0,5,39.93,28.5
"2011","Stoke-on-Trent 009C","E01014251","Total",1850,964,886,1833,17,9,77.98,23.7
"2011","Stoke-on-Trent 009D","E01014252","Total",1682,876,806,1660,22,6,72.41,23.2
"2011","Stoke-on-Trent 009E","E01014255","Total",2030,994,1036,1903,127,14,69.86,29.1
"2011","Stoke-on-Trent 010A","E01014269","Total",1629,816,813,1629,0,10,31.86,51.1
"2011","Stoke-on-Trent 010B","E01014324","Total",1453,706,747,1451,2,5,29.21,49.7
"2011","Stoke-on-Trent 010C","E01014325","Total",1335,679,656,1335,0,13,29.87,44.7
"2011","Stoke-on-Trent 010D","E01014326","Total",1483,775,708,1483,0,9,51.35,28.9
"2011","Stoke-on-Trent 011A","E01014249","Total",1736,914,822,1730,6,6,118.32,14.7
"2011","Stoke-on-Trent 011B","E01014253","Total",1551,744,807,1551,0,7,35.92,43.2
"2011","Stoke-on-Trent 011C","E01014254","Total",1572,840,732,1569,3,14,28.26,55.6
"2011","Stoke-on-Trent 011D","E01014256","Total",1621,814,807,1621,0,12,80.82,20.1
"2011","Stoke-on-Trent 012A","E01014210","Total",1490,721,769,1490,0,14,51.43,29.0
"2011","Stoke-on-Trent 012B","E01014211","Total",1484,687,797,1484,0,9,42.74,34.7
"2011","Stoke-on-Trent 012C","E01014212","Total",1311,632,679,1291,20,4,62.74,20.9
"2011","Stoke-on-Trent 012D","E01014213","Total",1238,633,605,1238,0,8,60.86,20.3
"2011","Stoke-on-Trent 012E","E01014217","Total",1435,677,758,1418,17,6,78.14,18.4
"2011","Stoke-on-Trent 013A","E01014323","Total",1274,615,659,1274,0,7,13.90,91.7
"2011","Stoke-on-Trent 013B","E01014327","Total",1452,704,748,1452,0,5,17.46,83.2
"2011","Stoke-on-Trent 013C","E01014328","Total",1441,739,702,1441,0,14,27.15,53.1
"2011","Stoke-on-Trent 013D","E01014329","Total",1532,763,769,1532,0,8,33.10,46.3
"2011","Stoke-on-Trent 013E","E01014330","Total",1595,894,701,1578,17,2,24.17,66.0
"2011","Stoke-on-Trent 014A","E01014218","Total",1511,729,782,1509,2,6,38.11,39.6
"2011","Stoke-on-Trent 014B","E01014219","Total",1272,610,662,1272,0,6,28.03,45.4
"2011","Stoke-on-Trent 014C","E01014225","Total",1476,715,761,1465,11,5,91.89,16.1
"2011","Stoke-on-Trent 014D","E01014226","Total",1456,668,788,1441,15,3,124.70,11.7
"2011","Stoke-on-Trent 014E","E01014228","Total",1311,657,654,1311,0,3,31.90,41.1
"2011","Stoke-on-Trent 014F","E01014230","Total",1494,747,747,1494,0,4,52.58,28.4
"2011","Stoke-on-Trent 015A","E01014281","Total",1752,1018,734,1653,99,24,37.96,46.2
"2011","Stoke-on-Trent 015B","E01014285","Total",2209,1183,1026,2207,2,19,240.84,9.2
"2011","Stoke-on-Trent 015C","E01014286","Total",1457,801,656,1378,79,11,18.00,80.9
"2011","Stoke-on-Trent 015D","E01014287","Total",1708,924,784,1484,224,16,98.24,17.4
"2011","Stoke-on-Trent 016B","E01014231","Total",1488,824,664,1488,0,6,42.29,35.2
"2011","Stoke-on-Trent 016D","E01014282","Total",1685,933,752,974,711,46,80.05,21.0
"2011","Stoke-on-Trent 016E","E01014283","Total",2041,1254,787,2041,0,12,36.70,55.6
"2011","Stoke-on-Trent 016F","E01014284","Total",1470,881,589,1470,0,26,13.34,110.2
"2011","Stoke-on-Trent 016G","E01033216","Total",2395,1255,1140,2395,0,9,214.40,11.2
"2011","Stoke-on-Trent 017A","E01014220","Total",1637,796,841,1637,0,4,59.22,27.6
"2011","Stoke-on-Trent 017B","E01014221","Total",1588,769,819,1588,0,4,25.55,62.2
"2011","Stoke-on-Trent 017C","E01014222","Total",1527,731,796,1524,3,6,32.00,47.7
"2011","Stoke-on-Trent 017D","E01014223","Total",1613,808,805,1604,9,2,167.48,9.6
"2011","Stoke-on-Trent 017E","E01014224","Total",1604,758,846,1521,83,2,25.68,62.5
"2011","Stoke-on-Trent 017F","E01014229","Total",1778,835,943,1778,0,12,64.65,27.5
"2011","Stoke-on-Trent 018A","E01014288","Total",1596,778,818,1596,0,9,17.57,90.8
"2011","Stoke-on-Trent 018B","E01014289","Total",1567,766,801,1555,12,10,35.49,44.2
"2011","Stoke-on-Trent 018C","E01014290","Total",1525,762,763,1524,1,9,36.61,41.7
"2011","Stoke-on-Trent 018D","E01014291","Total",1393,700,693,1357,36,12,99.46,14.0
"2011","Stoke-on-Trent 018E","E01014292","Total",1622,816,806,1602,20,15,26.14,62.1
"2011","Stoke-on-Trent 018F","E01014294","Total",1327,649,678,1287,40,11,65.36,20.3
"2011","Stoke-on-Trent 019A","E01014293","Total",1678,897,781,1650,28,9,55.07,30.5
"2011","Stoke-on-Trent 019B","E01014295","Total",1706,840,866,1706,0,11,31.92,53.4
"2011","Stoke-on-Trent 019C","E01014339","Total",1659,857,802,1659,0,5,38.56,43.0
"2011","Stoke-on-Trent 019D","E01014340","Total",1892,932,960,1884,8,11,31.10,60.8
"2011","Stoke-on-Trent 019E","E01014345","Total",1718,930,788,1718,0,9,40.43,42.5
"2011","Stoke-on-Trent 020A","E01014274","Total",1837,858,979,1800,37,6,82.05,22.4
"2011","Stoke-on-Trent 020B","E01014275","Total",1423,687,736,1417,6,1,42.03,33.9
"2011","Stoke-on-Trent 020C","E01014276","Total",1573,782,791,1549,24,10,63.22,24.9
"2011","Stoke-on-Trent 020D","E01014277","Total",1558,783,775,1558,0,8,55.00,28.3
"2011","Stoke-on-Trent 020E","E01014279","Total",1732,868,864,1730,2,10,72.43,23.9
"2011","Stoke-on-Trent 021A","E01014273","Total",1280,651,629,1280,0,3,38.83,33.0
"2011","Stoke-on-Trent 021B","E01014278","Total",1354,680,674,1354,0,2,21.15,64.0
"2011","Stoke-on-Trent 021C","E01014280","Total",1313,660,653,1313,0,8,63.50,20.7
"2011","Stoke-on-Trent 021D","E01014297","Total",1305,644,661,1305,0,2,36.44,35.8
"2011","Stoke-on-Trent 022A","E01014296","Total",1423,703,720,1420,3,8,46.16,30.8
"2011","Stoke-on-Trent 022B","E01014298","Total",1593,771,822,1589,4,10,21.11,75.5
"2011","Stoke-on-Trent 022C","E01014300","Total",1427,672,755,1417,10,7,26.37,54.1
"2011","Stoke-on-Trent 022D","E01014302","Total",1822,932,890,1817,5,9,110.15,16.5
"2011","Stoke-on-Trent 023A","E01014338","Total",1487,774,713,1487,0,10,35.10,42.4
"2011","Stoke-on-Trent 023B","E01014341","Total",1760,898,862,1760,0,14,68.45,25.7
"2011","Stoke-on-Trent 023C","E01014342","Total",1516,745,771,1516,0,9,28.15,53.9
"2011","Stoke-on-Trent 023D","E01014343","Total",1770,892,878,1770,0,7,157.51,11.2
"2011","Stoke-on-Trent 023E","E01014344","Total",1512,755,757,1509,3,9,63.25,23.9
"2011","Stoke-on-Trent 024A","E01014363","Total",1350,670,680,1350,0,6,36.63,36.9
"2011","Stoke-on-Trent 024B","E01014364","Total",1496,736,760,1402,94,12,84.84,17.6
"2011","Stoke-on-Trent 024C","E01014365","Total",1478,722,756,1445,33,4,40.17,36.8
"2011","Stoke-on-Trent 024D","E01014369","Total",1298,635,663,1295,3,4,36.07,36.0
"2011","Stoke-on-Trent 025A","E01014299","Total",1431,712,719,1417,14,6,25.11,57.0
"2011","Stoke-on-Trent 025B","E01014301","Total",1753,878,875,1753,0,9,30.05,58.3
"2011","Stoke-on-Trent 025C","E01014303","Total",1596,798,798,1596,0,7,21.48,74.3
"2011","Stoke-on-Trent 025D","E01014304","Total",1458,724,734,1457,1,6,29.74,49.0
"2011","Stoke-on-Trent 025E","E01014362","Total",1420,714,706,1420,0,2,68.96,20.6
"2011","Stoke-on-Trent 026A","E01014233","Total",1411,678,733,1407,4,5,34.25,41.2
"2011","Stoke-on-Trent 026B","E01014234","Total",1584,776,808,1582,2,8,137.23,11.5
"2011","Stoke-on-Trent 026C","E01014239","Total",1484,732,752,1470,14,4,30.95,47.9
"2011","Stoke-on-Trent 026D","E01014240","Total",1529,722,807,1529,0,6,46.55,32.8
"2011","Stoke-on-Trent 027A","E01014308","Total",1668,821,847,1658,10,9,38.99,42.8
"2011","Stoke-on-Trent 027B","E01014309","Total",1285,613,672,1218,67,8,43.12,29.8
"2011","Stoke-on-Trent 027C","E01014311","Total",1363,659,704,1319,44,15,42.06,32.4
"2011","Stoke-on-Trent 027D","E01014313","Total",1568,739,829,1567,1,8,61.89,25.3
"2011","Stoke-on-Trent 028A","E01014321","Total",1425,731,694,1425,0,11,20.69,68.9
"2011","Stoke-on-Trent 028B","E01014366","Total",1899,975,924,1885,14,10,27.67,68.6
"2011","Stoke-on-Trent 028C","E01014367","Total",1460,705,755,1460,0,4,60.35,24.2
"2011","Stoke-on-Trent 028D","E01014368","Total",1597,771,826,1597,0,3,29.44,54.2
"2011","Stoke-on-Trent 029A","E01014305","Total",1395,737,658,1339,56,5,15.18,91.9
"2011","Stoke-on-Trent 029B","E01014306","Total",1419,690,729,1396,23,2,27.66,51.3
"2011","Stoke-on-Trent 029C","E01014307","Total",1383,690,693,1382,1,12,23.87,57.9
"2011","Stoke-on-Trent 029D","E01014312","Total",1425,693,732,1425,0,6,25.79,55.3
"2011","Stoke-on-Trent 030A","E01014346","Total",1577,772,805,1559,18,15,190.84,8.3
"2011","Stoke-on-Trent 030B","E01014348","Total",1366,658,708,1366,0,14,58.10,23.5
"2011","Stoke-on-Trent 030C","E01014349","Total",1429,707,722,1418,11,9,50.94,28.1
"2011","Stoke-on-Trent 030D","E01014353","Total",1710,820,890,1708,2,14,56.06,30.5
"2011","Stoke-on-Trent 031A","E01014310","Total",2062,1019,1043,2062,0,16,84.80,24.3
"2011","Stoke-on-Trent 031B","E01014314","Total",1413,708,705,1409,4,19,175.56,8.0
"2011","Stoke-on-Trent 031C","E01014316","Total",1566,777,789,1552,14,10,33.64,46.6
"2011","Stoke-on-Trent 031D","E01014317","Total",1557,726,831,1557,0,8,39.76,39.2
"2011","Stoke-on-Trent 031E","E01014322","Total",1662,802,860,1662,0,19,32.00,51.9
"2011","Stoke-on-Trent 032A","E01014235","Total",1587,767,820,1585,2,11,45.81,34.6
"2011","Stoke-on-Trent 032B","E01014236","Total",2344,1150,1194,2344,0,28,234.40,10.0
"2011","Stoke-on-Trent 032C","E01014237","Total",1592,825,767,1592,0,2,30.04,53.0
"2011","Stoke-on-Trent 032D","E01014238","Total",1525,762,763,1523,2,3,35.60,42.8
"2011","Stoke-on-Trent 033A","E01014315","Total",1331,661,670,1331,0,11,75.79,17.6
"2011","Stoke-on-Trent 033B","E01014318","Total",1448,746,702,1448,0,12,48.72,29.7
"2011","Stoke-on-Trent 033C","E01014319","Total",1510,737,773,1508,2,24,39.39,38.3
"2011","Stoke-on-Trent 033D","E01014320","Total",1291,641,650,1291,0,18,31.03,41.6
"2011","Stoke-on-Trent 034A","E01014347","Total",1413,699,714,1413,0,24,38.85,36.4
"2011","Stoke-on-Trent 034B","E01014350","Total",1370,684,686,1370,0,11,27.59,49.7
"2011","Stoke-on-Trent 034C","E01014351","Total",1585,750,835,1315,270,27,40.08,39.5
"2011","Stoke-on-Trent 034D","E01014352","Total",1386,699,687,1386,0,27,198.68,7.0
"2011","Telford and Wrekin 001A","E01014171","Total",1419,721,698,1419,0,14,28.13,50.4
"2011","Telford and Wrekin 001B","E01014172","Total",1407,697,710,1407,0,33,49.07,28.7
"2011","Telford and Wrekin 001C","E01014173","Total",1550,763,787,1515,35,17,61.07,25.4
"2011","Telford and Wrekin 001D","E01014174","Total",1627,809,818,1594,33,58,81.13,20.1
"2011","Telford and Wrekin 002A","E01014112","Total",1673,825,848,1553,120,42,2030.36,0.8
"2011","Telford and Wrekin 002B","E01014131","Total",2242,1148,1094,1531,711,70,4464.51,0.5
"2011","Telford and Wrekin 002C","E01014132","Total",1080,536,544,1080,0,20,240.49,4.5
"2011","Telford and Wrekin 002D","E01014135","Total",1235,616,619,1215,20,19,3127.62,0.4
"2011","Telford and Wrekin 003A","E01014175","Total",1140,570,570,1140,0,19,59.71,19.1
"2011","Telford and Wrekin 003B","E01014176","Total",1495,720,775,1465,30,27,56.17,26.6
"2011","Telford and Wrekin 003C","E01014177","Total",1384,681,703,1384,0,22,39.63,34.9
"2011","Telford and Wrekin 003D","E01014178","Total",1514,777,737,1421,93,7,38.47,39.4
"2011","Telford and Wrekin 004A","E01014111","Total",1550,763,787,1540,10,19,1661.44,0.9
"2011","Telford and Wrekin 004B","E01014167","Total",1949,962,987,1949,0,19,686.25,2.8
"2011","Telford and Wrekin 004C","E01014168","Total",1389,693,696,1389,0,19,30.87,45.0
"2011","Telford and Wrekin 004D","E01014170","Total",1482,710,772,1482,0,19,130.06,11.4
"2011","Telford and Wrekin 005A","E01014125","Total",1563,809,754,1562,1,7,26.79,58.3
"2011","Telford and Wrekin 005B","E01014126","Total",1459,707,752,1454,5,8,51.11,28.5
"2011","Telford and Wrekin 005C","E01014127","Total",1726,852,874,1711,15,12,31.60,54.6
"2011","Telford and Wrekin 005D","E01014128","Total",2135,1062,1073,2021,114,27,216.62,9.9
"2011","Telford and Wrekin 005E","E01014169","Total",1737,834,903,1737,0,11,42.68,40.7
"2011","Telford and Wrekin 006A","E01014129","Total",1029,524,505,1012,17,7,27.68,37.2
"2011","Telford and Wrekin 006B","E01014130","Total",1413,692,721,1412,1,21,65.43,21.6
"2011","Telford and Wrekin 006C","E01014179","Total",1192,594,598,1192,0,6,26.35,45.2
"2011","Telford and Wrekin 006D","E01014180","Total",1334,639,695,1300,34,12,33.42,39.9
"2011","Telford and Wrekin 006E","E01014189","Total",1537,761,776,1537,0,13,41.29,37.2
"2011","Telford and Wrekin 006F","E01014190","Total",1702,834,868,1702,0,44,52.75,32.3
"2011","Telford and Wrekin 007A","E01014102","Total",1823,883,940,1803,20,34,208.66,8.7
"2011","Telford and Wrekin 007B","E01014103","Total",1235,610,625,1235,0,24,37.10,33.3
"2011","Telford and Wrekin 007C","E01014138","Total",1486,716,770,1486,0,19,40.52,36.7
"2011","Telford and Wrekin 007D","E01014140","Total",1463,718,745,1463,0,3,42.74,34.2
"2011","Telford and Wrekin 008A","E01014205","Total",1382,666,716,1382,0,14,32.95,41.9
"2011","Telford and Wrekin 008B","E01014206","Total",1322,658,664,1322,0,10,33.54,39.4
"2011","Telford and Wrekin 008C","E01014207","Total",1291,644,647,1291,0,11,99.28,13.0
"2011","Telford and Wrekin 008D","E01014208","Total",1226,583,643,1218,8,8,40.31,30.4
"2011","Telford and Wrekin 008E","E01014209","Total",1458,732,726,1458,0,12,54.00,27.0
"2011","Telford and Wrekin 009A","E01014137","Total",1533,762,771,1525,8,22,410.87,3.7
"2011","Telford and Wrekin 009B","E01014139","Total",1396,679,717,1396,0,13,26.98,51.7
"2011","Telford and Wrekin 009C","E01014141","Total",2799,1391,1408,2795,4,17,132.04,21.2
"2011","Telford and Wrekin 009D","E01014142","Total",1402,662,740,1402,0,4,27.61,50.8
"2011","Telford and Wrekin 009E","E01014143","Total",1486,740,746,1476,10,5,41.76,35.6
"2011","Telford and Wrekin 010A","E01014136","Total",1639,812,827,1535,104,27,3739.23,0.4
"2011","Telford and Wrekin 010B","E01014148","Total",1493,774,719,1478,15,28,248.54,6.0
"2011","Telford and Wrekin 010C","E01014149","Total",1089,549,540,1030,59,28,326.96,3.3
"2011","Telford and Wrekin 010D","E01014202","Total",2389,1227,1162,2361,28,31,3121.60,0.8
"2011","Telford and Wrekin 010E","E01014203","Total",1542,773,769,1532,10,23,216.13,7.1
"2011","Telford and Wrekin 010F","E01014204","Total",1981,996,985,1981,0,49,2054.45,1.0
"2011","Telford and Wrekin 011A","E01014104","Total",1700,848,852,1700,0,16,62.67,27.1
"2011","Telford and Wrekin 011B","E01014105","Total",1935,951,984,1925,10,7,42.34,45.7
"2011","Telford and Wrekin 011C","E01014113","Total",1635,835,800,1604,31,18,61.66,26.5
"2011","Telford and Wrekin 011D","E01014114","Total",1456,744,712,1391,65,32,80.71,18.0
"2011","Telford and Wrekin 012A","E01014133","Total",1813,880,933,1733,80,34,79.06,22.9
"2011","Telford and Wrekin 012B","E01014134","Total",1308,615,693,1297,11,19,56.34,23.2
"2011","Telford and Wrekin 012C","E01014144","Total",1530,740,790,1506,24,13,48.97,31.2
"2011","Telford and Wrekin 012D","E01014145","Total",1768,886,882,1767,1,8,45.81,38.6
"2011","Telford and Wrekin 013A","E01014185","Total",1641,771,870,1641,0,14,43.46,37.8
"2011","Telford and Wrekin 013B","E01014186","Total",1434,695,739,1429,5,16,28.70,50.0
"2011","Telford and Wrekin 013C","E01014187","Total",1471,742,729,1471,0,7,64.35,22.9
"2011","Telford and Wrekin 013D","E01014188","Total",1538,780,758,1511,27,5,48.08,32.0
"2011","Telford and Wrekin 014A","E01014150","Total",1644,827,817,1644,0,17,73.86,22.3
"2011","Telford and Wrekin 014B","E01014151","Total",1504,752,752,1504,0,2,87.01,17.3
"2011","Telford and Wrekin 014C","E01014152","Total",1307,607,700,1299,8,7,78.86,16.6
"2011","Telford and Wrekin 014D","E01014153","Total",1761,879,882,1703,58,6,72.65,24.2
"2011","Telford and Wrekin 014E","E01014154","Total",1681,861,820,1677,4,14,65.06,25.8
"2011","Telford and Wrekin 014F","E01014155","Total",1648,819,829,1648,0,5,101.93,16.2
"2011","Telford and Wrekin 015A","E01014181","Total",2003,1020,983,2003,0,35,119.24,16.8
"2011","Telford and Wrekin 015B","E01014182","Total",1265,634,631,1232,33,43,113.95,11.1
"2011","Telford and Wrekin 015C","E01014183","Total",1559,791,768,1558,1,34,95.86,16.3
"2011","Telford and Wrekin 015D","E01014184","Total",1498,736,762,1452,46,25,98.79,15.2
"2011","Telford and Wrekin 016A","E01014146","Total",2212,1078,1134,2101,111,20,279.23,7.9
"2011","Telford and Wrekin 016B","E01014147","Total",2080,1035,1045,2071,9,23,171.97,12.1
"2011","Telford and Wrekin 016C","E01014156","Total",2160,1058,1102,2160,0,15,128.86,16.8
"2011","Telford and Wrekin 016D","E01014157","Total",1506,786,720,1504,2,22,133.84,11.3
"2011","Telford and Wrekin 016E","E01014158","Total",1561,782,779,1561,0,17,116.74,13.4
"2011","Telford and Wrekin 017A","E01014124","Total",1684,845,839,1671,13,4,60.91,27.6
"2011","Telford and Wrekin 017B","E01014163","Total",1459,711,748,1459,0,6,64.09,22.8
"2011","Telford and Wrekin 017C","E01014164","Total",1647,819,828,1627,20,7,60.18,27.4
"2011","Telford and Wrekin 017D","E01014165","Total",1419,725,694,1419,0,3,98.13,14.5
"2011","Telford and Wrekin 017E","E01014166","Total",1581,777,804,1581,0,11,40.66,38.9
"2011","Telford and Wrekin 018A","E01014191","Total",1742,934,808,1742,0,13,45.23,38.5
"2011","Telford and Wrekin 018B","E01014192","Total",1443,733,710,1437,6,5,276.16,5.2
"2011","Telford and Wrekin 018C","E01014193","Total",1686,814,872,1668,18,27,25.30,66.6
"2011","Telford and Wrekin 018D","E01014194","Total",1520,752,768,1520,0,8,26.23,57.9
"2011","Telford and Wrekin 018E","E01014195","Total",1447,722,725,1447,0,24,130.93,11.1
"2011","Telford and Wrekin 018F","E01014196","Total",1543,744,799,1543,0,10,128.45,12.0
"2011","Telford and Wrekin 019A","E01014119","Total",1658,806,852,1658,0,16,52.23,31.7
"2011","Telford and Wrekin 019B","E01014120","Total",1756,879,877,1750,6,9,72.15,24.3
"2011","Telford and Wrekin 019C","E01014121","Total",1388,663,725,1388,0,15,60.40,23.0
"2011","Telford and Wrekin 019D","E01014122","Total",1566,788,778,1562,4,11,48.77,32.1
"2011","Telford and Wrekin 019E","E01014123","Total",1532,776,756,1532,0,13,68.60,22.3
"2011","Telford and Wrekin 020A","E01014106","Total",1584,784,800,1584,0,5,21.46,73.8
"2011","Telford and Wrekin 020B","E01014107","Total",1180,607,573,1178,2,19,29.43,40.1
"2011","Telford and Wrekin 020C","E01014108","Total",1467,757,710,1467,0,6,15.74,93.2
"2011","Telford and Wrekin 020D","E01014109","Total",1193,578,615,1193,0,14,56.17,21.2
"2011","Telford and Wrekin 020E","E01014110","Total",1499,726,773,1499,0,12,30.04,49.9
"2011","Telford and Wrekin 021A","E01014197","Total",1523,748,775,1486,37,18,30.41,50.1
"2011","Telford and Wrekin 021B","E01014198","Total",1091,522,569,1091,0,3,35.00,31.2
"2011","Telford and Wrekin 021C","E01014199","Total",1673,780,893,1673,0,6,44.28,37.8
"2011","Telford and Wrekin 021D","E01014200","Total",1307,613,694,1307,0,3,19.56,66.8
"2011","Telford and Wrekin 021E","E01014201","Total",1304,619,685,1304,0,6,13.72,95.0
"2011","Telford and Wrekin 022A","E01014159","Total",1231,598,633,1231,0,5,37.94,32.4
"2011","Telford and Wrekin 022B","E01014160","Total",1318,651,667,1311,7,24,63.36,20.8
"2011","Telford and Wrekin 022C","E01014161","Total",1146,589,557,1138,8,8,46.22,24.8
"2011","Telford and Wrekin 022D","E01014162","Total",1634,801,833,1588,46,7,118.89,13.7
"2011","Telford and Wrekin 023A","E01014115","Total",1341,678,663,1341,0,14,92.97,14.4
"2011","Telford and Wrekin 023B","E01014116","Total",1663,784,879,1662,1,7,240.14,6.9
"2011","Telford and Wrekin 023C","E01014117","Total",1185,587,598,1183,2,18,110.40,10.7
"2011","Telford and Wrekin 023D","E01014118","Total",1215,613,602,1215,0,8,31.20,38.9
"2011","Cannock Chase 001A","E01029368","Total",1226,619,607,1226,0,16,41.55,29.5
"2011","Cannock Chase 001B","E01029369","Total",1250,625,625,1250,0,8,17.69,70.7
"2011","Cannock Chase 001C","E01029370","Total",1393,701,692,1366,27,18,1585.60,0.9
"2011","Cannock Chase 001D","E01029371","Total",1550,795,755,1550,0,16,22.41,69.2
"2011","Cannock Chase 001E","E01029402","Total",1985,951,1034,1946,39,7,67.61,29.4
"2011","Cannock Chase 002A","E01029372","Total",1358,664,694,1358,0,11,15.98,85.0
"2011","Cannock Chase 002B","E01029373","Total",2306,1149,1157,2252,54,14,102.85,22.4
"2011","Cannock Chase 002C","E01029401","Total",1605,782,823,1605,0,6,31.20,51.4
"2011","Cannock Chase 002D","E01029403","Total",1504,743,761,1500,4,8,34.09,44.1
"2011","Cannock Chase 002E","E01029404","Total",1496,741,755,1437,59,4,70.68,21.2
"2011","Cannock Chase 003A","E01029345","Total",1656,804,852,1626,30,5,154.03,10.8
"2011","Cannock Chase 003B","E01029346","Total",1699,780,919,1699,0,11,31.54,53.9
"2011","Cannock Chase 003C","E01029347","Total",1432,710,722,1432,0,9,57.39,25.0
"2011","Cannock Chase 003D","E01029348","Total",1751,877,874,1751,0,13,285.16,6.1
"2011","Cannock Chase 003E","E01029374","Total",2349,1151,1198,2349,0,19,79.73,29.5
"2011","Cannock Chase 004A","E01029383","Total",1570,794,776,1570,0,16,87.11,18.0
"2011","Cannock Chase 004B","E01029385","Total",1479,749,730,1479,0,12,44.42,33.3
"2011","Cannock Chase 004C","E01029388","Total",1375,674,701,1373,2,8,833.57,1.6
"2011","Cannock Chase 004D","E01029390","Total",1124,564,560,1124,0,6,28.72,39.1
"2011","Cannock Chase 005A","E01029384","Total",1936,959,977,1936,0,11,106.63,18.2
"2011","Cannock Chase 005B","E01029386","Total",1436,718,718,1436,0,10,33.35,43.1
"2011","Cannock Chase 005C","E01029387","Total",1478,754,724,1478,0,4,29.44,50.2
"2011","Cannock Chase 005D","E01029389","Total",1645,840,805,1642,3,17,98.17,16.8
"2011","Cannock Chase 006A","E01029379","Total",1767,871,896,1767,0,15,59.39,29.8
"2011","Cannock Chase 006B","E01029398","Total",1682,842,840,1680,2,24,806.24,2.1
"2011","Cannock Chase 006C","E01029399","Total",1589,802,787,1526,63,18,40.71,39.0
"2011","Cannock Chase 006D","E01029400","Total",1706,849,857,1670,36,9,82.51,20.7
"2011","Cannock Chase 007A","E01029354","Total",1548,754,794,1548,0,12,27.34,56.6
"2011","Cannock Chase 007B","E01029355","Total",1571,763,808,1557,14,10,34.86,45.1
"2011","Cannock Chase 007C","E01029356","Total",1497,762,735,1497,0,1,27.08,55.3
"2011","Cannock Chase 007D","E01029357","Total",1354,686,668,1354,0,7,32.84,41.2
"2011","Cannock Chase 007E","E01029358","Total",1316,625,691,1316,0,7,25.77,51.1
"2011","Cannock Chase 008A","E01029349","Total",1280,633,647,1280,0,10,33.27,38.5
"2011","Cannock Chase 008B","E01029350","Total",1526,753,773,1526,0,7,32.65,46.7
"2011","Cannock Chase 008C","E01029351","Total",1503,739,764,1503,0,6,26.40,56.9
"2011","Cannock Chase 008D","E01029352","Total",1351,679,672,1351,0,7,19.27,70.1
"2011","Cannock Chase 008E","E01029393","Total",1671,841,830,1671,0,8,55.69,30.0
"2011","Cannock Chase 009A","E01029380","Total",1539,778,761,1539,0,21,31.49,48.9
"2011","Cannock Chase 009B","E01029381","Total",1506,764,742,1478,28,7,24.75,60.8
"2011","Cannock Chase 009C","E01029382","Total",1645,801,844,1596,49,12,100.78,16.3
"2011","Cannock Chase 009D","E01029391","Total",1666,828,838,1651,15,14,147.74,11.3
"2011","Cannock Chase 009E","E01029392","Total",1963,968,995,1963,0,21,67.11,29.3
"2011","Cannock Chase 010A","E01029375","Total",2504,1251,1253,2504,0,17,54.53,45.9
"2011","Cannock Chase 010B","E01029376","Total",1974,946,1028,1860,114,25,39.92,49.4
"2011","Cannock Chase 010C","E01029377","Total",1449,696,753,1449,0,20,46.26,31.3
"2011","Cannock Chase 010D","E01029378","Total",1701,844,857,1701,0,14,32.44,52.4
"2011","Cannock Chase 011A","E01029353","Total",1403,678,725,1403,0,10,89.89,15.6
"2011","Cannock Chase 011B","E01029364","Total",1601,761,840,1601,0,14,84.02,19.1
"2011","Cannock Chase 011C","E01029365","Total",1530,748,782,1530,0,17,35.41,43.2
"2011","Cannock Chase 011D","E01029366","Total",1687,819,868,1687,0,31,53.16,31.7
"2011","Cannock Chase 011E","E01029367","Total",2178,1046,1132,2140,38,19,74.18,29.4
"2011","Cannock Chase 012A","E01029359","Total",1619,802,817,1608,11,6,100.97,16.0
"2011","Cannock Chase 012B","E01029360","Total",1538,724,814,1466,72,9,54.06,28.4
"2011","Cannock Chase 012C","E01029361","Total",1547,777,770,1545,2,6,85.54,18.1
"2011","Cannock Chase 012D","E01029362","Total",1565,751,814,1562,3,9,59.14,26.5
"2011","Cannock Chase 012E","E01029363","Total",1404,705,699,1404,0,7,27.84,50.4
"2011","Cannock Chase 013A","E01029394","Total",1462,714,748,1462,0,4,252.93,5.8
"2011","Cannock Chase 013B","E01029395","Total",1577,797,780,1571,6,12,1074.91,1.5
"2011","Cannock Chase 013C","E01029396","Total",1712,851,861,1712,0,15,137.01,12.5
"2011","Cannock Chase 013D","E01029397","Total",2728,1334,1394,2728,0,14,51.07,53.4
"2011","East Staffordshire 001A","E01029405","Total",1635,813,822,1587,48,33,2796.91,0.6
"2011","East Staffordshire 001B","E01029406","Total",1230,628,602,1227,3,24,4332.12,0.3
"2011","East Staffordshire 001C","E01029422","Total",1351,704,647,1138,213,35,1176.95,1.1
"2011","East Staffordshire 001D","E01029423","Total",1569,758,811,1569,0,18,151.49,10.4
"2011","East Staffordshire 001E","E01029467","Total",2052,1007,1045,2048,4,39,3975.47,0.5
"2011","East Staffordshire 002A","E01029430","Total",1493,735,758,1474,19,10,226.13,6.6
"2011","East Staffordshire 002B","E01029431","Total",1622,779,843,1622,0,16,26.16,62.0
"2011","East Staffordshire 002C","E01029432","Total",1475,716,759,1475,0,13,24.21,60.9
"2011","East Staffordshire 002D","E01029433","Total",1608,809,799,1586,22,23,170.62,9.4
"2011","East Staffordshire 003A","E01029459","Total",1574,775,799,1574,0,36,136.45,11.5
"2011","East Staffordshire 003B","E01029460","Total",1732,865,867,1729,3,39,472.70,3.7
"2011","East Staffordshire 003C","E01029461","Total",1940,983,957,1915,25,25,94.30,20.6
"2011","East Staffordshire 003D","E01029462","Total",1645,799,846,1524,121,12,263.59,6.2
"2011","East Staffordshire 004A","E01029443","Total",1677,820,857,1677,0,44,338.70,5.0
"2011","East Staffordshire 004B","E01029444","Total",1590,764,826,1590,0,26,316.00,5.0
"2011","East Staffordshire 004C","E01029463","Total",1261,608,653,1236,25,31,1871.70,0.7
"2011","East Staffordshire 004D","E01029464","Total",1573,768,805,1573,0,9,103.75,15.2
"2011","East Staffordshire 004E","E01029465","Total",1503,749,754,1502,1,26,219.98,6.8
"2011","East Staffordshire 004F","E01029466","Total",1560,780,780,1560,0,22,231.83,6.7
"2011","East Staffordshire 005A","E01029454","Total",1638,808,830,1638,0,31,66.92,24.5
"2011","East Staffordshire 005B","E01029455","Total",1827,891,936,1827,0,16,111.15,16.4
"2011","East Staffordshire 005C","E01029456","Total",1519,709,810,1487,32,9,57.49,26.4
"2011","East Staffordshire 005D","E01029457","Total",1370,660,710,1370,0,14,24.36,56.2
"2011","East Staffordshire 005E","E01029458","Total",1495,728,767,1495,0,29,115.26,13.0
"2011","East Staffordshire 006A","E01029411","Total",1287,656,631,1287,0,20,5591.79,0.2
"2011","East Staffordshire 006B","E01029412","Total",1351,631,720,1286,65,44,289.43,4.7
"2011","East Staffordshire 006C","E01029424","Total",1029,480,549,1005,24,13,1887.35,0.5
"2011","East Staffordshire 006D","E01029425","Total",2360,1598,762,1475,885,26,2189.92,1.1
"2011","East Staffordshire 006E","E01029473","Total",1414,697,717,1364,50,38,3810.54,0.4
"2011","East Staffordshire 006F","E01029474","Total",1207,567,640,1207,0,24,123.52,9.8
"2011","East Staffordshire 007A","E01029434","Total",1567,756,811,1567,0,11,23.47,66.8
"2011","East Staffordshire 007B","E01029435","Total",1496,715,781,1484,12,13,49.79,30.0
"2011","East Staffordshire 007C","E01029436","Total",1859,936,923,1843,16,8,35.10,53.0
"2011","East Staffordshire 007D","E01029437","Total",2317,1080,1237,2237,80,15,47.02,49.3
"2011","East Staffordshire 007E","E01029438","Total",1512,719,793,1512,0,8,25.75,58.7
"2011","East Staffordshire 008A","E01029426","Total",1747,852,895,1727,20,10,45.50,38.4
"2011","East Staffordshire 008B","E01029427","Total",1521,736,785,1521,0,12,26.92,56.5
"2011","East Staffordshire 008C","E01029428","Total",1584,789,795,1584,0,15,98.78,16.0
"2011","East Staffordshire 008D","E01029429","Total",1350,692,658,1347,3,9,21.10,64.0
"2011","East Staffordshire 009A","E01029445","Total",1932,995,937,1932,0,9,29.71,65.0
"2011","East Staffordshire 009B","E01029446","Total",1730,849,881,1707,23,21,162.57,10.6
"2011","East Staffordshire 009C","E01029447","Total",1739,891,848,1739,0,10,16.80,103.5
"2011","East Staffordshire 009D","E01029448","Total",1660,774,886,1628,32,14,95.14,17.4
"2011","East Staffordshire 010A","E01029468","Total",1655,813,842,1655,0,8,33.01,50.1
"2011","East Staffordshire 010B","E01029469","Total",1846,895,951,1837,9,19,65.78,28.1
"2011","East Staffordshire 010C","E01029470","Total",1562,778,784,1562,0,13,44.08,35.4
"2011","East Staffordshire 010D","E01029471","Total",1772,852,920,1642,130,26,60.55,29.3
"2011","East Staffordshire 010E","E01029472","Total",1631,789,842,1631,0,10,32.59,50.0
"2011","East Staffordshire 011A","E01029407","Total",1454,750,704,1454,0,6,33.61,43.3
"2011","East Staffordshire 011B","E01029408","Total",2118,1093,1025,2118,0,14,22.62,93.6
"2011","East Staffordshire 011C","E01029409","Total",1681,902,779,1681,0,6,59.17,28.4
"2011","East Staffordshire 011D","E01029410","Total",1556,784,772,1514,42,17,29.36,53.0
"2011","East Staffordshire 011F","E01032896","Total",1092,605,487,1052,40,9,138.80,7.9
"2011","East Staffordshire 011G","E01032897","Total",1173,594,579,1172,1,7,339.89,3.5
"2011","East Staffordshire 011H","E01032898","Total",1256,655,601,1231,25,5,68.89,18.2
"2011","East Staffordshire 012A","E01029418","Total",2106,1061,1045,2101,5,36,84.69,24.9
"2011","East Staffordshire 012B","E01029419","Total",1547,759,788,1547,0,24,62.39,24.8
"2011","East Staffordshire 012C","E01029420","Total",1732,809,923,1691,41,25,54.47,31.8
"2011","East Staffordshire 013A","E01029413","Total",1488,743,745,1488,0,13,81.11,18.3
"2011","East Staffordshire 013B","E01029414","Total",1658,828,830,1634,24,18,124.05,13.4
"2011","East Staffordshire 013C","E01029415","Total",1622,802,820,1622,0,17,39.06,41.5
"2011","East Staffordshire 013D","E01029416","Total",1245,616,629,1244,1,18,469.85,2.6
"2011","East Staffordshire 013E","E01029417","Total",1218,589,629,1218,0,20,252.31,4.8
"2011","East Staffordshire 014A","E01029449","Total",1650,798,852,1602,48,8,49.14,33.6
"2011","East Staffordshire 014B","E01029450","Total",1502,774,728,1502,0,5,30.26,49.6
"2011","East Staffordshire 014C","E01029451","Total",1745,813,932,1745,0,8,41.00,42.6
"2011","East Staffordshire 014D","E01029452","Total",1574,790,784,1574,0,14,37.46,42.0
"2011","East Staffordshire 014E","E01029453","Total",1506,720,786,1506,0,11,25.51,59.0
"2011","East Staffordshire 015A","E01029439","Total",1445,704,741,1445,0,25,45.35,31.9
"2011","East Staffordshire 015B","E01029440","Total",1293,652,641,1293,0,16,2529.80,0.5
"2011","East Staffordshire 015C","E01029441","Total",1513,707,806,1510,3,41,1899.74,0.8
"2011","East Staffordshire 015D","E01029442","Total",1342,641,701,1342,0,30,67.31,19.9
"2011","Lichfield 001A","E01029480","Total",1809,921,888,1809,0,13,216.49,8.4
"2011","Lichfield 001B","E01029481","Total",1882,915,967,1789,93,25,449.86,4.2
"2011","Lichfield 001C","E01029482","Total",1644,791,853,1625,19,13,106.32,15.5
"2011","Lichfield 001D","E01029498","Total",1799,898,901,1764,35,36,2859.90,0.6
"2011","Lichfield 002A","E01029477","Total",1547,763,784,1547,0,39,1635.75,0.9
"2011","Lichfield 002B","E01029478","Total",1582,755,827,1582,0,26,264.33,6.0
"2011","Lichfield 002C","E01029479","Total",2818,1387,1431,2818,0,54,580.29,4.9
"2011","Lichfield 002D","E01029509","Total",1679,815,864,1623,56,38,3209.90,0.5
"2011","Lichfield 003A","E01029486","Total",1419,735,684,1419,0,23,29.71,47.8
"2011","Lichfield 003B","E01029507","Total",1690,849,841,1690,0,34,260.95,6.5
"2011","Lichfield 003C","E01029508","Total",2313,1166,1147,2313,0,29,366.80,6.3
"2011","Lichfield 003D","E01029515","Total",1823,881,942,1823,0,39,2456.90,0.7
"2011","Lichfield 004A","E01029492","Total",2006,974,1032,2006,0,20,92.24,21.7
"2011","Lichfield 004B","E01029499","Total",1758,879,879,1758,0,5,25.16,69.9
"2011","Lichfield 004C","E01029501","Total",1539,733,806,1539,0,19,44.88,34.3
"2011","Lichfield 004E","E01029526","Total",1604,798,806,1560,44,11,69.23,23.2
"2011","Lichfield 004F","E01032899","Total",1524,707,817,1437,87,12,82.72,18.4
"2011","Lichfield 004G","E01032900","Total",2055,1009,1046,2055,0,30,32.02,64.2
"2011","Lichfield 005A","E01029483","Total",1553,762,791,1553,0,58,53.78,28.9
"2011","Lichfield 005B","E01029484","Total",1796,890,906,1739,57,36,77.58,23.2
"2011","Lichfield 005C","E01029485","Total",1495,739,756,1495,0,42,32.94,45.4
"2011","Lichfield 005D","E01029500","Total",1740,892,848,1740,0,21,49.94,34.8
"2011","Lichfield 005E","E01029520","Total",1579,787,792,1579,0,54,81.02,19.5
"2011","Lichfield 005F","E01029524","Total",1700,848,852,1669,31,20,42.53,40.0
"2011","Lichfield 005G","E01029525","Total",1747,864,883,1747,0,16,76.32,22.9
"2011","Lichfield 006A","E01029487","Total",1635,795,840,1626,9,9,44.91,36.4
"2011","Lichfield 006B","E01029493","Total",1971,984,987,1971,0,28,54.66,36.1
"2011","Lichfield 006C","E01029494","Total",1553,755,798,1499,54,12,32.69,47.5
"2011","Lichfield 006D","E01029495","Total",1658,805,853,1658,0,10,85.37,19.4
"2011","Lichfield 006E","E01029497","Total",1975,970,1005,1967,8,16,561.84,3.5
"2011","Lichfield 007A","E01029491","Total",1774,856,918,1774,0,21,33.29,53.3
"2011","Lichfield 007B","E01029511","Total",1601,773,828,1599,2,21,47.90,33.4
"2011","Lichfield 007C","E01029512","Total",1918,911,1007,1857,61,32,212.38,9.0
"2011","Lichfield 007D","E01029518","Total",2706,1310,1396,2706,0,55,294.66,9.2
"2011","Lichfield 007E","E01029519","Total",2124,1060,1064,2124,0,35,53.49,39.7
"2011","Lichfield 008A","E01029516","Total",1938,949,989,1872,66,33,4207.73,0.5
"2011","Lichfield 008B","E01029517","Total",1648,829,819,1648,0,24,1954.40,0.8
"2011","Lichfield 008C","E01029530","Total",1743,890,853,1716,27,27,1457.00,1.2
"2011","Lichfield 008D","E01029531","Total",1721,836,885,1678,43,39,1017.41,1.7
"2011","Lichfield 009A","E01029475","Total",2037,1003,1034,2007,30,11,41.90,48.6
"2011","Lichfield 009B","E01029476","Total",1384,670,714,1367,17,10,27.52,50.3
"2011","Lichfield 009C","E01029489","Total",1595,792,803,1556,39,13,31.47,50.7
"2011","Lichfield 009D","E01029490","Total",1458,737,721,1458,0,12,41.01,35.6
"2011","Lichfield 009E","E01029505","Total",1571,789,782,1530,41,22,866.99,1.8
"2011","Lichfield 009F","E01029506","Total",1841,943,898,1831,10,14,35.73,51.5
"2011","Lichfield 010A","E01029496","Total",1910,922,988,1837,73,5,36.87,51.8
"2011","Lichfield 010B","E01029527","Total",1282,634,648,1282,0,3,21.86,58.6
"2011","Lichfield 010C","E01029528","Total",1294,646,648,1294,0,18,36.49,35.5
"2011","Lichfield 010D","E01029529","Total",1281,656,625,1281,0,7,12.88,99.5
"2011","Lichfield 011A","E01029513","Total",1364,665,699,1355,9,45,218.67,6.2
"2011","Lichfield 011B","E01029514","Total",1556,745,811,1506,50,47,384.88,4.0
"2011","Lichfield 011C","E01029521","Total",1689,836,853,1686,3,42,1152.42,1.5
"2011","Lichfield 011D","E01029522","Total",1637,768,869,1509,128,22,1094.26,1.5
"2011","Lichfield 011E","E01029523","Total",1546,755,791,1546,0,28,886.71,1.7
"2011","Lichfield 012A","E01029488","Total",2332,1494,838,1696,636,34,4308.63,0.5
"2011","Lichfield 012B","E01029502","Total",1692,851,841,1692,0,20,113.66,14.9
"2011","Lichfield 012C","E01029503","Total",1585,769,816,1554,31,18,408.27,3.9
"2011","Lichfield 012D","E01029504","Total",1534,764,770,1532,2,10,154.20,9.9
"2011","Newcastle-under-Lyme 001A","E01029562","Total",1353,648,705,1353,0,6,30.61,44.2
"2011","Newcastle-under-Lyme 001B","E01029565","Total",1260,634,626,1260,0,15,58.71,21.5
"2011","Newcastle-under-Lyme 001C","E01029581","Total",1577,812,765,1577,0,13,191.47,8.2
"2011","Newcastle-under-Lyme 001D","E01029582","Total",1829,925,904,1829,0,19,365.43,5.0
"2011","Newcastle-under-Lyme 001E","E01029586","Total",1223,608,615,1223,0,12,94.96,12.9
"2011","Newcastle-under-Lyme 001F","E01029587","Total",1244,613,631,1244,0,8,72.44,17.2
"2011","Newcastle-under-Lyme 002A","E01029561","Total",1477,699,778,1472,5,12,78.40,18.8
"2011","Newcastle-under-Lyme 002B","E01029563","Total",1391,694,697,1391,0,9,26.62,52.3
"2011","Newcastle-under-Lyme 002C","E01029564","Total",1346,686,660,1346,0,4,27.99,48.1
"2011","Newcastle-under-Lyme 002D","E01029588","Total",1540,778,762,1532,8,16,47.09,32.7
"2011","Newcastle-under-Lyme 003A","E01029540","Total",1430,691,739,1396,34,11,63.08,22.7
"2011","Newcastle-under-Lyme 003B","E01029541","Total",1573,748,825,1573,0,11,51.55,30.5
"2011","Newcastle-under-Lyme 003C","E01029542","Total",1336,651,685,1335,1,3,86.97,15.4
"2011","Newcastle-under-Lyme 003D","E01029543","Total",1302,649,653,1234,68,10,37.24,35.0
"2011","Newcastle-under-Lyme 003E","E01029595","Total",1234,628,606,1232,2,6,165.16,7.5
"2011","Newcastle-under-Lyme 003F","E01029597","Total",1481,752,729,1481,0,9,29.34,50.5
"2011","Newcastle-under-Lyme 004A","E01029536","Total",1517,763,754,1517,0,14,303.05,5.0
"2011","Newcastle-under-Lyme 004B","E01029544","Total",1362,681,681,1338,24,13,68.24,20.0
"2011","Newcastle-under-Lyme 004C","E01029545","Total",1559,801,758,1559,0,7,84.90,18.4
"2011","Newcastle-under-Lyme 004D","E01029546","Total",1434,729,705,1434,0,13,80.71,17.8
"2011","Newcastle-under-Lyme 004E","E01029596","Total",1160,570,590,1152,8,9,316.55,3.7
"2011","Newcastle-under-Lyme 005A","E01029532","Total",1469,738,731,1465,4,10,1266.44,1.2
"2011","Newcastle-under-Lyme 005B","E01029533","Total",1526,754,772,1526,0,10,193.55,7.9
"2011","Newcastle-under-Lyme 005C","E01029534","Total",1518,748,770,1518,0,11,87.54,17.3
"2011","Newcastle-under-Lyme 005D","E01029535","Total",1414,695,719,1414,0,5,22.87,61.8
"2011","Newcastle-under-Lyme 005E","E01029556","Total",2510,1252,1258,2477,33,21,1380.95,1.8
"2011","Newcastle-under-Lyme 006A","E01029537","Total",1571,773,798,1571,0,12,58.97,26.6
"2011","Newcastle-under-Lyme 006B","E01029538","Total",1750,840,910,1598,152,9,57.46,30.5
"2011","Newcastle-under-Lyme 006C","E01029539","Total",1565,787,778,1565,0,7,35.64,43.9
"2011","Newcastle-under-Lyme 006D","E01029552","Total",1479,739,740,1463,16,10,69.30,21.3
"2011","Newcastle-under-Lyme 006E","E01029558","Total",1667,823,844,1667,0,5,31.23,53.4
"2011","Newcastle-under-Lyme 007A","E01029547","Total",1455,697,758,1407,48,7,50.78,28.7
"2011","Newcastle-under-Lyme 007B","E01029548","Total",1475,690,785,1475,0,5,102.34,14.4
"2011","Newcastle-under-Lyme 007C","E01029559","Total",1428,745,683,1428,0,4,203.39,7.0
"2011","Newcastle-under-Lyme 007D","E01029560","Total",1599,767,832,1566,33,8,37.24,42.9
"2011","Newcastle-under-Lyme 007E","E01029568","Total",1464,735,729,1464,0,13,53.65,27.3
"2011","Newcastle-under-Lyme 008A","E01029583","Total",1452,697,755,1431,21,7,22.83,63.6
"2011","Newcastle-under-Lyme 008B","E01029584","Total",1190,595,595,1181,9,7,27.73,42.9
"2011","Newcastle-under-Lyme 008C","E01029585","Total",1464,752,712,1464,0,11,18.47,79.3
"2011","Newcastle-under-Lyme 008D","E01029609","Total",1666,819,847,1666,0,12,22.11,75.4
"2011","Newcastle-under-Lyme 008E","E01029611","Total",1612,794,818,1612,0,6,74.51,21.6
"2011","Newcastle-under-Lyme 009A","E01029577","Total",1552,775,777,1513,39,14,23.19,66.9
"2011","Newcastle-under-Lyme 009B","E01029579","Total",1643,804,839,1643,0,18,34.80,47.2
"2011","Newcastle-under-Lyme 009C","E01029580","Total",1430,721,709,1430,0,25,36.86,38.8
"2011","Newcastle-under-Lyme 009D","E01029610","Total",1321,652,669,1303,18,20,22.73,58.1
"2011","Newcastle-under-Lyme 009E","E01029612","Total",1247,611,636,1201,46,12,32.55,38.3
"2011","Newcastle-under-Lyme 010A","E01029553","Total",1433,698,735,1433,0,7,37.75,38.0
"2011","Newcastle-under-Lyme 010B","E01029554","Total",1203,605,598,1203,0,6,46.61,25.8
"2011","Newcastle-under-Lyme 010C","E01029566","Total",1232,579,653,1232,0,8,22.23,55.4
"2011","Newcastle-under-Lyme 010D","E01029567","Total",1617,798,819,1590,27,14,87.74,18.4
"2011","Newcastle-under-Lyme 010E","E01029598","Total",1796,867,929,1796,0,10,57.32,31.3
"2011","Newcastle-under-Lyme 010F","E01029599","Total",1441,695,746,1441,0,15,42.72,33.7
"2011","Newcastle-under-Lyme 011A","E01029555","Total",1772,880,892,1768,4,9,58.41,30.3
"2011","Newcastle-under-Lyme 011B","E01029578","Total",1611,829,782,1562,49,15,54.05,29.8
"2011","Newcastle-under-Lyme 011C","E01029602","Total",1920,950,970,1856,64,15,47.05,40.8
"2011","Newcastle-under-Lyme 011D","E01029603","Total",1481,776,705,1455,26,17,36.00,41.1
"2011","Newcastle-under-Lyme 011E","E01029604","Total",1662,856,806,1589,73,8,61.28,27.1
"2011","Newcastle-under-Lyme 012A","E01029576","Total",4460,2225,2235,1222,3238,88,1084.50,4.1
"2011","Newcastle-under-Lyme 012B","E01029593","Total",1785,896,889,1785,0,11,147.33,12.1
"2011","Newcastle-under-Lyme 012C","E01029594","Total",1832,892,940,1830,2,13,143.87,12.7
"2011","Newcastle-under-Lyme 013A","E01029557","Total",1254,614,640,1230,24,20,1073.52,1.2
"2011","Newcastle-under-Lyme 013B","E01029573","Total",1498,725,773,1461,37,41,189.40,7.9
"2011","Newcastle-under-Lyme 013C","E01029574","Total",1375,663,712,1375,0,24,1593.02,0.9
"2011","Newcastle-under-Lyme 013D","E01029575","Total",1018,481,537,1017,1,11,158.24,6.4
"2011","Newcastle-under-Lyme 014A","E01029549","Total",1684,833,851,1684,0,17,68.30,24.7
"2011","Newcastle-under-Lyme 014B","E01029551","Total",1616,797,819,1610,6,25,52.28,30.9
"2011","Newcastle-under-Lyme 014C","E01029591","Total",1511,712,799,1511,0,8,33.80,44.7
"2011","Newcastle-under-Lyme 014D","E01029600","Total",1423,692,731,1419,4,15,38.80,36.7
"2011","Newcastle-under-Lyme 014E","E01029605","Total",1264,631,633,1264,0,22,56.21,22.5
"2011","Newcastle-under-Lyme 014F","E01029607","Total",1416,679,737,1416,0,16,38.95,36.4
"2011","Newcastle-under-Lyme 015B","E01029589","Total",1209,571,638,1209,0,26,28.37,42.6
"2011","Newcastle-under-Lyme 015C","E01029590","Total",1353,635,718,1353,0,20,28.65,47.2
"2011","Newcastle-under-Lyme 015E","E01029601","Total",1484,708,776,1484,0,22,187.40,7.9
"2011","Newcastle-under-Lyme 015F","E01029606","Total",1499,739,760,1499,0,47,43.45,34.5
"2011","Newcastle-under-Lyme 015G","E01029608","Total",1480,731,749,1480,0,42,97.13,15.2
"2011","Newcastle-under-Lyme 015H","E01033257","Total",2499,1209,1290,2494,5,29,155.70,16.1
"2011","Newcastle-under-Lyme 016A","E01029569","Total",1441,735,706,1407,34,23,4265.62,0.3
"2011","Newcastle-under-Lyme 016B","E01029570","Total",2468,1232,1236,2468,0,46,4289.59,0.6
"2011","Newcastle-under-Lyme 016C","E01029571","Total",1375,676,699,1375,0,39,360.30,3.8
"2011","Newcastle-under-Lyme 016D","E01029572","Total",1664,834,830,1664,0,30,162.52,10.2
"2011","South Staffordshire 001A","E01029655","Total",1972,951,1021,1971,1,17,834.55,2.4
"2011","South Staffordshire 001B","E01029656","Total",1823,924,899,1789,34,31,3153.29,0.6
"2011","South Staffordshire 001C","E01029657","Total",1789,890,899,1789,0,30,41.13,43.5
"2011","South Staffordshire 001D","E01029658","Total",1332,632,700,1325,7,16,1375.46,1.0
"2011","South Staffordshire 001E","E01029659","Total",1384,669,715,1384,0,11,27.46,50.4
"2011","South Staffordshire 001F","E01029660","Total",2049,1039,1010,2036,13,29,1895.12,1.1
"2011","South Staffordshire 002A","E01029621","Total",1479,733,746,1479,0,10,1025.38,1.4
"2011","South Staffordshire 002B","E01029646","Total",1433,708,725,1393,40,9,286.98,5.0
"2011","South Staffordshire 002C","E01029647","Total",2210,1077,1133,2205,5,21,1109.42,2.0
"2011","South Staffordshire 002D","E01029648","Total",1494,748,746,1494,0,14,65.11,22.9
"2011","South Staffordshire 003A","E01029617","Total",1675,844,831,1669,6,36,3040.11,0.6
"2011","South Staffordshire 003B","E01029618","Total",1540,687,853,1540,0,21,64.11,24.0
"2011","South Staffordshire 003C","E01029668","Total",1258,605,653,1217,41,24,1978.04,0.6
"2011","South Staffordshire 003D","E01029669","Total",1290,630,660,1290,0,12,260.52,5.0
"2011","South Staffordshire 003E","E01029670","Total",1579,794,785,1573,6,31,3790.94,0.4
"2011","South Staffordshire 004A","E01029620","Total",1286,626,660,1286,0,4,21.84,58.9
"2011","South Staffordshire 004B","E01029622","Total",1520,761,759,1520,0,13,78.34,19.4
"2011","South Staffordshire 004C","E01029623","Total",1196,588,608,1196,0,18,22.07,54.2
"2011","South Staffordshire 004D","E01029624","Total",1517,749,768,1517,0,17,53.80,28.2
"2011","South Staffordshire 004E","E01029625","Total",1124,561,563,1124,0,7,27.42,41.0
"2011","South Staffordshire 004F","E01029641","Total",1681,846,835,1681,0,21,59.16,28.4
"2011","South Staffordshire 004G","E01029642","Total",1513,762,751,1470,43,14,65.77,23.0
"2011","South Staffordshire 005A","E01029638","Total",2010,978,1032,1996,14,11,170.82,11.8
"2011","South Staffordshire 005B","E01029639","Total",1424,704,720,1424,0,22,115.14,12.4
"2011","South Staffordshire 005C","E01029640","Total",1483,741,742,1483,0,9,23.97,61.9
"2011","South Staffordshire 005D","E01029643","Total",1501,715,786,1469,32,10,29.43,51.0
"2011","South Staffordshire 005E","E01029644","Total",1448,718,730,1448,0,13,93.00,15.6
"2011","South Staffordshire 006A","E01029616","Total",1475,719,756,1475,0,8,628.20,2.3
"2011","South Staffordshire 006B","E01029619","Total",1883,951,932,1883,0,29,263.55,7.1
"2011","South Staffordshire 006C","E01029636","Total",1440,716,724,1440,0,13,438.58,3.3
"2011","South Staffordshire 006D","E01029637","Total",2558,1668,890,1746,812,27,349.29,7.3
"2011","South Staffordshire 007A","E01029632","Total",1816,872,944,1597,219,28,756.58,2.4
"2011","South Staffordshire 007B","E01029633","Total",1727,854,873,1727,0,15,617.25,2.8
"2011","South Staffordshire 007C","E01029634","Total",1414,691,723,1414,0,13,89.94,15.7
"2011","South Staffordshire 007D","E01029635","Total",1743,828,915,1743,0,11,335.68,5.2
"2011","South Staffordshire 008A","E01029613","Total",1384,692,692,1377,7,12,474.29,2.9
"2011","South Staffordshire 008B","E01029614","Total",1730,817,913,1730,0,16,38.13,45.4
"2011","South Staffordshire 008C","E01029615","Total",1216,560,656,1216,0,10,21.25,57.2
"2011","South Staffordshire 008D","E01029627","Total",1415,642,773,1384,31,17,47.34,29.9
"2011","South Staffordshire 009A","E01029626","Total",1443,709,734,1423,20,34,401.73,3.6
"2011","South Staffordshire 009B","E01029628","Total",1192,558,634,1192,0,18,49.07,24.3
"2011","South Staffordshire 009C","E01029629","Total",1218,574,644,1218,0,27,54.31,22.4
"2011","South Staffordshire 009D","E01029630","Total",1454,703,751,1332,122,31,543.38,2.7
"2011","South Staffordshire 009E","E01029631","Total",1443,709,734,1443,0,26,169.87,8.5
"2011","South Staffordshire 010A","E01029654","Total",2246,1106,1140,2246,0,45,1759.01,1.3
"2011","South Staffordshire 010B","E01029661","Total",1990,981,1009,1885,105,36,1514.10,1.3
"2011","South Staffordshire 010C","E01029663","Total",1456,710,746,1456,0,32,24.67,59.0
"2011","South Staffordshire 010D","E01029665","Total",1810,895,915,1810,0,35,42.17,42.9
"2011","South Staffordshire 011A","E01029662","Total",2279,1132,1147,2279,0,37,59.89,38.1
"2011","South Staffordshire 011B","E01029664","Total",1595,775,820,1595,0,16,25.47,62.6
"2011","South Staffordshire 011C","E01029666","Total",1556,729,827,1552,4,14,28.81,54.0
"2011","South Staffordshire 012A","E01029671","Total",1490,740,750,1490,0,25,65.95,22.6
"2011","South Staffordshire 012B","E01029673","Total",1659,791,868,1597,62,11,385.29,4.3
"2011","South Staffordshire 012C","E01029676","Total",1057,494,563,1057,0,13,139.29,7.6
"2011","South Staffordshire 012D","E01029679","Total",1454,686,768,1442,12,6,23.64,61.5
"2011","South Staffordshire 012E","E01029680","Total",1536,748,788,1529,7,15,115.23,13.3
"2011","South Staffordshire 013A","E01029645","Total",2033,979,1054,1913,120,13,1688.01,1.2
"2011","South Staffordshire 013B","E01029667","Total",2225,1124,1101,2184,41,38,4479.50,0.5
"2011","South Staffordshire 013C","E01029672","Total",1568,783,785,1556,12,39,934.84,1.7
"2011","South Staffordshire 013D","E01029674","Total",1849,942,907,1849,0,36,101.76,18.2
"2011","South Staffordshire 013E","E01029675","Total",1476,689,787,1476,0,15,37.37,39.5
"2011","South Staffordshire 013F","E01029677","Total",1314,635,679,1314,0,14,63.70,20.6
"2011","South Staffordshire 013G","E01029678","Total",1752,895,857,1752,0,33,59.55,29.4
"2011","South Staffordshire 014A","E01029649","Total",1158,535,623,1158,0,21,81.70,14.2
"2011","South Staffordshire 014B","E01029650","Total",1527,758,769,1503,24,42,1026.99,1.5
"2011","South Staffordshire 014C","E01029651","Total",1545,719,826,1440,105,33,1551.12,1.0
"2011","South Staffordshire 014D","E01029652","Total",1730,846,884,1701,29,37,1451.34,1.2
"2011","South Staffordshire 014E","E01029653","Total",1265,608,657,1265,0,19,85.30,14.8
"2011","Stafford 001A","E01029702","Total",1530,750,780,1475,55,15,52.62,29.1
"2011","Stafford 001B","E01029703","Total",1549,751,798,1517,32,37,927.41,1.7
"2011","Stafford 001C","E01029704","Total",1386,666,720,1386,0,19,117.04,11.8
"2011","Stafford 001D","E01029705","Total",1466,744,722,1466,0,16,393.50,3.7
"2011","Stafford 002A","E01029681","Total",1207,594,613,1207,0,9,875.80,1.4
"2011","Stafford 002B","E01029682","Total",1651,785,866,1559,92,19,343.51,4.8
"2011","Stafford 002C","E01029683","Total",1312,609,703,1284,28,31,2596.15,0.5
"2011","Stafford 002D","E01029748","Total",1358,698,660,1358,0,33,1084.65,1.3
"2011","Stafford 002E","E01029749","Total",1642,792,850,1627,15,26,2164.32,0.8
"2011","Stafford 003A","E01029740","Total",1675,792,883,1675,0,22,56.57,29.6
"2011","Stafford 003B","E01029744","Total",2356,1125,1231,2260,96,29,86.63,27.2
"2011","Stafford 003C","E01029745","Total",1686,846,840,1677,9,18,118.15,14.3
"2011","Stafford 003D","E01029746","Total",1533,751,782,1526,7,16,133.70,11.5
"2011","Stafford 003E","E01029753","Total",1305,641,664,1305,0,8,76.12,17.1
"2011","Stafford 003F","E01029756","Total",1779,884,895,1687,92,11,80.80,22.0
"2011","Stafford 004A","E01029733","Total",1954,963,991,1877,77,44,5389.14,0.4
"2011","Stafford 004B","E01029739","Total",1610,796,814,1610,0,40,102.02,15.8
"2011","Stafford 004C","E01029741","Total",1705,841,864,1705,0,30,40.05,42.6
"2011","Stafford 004D","E01029754","Total",1330,654,676,1330,0,23,159.53,8.3
"2011","Stafford 004E","E01029755","Total",1406,667,739,1406,0,16,35.69,39.4
"2011","Stafford 005A","E01029695","Total",2002,966,1036,1948,54,46,1801.14,1.1
"2011","Stafford 005B","E01029696","Total",1508,768,740,1505,3,47,5263.31,0.3
"2011","Stafford 005C","E01029697","Total",1614,699,915,1350,264,35,3957.37,0.4
"2011","Stafford 005D","E01029698","Total",1533,738,795,1533,0,40,1429.23,1.1
"2011","Stafford 005E","E01029747","Total",1453,746,707,1453,0,31,395.07,3.7
"2011","Stafford 006A","E01029690","Total",1550,777,773,1550,0,9,149.63,10.4
"2011","Stafford 006B","E01029718","Total",1962,994,968,1962,0,23,40.80,48.1
"2011","Stafford 006C","E01029743","Total",1396,683,713,1389,7,26,2084.32,0.7
"2011","Stafford 006D","E01029751","Total",1563,769,794,1563,0,24,49.76,31.4
"2011","Stafford 007A","E01029719","Total",1559,763,796,1559,0,15,31.95,48.8
"2011","Stafford 007B","E01029720","Total",1630,806,824,1630,0,13,37.62,43.3
"2011","Stafford 007C","E01029721","Total",1624,777,847,1550,74,20,50.92,31.9
"2011","Stafford 007D","E01029750","Total",1558,755,803,1558,0,10,199.31,7.8
"2011","Stafford 007E","E01029752","Total",1288,585,703,1288,0,3,60.17,21.4
"2011","Stafford 008A","E01029687","Total",1870,926,944,1870,0,56,3851.97,0.5
"2011","Stafford 008B","E01029710","Total",1434,699,735,1434,0,27,141.12,10.2
"2011","Stafford 008C","E01029711","Total",1514,745,769,1471,43,21,2592.67,0.6
"2011","Stafford 008D","E01029712","Total",1917,926,991,1870,47,25,733.12,2.6
"2011","Stafford 008E","E01029713","Total",1580,775,805,1580,0,14,128.39,12.3
"2011","Stafford 009A","E01029692","Total",1592,773,819,1592,0,8,22.67,70.2
"2011","Stafford 009B","E01029693","Total",1696,1024,672,1696,0,39,25.45,66.6
"2011","Stafford 009C","E01029722","Total",1655,854,801,1646,9,21,37.20,44.5
"2011","Stafford 009D","E01029725","Total",2244,1628,616,1458,786,4,65.27,34.4
"2011","Stafford 010A","E01029689","Total",1671,892,779,1616,55,10,42.80,39.0
"2011","Stafford 010B","E01029691","Total",1213,652,561,1197,16,12,36.52,33.2
"2011","Stafford 010C","E01029694","Total",1445,799,646,1445,0,10,39.52,36.6
"2011","Stafford 010D","E01029699","Total",1966,990,976,1915,51,17,68.35,28.8
"2011","Stafford 010E","E01029701","Total",1940,1077,863,1933,7,7,124.73,15.6
"2011","Stafford 011A","E01029686","Total",1421,674,747,1421,0,19,45.04,31.5
"2011","Stafford 011B","E01029700","Total",1276,612,664,1274,2,25,101.90,12.5
"2011","Stafford 011C","E01029723","Total",1586,839,747,1586,0,30,58.90,26.9
"2011","Stafford 011D","E01029724","Total",1771,881,890,1702,69,46,46.56,38.0
"2011","Stafford 011E","E01029732","Total",2423,1506,917,1482,941,48,2718.48,0.9
"2011","Stafford 012A","E01029714","Total",1589,785,804,1589,0,33,33.14,47.9
"2011","Stafford 012B","E01029736","Total",1585,756,829,1490,95,38,216.90,7.3
"2011","Stafford 012C","E01029737","Total",1577,772,805,1533,44,25,74.83,21.1
"2011","Stafford 012D","E01029738","Total",1378,667,711,1363,15,38,56.02,24.6
"2011","Stafford 012E","E01029742","Total",2080,1081,999,1982,98,21,3631.59,0.6
"2011","Stafford 013A","E01029715","Total",1631,762,869,1631,0,17,37.62,43.4
"2011","Stafford 013B","E01029716","Total",1592,782,810,1592,0,11,24.65,64.6
"2011","Stafford 013C","E01029717","Total",1779,844,935,1779,0,7,33.39,53.3
"2011","Stafford 013D","E01029727","Total",1552,768,784,1552,0,4,42.62,36.4
"2011","Stafford 013E","E01029728","Total",1429,688,741,1429,0,9,36.19,39.5
"2011","Stafford 014A","E01029684","Total",1488,723,765,1488,0,31,33.87,43.9
"2011","Stafford 014B","E01029685","Total",1568,741,827,1568,0,31,60.68,25.8
"2011","Stafford 014C","E01029730","Total",1082,534,548,1082,0,37,937.79,1.2
"2011","Stafford 014D","E01029731","Total",1637,806,831,1637,0,37,223.03,7.3
"2011","Stafford 014E","E01029757","Total",1604,797,807,1604,0,19,25.43,63.1
"2011","Stafford 014F","E01029758","Total",1535,748,787,1535,0,33,68.45,22.4
"2011","Stafford 014G","E01029759","Total",1715,849,866,1715,0,32,91.49,18.7
"2011","Stafford 014H","E01029760","Total",1570,765,805,1570,0,30,55.12,28.5
"2011","Stafford 015A","E01029688","Total",2275,1139,1136,2224,51,38,4700.58,0.5
"2011","Stafford 015B","E01029706","Total",1547,785,762,1547,0,35,2309.78,0.7
"2011","Stafford 015C","E01029707","Total",1456,714,742,1446,10,15,92.28,15.8
"2011","Stafford 015D","E01029708","Total",1909,970,939,1907,2,46,5310.05,0.4
"2011","Stafford 015E","E01029709","Total",1483,724,759,1483,0,41,128.68,11.5
"2011","Stafford 016A","E01029726","Total",1723,852,871,1709,14,10,63.34,27.2
"2011","Stafford 016B","E01029729","Total",1604,812,792,1604,0,7,30.79,52.1
"2011","Stafford 016C","E01029734","Total",2242,1081,1161,2242,0,15,69.65,32.2
"2011","Stafford 016D","E01029735","Total",2345,1162,1183,2345,0,25,164.64,14.2
"2011","Staffordshire Moorlands 001A","E01029797","Total",1553,781,772,1536,17,23,9105.66,0.2
"2011","Staffordshire Moorlands 001B","E01029806","Total",1499,718,781,1465,34,23,125.54,11.9
"2011","Staffordshire Moorlands 001C","E01029808","Total",1424,691,733,1418,6,10,66.29,21.5
"2011","Staffordshire Moorlands 001D","E01029809","Total",1458,683,775,1458,0,15,35.47,41.1
"2011","Staffordshire Moorlands 001E","E01029810","Total",1384,686,698,1337,47,5,23.36,59.2
"2011","Staffordshire Moorlands 002A","E01029767","Total",1640,829,811,1640,0,22,327.20,5.0
"2011","Staffordshire Moorlands 002B","E01029769","Total",1664,828,836,1664,0,15,869.20,1.9
"2011","Staffordshire Moorlands 002C","E01029770","Total",1925,978,947,1925,0,24,49.21,39.1
"2011","Staffordshire Moorlands 002D","E01029802","Total",1809,922,887,1760,49,41,4337.21,0.4
"2011","Staffordshire Moorlands 003A","E01029763","Total",1630,754,876,1580,50,9,27.61,59.0
"2011","Staffordshire Moorlands 003B","E01029764","Total",1848,882,966,1814,34,18,64.29,28.7
"2011","Staffordshire Moorlands 003C","E01029765","Total",1390,670,720,1390,0,6,25.05,55.5
"2011","Staffordshire Moorlands 003D","E01029766","Total",1510,727,783,1506,4,6,27.11,55.7
"2011","Staffordshire Moorlands 003E","E01029774","Total",1980,955,1025,1974,6,14,57.21,34.6
"2011","Staffordshire Moorlands 004A","E01029768","Total",1374,672,702,1374,0,7,257.12,5.3
"2011","Staffordshire Moorlands 004B","E01029771","Total",1641,753,888,1592,49,17,521.58,3.1
"2011","Staffordshire Moorlands 004C","E01029772","Total",1752,883,869,1750,2,16,99.39,17.6
"2011","Staffordshire Moorlands 004D","E01029773","Total",1538,769,769,1530,8,20,362.45,4.2
"2011","Staffordshire Moorlands 005A","E01029804","Total",1763,874,889,1763,0,21,30.02,58.7
"2011","Staffordshire Moorlands 005B","E01029807","Total",1143,532,611,1075,68,8,278.61,4.1
"2011","Staffordshire Moorlands 005C","E01029811","Total",1557,770,787,1519,38,9,37.88,41.1
"2011","Staffordshire Moorlands 005D","E01029812","Total",2009,997,1012,1986,23,20,22.74,88.3
"2011","Staffordshire Moorlands 005E","E01029814","Total",1685,836,849,1685,0,19,51.89,32.5
"2011","Staffordshire Moorlands 006A","E01029792","Total",2395,1187,1208,2334,61,31,1217.03,2.0
"2011","Staffordshire Moorlands 006B","E01029793","Total",1628,816,812,1625,3,16,79.03,20.6
"2011","Staffordshire Moorlands 006C","E01029805","Total",1719,808,911,1655,64,28,307.20,5.6
"2011","Staffordshire Moorlands 006D","E01029813","Total",2165,1069,1096,2165,0,27,487.82,4.4
"2011","Staffordshire Moorlands 006E","E01029815","Total",1526,734,792,1497,29,16,220.22,6.9
"2011","Staffordshire Moorlands 006F","E01029816","Total",1436,678,758,1436,0,29,55.21,26.0
"2011","Staffordshire Moorlands 007A","E01029801","Total",1840,947,893,1798,42,34,6581.08,0.3
"2011","Staffordshire Moorlands 007B","E01029803","Total",1798,897,901,1795,3,31,3784.30,0.5
"2011","Staffordshire Moorlands 007C","E01029817","Total",1848,927,921,1835,13,20,8572.38,0.2
"2011","Staffordshire Moorlands 008A","E01029762","Total",1591,785,806,1591,0,26,1255.58,1.3
"2011","Staffordshire Moorlands 008B","E01029775","Total",1534,757,777,1531,3,15,643.98,2.4
"2011","Staffordshire Moorlands 008C","E01029776","Total",1815,887,928,1800,15,36,510.02,3.6
"2011","Staffordshire Moorlands 008D","E01029777","Total",1532,737,795,1500,32,16,111.44,13.7
"2011","Staffordshire Moorlands 009A","E01029779","Total",1616,770,846,1616,0,9,167.48,9.6
"2011","Staffordshire Moorlands 009B","E01029780","Total",1637,815,822,1517,120,13,50.38,32.5
"2011","Staffordshire Moorlands 009C","E01029794","Total",1421,704,717,1392,29,22,2230.55,0.6
"2011","Staffordshire Moorlands 009D","E01029818","Total",1531,739,792,1486,45,15,55.83,27.4
"2011","Staffordshire Moorlands 009E","E01029819","Total",1670,837,833,1667,3,18,375.76,4.4
"2011","Staffordshire Moorlands 010A","E01029761","Total",1377,689,688,1344,33,23,1793.43,0.8
"2011","Staffordshire Moorlands 010B","E01029782","Total",2036,1041,995,1945,91,15,585.96,3.5
"2011","Staffordshire Moorlands 010C","E01029795","Total",1662,831,831,1659,3,18,2299.68,0.7
"2011","Staffordshire Moorlands 010D","E01029796","Total",1480,718,762,1478,2,18,888.03,1.7
"2011","Staffordshire Moorlands 011A","E01029781","Total",1524,765,759,1524,0,11,57.30,26.6
"2011","Staffordshire Moorlands 011B","E01029783","Total",1416,679,737,1412,4,11,42.81,33.1
"2011","Staffordshire Moorlands 011C","E01029786","Total",1463,723,740,1435,28,16,575.01,2.5
"2011","Staffordshire Moorlands 011D","E01029787","Total",1716,837,879,1634,82,19,64.01,26.8
"2011","Staffordshire Moorlands 012A","E01029778","Total",1720,866,854,1681,39,20,2302.41,0.7
"2011","Staffordshire Moorlands 012B","E01029789","Total",1029,514,515,1026,3,11,1586.78,0.6
"2011","Staffordshire Moorlands 012C","E01029798","Total",1698,840,858,1688,10,10,55.00,30.9
"2011","Staffordshire Moorlands 012D","E01029799","Total",1841,925,916,1841,0,24,391.34,4.7
"2011","Staffordshire Moorlands 012E","E01029800","Total",1556,744,812,1547,9,15,93.00,16.7
"2011","Staffordshire Moorlands 013A","E01029784","Total",2201,1111,1090,2170,31,25,789.39,2.8
"2011","Staffordshire Moorlands 013B","E01029785","Total",1809,877,932,1809,0,34,368.03,4.9
"2011","Staffordshire Moorlands 013C","E01029788","Total",1356,697,659,1356,0,22,1489.18,0.9
"2011","Staffordshire Moorlands 013D","E01029790","Total",1955,977,978,1941,14,20,65.71,29.8
"2011","Staffordshire Moorlands 013E","E01029791","Total",1389,672,717,1389,0,28,630.26,2.2
"2011","Tamworth 001A","E01029846","Total",1267,619,648,1267,0,16,35.79,35.4
"2011","Tamworth 001B","E01029847","Total",1342,659,683,1295,47,15,50.04,26.8
"2011","Tamworth 001C","E01029848","Total",1231,611,620,1231,0,15,85.08,14.5
"2011","Tamworth 001D","E01029852","Total",1743,814,929,1743,0,18,45.82,38.0
"2011","Tamworth 001E","E01029853","Total",1721,789,932,1598,123,16,35.27,48.8
"2011","Tamworth 001F","E01029854","Total",1513,743,770,1513,0,36,338.41,4.5
"2011","Tamworth 002A","E01029835","Total",1661,803,858,1633,28,12,82.75,20.1
"2011","Tamworth 002B","E01029836","Total",1278,625,653,1263,15,5,194.52,6.6
"2011","Tamworth 002C","E01029849","Total",1470,703,767,1470,0,10,25.82,56.9
"2011","Tamworth 002D","E01029850","Total",1310,639,671,1310,0,9,61.42,21.3
"2011","Tamworth 002E","E01029851","Total",2132,1031,1101,2120,12,15,56.87,37.5
"2011","Tamworth 003A","E01029820","Total",1558,785,773,1558,0,20,146.89,10.6
"2011","Tamworth 003B","E01029821","Total",1470,727,743,1456,14,17,229.05,6.4
"2011","Tamworth 003C","E01029822","Total",1576,788,788,1576,0,18,29.27,53.8
"2011","Tamworth 003D","E01029824","Total",1832,873,959,1832,0,12,36.50,50.2
"2011","Tamworth 003E","E01029841","Total",1451,734,717,1451,0,6,28.65,50.6
"2011","Tamworth 004A","E01029823","Total",1483,717,766,1483,0,14,28.92,51.3
"2011","Tamworth 004B","E01029831","Total",1494,742,752,1494,0,10,33.22,45.0
"2011","Tamworth 004C","E01029832","Total",1636,788,848,1628,8,12,33.87,48.3
"2011","Tamworth 004D","E01029834","Total",1541,750,791,1541,0,7,36.82,41.9
"2011","Tamworth 004E","E01029844","Total",1244,617,627,1244,0,15,31.93,39.0
"2011","Tamworth 005A","E01029833","Total",1693,865,828,1693,0,26,35.12,48.2
"2011","Tamworth 005B","E01029837","Total",1591,793,798,1591,0,11,158.22,10.1
"2011","Tamworth 005C","E01029838","Total",1568,803,765,1568,0,13,62.73,25.0
"2011","Tamworth 005D","E01029839","Total",1235,623,612,1235,0,22,22.80,54.2
"2011","Tamworth 006A","E01029825","Total",1338,675,663,1338,0,7,25.29,52.9
"2011","Tamworth 006B","E01029826","Total",1546,768,778,1546,0,12,38.61,40.0
"2011","Tamworth 006C","E01029827","Total",1457,705,752,1395,62,10,27.14,53.7
"2011","Tamworth 006D","E01029828","Total",1328,636,692,1328,0,8,23.17,57.3
"2011","Tamworth 006E","E01029830","Total",1190,568,622,1164,26,2,18.84,63.2
"2011","Tamworth 007A","E01029840","Total",1360,670,690,1360,0,6,28.55,47.6
"2011","Tamworth 007B","E01029842","Total",1354,644,710,1354,0,6,19.21,70.5
"2011","Tamworth 007C","E01029843","Total",1497,728,769,1497,0,1,27.19,55.1
"2011","Tamworth 007D","E01029845","Total",1113,506,607,1113,0,1,17.86,62.3
"2011","Tamworth 007E","E01029859","Total",1846,906,940,1834,12,8,30.05,61.4
"2011","Tamworth 008A","E01029855","Total",1543,738,805,1543,0,11,44.49,34.7
"2011","Tamworth 008B","E01029856","Total",1465,739,726,1465,0,9,43.79,33.5
"2011","Tamworth 008C","E01029857","Total",1418,711,707,1418,0,10,50.88,27.9
"2011","Tamworth 008D","E01029858","Total",1590,768,822,1590,0,16,30.37,52.4
"2011","Tamworth 008E","E01029865","Total",1676,831,845,1676,0,23,76.89,21.8
"2011","Tamworth 009A","E01029860","Total",1329,679,650,1329,0,11,23.61,56.3
"2011","Tamworth 009B","E01029861","Total",1348,639,709,1348,0,19,70.62,19.1
"2011","Tamworth 009C","E01029862","Total",1340,660,680,1340,0,18,110.01,12.2
"2011","Tamworth 009D","E01029863","Total",1753,888,865,1753,0,20,36.71,47.8
"2011","Tamworth 009E","E01029864","Total",1605,799,806,1605,0,27,52.98,30.3
"2011","Tamworth 010A","E01029829","Total",1995,1004,991,1995,0,9,77.55,25.7
"2011","Tamworth 010C","E01029867","Total",1675,829,846,1675,0,11,36.79,45.5
"2011","Tamworth 010D","E01029868","Total",1430,711,719,1430,0,27,41.86,34.2
"2011","Tamworth 010E","E01029869","Total",1618,805,813,1618,0,22,45.36,35.7
"2011","Tamworth 010F","E01032901","Total",1607,790,817,1607,0,15,101.41,15.8
"2011","Tamworth 010G","E01032902","Total",1352,656,696,1332,20,6,59.61,22.7
"2011","North Warwickshire 001A","E01031035","Total",1977,965,1012,1900,77,24,1368.61,1.4
"2011","North Warwickshire 001B","E01031036","Total",1527,758,769,1527,0,53,1770.55,0.9
"2011","North Warwickshire 001C","E01031037","Total",1500,738,762,1490,10,12,350.75,4.3
"2011","North Warwickshire 001D","E01031038","Total",2017,996,1021,2002,15,23,187.66,10.7
"2011","North Warwickshire 001E","E01031039","Total",1692,844,848,1692,0,17,35.51,47.6
"2011","North Warwickshire 001F","E01031040","Total",1773,881,892,1773,0,21,274.13,6.5
"2011","North Warwickshire 002A","E01031016","Total",1571,765,806,1571,0,12,423.81,3.7
"2011","North Warwickshire 002B","E01031025","Total",1601,780,821,1553,48,16,802.65,2.0
"2011","North Warwickshire 002C","E01031026","Total",1614,800,814,1614,0,19,67.69,23.8
"2011","North Warwickshire 002D","E01031031","Total",2583,1299,1284,2583,0,15,1753.76,1.5
"2011","North Warwickshire 002E","E01031032","Total",1339,667,672,1339,0,9,308.41,4.3
"2011","North Warwickshire 003A","E01031009","Total",2192,1096,1096,2184,8,13,74.19,29.5
"2011","North Warwickshire 003B","E01031010","Total",1753,891,862,1722,31,6,33.79,51.9
"2011","North Warwickshire 003C","E01031011","Total",1966,960,1006,1955,11,32,145.05,13.6
"2011","North Warwickshire 003D","E01031012","Total",1442,680,762,1418,24,4,115.24,12.5
"2011","North Warwickshire 003E","E01031013","Total",1043,504,539,1043,0,13,36.84,28.3
"2011","North Warwickshire 003F","E01031014","Total",1204,606,598,1204,0,20,296.98,4.1
"2011","North Warwickshire 003G","E01031015","Total",1403,693,710,1403,0,5,537.30,2.6
"2011","North Warwickshire 004A","E01031023","Total",1578,801,777,1578,0,22,1734.31,0.9
"2011","North Warwickshire 004B","E01031024","Total",1617,815,802,1617,0,30,2922.96,0.6
"2011","North Warwickshire 004C","E01031033","Total",1851,883,968,1851,0,13,91.63,20.2
"2011","North Warwickshire 004D","E01031034","Total",1879,945,934,1879,0,24,246.37,7.6
"2011","North Warwickshire 005A","E01031005","Total",1429,711,718,1429,0,12,556.08,2.6
"2011","North Warwickshire 005B","E01031008","Total",1353,666,687,1353,0,4,675.09,2.0
"2011","North Warwickshire 005C","E01031017","Total",1283,647,636,1283,0,18,911.34,1.4
"2011","North Warwickshire 005D","E01031018","Total",1137,556,581,1093,44,21,1568.48,0.7
"2011","North Warwickshire 005E","E01031029","Total",1503,720,783,1460,43,10,142.01,10.6
"2011","North Warwickshire 005F","E01031030","Total",2235,1078,1157,2227,8,24,781.30,2.9
"2011","North Warwickshire 006A","E01031019","Total",1709,839,870,1709,0,10,451.52,3.8
"2011","North Warwickshire 006B","E01031020","Total",1524,733,791,1524,0,12,195.18,7.8
"2011","North Warwickshire 006C","E01031021","Total",1572,741,831,1540,32,20,115.90,13.6
"2011","North Warwickshire 006D","E01031022","Total",1676,813,863,1596,80,18,716.46,2.3
"2011","North Warwickshire 006E","E01031041","Total",1711,835,876,1677,34,15,114.52,14.9
"2011","North Warwickshire 006F","E01031042","Total",1733,848,885,1733,0,28,137.46,12.6
"2011","North Warwickshire 007A","E01031006","Total",1471,734,737,1471,0,7,145.40,10.1
"2011","North Warwickshire 007B","E01031007","Total",1218,613,605,1218,0,16,1304.10,0.9
"2011","North Warwickshire 007C","E01031027","Total",1472,742,730,1402,70,12,2110.11,0.7
"2011","North Warwickshire 007D","E01031028","Total",1866,961,905,1855,11,26,4923.55,0.4
"2011","Nuneaton and Bedworth 001A","E01031110","Total",1525,723,802,1506,19,30,140.24,10.9
"2011","Nuneaton and Bedworth 001B","E01031111","Total",1122,569,553,1122,0,29,71.18,15.8
"2011","Nuneaton and Bedworth 001C","E01031112","Total",1636,794,842,1623,13,24,52.90,30.9
"2011","Nuneaton and Bedworth 001D","E01031113","Total",1466,712,754,1462,4,19,293.06,5.0
"2011","Nuneaton and Bedworth 001E","E01031114","Total",1507,723,784,1507,0,17,54.39,27.7
"2011","Nuneaton and Bedworth 002C","E01031073","Total",1884,925,959,1884,0,9,80.28,23.5
"2011","Nuneaton and Bedworth 002D","E01031074","Total",1550,788,762,1550,0,8,29.33,52.8
"2011","Nuneaton and Bedworth 002E","E01031075","Total",1646,773,873,1646,0,6,110.91,14.8
"2011","Nuneaton and Bedworth 002F","E01032890","Total",2241,1043,1198,2195,46,4,64.57,34.7
"2011","Nuneaton and Bedworth 003A","E01031100","Total",1357,695,662,1357,0,32,52.58,25.8
"2011","Nuneaton and Bedworth 003B","E01031101","Total",1442,720,722,1442,0,46,35.09,41.1
"2011","Nuneaton and Bedworth 003C","E01031102","Total",1364,685,679,1319,45,19,66.89,20.4
"2011","Nuneaton and Bedworth 003D","E01031103","Total",1333,685,648,1305,28,26,239.75,5.6
"2011","Nuneaton and Bedworth 003E","E01031104","Total",1447,667,780,1440,7,26,59.08,24.5
"2011","Nuneaton and Bedworth 004A","E01031081","Total",1693,828,865,1693,0,16,39.79,42.5
"2011","Nuneaton and Bedworth 004B","E01031082","Total",1386,721,665,1386,0,33,36.07,38.4
"2011","Nuneaton and Bedworth 004C","E01031083","Total",1552,780,772,1552,0,8,299.34,5.2
"2011","Nuneaton and Bedworth 004D","E01031084","Total",2227,1087,1140,2227,0,13,57.21,38.9
"2011","Nuneaton and Bedworth 004E","E01031085","Total",1375,690,685,1375,0,20,25.04,54.9
"2011","Nuneaton and Bedworth 005A","E01031043","Total",1647,868,779,1644,3,10,68.98,23.9
"2011","Nuneaton and Bedworth 005B","E01031044","Total",1680,822,858,1664,16,8,51.07,32.9
"2011","Nuneaton and Bedworth 005C","E01031045","Total",1729,855,874,1693,36,7,39.01,44.3
"2011","Nuneaton and Bedworth 005D","E01031046","Total",1728,865,863,1728,0,23,22.85,75.6
"2011","Nuneaton and Bedworth 005E","E01031047","Total",1934,964,970,1934,0,24,17.07,113.3
"2011","Nuneaton and Bedworth 006A","E01031057","Total",1566,785,781,1566,0,6,52.77,29.7
"2011","Nuneaton and Bedworth 006B","E01031058","Total",1453,702,751,1453,0,10,33.05,44.0
"2011","Nuneaton and Bedworth 006C","E01031059","Total",1470,734,736,1470,0,9,43.63,33.7
"2011","Nuneaton and Bedworth 006D","E01031060","Total",1442,718,724,1442,0,11,23.60,61.1
"2011","Nuneaton and Bedworth 006E","E01031061","Total",1521,748,773,1521,0,19,25.10,60.6
"2011","Nuneaton and Bedworth 007A","E01031090","Total",1447,703,744,1447,0,9,107.39,13.5
"2011","Nuneaton and Bedworth 007B","E01031091","Total",1455,688,767,1450,5,8,35.42,41.1
"2011","Nuneaton and Bedworth 007C","E01031092","Total",1466,734,732,1466,0,7,25.79,56.8
"2011","Nuneaton and Bedworth 007D","E01031093","Total",1348,679,669,1348,0,7,19.34,69.7
"2011","Nuneaton and Bedworth 007E","E01031094","Total",1162,575,587,1162,0,2,15.00,77.5
"2011","Nuneaton and Bedworth 008A","E01031048","Total",1265,623,642,1265,0,9,19.69,64.2
"2011","Nuneaton and Bedworth 008B","E01031049","Total",2258,1109,1149,2209,49,28,82.55,27.4
"2011","Nuneaton and Bedworth 008C","E01031050","Total",1838,948,890,1824,14,15,1070.83,1.7
"2011","Nuneaton and Bedworth 008D","E01031051","Total",1375,654,721,1368,7,14,20.81,66.1
"2011","Nuneaton and Bedworth 009A","E01031115","Total",1762,867,895,1755,7,16,22.19,79.4
"2011","Nuneaton and Bedworth 009B","E01031116","Total",1690,795,895,1679,11,5,86.02,19.6
"2011","Nuneaton and Bedworth 009C","E01031117","Total",1502,704,798,1472,30,10,62.26,24.1
"2011","Nuneaton and Bedworth 009D","E01031118","Total",1202,573,629,1202,0,2,164.94,7.3
"2011","Nuneaton and Bedworth 009E","E01031119","Total",1631,846,785,1613,18,14,34.78,46.9
"2011","Nuneaton and Bedworth 010A","E01031052","Total",1512,728,784,1512,0,10,24.61,61.4
"2011","Nuneaton and Bedworth 010B","E01031053","Total",1441,672,769,1338,103,13,32.40,44.5
"2011","Nuneaton and Bedworth 010C","E01031054","Total",1569,767,802,1561,8,18,38.39,40.9
"2011","Nuneaton and Bedworth 010D","E01031055","Total",1654,817,837,1654,0,20,26.69,62.0
"2011","Nuneaton and Bedworth 010E","E01031056","Total",1500,729,771,1500,0,15,71.99,20.8
"2011","Nuneaton and Bedworth 011A","E01031120","Total",1395,678,717,1395,0,22,96.53,14.5
"2011","Nuneaton and Bedworth 011B","E01031121","Total",1203,593,610,1202,1,35,60.83,19.8
"2011","Nuneaton and Bedworth 011C","E01031122","Total",1482,716,766,1482,0,29,29.87,49.6
"2011","Nuneaton and Bedworth 011D","E01031123","Total",1260,642,618,1260,0,32,289.63,4.4
"2011","Nuneaton and Bedworth 011E","E01031124","Total",1537,764,773,1537,0,29,75.25,20.4
"2011","Nuneaton and Bedworth 012A","E01031105","Total",1434,700,734,1398,36,2,34.60,41.4
"2011","Nuneaton and Bedworth 012B","E01031106","Total",1437,714,723,1437,0,16,53.72,26.7
"2011","Nuneaton and Bedworth 012C","E01031107","Total",1158,579,579,1158,0,6,11.89,97.4
"2011","Nuneaton and Bedworth 012D","E01031108","Total",1389,705,684,1389,0,16,316.24,4.4
"2011","Nuneaton and Bedworth 012E","E01031109","Total",1623,802,821,1623,0,13,32.46,50.0
"2011","Nuneaton and Bedworth 013A","E01031062","Total",1237,607,630,1237,0,12,20.78,59.5
"2011","Nuneaton and Bedworth 013B","E01031063","Total",1310,644,666,1304,6,6,22.49,58.2
"2011","Nuneaton and Bedworth 013C","E01031064","Total",1202,571,631,1164,38,4,41.79,28.8
"2011","Nuneaton and Bedworth 013D","E01031065","Total",1525,727,798,1494,31,15,46.73,32.6
"2011","Nuneaton and Bedworth 013E","E01031066","Total",1392,647,745,1392,0,7,26.41,52.7
"2011","Nuneaton and Bedworth 014A","E01031067","Total",1487,733,754,1487,0,18,43.35,34.3
"2011","Nuneaton and Bedworth 014B","E01031068","Total",1692,830,862,1686,6,6,265.38,6.4
"2011","Nuneaton and Bedworth 014C","E01031069","Total",1476,720,756,1475,1,19,303.70,4.9
"2011","Nuneaton and Bedworth 014D","E01031070","Total",1491,719,772,1489,2,12,758.04,2.0
"2011","Nuneaton and Bedworth 015A","E01031095","Total",1247,626,621,1247,0,6,41.26,30.2
"2011","Nuneaton and Bedworth 015B","E01031096","Total",1380,680,700,1380,0,20,44.12,31.3
"2011","Nuneaton and Bedworth 015C","E01031097","Total",1653,816,837,1644,9,8,70.14,23.6
"2011","Nuneaton and Bedworth 015D","E01031098","Total",1493,736,757,1493,0,9,47.93,31.1
"2011","Nuneaton and Bedworth 015E","E01031099","Total",2270,1144,1126,2270,0,17,117.92,19.3
"2011","Nuneaton and Bedworth 016A","E01031086","Total",1873,938,935,1827,46,20,164.07,11.4
"2011","Nuneaton and Bedworth 016B","E01031087","Total",2211,1080,1131,2210,1,29,41.67,53.1
"2011","Nuneaton and Bedworth 016C","E01031088","Total",1942,933,1009,1942,0,11,54.90,35.4
"2011","Nuneaton and Bedworth 016D","E01031089","Total",1447,671,776,1445,2,9,79.01,18.3
"2011","Nuneaton and Bedworth 018A","E01031077","Total",1448,690,758,1448,0,0,69.21,20.9
"2011","Nuneaton and Bedworth 018B","E01031078","Total",2077,1015,1062,2006,71,21,172.29,12.1
"2011","Nuneaton and Bedworth 018C","E01031079","Total",1476,732,744,1476,0,4,41.02,36.0
"2011","Nuneaton and Bedworth 018D","E01031080","Total",1623,743,880,1517,106,19,72.73,22.3
"2011","Nuneaton and Bedworth 018E","E01032588","Total",1382,666,716,1365,17,15,203.26,6.8
"2011","Rugby 001B","E01031129","Total",1148,549,599,1125,23,8,261.44,4.4
"2011","Rugby 001C","E01031159","Total",1642,816,826,1642,0,31,3468.68,0.5
"2011","Rugby 001D","E01031160","Total",2134,1097,1037,2134,0,31,3911.43,0.5
"2011","Rugby 001E","E01031182","Total",2410,1327,1083,2128,282,56,4501.98,0.5
"2011","Rugby 001F","E01032891","Total",1684,859,825,1681,3,28,42.67,39.5
"2011","Rugby 001G","E01032892","Total",2086,1009,1077,1919,167,26,3632.55,0.6
"2011","Rugby 002A","E01031137","Total",1167,581,586,1167,0,10,26.40,44.2
"2011","Rugby 002B","E01031138","Total",1196,577,619,1196,0,28,23.09,51.8
"2011","Rugby 002C","E01031139","Total",1844,918,926,1838,6,36,34.32,53.7
"2011","Rugby 002D","E01031140","Total",1369,677,692,1369,0,24,23.16,59.1
"2011","Rugby 002E","E01031141","Total",1799,892,907,1799,0,21,178.99,10.1
"2011","Rugby 002F","E01031142","Total",1672,824,848,1672,0,8,48.52,34.5
"2011","Rugby 003A","E01031171","Total",1505,760,745,1491,14,13,114.74,13.1
"2011","Rugby 003B","E01031172","Total",1667,809,858,1667,0,13,156.48,10.7
"2011","Rugby 003C","E01031173","Total",1858,971,887,1788,70,13,41.37,44.9
"2011","Rugby 003D","E01031174","Total",1724,886,838,1709,15,10,45.44,37.9
"2011","Rugby 004A","E01031151","Total",1561,805,756,1554,7,20,212.41,7.3
"2011","Rugby 004B","E01031152","Total",1104,548,556,1104,0,11,80.32,13.7
"2011","Rugby 004C","E01031153","Total",1456,713,743,1416,40,28,1091.58,1.3
"2011","Rugby 004D","E01031154","Total",1751,869,882,1750,1,26,1015.00,1.7
"2011","Rugby 004E","E01031181","Total",1813,913,900,1812,1,25,919.70,2.0
"2011","Rugby 005A","E01031130","Total",1764,903,861,1764,0,17,72.16,24.4
"2011","Rugby 005B","E01031131","Total",1642,879,763,1629,13,16,14.17,115.9
"2011","Rugby 005C","E01031132","Total",1942,1003,939,1911,31,33,27.33,71.1
"2011","Rugby 005D","E01031133","Total",1589,826,763,1589,0,18,75.89,20.9
"2011","Rugby 006A","E01031167","Total",1378,686,692,1346,32,21,41.42,33.3
"2011","Rugby 006B","E01031168","Total",2766,1327,1439,2766,0,20,204.28,13.5
"2011","Rugby 006C","E01031169","Total",2003,1040,963,2003,0,13,40.95,48.9
"2011","Rugby 006D","E01031170","Total",1613,822,791,1606,7,12,18.18,88.7
"2011","Rugby 007A","E01031125","Total",1472,748,724,1472,0,22,28.69,51.3
"2011","Rugby 007C","E01031127","Total",1580,786,794,1580,0,16,33.07,47.8
"2011","Rugby 007D","E01031164","Total",2003,998,1005,2000,3,28,517.87,3.9
"2011","Rugby 007E","E01031165","Total",1595,802,793,1595,0,24,1530.27,1.0
"2011","Rugby 007F","E01032893","Total",1872,923,949,1872,0,46,51.99,36.0
"2011","Rugby 007G","E01032894","Total",1362,668,694,1362,0,14,84.92,16.0
"2011","Rugby 007H","E01032895","Total",1440,721,719,1440,0,23,31.16,46.2
"2011","Rugby 008A","E01031155","Total",1408,692,716,1408,0,34,42.49,33.1
"2011","Rugby 008B","E01031156","Total",1466,719,747,1464,2,17,28.97,50.6
"2011","Rugby 008C","E01031157","Total",1956,970,986,1956,0,38,52.19,37.5
"2011","Rugby 008D","E01031158","Total",1085,554,531,1085,0,15,60.38,18.0
"2011","Rugby 009A","E01031143","Total",1526,779,747,1526,0,28,388.34,3.9
"2011","Rugby 009B","E01031144","Total",1288,632,656,1235,53,33,41.71,30.9
"2011","Rugby 009C","E01031145","Total",1526,788,738,888,638,35,63.67,24.0
"2011","Rugby 009D","E01031146","Total",1525,737,788,1472,53,22,45.97,33.2
"2011","Rugby 010A","E01031161","Total",2006,1024,982,1962,44,7,74.64,26.9
"2011","Rugby 010B","E01031162","Total",1727,854,873,1727,0,19,200.64,8.6
"2011","Rugby 010C","E01031163","Total",1543,760,783,1527,16,22,74.21,20.8
"2011","Rugby 010D","E01031179","Total",1730,861,869,1730,0,30,181.17,9.5
"2011","Rugby 010E","E01031180","Total",2018,1002,1016,2018,0,21,42.54,47.4
"2011","Rugby 011A","E01031134","Total",1685,799,886,1658,27,36,64.39,26.2
"2011","Rugby 011B","E01031135","Total",1607,765,842,1607,0,15,53.55,30.0
"2011","Rugby 011C","E01031136","Total",1719,794,925,1620,99,21,44.51,38.6
"2011","Rugby 011D","E01031175","Total",1460,700,760,1351,109,25,48.80,29.9
"2011","Rugby 011E","E01031176","Total",1490,729,761,1490,0,12,41.52,35.9
"2011","Rugby 011F","E01031177","Total",1442,684,758,1442,0,15,22.01,65.5
"2011","Rugby 011G","E01031178","Total",1398,681,717,1386,12,18,32.26,43.3
"2011","Rugby 012A","E01031147","Total",1576,759,817,1529,47,30,1701.10,0.9
"2011","Rugby 012B","E01031148","Total",1730,843,887,1654,76,54,178.88,9.7
"2011","Rugby 012C","E01031149","Total",1486,735,751,1483,3,41,2369.44,0.6
"2011","Rugby 012D","E01031150","Total",1159,571,588,1158,1,26,776.14,1.5
"2011","Rugby 012E","E01031166","Total",1908,920,988,1908,0,46,5879.27,0.3
"2011","Stratford-on-Avon 001A","E01031213","Total",1858,930,928,1836,22,26,3714.05,0.5
"2011","Stratford-on-Avon 001B","E01031243","Total",1960,982,978,1960,0,46,1269.67,1.5
"2011","Stratford-on-Avon 001C","E01031244","Total",1861,886,975,1817,44,44,3154.37,0.6
"2011","Stratford-on-Avon 002A","E01031195","Total",2274,1081,1193,2245,29,65,2461.37,0.9
"2011","Stratford-on-Avon 002B","E01031202","Total",1557,751,806,1554,3,27,138.57,11.2
"2011","Stratford-on-Avon 002C","E01031203","Total",1507,713,794,1507,0,32,628.90,2.4
"2011","Stratford-on-Avon 002D","E01031204","Total",1318,637,681,1318,0,18,1926.58,0.7
"2011","Stratford-on-Avon 003A","E01031239","Total",1570,773,797,1570,0,14,664.98,2.4
"2011","Stratford-on-Avon 003B","E01031240","Total",1364,649,715,1330,34,12,39.04,34.9
"2011","Stratford-on-Avon 003C","E01031241","Total",1433,708,725,1430,3,21,54.86,26.1
"2011","Stratford-on-Avon 003D","E01031242","Total",1512,729,783,1494,18,17,102.75,14.7
"2011","Stratford-on-Avon 004A","E01031219","Total",1507,744,763,1507,0,33,245.14,6.1
"2011","Stratford-on-Avon 004B","E01031220","Total",1529,744,785,1529,0,23,34.99,43.7
"2011","Stratford-on-Avon 004C","E01031221","Total",1532,711,821,1532,0,12,112.65,13.6
"2011","Stratford-on-Avon 004D","E01031222","Total",1999,1007,992,1923,76,32,869.11,2.3
"2011","Stratford-on-Avon 004E","E01031223","Total",1347,693,654,1347,0,24,560.52,2.4
"2011","Stratford-on-Avon 004F","E01031224","Total",1144,567,577,1144,0,36,2496.76,0.5
"2011","Stratford-on-Avon 005A","E01031197","Total",1202,591,611,1202,0,41,5363.06,0.2
"2011","Stratford-on-Avon 005B","E01031198","Total",1283,626,657,1283,0,20,2257.69,0.6
"2011","Stratford-on-Avon 005C","E01031199","Total",1476,735,741,1460,16,28,3830.41,0.4
"2011","Stratford-on-Avon 005D","E01031200","Total",1583,790,793,1583,0,14,114.88,13.8
"2011","Stratford-on-Avon 005E","E01031201","Total",1566,747,819,1566,0,26,113.22,13.8
"2011","Stratford-on-Avon 005F","E01031210","Total",1258,613,645,1258,0,25,1898.55,0.7
"2011","Stratford-on-Avon 005G","E01031211","Total",1074,514,560,1049,25,18,796.29,1.3
"2011","Stratford-on-Avon 006A","E01031183","Total",1648,803,845,1648,0,26,1362.61,1.2
"2011","Stratford-on-Avon 006B","E01031184","Total",1519,756,763,1507,12,50,637.14,2.4
"2011","Stratford-on-Avon 006C","E01031185","Total",1370,645,725,1370,0,7,43.41,31.6
"2011","Stratford-on-Avon 006D","E01031186","Total",1546,728,818,1498,48,17,47.62,32.5
"2011","Stratford-on-Avon 007A","E01031187","Total",1886,917,969,1881,5,38,3327.53,0.6
"2011","Stratford-on-Avon 007B","E01031188","Total",2228,1095,1133,2213,15,56,3234.37,0.7
"2011","Stratford-on-Avon 007C","E01031208","Total",2068,1011,1057,1977,91,46,1423.89,1.5
"2011","Stratford-on-Avon 008A","E01031217","Total",1201,582,619,1201,0,29,794.85,1.5
"2011","Stratford-on-Avon 008B","E01031218","Total",1200,617,583,1172,28,35,3757.63,0.3
"2011","Stratford-on-Avon 008C","E01031249","Total",1201,549,652,1201,0,9,36.90,32.5
"2011","Stratford-on-Avon 008D","E01031250","Total",1476,709,767,1476,0,19,831.74,1.8
"2011","Stratford-on-Avon 008E","E01031251","Total",1199,575,624,1199,0,22,26.64,45.0
"2011","Stratford-on-Avon 008F","E01031252","Total",1365,639,726,1161,204,63,2343.07,0.6
"2011","Stratford-on-Avon 008G","E01031253","Total",1522,729,793,1522,0,23,50.95,29.9
"2011","Stratford-on-Avon 009A","E01031228","Total",1589,787,802,1589,0,29,345.29,4.6
"2011","Stratford-on-Avon 009B","E01031229","Total",1822,857,965,1751,71,12,78.51,23.2
"2011","Stratford-on-Avon 009C","E01031230","Total",2406,1209,1197,2406,0,31,105.70,22.8
"2011","Stratford-on-Avon 009D","E01031231","Total",2146,1055,1091,2098,48,18,65.03,33.0
"2011","Stratford-on-Avon 009E","E01031236","Total",1605,798,807,1573,32,10,34.27,46.8
"2011","Stratford-on-Avon 009F","E01031238","Total",1333,671,662,1325,8,11,55.49,24.0
"2011","Stratford-on-Avon 010A","E01031225","Total",1641,781,860,1590,51,45,94.51,17.4
"2011","Stratford-on-Avon 010C","E01031227","Total",2007,943,1064,1961,46,35,371.21,5.4
"2011","Stratford-on-Avon 010D","E01033250","Total",1394,699,695,1394,0,35,19.04,73.2
"2011","Stratford-on-Avon 010E","E01033251","Total",1154,577,577,1154,0,23,1098.59,1.1
"2011","Stratford-on-Avon 010F","E01033252","Total",1291,624,667,1286,5,40,99.71,12.9
"2011","Stratford-on-Avon 011A","E01031232","Total",2440,1155,1285,2325,115,34,64.19,38.0
"2011","Stratford-on-Avon 011B","E01031233","Total",1622,769,853,1622,0,36,159.62,10.2
"2011","Stratford-on-Avon 011C","E01031234","Total",1756,764,992,1669,87,24,46.92,37.4
"2011","Stratford-on-Avon 011D","E01031235","Total",1818,827,991,1801,17,21,84.72,21.5
"2011","Stratford-on-Avon 011E","E01031237","Total",1421,702,719,1412,9,23,33.43,42.5
"2011","Stratford-on-Avon 012A","E01031189","Total",1546,760,786,1456,90,25,1929.67,0.8
"2011","Stratford-on-Avon 012B","E01031190","Total",1750,855,895,1702,48,17,260.68,6.7
"2011","Stratford-on-Avon 012C","E01031191","Total",1851,922,929,1822,29,26,404.86,4.6
"2011","Stratford-on-Avon 012D","E01031192","Total",1904,908,996,1904,0,27,926.06,2.1
"2011","Stratford-on-Avon 012E","E01031248","Total",2172,1059,1113,2170,2,56,2523.15,0.9
"2011","Stratford-on-Avon 013A","E01031194","Total",2412,1209,1203,2317,95,32,4514.75,0.5
"2011","Stratford-on-Avon 013B","E01031205","Total",1585,790,795,1533,52,38,2582.15,0.6
"2011","Stratford-on-Avon 013C","E01031206","Total",1476,713,763,1422,54,39,784.65,1.9
"2011","Stratford-on-Avon 013D","E01031207","Total",1259,622,637,1257,2,17,851.34,1.5
"2011","Stratford-on-Avon 013E","E01031247","Total",2287,1115,1172,2287,0,64,5376.87,0.4
"2011","Stratford-on-Avon 014A","E01031196","Total",2402,1198,1204,2395,7,63,3804.53,0.6
"2011","Stratford-on-Avon 014B","E01031212","Total",2648,1274,1374,2614,34,43,3698.57,0.7
"2011","Stratford-on-Avon 014C","E01031245","Total",1219,569,650,1219,0,29,2142.60,0.6
"2011","Stratford-on-Avon 014D","E01031246","Total",1089,544,545,1077,12,41,2167.51,0.5
"2011","Stratford-on-Avon 015A","E01031193","Total",2143,1036,1107,2143,0,60,6409.37,0.3
"2011","Stratford-on-Avon 015B","E01031209","Total",2116,1028,1088,2112,4,59,5393.93,0.4
"2011","Stratford-on-Avon 015C","E01031214","Total",1827,893,934,1827,0,44,332.99,5.5
"2011","Stratford-on-Avon 015D","E01031215","Total",1736,815,921,1730,6,15,109.82,15.8
"2011","Stratford-on-Avon 015E","E01031216","Total",1475,693,782,1440,35,23,50.14,29.4
"2011","Warwick 001A","E01031254","Total",1508,737,771,1508,0,34,1606.13,0.9
"2011","Warwick 001B","E01031255","Total",1487,733,754,1487,0,33,38.94,38.2
"2011","Warwick 001C","E01031256","Total",1625,799,826,1623,2,53,94.81,17.1
"2011","Warwick 001D","E01031257","Total",1434,685,749,1381,53,19,24.16,59.4
"2011","Warwick 001E","E01031258","Total",1511,711,800,1502,9,34,37.00,40.8
"2011","Warwick 002A","E01031296","Total",1645,794,851,1645,0,23,39.43,41.7
"2011","Warwick 002B","E01031297","Total",1949,1000,949,1949,0,38,113.19,17.2
"2011","Warwick 002C","E01031298","Total",1654,781,873,1654,0,33,45.87,36.1
"2011","Warwick 002D","E01031299","Total",1424,703,721,1424,0,63,96.43,14.8
"2011","Warwick 002E","E01031300","Total",1716,837,879,1716,0,49,211.49,8.1
"2011","Warwick 003A","E01031303","Total",1498,715,783,1472,26,28,31.58,47.4
"2011","Warwick 003B","E01031304","Total",1505,749,756,1505,0,32,31.03,48.5
"2011","Warwick 003C","E01031305","Total",1521,734,787,1492,29,32,77.94,19.5
"2011","Warwick 003D","E01031306","Total",1494,757,737,1494,0,29,317.94,4.7
"2011","Warwick 003E","E01031307","Total",1445,713,732,1445,0,41,37.98,38.0
"2011","Warwick 004A","E01031281","Total",1485,753,732,1483,2,64,2044.78,0.7
"2011","Warwick 004B","E01031282","Total",1469,737,732,1468,1,35,2118.24,0.7
"2011","Warwick 004C","E01031283","Total",1278,634,644,1270,8,24,1992.63,0.6
"2011","Warwick 004D","E01031284","Total",1232,607,625,1220,12,50,1897.96,0.6
"2011","Warwick 005A","E01031277","Total",1557,762,795,1557,0,22,294.79,5.3
"2011","Warwick 005B","E01031278","Total",1461,712,749,1445,16,32,849.67,1.7
"2011","Warwick 005C","E01031279","Total",1359,645,714,1329,30,14,161.11,8.4
"2011","Warwick 005D","E01031280","Total",1313,639,674,1305,8,35,1662.42,0.8
"2011","Warwick 005E","E01031301","Total",1420,699,721,1420,0,43,2220.46,0.6
"2011","Warwick 005F","E01031302","Total",1022,507,515,1022,0,14,72.53,14.1
"2011","Warwick 005G","E01031308","Total",3496,1758,1738,1843,1653,76,3149.50,1.1
"2011","Warwick 006A","E01031273","Total",1326,709,617,1326,0,6,17.11,77.5
"2011","Warwick 006B","E01031274","Total",1504,700,804,1459,45,24,33.54,44.8
"2011","Warwick 006C","E01031275","Total",1252,608,644,1252,0,10,23.75,52.7
"2011","Warwick 006D","E01031276","Total",1542,762,780,1542,0,12,21.49,71.8
"2011","Warwick 007B","E01031272","Total",1806,903,903,1790,16,32,24.24,74.5
"2011","Warwick 007C","E01031285","Total",2086,1012,1074,2006,80,42,54.40,38.3
"2011","Warwick 007D","E01031286","Total",1463,703,760,1463,0,8,22.71,64.4
"2011","Warwick 007E","E01031287","Total",1561,762,799,1561,0,38,35.54,43.9
"2011","Warwick 007F","E01031288","Total",1710,827,883,1607,103,33,54.23,31.5
"2011","Warwick 007G","E01031289","Total",1525,731,794,1485,40,24,29.26,52.1
"2011","Warwick 007H","E01033253","Total",1446,782,664,1437,9,16,32.60,44.4
"2011","Warwick 007I","E01033256","Total",1265,708,557,1243,22,22,14.58,86.8
"2011","Warwick 008A","E01031309","Total",1726,885,841,1726,0,21,29.26,59.0
"2011","Warwick 008B","E01031310","Total",1344,676,668,1342,2,18,38.01,35.4
"2011","Warwick 008C","E01031311","Total",1360,652,708,1327,33,18,42.97,31.6
"2011","Warwick 008D","E01031312","Total",1192,575,617,1192,0,5,178.38,6.7
"2011","Warwick 008E","E01031313","Total",1358,688,670,1358,0,26,70.58,19.2
"2011","Warwick 008F","E01031314","Total",1338,661,677,1338,0,10,35.15,38.1
"2011","Warwick 009A","E01031290","Total",1666,878,788,1636,30,24,27.69,60.2
"2011","Warwick 009B","E01031291","Total",1563,833,730,1488,75,16,36.97,42.3
"2011","Warwick 009C","E01031292","Total",1495,728,767,1495,0,24,40.14,37.2
"2011","Warwick 009D","E01031293","Total",1679,797,882,1555,124,10,55.49,30.3
"2011","Warwick 009E","E01031294","Total",1581,777,804,1461,120,34,23.82,66.4
"2011","Warwick 009F","E01031295","Total",1182,582,600,1167,15,35,67.46,17.5
"2011","Warwick 010A","E01031271","Total",1749,852,897,1749,0,18,305.80,5.7
"2011","Warwick 010B","E01031332","Total",1398,693,705,1368,30,20,25.94,53.9
"2011","Warwick 010C","E01031333","Total",1353,677,676,1344,9,16,27.37,49.4
"2011","Warwick 010D","E01031334","Total",1522,706,816,1522,0,3,34.42,44.2
"2011","Warwick 010E","E01031335","Total",1475,776,699,1415,60,15,23.54,62.7
"2011","Warwick 010F","E01031336","Total",2143,1146,997,2109,34,15,20.80,103.0
"2011","Warwick 010G","E01031337","Total",1502,795,707,1494,8,15,47.74,31.5
"2011","Warwick 011A","E01031321","Total",1332,678,654,1332,0,9,23.58,56.5
"2011","Warwick 011B","E01031322","Total",1862,943,919,1831,31,8,60.28,30.9
"2011","Warwick 011C","E01031323","Total",1588,773,815,1562,26,20,55.53,28.6
"2011","Warwick 011D","E01031324","Total",2021,1030,991,2017,4,11,113.23,17.8
"2011","Warwick 011E","E01031325","Total",1402,653,749,1400,2,21,24.73,56.7
"2011","Warwick 011G","E01033254","Total",1440,718,722,1440,0,9,24.03,59.9
"2011","Warwick 011H","E01033255","Total",1659,833,826,1656,3,21,495.22,3.4
"2011","Warwick 012A","E01031315","Total",2201,1115,1086,2198,3,44,264.30,8.3
"2011","Warwick 012B","E01031316","Total",1445,678,767,1435,10,21,59.28,24.4
"2011","Warwick 012C","E01031317","Total",1510,729,781,1444,66,39,265.99,5.7
"2011","Warwick 012D","E01031318","Total",1920,957,963,1920,0,28,168.69,11.4
"2011","Warwick 012E","E01031319","Total",1996,987,1009,1952,44,39,43.02,46.4
"2011","Warwick 012F","E01031320","Total",1420,744,676,1417,3,31,54.14,26.2
"2011","Warwick 013A","E01031261","Total",1547,842,705,1547,0,13,38.03,40.7
"2011","Warwick 013B","E01031262","Total",1430,761,669,1430,0,12,42.46,33.7
"2011","Warwick 013C","E01031263","Total",1868,1024,844,1868,0,27,23.46,79.6
"2011","Warwick 013D","E01031264","Total",1699,856,843,1699,0,13,25.18,67.5
"2011","Warwick 013E","E01031265","Total",1439,735,704,1439,0,11,41.84,34.4
"2011","Warwick 013F","E01031266","Total",1948,1108,840,1845,103,11,19.04,102.3
"2011","Warwick 014A","E01031259","Total",1370,681,689,1370,0,45,187.52,7.3
"2011","Warwick 014B","E01031260","Total",1188,593,595,1180,8,15,1257.62,0.9
"2011","Warwick 014C","E01031267","Total",1776,879,897,1776,0,41,1125.84,1.6
"2011","Warwick 014D","E01031268","Total",2732,1346,1386,2732,0,48,859.88,3.2
"2011","Warwick 014E","E01031269","Total",1663,801,862,1663,0,43,1768.86,0.9
"2011","Warwick 015A","E01031327","Total",1531,742,789,1531,0,13,36.66,41.8
"2011","Warwick 015B","E01031328","Total",2208,1072,1136,2184,24,32,101.48,21.8
"2011","Warwick 015C","E01031329","Total",2561,1307,1254,2561,0,30,46.34,55.3
"2011","Warwick 015D","E01031330","Total",1486,728,758,1459,27,25,23.82,62.4
"2011","Warwick 015E","E01031331","Total",1786,852,934,1786,0,24,275.26,6.5
"2011","Birmingham 001A","E01009417","Total",1493,752,741,1492,1,27,35.87,41.6
"2011","Birmingham 001B","E01009418","Total",1471,674,797,1471,0,22,105.52,13.9
"2011","Birmingham 001C","E01009419","Total",1322,644,678,1322,0,24,36.08,36.6
"2011","Birmingham 001D","E01009433","Total",1759,832,927,1759,0,28,54.04,32.5
"2011","Birmingham 002A","E01009415","Total",1638,796,842,1613,25,33,62.05,26.4
"2011","Birmingham 002B","E01009422","Total",1912,918,994,1894,18,34,75.77,25.2
"2011","Birmingham 002C","E01009423","Total",1677,772,905,1677,0,24,129.05,13.0
"2011","Birmingham 002D","E01009425","Total",1693,789,904,1693,0,31,55.01,30.8
"2011","Birmingham 003A","E01009416","Total",2669,1293,1376,2669,0,55,327.95,8.1
"2011","Birmingham 003B","E01009420","Total",1537,753,784,1537,0,26,30.21,50.9
"2011","Birmingham 003C","E01009426","Total",1449,694,755,1449,0,29,77.86,18.6
"2011","Birmingham 003D","E01009429","Total",1497,736,761,1493,4,30,63.21,23.7
"2011","Birmingham 003E","E01009431","Total",1583,789,794,1583,0,40,43.74,36.2
"2011","Birmingham 004A","E01009421","Total",1635,791,844,1635,0,64,299.57,5.5
"2011","Birmingham 004B","E01009424","Total",1520,727,793,1456,64,24,644.78,2.4
"2011","Birmingham 004C","E01009427","Total",1494,733,761,1494,0,42,86.75,17.2
"2011","Birmingham 004D","E01009428","Total",1644,792,852,1644,0,50,76.73,21.4
"2011","Birmingham 004E","E01009430","Total",1631,786,845,1609,22,58,96.20,17.0
"2011","Birmingham 004F","E01009468","Total",1513,716,797,1473,40,38,107.95,14.0
"2011","Birmingham 005A","E01009445","Total",1682,770,912,1682,0,8,28.74,58.5
"2011","Birmingham 005B","E01009446","Total",2432,1161,1271,2404,28,26,48.89,49.7
"2011","Birmingham 005C","E01009447","Total",1601,786,815,1601,0,18,37.31,42.9
"2011","Birmingham 005D","E01009448","Total",1631,773,858,1631,0,15,78.77,20.7
"2011","Birmingham 005E","E01009452","Total",1657,766,891,1645,12,31,36.20,45.8
"2011","Birmingham 005F","E01009455","Total",1323,642,681,1322,1,20,20.50,64.5
"2011","Birmingham 006A","E01009432","Total",1508,748,760,1508,0,27,86.90,17.4
"2011","Birmingham 006B","E01009435","Total",1826,880,946,1826,0,43,60.41,30.2
"2011","Birmingham 006C","E01009437","Total",1785,851,934,1780,5,21,112.81,15.8
"2011","Birmingham 006D","E01009444","Total",1538,759,779,1538,0,25,40.51,38.0
"2011","Birmingham 006E","E01009454","Total",1511,764,747,1511,0,27,42.07,35.9
"2011","Birmingham 007A","E01009221","Total",1483,728,755,1483,0,10,36.25,40.9
"2011","Birmingham 007B","E01009464","Total",1385,704,681,1385,0,17,42.25,32.8
"2011","Birmingham 007C","E01009465","Total",1381,692,689,1378,3,20,38.25,36.1
"2011","Birmingham 007D","E01009467","Total",1559,731,828,1559,0,23,35.61,43.8
"2011","Birmingham 008A","E01009220","Total",1560,757,803,1560,0,10,24.09,64.8
"2011","Birmingham 008B","E01009222","Total",1576,744,832,1576,0,2,32.91,47.9
"2011","Birmingham 008C","E01009224","Total",1469,670,799,1469,0,13,22.41,65.6
"2011","Birmingham 008D","E01009233","Total",1534,722,812,1534,0,8,27.45,55.9
"2011","Birmingham 009A","E01009449","Total",1829,885,944,1815,14,40,76.01,24.1
"2011","Birmingham 009B","E01009451","Total",1431,715,716,1431,0,30,42.28,33.8
"2011","Birmingham 009C","E01009453","Total",1467,736,731,1467,0,26,26.84,54.7
"2011","Birmingham 009D","E01009466","Total",1632,807,825,1615,17,52,45.43,35.9
"2011","Birmingham 009E","E01009471","Total",1817,859,958,1674,143,50,45.51,39.9
"2011","Birmingham 010A","E01009135","Total",1450,716,734,1422,28,14,45.91,31.6
"2011","Birmingham 010B","E01009469","Total",1437,721,716,1437,0,24,35.61,40.4
"2011","Birmingham 010C","E01009470","Total",1439,704,735,1439,0,33,35.45,40.6
"2011","Birmingham 010D","E01009472","Total",1659,814,845,1659,0,30,35.35,46.9
"2011","Birmingham 010E","E01009473","Total",1595,769,826,1595,0,15,40.99,38.9
"2011","Birmingham 010F","E01009474","Total",1600,754,846,1590,10,41,37.34,42.8
"2011","Birmingham 011A","E01009127","Total",1571,733,838,1571,0,2,18.24,86.1
"2011","Birmingham 011B","E01009128","Total",1374,674,700,1374,0,12,19.26,71.3
"2011","Birmingham 011C","E01009130","Total",1505,740,765,1505,0,4,21.52,69.9
"2011","Birmingham 011D","E01009131","Total",1448,718,730,1448,0,4,18.95,76.4
"2011","Birmingham 011E","E01009133","Total",1492,711,781,1492,0,2,19.48,76.6
"2011","Birmingham 011F","E01009134","Total",1589,741,848,1560,29,10,27.20,58.4
"2011","Birmingham 011G","E01009137","Total",1606,774,832,1606,0,10,23.78,67.5
"2011","Birmingham 012A","E01009434","Total",1567,768,799,1567,0,33,91.07,17.2
"2011","Birmingham 012B","E01009436","Total",1441,729,712,1441,0,45,44.98,32.0
"2011","Birmingham 012C","E01009438","Total",1450,688,762,1450,0,34,86.68,16.7
"2011","Birmingham 012D","E01009440","Total",1580,734,846,1525,55,21,44.28,35.7
"2011","Birmingham 012E","E01009450","Total",1635,807,828,1635,0,32,873.86,1.9
"2011","Birmingham 013A","E01009223","Total",1527,721,806,1527,0,8,87.84,17.4
"2011","Birmingham 013B","E01009225","Total",1640,743,897,1606,34,4,45.33,36.2
"2011","Birmingham 013C","E01009227","Total",1618,792,826,1618,0,7,27.33,59.2
"2011","Birmingham 013D","E01009228","Total",1657,809,848,1657,0,8,24.34,68.1
"2011","Birmingham 014A","E01009121","Total",2306,1057,1249,2300,6,19,53.93,42.8
"2011","Birmingham 014B","E01009122","Total",1626,784,842,1598,28,8,22.26,73.0
"2011","Birmingham 014C","E01009129","Total",1628,778,850,1628,0,8,26.39,61.7
"2011","Birmingham 014D","E01009132","Total",1560,729,831,1555,5,10,25.40,61.4
"2011","Birmingham 014E","E01009136","Total",1651,775,876,1597,54,10,26.97,61.2
"2011","Birmingham 015A","E01009457","Total",1519,766,753,1519,0,31,71.84,21.1
"2011","Birmingham 015B","E01009459","Total",1649,795,854,1636,13,42,45.10,36.6
"2011","Birmingham 015C","E01009461","Total",1332,644,688,1332,0,28,59.99,22.2
"2011","Birmingham 015D","E01009463","Total",1493,713,780,1458,35,28,53.57,27.9
"2011","Birmingham 016A","E01009235","Total",1607,768,839,1607,0,8,23.35,68.8
"2011","Birmingham 016B","E01009243","Total",1518,739,779,1518,0,8,44.44,34.2
"2011","Birmingham 016C","E01009245","Total",1453,706,747,1449,4,8,26.47,54.9
"2011","Birmingham 016D","E01009246","Total",1581,776,805,1577,4,10,24.41,64.8
"2011","Birmingham 016E","E01009247","Total",1504,719,785,1504,0,18,22.98,65.4
"2011","Birmingham 017A","E01009226","Total",1486,721,765,1458,28,2,30.85,48.2
"2011","Birmingham 017B","E01009229","Total",1578,759,819,1578,0,8,24.87,63.4
"2011","Birmingham 017C","E01009230","Total",1512,757,755,1508,4,12,32.40,46.7
"2011","Birmingham 017D","E01009231","Total",1879,928,951,1879,0,9,37.09,50.7
"2011","Birmingham 018A","E01009001","Total",1529,759,770,1529,0,9,32.36,47.2
"2011","Birmingham 018B","E01009003","Total",1680,858,822,1549,131,22,34.64,48.5
"2011","Birmingham 018C","E01009456","Total",1690,810,880,1665,25,46,35.70,47.3
"2011","Birmingham 018D","E01009458","Total",1485,687,798,1485,0,15,28.70,51.7
"2011","Birmingham 018E","E01009460","Total",1652,817,835,1638,14,14,27.40,60.3
"2011","Birmingham 018F","E01009462","Total",1680,819,861,1667,13,19,33.39,50.3
"2011","Birmingham 019A","E01009234","Total",1520,733,787,1520,0,8,27.17,55.9
"2011","Birmingham 019B","E01009236","Total",1551,748,803,1551,0,13,25.93,59.8
"2011","Birmingham 019C","E01009244","Total",1436,678,758,1436,0,11,35.63,40.3
"2011","Birmingham 019D","E01009248","Total",1767,845,922,1767,0,11,26.47,66.8
"2011","Birmingham 020A","E01009403","Total",1506,711,795,1506,0,10,21.74,69.3
"2011","Birmingham 020B","E01009404","Total",1552,770,782,1552,0,4,22.33,69.5
"2011","Birmingham 020C","E01009405","Total",1406,689,717,1406,0,10,27.24,51.6
"2011","Birmingham 020D","E01009406","Total",1648,811,837,1648,0,12,33.84,48.7
"2011","Birmingham 020E","E01009407","Total",1717,838,879,1690,27,12,25.59,67.1
"2011","Birmingham 021A","E01009439","Total",1384,696,688,1384,0,24,102.42,13.5
"2011","Birmingham 021B","E01009441","Total",1445,705,740,1445,0,8,520.78,2.8
"2011","Birmingham 021C","E01009442","Total",1472,721,751,1472,0,21,53.68,27.4
"2011","Birmingham 021D","E01009443","Total",1220,571,649,1220,0,19,66.84,18.3
"2011","Birmingham 022A","E01009123","Total",1437,669,768,1437,0,6,56.13,25.6
"2011","Birmingham 022B","E01009124","Total",1607,715,892,1607,0,9,16.11,99.8
"2011","Birmingham 022C","E01009125","Total",1757,825,932,1757,0,7,26.73,65.7
"2011","Birmingham 022D","E01009232","Total",1571,750,821,1490,81,6,101.37,15.5
"2011","Birmingham 023A","E01009002","Total",1470,675,795,1470,0,4,27.55,53.4
"2011","Birmingham 023C","E01009006","Total",1522,747,775,1519,3,11,19.45,78.3
"2011","Birmingham 023D","E01009007","Total",1604,822,782,1604,0,11,40.98,39.1
"2011","Birmingham 023F","E01033632","Total",2286,1112,1174,2245,41,16,45.37,50.4
"2011","Birmingham 024A","E01009237","Total",1468,713,755,1468,0,7,30.43,48.2
"2011","Birmingham 024B","E01009238","Total",1632,790,842,1631,1,20,42.55,38.4
"2011","Birmingham 024C","E01009240","Total",1580,767,813,1580,0,10,51.57,30.6
"2011","Birmingham 024D","E01009241","Total",1707,823,884,1703,4,10,40.85,41.8
"2011","Birmingham 024E","E01009242","Total",1786,876,910,1785,1,15,71.99,24.8
"2011","Birmingham 025A","E01009005","Total",1336,670,666,1286,50,10,26.04,51.3
"2011","Birmingham 025B","E01009009","Total",1472,717,755,1467,5,14,24.66,59.7
"2011","Birmingham 025C","E01009098","Total",2091,1016,1075,2083,8,11,50.89,41.1
"2011","Birmingham 025D","E01009100","Total",2064,945,1119,2040,24,21,66.89,30.9
"2011","Birmingham 025E","E01009105","Total",1613,778,835,1613,0,9,51.66,31.2
"2011","Birmingham 026A","E01009126","Total",1412,695,717,1412,0,5,26.82,52.6
"2011","Birmingham 026B","E01009408","Total",1711,837,874,1711,0,23,25.80,66.3
"2011","Birmingham 026C","E01009409","Total",1641,806,835,1641,0,5,24.30,67.5
"2011","Birmingham 026D","E01009410","Total",1780,874,906,1748,32,6,42.44,41.9
"2011","Birmingham 028A","E01009008","Total",1484,702,782,1484,0,10,40.60,36.6
"2011","Birmingham 028B","E01009011","Total",1760,896,864,1760,0,16,44.84,39.3
"2011","Birmingham 028C","E01009012","Total",1457,734,723,1457,0,13,32.85,44.4
"2011","Birmingham 028D","E01009102","Total",1491,732,759,1491,0,10,191.10,7.8
"2011","Birmingham 028E","E01009104","Total",1585,743,842,1541,44,3,26.65,59.5
"2011","Birmingham 029A","E01009096","Total",1651,778,873,1651,0,1,40.61,40.7
"2011","Birmingham 029B","E01009097","Total",2040,916,1124,1958,82,11,76.95,26.5
"2011","Birmingham 029C","E01009099","Total",1777,797,980,1777,0,9,25.53,69.6
"2011","Birmingham 029D","E01009101","Total",1616,710,906,1553,63,4,116.91,13.8
"2011","Birmingham 029E","E01009103","Total",1536,722,814,1536,0,16,26.43,58.1
"2011","Birmingham 029F","E01009106","Total",1351,659,692,1351,0,5,22.03,61.3
"2011","Birmingham 030A","E01008915","Total",1374,683,691,1374,0,10,59.53,23.1
"2011","Birmingham 030B","E01009411","Total",1818,879,939,1818,0,18,34.11,53.3
"2011","Birmingham 030C","E01009412","Total",1753,866,887,1710,43,15,22.30,78.6
"2011","Birmingham 030D","E01009413","Total",1655,855,800,1652,3,10,25.16,65.8
"2011","Birmingham 030E","E01009414","Total",1912,970,942,1905,7,12,51.77,36.9
"2011","Birmingham 031A","E01008998","Total",1827,877,950,1827,0,14,24.92,73.3
"2011","Birmingham 031B","E01008999","Total",1580,784,796,1545,35,15,30.13,52.4
"2011","Birmingham 031C","E01009000","Total",1710,853,857,1614,96,10,26.29,65.0
"2011","Birmingham 031D","E01009013","Total",1902,938,964,1880,22,15,35.15,54.1
"2011","Birmingham 031E","E01009400","Total",1452,702,750,1404,48,6,68.55,21.2
"2011","Birmingham 031F","E01009401","Total",1668,843,825,1651,17,10,44.84,37.2
"2011","Birmingham 031H","E01033630","Total",1139,587,552,1118,21,5,14.89,76.5
"2011","Birmingham 031I","E01033646","Total",1624,855,769,1544,80,12,29.05,55.9
"2011","Birmingham 032A","E01009049","Total",1631,825,806,1628,3,28,26.54,61.5
"2011","Birmingham 032B","E01009056","Total",2026,1039,987,2026,0,18,62.71,32.3
"2011","Birmingham 032C","E01009263","Total",1629,800,829,1602,27,29,31.63,51.5
"2011","Birmingham 032D","E01009264","Total",1415,678,737,988,427,26,16.79,84.3
"2011","Birmingham 032E","E01009265","Total",1752,871,881,1731,21,16,26.24,66.8
"2011","Birmingham 033A","E01009051","Total",1621,858,763,1620,1,18,27.67,58.6
"2011","Birmingham 033B","E01009053","Total",1481,772,709,1481,0,20,13.55,109.3
"2011","Birmingham 033C","E01009054","Total",1654,820,834,1642,12,20,15.33,107.9
"2011","Birmingham 033D","E01009058","Total",1668,863,805,1668,0,3,10.95,152.3
"2011","Birmingham 033E","E01009061","Total",1816,926,890,1801,15,9,14.47,125.5
"2011","Birmingham 033F","E01009239","Total",1875,861,1014,1195,680,25,258.91,7.2
"2011","Birmingham 034A","E01009266","Total",1711,856,855,1711,0,17,18.94,90.3
"2011","Birmingham 034B","E01009269","Total",1535,762,773,1535,0,15,28.65,53.6
"2011","Birmingham 034C","E01009270","Total",1966,1017,949,1966,0,20,22.59,87.0
"2011","Birmingham 034D","E01009271","Total",1522,738,784,1522,0,7,12.86,118.4
"2011","Birmingham 034E","E01009273","Total",1603,825,778,1603,0,16,16.14,99.3
"2011","Birmingham 035A","E01009050","Total",1826,976,850,1815,11,16,30.23,60.4
"2011","Birmingham 035D","E01009057","Total",2064,1090,974,2057,7,19,18.40,112.2
"2011","Birmingham 035E","E01009059","Total",1800,948,852,1793,7,16,15.76,114.2
"2011","Birmingham 035F","E01009060","Total",1597,814,783,1591,6,27,13.73,116.3
"2011","Birmingham 035G","E01033621","Total",2874,1423,1451,2858,16,27,38.72,74.2
"2011","Birmingham 036A","E01009268","Total",1517,752,765,1517,0,7,18.49,82.0
"2011","Birmingham 036B","E01009272","Total",1401,643,758,1401,0,9,92.08,15.2
"2011","Birmingham 036C","E01009274","Total",2143,1081,1062,2140,3,18,30.48,70.3
"2011","Birmingham 036D","E01009349","Total",1679,817,862,1679,0,20,42.11,39.9
"2011","Birmingham 036E","E01009351","Total",1693,836,857,1693,0,13,11.55,146.6
"2011","Birmingham 036F","E01009354","Total",1471,722,749,1467,4,8,27.56,53.4
"2011","Birmingham 037A","E01008899","Total",1237,611,626,1204,33,4,89.76,13.8
"2011","Birmingham 037C","E01008901","Total",1686,854,832,1686,0,13,86.99,19.4
"2011","Birmingham 037E","E01008916","Total",1531,767,764,1531,0,4,25.22,60.7
"2011","Birmingham 037F","E01033636","Total",3385,1717,1668,3385,0,8,25.08,135.0
"2011","Birmingham 038A","E01009079","Total",1629,819,810,1629,0,11,30.78,52.9
"2011","Birmingham 038B","E01009080","Total",1113,509,604,1113,0,7,26.80,41.5
"2011","Birmingham 038C","E01009081","Total",1301,658,643,1301,0,6,15.13,86.0
"2011","Birmingham 038D","E01009083","Total",1488,653,835,1488,0,16,22.13,67.2
"2011","Birmingham 039A","E01009275","Total",1576,823,753,1576,0,9,16.81,93.8
"2011","Birmingham 039B","E01009350","Total",1562,797,765,1554,8,6,10.96,142.5
"2011","Birmingham 039C","E01009352","Total",1715,895,820,1703,12,4,15.39,111.4
"2011","Birmingham 039D","E01009353","Total",1615,811,804,1615,0,14,11.82,136.6
"2011","Birmingham 039E","E01009355","Total",1575,813,762,1575,0,8,27.20,57.9
"2011","Birmingham 039H","E01033635","Total",2889,1473,1416,2889,0,30,39.77,72.6
"2011","Birmingham 040A","E01008905","Total",1701,835,866,1701,0,8,12.72,133.7
"2011","Birmingham 040B","E01008907","Total",1675,879,796,1630,45,5,16.69,100.4
"2011","Birmingham 040C","E01009047","Total",1804,937,867,1804,0,9,20.10,89.8
"2011","Birmingham 040D","E01009048","Total",1762,966,796,1697,65,2,22.82,77.2
"2011","Birmingham 040E","E01009062","Total",1729,837,892,1729,0,4,13.80,125.3
"2011","Birmingham 041D","E01008909","Total",1633,754,879,1633,0,21,22.81,71.6
"2011","Birmingham 041F","E01033628","Total",2430,1232,1198,2430,0,14,37.82,64.3
"2011","Birmingham 041G","E01033637","Total",2838,1367,1471,2812,26,32,31.12,91.2
"2011","Birmingham 042A","E01009084","Total",1742,816,926,1742,0,5,25.44,68.5
"2011","Birmingham 042B","E01009085","Total",1977,944,1033,1977,0,12,30.75,64.3
"2011","Birmingham 042C","E01009087","Total",1514,768,746,1514,0,7,30.55,49.6
"2011","Birmingham 042D","E01009089","Total",1527,764,763,1527,0,14,35.85,42.6
"2011","Birmingham 042E","E01009090","Total",1857,882,975,1797,60,20,54.63,34.0
"2011","Birmingham 043A","E01009201","Total",1720,820,900,1716,4,8,88.15,19.5
"2011","Birmingham 043B","E01009202","Total",1503,712,791,1503,0,2,92.57,16.2
"2011","Birmingham 043C","E01009203","Total",2837,1394,1443,2837,0,31,92.26,30.8
"2011","Birmingham 044A","E01009082","Total",1411,672,739,1411,0,14,47.42,29.8
"2011","Birmingham 044B","E01009086","Total",1881,932,949,1846,35,13,34.41,54.7
"2011","Birmingham 044C","E01009480","Total",1756,862,894,1756,0,11,24.04,73.0
"2011","Birmingham 044D","E01009481","Total",2289,1115,1174,2289,0,5,25.40,90.1
"2011","Birmingham 044E","E01009486","Total",2018,1008,1010,2004,14,14,23.24,86.8
"2011","Birmingham 044F","E01009487","Total",2205,1057,1148,2165,40,9,21.35,103.3
"2011","Birmingham 045A","E01009088","Total",1610,752,858,1610,0,5,28.39,56.7
"2011","Birmingham 045B","E01009091","Total",1554,725,829,1526,28,1,45.71,34.0
"2011","Birmingham 045C","E01009305","Total",1610,800,810,1610,0,8,32.88,49.0
"2011","Birmingham 045D","E01009307","Total",1529,707,822,1529,0,6,33.63,45.5
"2011","Birmingham 045E","E01009309","Total",1418,637,781,1365,53,2,26.27,54.0
"2011","Birmingham 046A","E01009304","Total",1807,863,944,1807,0,9,34.56,52.3
"2011","Birmingham 046B","E01009306","Total",1550,750,800,1550,0,8,90.85,17.1
"2011","Birmingham 046C","E01009308","Total",1943,877,1066,1943,0,6,35.38,54.9
"2011","Birmingham 046D","E01009310","Total",1861,852,1009,1858,3,10,33.86,55.0
"2011","Birmingham 047A","E01009348","Total",1969,953,1016,1957,12,7,59.22,33.2
"2011","Birmingham 047B","E01009358","Total",2053,1089,964,2009,44,21,36.37,56.4
"2011","Birmingham 047C","E01009359","Total",1968,1017,951,1958,10,12,26.64,73.9
"2011","Birmingham 047D","E01009360","Total",2435,1146,1289,2432,3,7,43.88,55.5
"2011","Birmingham 047E","E01009361","Total",2109,1044,1065,2086,23,14,17.68,119.3
"2011","Birmingham 048A","E01009478","Total",1835,910,925,1835,0,17,57.64,31.8
"2011","Birmingham 048B","E01009479","Total",2206,1113,1093,2190,16,4,71.77,30.7
"2011","Birmingham 048C","E01009482","Total",1721,850,871,1721,0,9,15.67,109.8
"2011","Birmingham 048D","E01009484","Total",1755,903,852,1715,40,14,15.90,110.4
"2011","Birmingham 048E","E01009485","Total",1835,917,918,1835,0,7,28.95,63.4
"2011","Birmingham 049A","E01008906","Total",1780,891,889,1763,17,10,11.17,159.4
"2011","Birmingham 049B","E01008911","Total",1609,788,821,1609,0,12,23.62,68.1
"2011","Birmingham 049D","E01009347","Total",1766,844,922,1752,14,24,37.28,47.4
"2011","Birmingham 049E","E01033559","Total",1263,720,543,1262,1,11,37.68,33.5
"2011","Birmingham 049F","E01033638","Total",1750,865,885,1747,3,18,33.86,51.7
"2011","Birmingham 050A","E01008910","Total",1812,932,880,1812,0,8,48.92,37.0
"2011","Birmingham 050B","E01008913","Total",1481,769,712,1481,0,13,29.05,51.0
"2011","Birmingham 050C","E01008914","Total",2715,1441,1274,2049,666,18,67.07,40.5
"2011","Birmingham 050E","E01033561","Total",2939,1475,1464,1111,1828,50,132.69,22.1
"2011","Birmingham 050F","E01033617","Total",2962,1402,1560,847,2115,64,42.42,69.8
"2011","Birmingham 051A","E01009194","Total",2846,1452,1394,2828,18,22,34.41,82.7
"2011","Birmingham 051B","E01009483","Total",1851,943,908,1851,0,12,32.65,56.7
"2011","Birmingham 051C","E01009488","Total",2163,1055,1108,2157,6,21,28.91,74.8
"2011","Birmingham 051D","E01009489","Total",2001,1016,985,1985,16,19,13.97,143.2
"2011","Birmingham 051E","E01009491","Total",1794,913,881,1794,0,8,14.24,126.0
"2011","Birmingham 052B","E01009192","Total",2749,1376,1373,2743,6,6,20.24,135.8
"2011","Birmingham 052D","E01009199","Total",1415,700,715,1415,0,10,59.52,23.8
"2011","Birmingham 052E","E01009204","Total",1793,907,886,1793,0,10,77.19,23.2
"2011","Birmingham 052F","E01033644","Total",2998,1491,1507,2998,0,24,63.20,47.4
"2011","Birmingham 053A","E01009151","Total",2007,946,1061,2007,0,7,10.85,185.0
"2011","Birmingham 053B","E01009152","Total",2163,1151,1012,2163,0,16,21.76,99.4
"2011","Birmingham 053C","E01009153","Total",2147,1073,1074,2141,6,17,60.10,35.7
"2011","Birmingham 053D","E01009345","Total",2377,1479,898,1497,880,15,50.25,47.3
"2011","Birmingham 053E","E01009346","Total",1682,797,885,1682,0,11,19.73,85.3
"2011","Birmingham 054A","E01009092","Total",1675,745,930,1675,0,7,19.90,84.2
"2011","Birmingham 054B","E01009093","Total",1603,739,864,1603,0,9,24.10,66.5
"2011","Birmingham 054C","E01009094","Total",1434,679,755,1429,5,5,21.95,65.3
"2011","Birmingham 054D","E01009298","Total",1578,760,818,1578,0,10,26.05,60.6
"2011","Birmingham 054E","E01009311","Total",1658,806,852,1658,0,6,20.68,80.2
"2011","Birmingham 054F","E01009511","Total",1486,727,759,1486,0,6,21.10,70.4
"2011","Birmingham 055A","E01009475","Total",2072,977,1095,2072,0,8,19.26,107.6
"2011","Birmingham 055B","E01009476","Total",1889,985,904,1889,0,1,32.88,57.5
"2011","Birmingham 055C","E01009477","Total",1692,807,885,1692,0,6,34.84,48.6
"2011","Birmingham 055D","E01009490","Total",1927,962,965,1927,0,8,40.29,47.8
"2011","Birmingham 055E","E01009492","Total",1754,885,869,1754,0,7,20.54,85.4
"2011","Birmingham 056A","E01009095","Total",1700,845,855,1700,0,7,49.73,34.2
"2011","Birmingham 056B","E01009507","Total",1551,803,748,1486,65,11,21.09,73.5
"2011","Birmingham 056C","E01009508","Total",1548,746,802,1536,12,11,28.01,55.3
"2011","Birmingham 056D","E01009509","Total",1747,864,883,1743,4,10,31.52,55.4
"2011","Birmingham 056E","E01009510","Total",1606,767,839,1563,43,11,25.96,61.9
"2011","Birmingham 057A","E01009297","Total",1606,762,844,1606,0,2,74.76,21.5
"2011","Birmingham 057B","E01009299","Total",1637,769,868,1637,0,6,26.09,62.7
"2011","Birmingham 057C","E01009300","Total",1803,858,945,1803,0,7,55.15,32.7
"2011","Birmingham 057D","E01009301","Total",1604,748,856,1604,0,2,29.37,54.6
"2011","Birmingham 057E","E01009303","Total",1479,726,753,1479,0,7,49.48,29.9
"2011","Birmingham 058A","E01009195","Total",2600,1341,1259,2600,0,19,23.52,110.5
"2011","Birmingham 058C","E01009197","Total",1679,804,875,1673,6,11,23.55,71.3
"2011","Birmingham 058D","E01009198","Total",1761,894,867,1761,0,10,52.76,33.4
"2011","Birmingham 058E","E01033647","Total",1398,677,721,1398,0,3,14.68,95.2
"2011","Birmingham 058F","E01033649","Total",1801,878,923,1801,0,7,14.61,123.3
"2011","Birmingham 060A","E01009138","Total",1646,824,822,1646,0,11,27.07,60.8
"2011","Birmingham 060B","E01009139","Total",1583,814,769,1583,0,28,20.04,79.0
"2011","Birmingham 060C","E01009140","Total",1915,1018,897,1900,15,26,80.58,23.8
"2011","Birmingham 060D","E01009145","Total",1981,1031,950,1972,9,21,35.19,56.3
"2011","Birmingham 060E","E01009147","Total",1683,908,775,1556,127,15,37.32,45.1
"2011","Birmingham 062A","E01009512","Total",1616,783,833,1616,0,7,38.25,42.2
"2011","Birmingham 062B","E01009514","Total",1510,708,802,1444,66,9,29.41,51.3
"2011","Birmingham 062C","E01009516","Total",1412,679,733,1394,18,2,21.71,65.0
"2011","Birmingham 062D","E01009517","Total",1709,836,873,1707,2,11,35.20,48.6
"2011","Birmingham 063A","E01009325","Total",1797,911,886,1797,0,3,19.03,94.4
"2011","Birmingham 063D","E01009342","Total",1738,856,882,1638,100,2,35.50,49.0
"2011","Birmingham 063E","E01009343","Total",1706,844,862,1706,0,9,14.39,118.6
"2011","Birmingham 063F","E01033642","Total",3105,1544,1561,3105,0,12,23.90,129.9
"2011","Birmingham 064A","E01008986","Total",1801,964,837,1755,46,11,22.56,79.8
"2011","Birmingham 064B","E01008987","Total",1540,751,789,1540,0,10,16.18,95.2
"2011","Birmingham 064C","E01008988","Total",2037,1132,905,1965,72,21,37.86,53.8
"2011","Birmingham 064D","E01008989","Total",1742,933,809,1597,145,9,27.29,63.8
"2011","Birmingham 064E","E01008990","Total",1171,533,638,1037,134,28,75.98,15.4
"2011","Birmingham 064F","E01008991","Total",1515,732,783,1495,20,42,68.81,22.0
"2011","Birmingham 066A","E01008882","Total",1747,842,905,1747,0,2,24.59,71.0
"2011","Birmingham 066B","E01008896","Total",1575,765,810,1575,0,8,20.38,77.3
"2011","Birmingham 066C","E01008898","Total",1674,789,885,1674,0,1,19.94,84.0
"2011","Birmingham 066D","E01009326","Total",1919,952,967,1919,0,9,48.88,39.3
"2011","Birmingham 066E","E01009341","Total",1558,762,796,1554,4,10,53.86,28.9
"2011","Birmingham 066F","E01009513","Total",1720,836,884,1720,0,9,39.44,43.6
"2011","Birmingham 067A","E01008881","Total",1599,778,821,1599,0,12,39.69,40.3
"2011","Birmingham 067B","E01008897","Total",1686,847,839,1686,0,10,22.80,73.9
"2011","Birmingham 067C","E01009515","Total",1564,763,801,1521,43,10,33.10,47.3
"2011","Birmingham 067D","E01009518","Total",1608,794,814,1589,19,23,38.37,41.9
"2011","Birmingham 067E","E01009521","Total",1640,827,813,1640,0,13,26.77,61.3
"2011","Birmingham 069A","E01009302","Total",1507,730,777,1422,85,4,37.57,40.1
"2011","Birmingham 069B","E01009314","Total",1586,746,840,1561,25,5,29.25,54.2
"2011","Birmingham 069C","E01009321","Total",1840,854,986,1840,0,9,86.33,21.3
"2011","Birmingham 069D","E01009322","Total",1386,689,697,1386,0,3,67.75,20.5
"2011","Birmingham 069E","E01009323","Total",1471,706,765,1471,0,3,25.44,57.8
"2011","Birmingham 070A","E01009329","Total",2341,1209,1132,2341,0,19,23.24,100.7
"2011","Birmingham 070B","E01009334","Total",1889,936,953,1884,5,24,15.04,125.6
"2011","Birmingham 070C","E01009337","Total",1788,907,881,1788,0,13,15.23,117.4
"2011","Birmingham 070D","E01009338","Total",1569,789,780,1556,13,12,47.95,32.7
"2011","Birmingham 070E","E01009380","Total",1700,874,826,1700,0,5,10.69,159.0
"2011","Birmingham 071A","E01009362","Total",1316,682,634,1316,0,4,21.21,62.0
"2011","Birmingham 071B","E01009363","Total",1554,803,751,1544,10,9,59.22,26.2
"2011","Birmingham 071C","E01009364","Total",1338,683,655,1329,9,3,33.55,39.9
"2011","Birmingham 071D","E01009365","Total",1719,929,790,1669,50,7,38.98,44.1
"2011","Birmingham 071E","E01009379","Total",1669,860,809,1663,6,2,34.75,48.0
"2011","Birmingham 072A","E01009312","Total",1576,753,823,1576,0,15,28.83,54.7
"2011","Birmingham 072B","E01009324","Total",1641,782,859,1641,0,12,26.72,61.4
"2011","Birmingham 072C","E01009519","Total",1519,763,756,1519,0,12,23.22,65.4
"2011","Birmingham 072D","E01009520","Total",1752,887,865,1752,0,21,31.24,56.1
"2011","Birmingham 073A","E01009066","Total",1508,746,762,1508,0,58,66.43,22.7
"2011","Birmingham 073B","E01009070","Total",1678,763,915,1613,65,23,40.33,41.6
"2011","Birmingham 073C","E01009252","Total",1538,766,772,1497,41,38,37.55,41.0
"2011","Birmingham 073D","E01009260","Total",1535,751,784,1530,5,33,50.28,30.5
"2011","Birmingham 073E","E01009261","Total",1607,770,837,1607,0,28,35.47,45.3
"2011","Birmingham 074A","E01008984","Total",2090,1046,1044,1767,323,20,25.66,81.4
"2011","Birmingham 074B","E01008994","Total",1695,849,846,1437,258,30,50.31,33.7
"2011","Birmingham 074C","E01008996","Total",1571,773,798,1570,1,16,24.66,63.7
"2011","Birmingham 074D","E01008997","Total",1445,705,740,1445,0,46,57.98,24.9
"2011","Birmingham 075A","E01009065","Total",1716,885,831,1581,135,42,55.47,30.9
"2011","Birmingham 075B","E01009067","Total",1480,690,790,1465,15,31,30.37,48.7
"2011","Birmingham 075C","E01009068","Total",1543,698,845,1543,0,22,21.82,70.7
"2011","Birmingham 075D","E01009069","Total",1564,747,817,1564,0,11,25.63,61.0
"2011","Birmingham 075E","E01009072","Total",1599,745,854,1599,0,23,33.85,47.2
"2011","Birmingham 076A","E01008885","Total",1308,630,678,1308,0,12,19.29,67.8
"2011","Birmingham 076B","E01008886","Total",1564,762,802,1564,0,11,45.29,34.5
"2011","Birmingham 076C","E01008888","Total",1658,850,808,1658,0,9,22.42,74.0
"2011","Birmingham 076D","E01009313","Total",1571,771,800,1571,0,11,26.06,60.3
"2011","Birmingham 077A","E01009368","Total",1468,769,699,1465,3,16,10.66,137.7
"2011","Birmingham 077D","E01009371","Total",1777,957,820,1777,0,13,24.03,73.9
"2011","Birmingham 077E","E01009397","Total",1759,860,899,1759,0,21,15.34,114.7
"2011","Birmingham 077F","E01033650","Total",2596,1292,1304,2596,0,11,22.45,115.6
"2011","Birmingham 078A","E01008883","Total",1816,889,927,1797,19,10,39.39,46.1
"2011","Birmingham 078B","E01008884","Total",1870,906,964,1870,0,4,69.84,26.8
"2011","Birmingham 078C","E01008887","Total",1478,719,759,1475,3,14,45.84,32.2
"2011","Birmingham 078D","E01008889","Total",1775,916,859,1666,109,12,83.28,21.3
"2011","Birmingham 079A","E01008982","Total",1475,743,732,1336,139,15,42.46,34.7
"2011","Birmingham 079C","E01008992","Total",1800,859,941,1175,625,41,63.69,28.3
"2011","Birmingham 079E","E01009283","Total",1476,745,731,1448,28,27,35.97,41.0
"2011","Birmingham 079F","E01033631","Total",4965,2436,2529,2106,2859,104,297.52,16.7
"2011","Birmingham 080A","E01009249","Total",1586,740,846,1586,0,8,25.47,62.3
"2011","Birmingham 080B","E01009250","Total",1615,788,827,1615,0,7,48.20,33.5
"2011","Birmingham 080C","E01009251","Total",1499,740,759,1499,0,17,25.49,58.8
"2011","Birmingham 080D","E01009253","Total",1540,724,816,1540,0,30,38.03,40.5
"2011","Birmingham 080E","E01009255","Total",1553,739,814,1553,0,16,24.02,64.7
"2011","Birmingham 080F","E01009257","Total",1522,727,795,1522,0,4,23.53,64.7
"2011","Birmingham 081A","E01009315","Total",1594,817,777,1580,14,8,50.59,31.5
"2011","Birmingham 081B","E01009316","Total",1647,778,869,1647,0,11,34.49,47.8
"2011","Birmingham 081C","E01009317","Total",1670,821,849,1670,0,6,44.21,37.8
"2011","Birmingham 081D","E01009318","Total",1533,760,773,1533,0,5,71.23,21.5
"2011","Birmingham 081E","E01009319","Total",1634,855,779,1634,0,19,24.86,65.7
"2011","Birmingham 081F","E01009320","Total",1544,786,758,1544,0,9,62.54,24.7
"2011","Birmingham 082A","E01009372","Total",1822,905,917,1822,0,7,8.45,215.6
"2011","Birmingham 082B","E01009373","Total",1838,897,941,1838,0,9,8.29,221.7
"2011","Birmingham 082D","E01009396","Total",2153,1113,1040,2153,0,9,14.10,152.7
"2011","Birmingham 082F","E01033643","Total",3095,1571,1524,3083,12,12,22.19,139.5
"2011","Birmingham 083A","E01009367","Total",1642,859,783,1634,8,6,36.38,45.1
"2011","Birmingham 083B","E01009375","Total",1932,972,960,1899,33,21,17.64,109.5
"2011","Birmingham 083C","E01009377","Total",1370,687,683,1366,4,18,12.20,112.3
"2011","Birmingham 083D","E01009383","Total",1452,768,684,1452,0,14,11.60,125.2
"2011","Birmingham 083E","E01009399","Total",1590,809,781,1590,0,15,8.60,184.9
"2011","Birmingham 084A","E01009366","Total",1581,794,787,1581,0,25,22.33,70.8
"2011","Birmingham 084B","E01009374","Total",1147,563,584,1147,0,4,21.67,52.9
"2011","Birmingham 084C","E01009376","Total",1674,861,813,1665,9,11,21.16,79.1
"2011","Birmingham 084F","E01033648","Total",2715,1374,1341,2712,3,15,22.80,119.1
"2011","Birmingham 085A","E01009073","Total",1614,742,872,1614,0,13,18.83,85.7
"2011","Birmingham 085B","E01009074","Total",1672,817,855,1672,0,10,19.72,84.8
"2011","Birmingham 085C","E01009254","Total",1558,745,813,1558,0,13,34.50,45.2
"2011","Birmingham 085D","E01009256","Total",1565,748,817,1565,0,13,24.89,62.9
"2011","Birmingham 085E","E01009258","Total",1526,716,810,1526,0,3,40.68,37.5
"2011","Birmingham 087B","E01009071","Total",1615,808,807,1568,47,27,92.44,17.5
"2011","Birmingham 087C","E01009075","Total",1634,808,826,1634,0,7,19.53,83.7
"2011","Birmingham 087E","E01009078","Total",1433,711,722,1433,0,11,30.06,47.7
"2011","Birmingham 087F","E01033562","Total",2504,1260,1244,2460,44,20,106.71,23.5
"2011","Birmingham 088C","E01009183","Total",1604,818,786,1604,0,39,72.57,22.1
"2011","Birmingham 088D","E01009186","Total",1701,887,814,1699,2,20,127.35,13.4
"2011","Birmingham 088E","E01033645","Total",3485,1765,1720,3383,102,38,34.77,100.2
"2011","Birmingham 089A","E01008890","Total",1734,862,872,1698,36,12,30.86,56.2
"2011","Birmingham 089B","E01008891","Total",1560,785,775,1560,0,5,29.29,53.3
"2011","Birmingham 089C","E01008892","Total",1527,736,791,1527,0,10,14.27,107.0
"2011","Birmingham 089D","E01008893","Total",1716,912,804,1704,12,18,28.62,60.0
"2011","Birmingham 089E","E01008894","Total",1412,686,726,1318,94,15,26.55,53.2
"2011","Birmingham 089F","E01008895","Total",1822,891,931,1822,0,17,28.37,64.2
"2011","Birmingham 089G","E01009015","Total",1736,850,886,1710,26,14,35.05,49.5
"2011","Birmingham 090A","E01009014","Total",2023,991,1032,2023,0,21,36.92,54.8
"2011","Birmingham 090B","E01009018","Total",1673,848,825,1591,82,13,33.65,49.7
"2011","Birmingham 090C","E01009026","Total",1578,775,803,1578,0,6,31.36,50.3
"2011","Birmingham 090D","E01009028","Total",1790,854,936,1790,0,14,19.39,92.3
"2011","Birmingham 090E","E01009029","Total",1548,728,820,1517,31,6,24.37,63.5
"2011","Birmingham 092A","E01009182","Total",1624,867,757,1546,78,14,20.53,79.1
"2011","Birmingham 092B","E01009184","Total",1606,869,737,1544,62,21,44.16,36.4
"2011","Birmingham 092C","E01009187","Total",1572,786,786,1513,59,37,32.11,49.0
"2011","Birmingham 092D","E01009188","Total",1523,728,795,1523,0,30,27.39,55.6
"2011","Birmingham 092E","E01009384","Total",1334,705,629,1325,9,6,19.40,68.8
"2011","Birmingham 092F","E01009385","Total",1297,707,590,1231,66,10,20.98,61.8
"2011","Birmingham 093A","E01009185","Total",1634,789,845,1595,39,35,44.53,36.7
"2011","Birmingham 093B","E01009389","Total",1761,879,882,1741,20,19,19.07,92.3
"2011","Birmingham 093C","E01009390","Total",1564,870,694,1465,99,8,19.36,80.8
"2011","Birmingham 093D","E01009394","Total",1730,881,849,1719,11,27,26.68,64.8
"2011","Birmingham 094A","E01008918","Total",1726,789,937,1726,0,8,41.37,41.7
"2011","Birmingham 094B","E01008920","Total",1389,670,719,1389,0,8,41.76,33.3
"2011","Birmingham 094C","E01008921","Total",1426,696,730,1426,0,16,61.99,23.0
"2011","Birmingham 094D","E01008931","Total",1439,660,779,1439,0,0,62.78,22.9
"2011","Birmingham 094E","E01009259","Total",1607,739,868,1599,8,5,69.96,23.0
"2011","Birmingham 095A","E01008919","Total",1577,756,821,1573,4,13,64.05,24.6
"2011","Birmingham 095B","E01009064","Total",1477,718,759,1477,0,12,27.58,53.6
"2011","Birmingham 095C","E01009077","Total",1706,807,899,1676,30,18,37.77,45.2
"2011","Birmingham 095D","E01009291","Total",1537,711,826,1537,0,13,33.83,45.4
"2011","Birmingham 095E","E01009500","Total",1536,709,827,1529,7,11,35.94,42.7
"2011","Birmingham 096A","E01009284","Total",2287,1042,1245,1830,457,15,66.27,34.5
"2011","Birmingham 096C","E01009286","Total",2212,1069,1143,2191,21,25,27.10,81.6
"2011","Birmingham 096E","E01009289","Total",2097,948,1149,2096,1,20,14.23,147.4
"2011","Birmingham 096F","E01009290","Total",2000,951,1049,2000,0,28,12.60,158.7
"2011","Birmingham 096G","E01033634","Total",4054,1885,2169,3292,762,41,21.64,187.3
"2011","Birmingham 097A","E01009017","Total",1669,785,884,1669,0,13,20.54,81.3
"2011","Birmingham 097B","E01009043","Total",1971,951,1020,1964,7,26,27.70,71.2
"2011","Birmingham 097C","E01009044","Total",1624,813,811,1624,0,12,14.56,111.5
"2011","Birmingham 097D","E01009045","Total",1712,838,874,1712,0,15,41.34,41.4
"2011","Birmingham 097E","E01009046","Total",1800,872,928,1794,6,33,39.63,45.4
"2011","Birmingham 097F","E01009395","Total",1681,860,821,1664,17,17,30.60,54.9
"2011","Birmingham 098A","E01009016","Total",1559,777,782,1559,0,7,24.52,63.6
"2011","Birmingham 098B","E01009022","Total",1749,850,899,1742,7,5,36.95,47.3
"2011","Birmingham 098C","E01009023","Total",1673,831,842,1673,0,18,26.24,63.8
"2011","Birmingham 098D","E01009030","Total",1475,727,748,1475,0,30,28.09,52.5
"2011","Birmingham 099A","E01009281","Total",1429,623,806,1358,71,17,68.64,20.8
"2011","Birmingham 099B","E01009292","Total",1648,829,819,1648,0,14,37.47,44.0
"2011","Birmingham 099C","E01009294","Total",1837,907,930,1819,18,15,77.95,23.6
"2011","Birmingham 099D","E01009295","Total",1770,820,950,1723,47,26,36.87,48.0
"2011","Birmingham 100A","E01009280","Total",1317,650,667,1312,5,13,43.75,30.1
"2011","Birmingham 100B","E01009282","Total",1648,891,757,1534,114,21,40.14,41.1
"2011","Birmingham 100C","E01009288","Total",1234,592,642,993,241,28,47.84,25.8
"2011","Birmingham 100D","E01009293","Total",1516,777,739,1516,0,16,21.72,69.8
"2011","Birmingham 100E","E01009296","Total",1499,761,738,1475,24,12,22.85,65.6
"2011","Birmingham 101A","E01008924","Total",1427,693,734,1370,57,13,41.13,34.7
"2011","Birmingham 101B","E01009501","Total",1564,716,848,1564,0,6,28.07,55.7
"2011","Birmingham 101C","E01009502","Total",1508,709,799,1508,0,11,24.20,62.3
"2011","Birmingham 101D","E01009503","Total",1541,738,803,1541,0,19,24.92,61.8
"2011","Birmingham 101E","E01009505","Total",1662,807,855,1651,11,4,33.75,49.2
"2011","Birmingham 102A","E01008917","Total",1335,661,674,1335,0,10,35.69,37.4
"2011","Birmingham 102B","E01008923","Total",1347,637,710,1340,7,5,29.19,46.1
"2011","Birmingham 102C","E01008925","Total",1301,642,659,1301,0,12,25.44,51.1
"2011","Birmingham 102D","E01008927","Total",1390,668,722,1389,1,2,36.55,38.0
"2011","Birmingham 102E","E01008928","Total",1485,654,831,1485,0,4,33.88,43.8
"2011","Birmingham 103A","E01009019","Total",1611,794,817,1611,0,8,31.89,50.5
"2011","Birmingham 103B","E01009020","Total",1511,709,802,1511,0,12,21.12,71.5
"2011","Birmingham 103C","E01009021","Total",1620,757,863,1620,0,4,24.33,66.6
"2011","Birmingham 103D","E01009024","Total",1623,775,848,1600,23,9,20.97,77.4
"2011","Birmingham 103E","E01009025","Total",1514,710,804,1514,0,14,17.95,84.3
"2011","Birmingham 103F","E01009033","Total",1770,884,886,1770,0,8,23.41,75.6
"2011","Birmingham 104A","E01009175","Total",1470,757,713,1462,8,16,27.44,53.6
"2011","Birmingham 104B","E01009177","Total",1578,769,809,1578,0,21,15.04,104.9
"2011","Birmingham 104C","E01009178","Total",1594,794,800,1594,0,18,27.70,57.5
"2011","Birmingham 104D","E01009179","Total",1720,841,879,1720,0,28,35.45,48.5
"2011","Birmingham 104E","E01009189","Total",1496,720,776,1491,5,33,23.02,65.0
"2011","Birmingham 105A","E01008933","Total",1556,768,788,1556,0,8,46.00,33.8
"2011","Birmingham 105B","E01008934","Total",1405,672,733,1405,0,22,26.10,53.8
"2011","Birmingham 105C","E01009031","Total",1655,829,826,1653,2,42,44.02,37.6
"2011","Birmingham 105D","E01009037","Total",1620,780,840,1620,0,24,49.21,32.9
"2011","Birmingham 105E","E01009176","Total",1650,805,845,1650,0,17,86.10,19.2
"2011","Birmingham 106C","E01008929","Total",1479,697,782,1461,18,4,53.28,27.8
"2011","Birmingham 106D","E01008930","Total",1498,700,798,1498,0,7,155.71,9.6
"2011","Birmingham 106E","E01009495","Total",1225,573,652,1225,0,8,30.40,40.3
"2011","Birmingham 106F","E01033629","Total",2593,1210,1383,2402,191,21,93.56,27.7
"2011","Birmingham 107A","E01008953","Total",1564,755,809,1564,0,8,33.70,46.4
"2011","Birmingham 107B","E01008963","Total",1371,658,713,1357,14,4,49.05,28.0
"2011","Birmingham 107C","E01008964","Total",1473,687,786,1418,55,16,27.46,53.6
"2011","Birmingham 107D","E01008965","Total",1529,739,790,1499,30,17,29.62,51.6
"2011","Birmingham 107E","E01008966","Total",1688,824,864,1674,14,14,26.18,64.5
"2011","Birmingham 108A","E01009032","Total",1794,897,897,1794,0,16,30.28,59.2
"2011","Birmingham 108B","E01009034","Total",1691,829,862,1662,29,15,29.15,58.0
"2011","Birmingham 108C","E01009035","Total",1812,886,926,1812,0,13,31.13,58.2
"2011","Birmingham 108D","E01009036","Total",1514,753,761,1514,0,24,29.80,50.8
"2011","Birmingham 109A","E01009494","Total",1626,710,916,1626,0,11,26.29,61.8
"2011","Birmingham 109B","E01009496","Total",1481,716,765,1481,0,10,48.35,30.6
"2011","Birmingham 109C","E01009497","Total",1767,848,919,1767,0,7,38.31,46.1
"2011","Birmingham 109D","E01009504","Total",1471,707,764,1443,28,23,46.15,31.9
"2011","Birmingham 109E","E01009506","Total",1494,752,742,1494,0,20,37.75,39.6
"2011","Birmingham 110A","E01008967","Total",1687,822,865,1679,8,29,36.53,46.2
"2011","Birmingham 110B","E01008968","Total",1707,847,860,1707,0,32,33.95,50.3
"2011","Birmingham 110C","E01008970","Total",1541,742,799,1541,0,16,19.63,78.5
"2011","Birmingham 110D","E01008981","Total",1538,737,801,1511,27,34,33.22,46.3
"2011","Birmingham 111A","E01008932","Total",1544,727,817,1544,0,11,37.63,41.0
"2011","Birmingham 111B","E01008935","Total",1675,801,874,1628,47,10,55.96,29.9
"2011","Birmingham 111C","E01008936","Total",1568,751,817,1563,5,33,33.91,46.2
"2011","Birmingham 111D","E01008938","Total",1593,775,818,1593,0,7,21.43,74.3
"2011","Birmingham 111E","E01008939","Total",1543,719,824,1543,0,6,34.60,44.6
"2011","Birmingham 112A","E01008951","Total",1427,679,748,1420,7,21,37.53,38.0
"2011","Birmingham 112B","E01008952","Total",1595,778,817,1595,0,12,38.16,41.8
"2011","Birmingham 112C","E01008955","Total",1533,768,765,1512,21,15,47.97,32.0
"2011","Birmingham 112D","E01008956","Total",1513,698,815,1463,50,26,38.02,39.8
"2011","Birmingham 112E","E01008957","Total",1658,792,866,1570,88,16,23.51,70.5
"2011","Birmingham 113A","E01008950","Total",1431,655,776,1431,0,12,54.25,26.4
"2011","Birmingham 113B","E01008954","Total",1357,671,686,1357,0,18,51.43,26.4
"2011","Birmingham 113C","E01008958","Total",1554,683,871,1549,5,10,32.72,47.5
"2011","Birmingham 113D","E01009493","Total",1470,801,669,1470,0,11,33.42,44.0
"2011","Birmingham 115A","E01008937","Total",1426,672,754,1426,0,10,34.85,40.9
"2011","Birmingham 115B","E01008940","Total",1538,732,806,1453,85,6,39.29,39.1
"2011","Birmingham 115C","E01008941","Total",1522,735,787,1522,0,10,23.87,63.8
"2011","Birmingham 115D","E01008944","Total",1716,823,893,1697,19,3,42.00,40.9
"2011","Birmingham 116A","E01008959","Total",1759,785,974,1710,49,17,37.33,47.1
"2011","Birmingham 116B","E01008960","Total",1606,780,826,1606,0,31,23.49,68.4
"2011","Birmingham 116C","E01008961","Total",1495,760,735,1451,44,21,27.28,54.8
"2011","Birmingham 116D","E01008962","Total",1907,906,1001,1906,1,15,27.33,69.8
"2011","Birmingham 117A","E01008942","Total",1599,787,812,1597,2,6,24.57,65.1
"2011","Birmingham 117B","E01008943","Total",1458,693,765,1429,29,3,49.26,29.6
"2011","Birmingham 117C","E01008969","Total",1646,793,853,1646,0,16,43.56,37.8
"2011","Birmingham 117D","E01008971","Total",1691,798,893,1691,0,18,50.58,33.4
"2011","Birmingham 118A","E01008972","Total",1790,830,960,1780,10,11,49.49,36.2
"2011","Birmingham 118B","E01008973","Total",1906,918,988,1882,24,8,37.82,50.4
"2011","Birmingham 118C","E01008974","Total",2881,1455,1426,2876,5,22,65.65,43.9
"2011","Birmingham 118D","E01008975","Total",1549,775,774,1513,36,12,33.96,45.6
"2011","Birmingham 119A","E01009172","Total",1420,676,744,1413,7,9,42.70,33.3
"2011","Birmingham 119B","E01009173","Total",1733,863,870,1733,0,12,22.84,75.9
"2011","Birmingham 119C","E01009174","Total",1255,602,653,1255,0,4,22.68,55.3
"2011","Birmingham 119D","E01009498","Total",1636,759,877,1636,0,9,43.89,37.3
"2011","Birmingham 119E","E01009499","Total",1740,807,933,1740,0,11,28.63,60.8
"2011","Birmingham 120A","E01009205","Total",1531,776,755,1524,7,27,42.93,35.7
"2011","Birmingham 120B","E01009206","Total",1624,824,800,1624,0,11,35.18,46.2
"2011","Birmingham 120C","E01009211","Total",1442,742,700,1442,0,13,25.61,56.3
"2011","Birmingham 120D","E01009218","Total",1527,755,772,1490,37,32,50.33,30.3
"2011","Birmingham 120E","E01009219","Total",1564,751,813,1539,25,6,26.19,59.7
"2011","Birmingham 121A","E01008976","Total",1541,719,822,1541,0,7,36.00,42.8
"2011","Birmingham 121B","E01008978","Total",1393,699,694,1352,41,8,21.87,63.7
"2011","Birmingham 121C","E01008979","Total",1605,767,838,1601,4,4,33.69,47.6
"2011","Birmingham 121D","E01008980","Total",1626,801,825,1621,5,6,31.19,52.1
"2011","Birmingham 122A","E01008945","Total",1835,888,947,1830,5,6,27.57,66.6
"2011","Birmingham 122B","E01008946","Total",1485,756,729,1485,0,5,32.83,45.2
"2011","Birmingham 122C","E01008947","Total",1392,678,714,1351,41,7,19.18,72.6
"2011","Birmingham 122D","E01008948","Total",1459,707,752,1459,0,6,26.00,56.1
"2011","Birmingham 122E","E01008949","Total",1262,641,621,1262,0,11,19.46,64.9
"2011","Birmingham 123A","E01008977","Total",1574,744,830,1551,23,11,35.33,44.6
"2011","Birmingham 123B","E01009109","Total",1368,617,751,1368,0,3,18.26,74.9
"2011","Birmingham 123C","E01009119","Total",1439,690,749,1378,61,12,99.84,14.4
"2011","Birmingham 123D","E01009120","Total",1438,676,762,1398,40,7,37.07,38.8
"2011","Birmingham 124A","E01009162","Total",1602,745,857,1588,14,8,48.66,32.9
"2011","Birmingham 124B","E01009207","Total",1659,817,842,1639,20,12,30.85,53.8
"2011","Birmingham 124C","E01009208","Total",1531,754,777,1531,0,9,28.13,54.4
"2011","Birmingham 124D","E01009209","Total",2128,1060,1068,2128,0,15,44.12,48.2
"2011","Birmingham 124E","E01009213","Total",1486,704,782,1477,9,9,37.44,39.7
"2011","Birmingham 125B","E01009155","Total",1356,667,689,1356,0,5,26.81,50.6
"2011","Birmingham 125D","E01009157","Total",1510,729,781,1510,0,2,17.68,85.4
"2011","Birmingham 125E","E01009160","Total",1586,774,812,1586,0,3,22.86,69.4
"2011","Birmingham 125F","E01009161","Total",1412,683,729,1412,0,3,26.43,53.4
"2011","Birmingham 125G","E01033633","Total",2353,1122,1231,2336,17,10,68.04,34.6
"2011","Birmingham 126A","E01009117","Total",2060,957,1103,2060,0,6,28.33,72.7
"2011","Birmingham 126B","E01009210","Total",1855,897,958,1851,4,13,29.25,63.4
"2011","Birmingham 126C","E01009212","Total",1678,794,884,1678,0,8,33.31,50.4
"2011","Birmingham 126D","E01009214","Total",1652,798,854,1652,0,3,40.63,40.7
"2011","Birmingham 126E","E01009215","Total",1650,811,839,1649,1,8,35.15,46.9
"2011","Birmingham 127A","E01009108","Total",1341,648,693,1329,12,9,30.72,43.7
"2011","Birmingham 127B","E01009111","Total",1387,694,693,1380,7,16,26.03,53.3
"2011","Birmingham 127C","E01009112","Total",1508,727,781,1418,90,8,30.93,48.8
"2011","Birmingham 127D","E01009116","Total",1426,683,743,1412,14,26,103.93,13.7
"2011","Birmingham 127E","E01009118","Total",1469,701,768,1469,0,7,25.81,56.9
"2011","Birmingham 128A","E01009107","Total",1741,821,920,1741,0,9,35.19,49.5
"2011","Birmingham 128B","E01009110","Total",1565,750,815,1549,16,13,38.61,40.5
"2011","Birmingham 128C","E01009113","Total",1518,721,797,1518,0,5,50.05,30.3
"2011","Birmingham 128D","E01009114","Total",1571,748,823,1571,0,4,26.70,58.8
"2011","Birmingham 128E","E01009115","Total",1417,686,731,1405,12,9,33.82,41.9
"2011","Birmingham 129A","E01009158","Total",1897,913,984,1829,68,7,71.24,26.6
"2011","Birmingham 129B","E01009163","Total",1452,673,779,1446,6,3,154.21,9.4
"2011","Birmingham 129C","E01009165","Total",1352,666,686,1352,0,5,34.30,39.4
"2011","Birmingham 129D","E01009169","Total",1680,817,863,1680,0,10,24.90,67.5
"2011","Birmingham 130A","E01009159","Total",1775,856,919,1742,33,14,80.50,22.0
"2011","Birmingham 130B","E01009164","Total",1484,711,773,1484,0,13,22.16,67.0
"2011","Birmingham 130C","E01009167","Total",1550,762,788,1550,0,16,23.43,66.2
"2011","Birmingham 130D","E01009171","Total",1597,759,838,1591,6,14,35.93,44.4
"2011","Birmingham 131A","E01009166","Total",1319,637,682,1319,0,4,17.18,76.8
"2011","Birmingham 131B","E01009168","Total",1489,761,728,1489,0,5,24.56,60.6
"2011","Birmingham 131C","E01009170","Total",1483,725,758,1483,0,10,30.02,49.4
"2011","Birmingham 131D","E01009216","Total",1991,949,1042,1968,23,17,36.96,53.9
"2011","Birmingham 131E","E01009217","Total",1630,819,811,1630,0,10,25.50,63.9
"2011","Birmingham 132A","E01009039","Total",1705,846,859,1705,0,18,27.57,61.8
"2011","Birmingham 132B","E01009040","Total",1747,863,884,1747,0,28,43.49,40.2
"2011","Birmingham 132C","E01009041","Total",1661,827,834,1661,0,19,25.40,65.4
"2011","Birmingham 132D","E01009042","Total",1379,681,698,1379,0,12,23.92,57.7
"2011","Birmingham 132E","E01032589","Total",1411,657,754,1399,12,31,24.15,58.4
"2011","Birmingham 133A","E01009262","Total",1756,847,909,1723,33,33,41.77,42.0
"2011","Birmingham 133B","E01009267","Total",1756,856,900,1734,22,27,35.24,49.8
"2011","Birmingham 133C","E01009276","Total",1618,766,852,1618,0,20,51.40,31.5
"2011","Birmingham 133D","E01009278","Total",1729,839,890,1729,0,25,44.63,38.7
"2011","Birmingham 133E","E01009279","Total",1528,758,770,1507,21,28,30.98,49.3
"2011","Birmingham 133F","E01032591","Total",1645,824,821,1645,0,26,168.20,9.8
"2011","Birmingham 134A","E01008995","Total",1816,928,888,1425,391,14,23.83,76.2
"2011","Birmingham 134B","E01033557","Total",2059,1025,1034,1362,697,35,14.50,142.0
"2011","Birmingham 134C","E01033624","Total",1033,501,532,984,49,6,15.31,67.5
"2011","Birmingham 134D","E01033626","Total",1069,566,503,1069,0,2,6.07,176.1
"2011","Birmingham 134E","E01033640","Total",1296,663,633,1296,0,8,27.39,47.3
"2011","Birmingham 135A","E01009378","Total",2065,1159,906,2017,48,10,67.56,30.6
"2011","Birmingham 135B","E01033567","Total",1172,660,512,1172,0,7,7.52,155.9
"2011","Birmingham 135C","E01033615","Total",1019,620,399,1015,4,6,38.42,26.5
"2011","Birmingham 135D","E01033616","Total",1012,686,326,1012,0,2,12.46,81.2
"2011","Birmingham 136A","E01009143","Total",1419,758,661,1400,19,7,29.05,48.8
"2011","Birmingham 136B","E01009146","Total",1923,1098,825,1340,583,26,22.04,87.3
"2011","Birmingham 136C","E01033564","Total",1231,710,521,1231,0,5,9.40,131.0
"2011","Birmingham 136D","E01033639","Total",1803,912,891,1803,0,16,24.17,74.6
"2011","Birmingham 137A","E01009141","Total",1760,881,879,1745,15,5,28.30,62.2
"2011","Birmingham 137B","E01033565","Total",1021,599,422,1021,0,3,16.40,62.3
"2011","Birmingham 137C","E01033618","Total",1191,693,498,1191,0,5,6.07,196.2
"2011","Birmingham 137D","E01033619","Total",1134,599,535,1134,0,3,21.50,52.7
"2011","Birmingham 137E","E01033627","Total",1078,601,477,1078,0,5,31.04,34.7
"2011","Birmingham 138A","E01033620","Total",1020,597,423,1019,1,5,53.91,18.9
"2011","Birmingham 138B","E01033622","Total",1713,955,758,1509,204,9,17.96,95.4
"2011","Birmingham 138C","E01033623","Total",1120,712,408,1120,0,3,22.50,49.8
"2011","Birmingham 138D","E01033625","Total",1694,976,718,1694,0,9,17.38,97.5
"2011","Birmingham 139A","E01009200","Total",1712,871,841,1682,30,10,76.76,22.3
"2011","Birmingham 139B","E01009327","Total",1633,798,835,1633,0,9,12.46,131.1
"2011","Birmingham 139C","E01009328","Total",2366,1197,1169,2366,0,15,13.04,181.4
"2011","Birmingham 139D","E01009331","Total",2145,1080,1065,2145,0,13,16.83,127.5
"2011","Birmingham 139E","E01009332","Total",1706,847,859,1655,51,9,37.28,45.8
"2011","Birmingham 139F","E01009333","Total",1654,813,841,1654,0,8,11.87,139.3
"2011","Birmingham 139G","E01009335","Total",1882,909,973,1882,0,8,21.66,86.9
"2011","Birmingham 139H","E01009344","Total",1615,820,795,1615,0,5,11.55,139.8
"2011","Birmingham 140A","E01009339","Total",1521,771,750,1521,0,11,59.57,25.5
"2011","Birmingham 140B","E01009340","Total",2708,1362,1346,2692,16,8,50.39,53.7
"2011","Birmingham 140C","E01009382","Total",1836,929,907,1836,0,13,24.13,76.1
"2011","Birmingham 140D","E01009391","Total",1622,847,775,1622,0,20,14.97,108.4
"2011","Birmingham 140E","E01009392","Total",1774,890,884,1774,0,6,12.18,145.6
"2011","Birmingham 140F","E01009393","Total",1645,858,787,1645,0,10,16.02,102.7
"2011","Birmingham 140G","E01033641","Total",3296,1673,1623,3296,0,25,60.84,54.2
"2011","Coventry 001A","E01009589","Total",1425,713,712,1425,0,13,59.52,23.9
"2011","Coventry 001F","E01032536","Total",1897,944,953,1897,0,13,107.45,17.7
"2011","Coventry 001G","E01032537","Total",1950,940,1010,1929,21,16,38.94,50.1
"2011","Coventry 001H","E01032538","Total",2180,1047,1133,2171,9,20,62.78,34.7
"2011","Coventry 002A","E01009590","Total",1388,687,701,1312,76,11,330.70,4.2
"2011","Coventry 002B","E01009591","Total",1540,762,778,1540,0,5,33.56,45.9
"2011","Coventry 002C","E01009593","Total",1654,832,822,1641,13,14,25.94,63.8
"2011","Coventry 002D","E01009598","Total",1619,800,819,1617,2,15,38.91,41.6
"2011","Coventry 004A","E01009604","Total",1459,732,727,1459,0,6,28.29,51.6
"2011","Coventry 004B","E01009605","Total",1499,725,774,1495,4,8,43.57,34.4
"2011","Coventry 004C","E01009607","Total",1495,764,731,1495,0,6,27.95,53.5
"2011","Coventry 004D","E01009608","Total",1581,771,810,1571,10,11,26.17,60.4
"2011","Coventry 004E","E01009610","Total",1464,731,733,1464,0,6,24.89,58.8
"2011","Coventry 005A","E01009564","Total",1657,800,857,1657,0,8,38.69,42.8
"2011","Coventry 005B","E01009575","Total",1310,609,701,1306,4,12,40.35,32.5
"2011","Coventry 005C","E01009606","Total",1478,711,767,1465,13,13,39.15,37.8
"2011","Coventry 005D","E01009609","Total",1589,751,838,1589,0,17,25.12,63.3
"2011","Coventry 006A","E01009524","Total",1504,692,812,1486,18,22,51.27,29.3
"2011","Coventry 006B","E01009525","Total",1435,689,746,1435,0,10,27.19,52.8
"2011","Coventry 006C","E01009527","Total",1610,813,797,1610,0,10,23.31,69.1
"2011","Coventry 006D","E01009594","Total",1377,680,697,1377,0,19,25.81,53.4
"2011","Coventry 007A","E01009577","Total",1293,615,678,1254,39,3,21.67,59.7
"2011","Coventry 007B","E01009579","Total",1681,791,890,1681,0,6,47.45,35.4
"2011","Coventry 007C","E01009581","Total",1569,720,849,1539,30,10,33.28,47.1
"2011","Coventry 007D","E01009584","Total",1422,681,741,1418,4,4,181.33,7.8
"2011","Coventry 007E","E01009585","Total",1062,477,585,1062,0,0,25.15,42.2
"2011","Coventry 007F","E01009709","Total",1065,498,567,1065,0,16,22.24,47.9
"2011","Coventry 008A","E01009576","Total",1575,754,821,1552,23,13,28.29,55.7
"2011","Coventry 008B","E01009578","Total",1425,711,714,1421,4,24,102.69,13.9
"2011","Coventry 008C","E01009582","Total",1740,816,924,1725,15,19,31.37,55.5
"2011","Coventry 008D","E01009583","Total",1608,761,847,1608,0,27,27.24,59.0
"2011","Coventry 008E","E01009586","Total",1671,831,840,1671,0,21,35.63,46.9
"2011","Coventry 009A","E01009565","Total",1715,857,858,1715,0,13,16.89,101.5
"2011","Coventry 009B","E01009566","Total",1581,806,775,1559,22,19,44.08,35.9
"2011","Coventry 009C","E01009567","Total",1838,939,899,1826,12,9,37.27,49.3
"2011","Coventry 009D","E01009568","Total",1788,902,886,1788,0,18,19.06,93.8
"2011","Coventry 010A","E01009523","Total",1532,741,791,1466,66,26,1255.74,1.2
"2011","Coventry 010B","E01009526","Total",1615,795,820,1559,56,18,254.36,6.3
"2011","Coventry 010C","E01009528","Total",1595,796,799,1587,8,20,82.03,19.4
"2011","Coventry 010D","E01009531","Total",1539,731,808,1535,4,21,42.22,36.5
"2011","Coventry 011A","E01009587","Total",1535,768,767,1535,0,13,73.42,20.9
"2011","Coventry 011B","E01009624","Total",1628,770,858,1628,0,9,19.57,83.2
"2011","Coventry 011C","E01009625","Total",2346,1131,1215,2346,0,29,26.05,90.1
"2011","Coventry 011D","E01009626","Total",1638,806,832,1638,0,10,40.16,40.8
"2011","Coventry 012A","E01009622","Total",1782,809,973,1737,45,13,27.82,64.1
"2011","Coventry 012B","E01009623","Total",1523,744,779,1523,0,6,19.62,77.6
"2011","Coventry 012C","E01009627","Total",1561,764,797,1561,0,9,22.71,68.7
"2011","Coventry 012D","E01009628","Total",1511,722,789,1511,0,12,22.39,67.5
"2011","Coventry 013A","E01009599","Total",1240,600,640,1237,3,13,47.26,26.2
"2011","Coventry 013B","E01009663","Total",1438,691,747,1438,0,5,29.44,48.8
"2011","Coventry 013C","E01009710","Total",1393,704,689,1380,13,15,47.02,29.6
"2011","Coventry 013D","E01009711","Total",1411,707,704,1381,30,10,52.02,27.1
"2011","Coventry 014A","E01009522","Total",1434,670,764,1434,0,14,49.10,29.2
"2011","Coventry 014B","E01009529","Total",1541,763,778,1541,0,16,21.24,72.6
"2011","Coventry 014C","E01009530","Total",1385,671,714,1385,0,23,25.30,54.7
"2011","Coventry 014D","E01009645","Total",1474,721,753,1474,0,15,16.39,89.9
"2011","Coventry 015A","E01009569","Total",1309,639,670,1309,0,11,25.52,51.3
"2011","Coventry 015B","E01009570","Total",1802,936,866,1778,24,18,23.46,76.8
"2011","Coventry 015C","E01009571","Total",1623,851,772,1599,24,3,17.38,93.4
"2011","Coventry 015D","E01009572","Total",2176,1119,1057,2176,0,14,74.28,29.3
"2011","Coventry 015E","E01009573","Total",1544,798,746,1544,0,19,19.86,77.7
"2011","Coventry 015F","E01009574","Total",1600,814,786,1529,71,16,28.92,55.3
"2011","Coventry 016A","E01009655","Total",1853,903,950,1853,0,7,21.42,86.5
"2011","Coventry 016B","E01009656","Total",1604,806,798,1583,21,7,31.15,51.5
"2011","Coventry 016C","E01009659","Total",1724,874,850,1724,0,13,17.51,98.5
"2011","Coventry 016D","E01009662","Total",1440,747,693,1440,0,17,37.77,38.1
"2011","Coventry 016E","E01009664","Total",1511,768,743,1511,0,13,20.48,73.8
"2011","Coventry 017A","E01009643","Total",1499,735,764,1499,0,21,32.44,46.2
"2011","Coventry 017B","E01009644","Total",1657,787,870,1657,0,18,21.80,76.0
"2011","Coventry 017C","E01009647","Total",1751,810,941,1715,36,23,50.99,34.3
"2011","Coventry 017D","E01009648","Total",1545,759,786,1545,0,23,24.93,62.0
"2011","Coventry 017E","E01009652","Total",1446,710,736,1446,0,11,54.09,26.7
"2011","Coventry 017F","E01009653","Total",1574,762,812,1574,0,20,20.17,78.0
"2011","Coventry 018A","E01009613","Total",1309,636,673,1308,1,13,18.45,70.9
"2011","Coventry 018B","E01009657","Total",1672,814,858,1672,0,24,24.01,69.6
"2011","Coventry 018C","E01009712","Total",1597,775,822,1597,0,9,31.02,51.5
"2011","Coventry 018D","E01009714","Total",1539,741,798,1539,0,10,19.64,78.4
"2011","Coventry 018E","E01009716","Total",1743,844,899,1738,5,20,25.64,68.0
"2011","Coventry 019A","E01009580","Total",1213,584,629,1191,22,11,137.10,8.8
"2011","Coventry 019B","E01009713","Total",1397,673,724,1386,11,14,37.52,37.2
"2011","Coventry 019C","E01009715","Total",1377,665,712,1377,0,18,35.93,38.3
"2011","Coventry 019D","E01009717","Total",1458,738,720,1458,0,27,81.33,17.9
"2011","Coventry 019E","E01009718","Total",1687,857,830,1673,14,7,46.55,36.2
"2011","Coventry 020A","E01009629","Total",2758,1431,1327,2698,60,19,38.05,72.5
"2011","Coventry 020B","E01009630","Total",1685,781,904,1661,24,14,33.96,49.6
"2011","Coventry 020C","E01009631","Total",1329,635,694,1316,13,9,22.40,59.3
"2011","Coventry 020D","E01009632","Total",1642,944,698,1596,46,10,32.19,51.0
"2011","Coventry 020E","E01009650","Total",1600,914,686,1547,53,10,20.43,78.3
"2011","Coventry 021A","E01009614","Total",1457,681,776,1452,5,25,20.70,70.4
"2011","Coventry 021B","E01009654","Total",1764,853,911,1764,0,10,20.10,87.8
"2011","Coventry 021C","E01009658","Total",1509,774,735,1487,22,5,33.15,45.5
"2011","Coventry 021D","E01009660","Total",1773,950,823,1768,5,26,25.88,68.5
"2011","Coventry 022A","E01009646","Total",1524,761,763,1524,0,19,20.08,75.9
"2011","Coventry 022B","E01009692","Total",1274,591,683,1226,48,19,51.70,24.6
"2011","Coventry 022C","E01009693","Total",1500,715,785,1500,0,12,24.97,60.1
"2011","Coventry 022D","E01009694","Total",1428,692,736,1428,0,19,42.83,33.3
"2011","Coventry 023A","E01009695","Total",1546,767,779,1546,0,11,36.48,42.4
"2011","Coventry 023B","E01009696","Total",1516,752,764,1492,24,14,29.59,51.2
"2011","Coventry 023C","E01009704","Total",1475,715,760,1475,0,30,35.57,41.5
"2011","Coventry 023D","E01009705","Total",1459,714,745,1459,0,20,35.60,41.0
"2011","Coventry 024A","E01009636","Total",2270,1202,1068,2269,1,29,19.19,118.3
"2011","Coventry 024B","E01009637","Total",1488,747,741,1488,0,11,10.44,142.5
"2011","Coventry 024C","E01009638","Total",1503,839,664,1503,0,8,33.70,44.6
"2011","Coventry 024D","E01009639","Total",1746,888,858,1746,0,17,13.01,134.2
"2011","Coventry 024E","E01009640","Total",1871,955,916,1871,0,15,17.87,104.7
"2011","Coventry 024F","E01009641","Total",2875,1531,1344,2050,825,46,29.45,97.6
"2011","Coventry 025A","E01009697","Total",1454,737,717,1454,0,18,66.65,21.8
"2011","Coventry 025B","E01009698","Total",1526,758,768,1526,0,16,31.89,47.9
"2011","Coventry 025C","E01009703","Total",2591,1240,1351,2591,0,22,76.11,34.0
"2011","Coventry 025D","E01009706","Total",1491,732,759,1491,0,21,31.18,47.8
"2011","Coventry 026A","E01009649","Total",1418,711,707,1418,0,7,33.69,42.1
"2011","Coventry 026B","E01009684","Total",1405,674,731,1366,39,9,23.11,60.8
"2011","Coventry 026C","E01009685","Total",1642,794,848,1634,8,16,27.37,60.0
"2011","Coventry 026D","E01009686","Total",1674,812,862,1667,7,27,83.93,19.9
"2011","Coventry 026E","E01009687","Total",1407,710,697,1407,0,15,38.50,36.5
"2011","Coventry 027A","E01009615","Total",1778,917,861,1736,42,15,25.12,70.8
"2011","Coventry 027B","E01009616","Total",1559,733,826,1559,0,21,17.39,89.6
"2011","Coventry 027C","E01009617","Total",1272,626,646,1248,24,15,19.27,66.0
"2011","Coventry 027D","E01009618","Total",1526,755,771,1526,0,15,26.80,56.9
"2011","Coventry 027E","E01009620","Total",1466,713,753,1425,41,9,45.08,32.5
"2011","Coventry 027F","E01009621","Total",1366,677,689,1335,31,5,25.81,52.9
"2011","Coventry 028A","E01009633","Total",1781,950,831,1778,3,16,34.99,50.9
"2011","Coventry 028B","E01009634","Total",1641,880,761,1641,0,8,25.77,63.7
"2011","Coventry 028C","E01009635","Total",3207,1834,1373,2129,1078,65,37.56,85.4
"2011","Coventry 028D","E01009661","Total",1824,946,878,1822,2,11,22.68,80.4
"2011","Coventry 029A","E01009674","Total",1590,757,833,1496,94,19,32.92,48.3
"2011","Coventry 029B","E01009699","Total",1430,714,716,1430,0,10,26.94,53.1
"2011","Coventry 029C","E01009700","Total",1614,790,824,1614,0,10,39.91,40.4
"2011","Coventry 029D","E01009701","Total",1519,716,803,1519,0,12,59.47,25.5
"2011","Coventry 029E","E01009702","Total",1444,700,744,1444,0,9,40.21,35.9
"2011","Coventry 030A","E01009688","Total",1479,784,695,1479,0,17,21.54,68.7
"2011","Coventry 030B","E01009689","Total",1475,810,665,1465,10,3,22.28,66.2
"2011","Coventry 030C","E01009690","Total",1471,731,740,1471,0,22,27.99,52.6
"2011","Coventry 030D","E01009691","Total",1360,706,654,1360,0,9,11.64,116.8
"2011","Coventry 031A","E01009548","Total",2273,1198,1075,2143,130,30,79.95,28.4
"2011","Coventry 031B","E01009553","Total",2099,1208,891,1459,640,40,36.11,58.1
"2011","Coventry 031C","E01009642","Total",2766,1677,1089,1736,1030,31,86.53,32.0
"2011","Coventry 031D","E01009651","Total",1648,902,746,1565,83,15,15.81,104.2
"2011","Coventry 032A","E01009676","Total",1482,712,770,1482,0,5,42.69,34.7
"2011","Coventry 032B","E01009681","Total",1286,653,633,1259,27,11,26.10,49.3
"2011","Coventry 032C","E01009682","Total",1531,771,760,1531,0,10,23.30,65.7
"2011","Coventry 032D","E01009683","Total",1354,645,709,1354,0,4,38.15,35.5
"2011","Coventry 033A","E01009532","Total",1338,638,700,1319,19,7,39.78,33.6
"2011","Coventry 033B","E01009535","Total",1330,657,673,1330,0,13,24.63,54.0
"2011","Coventry 033C","E01009536","Total",1472,743,729,1472,0,8,35.58,41.4
"2011","Coventry 033D","E01009543","Total",1761,882,879,1737,24,49,61.39,28.7
"2011","Coventry 033E","E01009707","Total",1869,919,950,1869,0,22,28.14,66.4
"2011","Coventry 033F","E01009708","Total",1486,709,777,1457,29,20,37.65,39.5
"2011","Coventry 034A","E01009554","Total",1321,669,652,1296,25,29,16.74,78.9
"2011","Coventry 034B","E01009555","Total",1452,746,706,1452,0,19,71.15,20.4
"2011","Coventry 034C","E01009556","Total",1522,740,782,1508,14,38,27.60,55.1
"2011","Coventry 034D","E01009557","Total",1329,658,671,1314,15,50,105.53,12.6
"2011","Coventry 034E","E01009558","Total",1490,775,715,1472,18,46,18.47,80.7
"2011","Coventry 034F","E01009559","Total",1401,674,727,1337,64,36,94.78,14.8
"2011","Coventry 035C","E01009537","Total",1494,717,777,1449,45,13,29.57,50.5
"2011","Coventry 035D","E01009538","Total",1447,687,760,1447,0,4,81.78,17.7
"2011","Coventry 035E","E01009611","Total",2138,1016,1122,2138,0,25,74.52,28.7
"2011","Coventry 035F","E01009612","Total",1402,679,723,1402,0,13,23.39,59.9
"2011","Coventry 035G","E01032527","Total",1571,752,819,1571,0,17,26.53,59.2
"2011","Coventry 035H","E01032528","Total",1521,712,809,1519,2,8,50.03,30.4
"2011","Coventry 036C","E01009679","Total",1463,739,724,1463,0,9,41.76,35.0
"2011","Coventry 036E","E01032531","Total",2600,1242,1358,2600,0,7,124.75,20.8
"2011","Coventry 036F","E01032532","Total",1320,645,675,1282,38,8,106.25,12.4
"2011","Coventry 036G","E01032533","Total",1857,945,912,1857,0,63,133.92,13.9
"2011","Coventry 037B","E01009549","Total",1619,795,824,1619,0,20,39.18,41.3
"2011","Coventry 037C","E01009550","Total",1854,913,941,1854,0,24,23.41,79.2
"2011","Coventry 037E","E01009552","Total",1595,770,825,1595,0,23,30.05,53.1
"2011","Coventry 037F","E01032534","Total",1906,895,1011,1854,52,23,22.97,83.0
"2011","Coventry 037G","E01032535","Total",1185,581,604,1177,8,8,22.11,53.6
"2011","Coventry 038A","E01009544","Total",1543,794,749,1506,37,9,127.23,12.1
"2011","Coventry 038D","E01009619","Total",1885,1031,854,1852,33,14,64.32,29.3
"2011","Coventry 038E","E01032529","Total",1238,583,655,1238,0,1,112.63,11.0
"2011","Coventry 038F","E01032530","Total",1849,924,925,1772,77,21,151.36,12.2
"2011","Coventry 039A","E01009539","Total",1587,783,804,1587,0,6,44.34,35.8
"2011","Coventry 039B","E01009540","Total",1926,919,1007,1926,0,10,32.69,58.9
"2011","Coventry 039C","E01009541","Total",1532,742,790,1532,0,5,42.66,35.9
"2011","Coventry 039D","E01009542","Total",1774,970,804,1736,38,16,33.72,52.6
"2011","Coventry 040A","E01009560","Total",1539,776,763,1523,16,35,36.33,42.4
"2011","Coventry 040B","E01009561","Total",1587,766,821,1587,0,26,51.39,30.9
"2011","Coventry 040C","E01009562","Total",1642,819,823,1642,0,23,35.42,46.4
"2011","Coventry 040D","E01009563","Total",1672,808,864,1672,0,37,30.80,54.3
"2011","Coventry 040E","E01009672","Total",2086,1020,1066,2086,0,55,62.90,33.2
"2011","Coventry 041A","E01009666","Total",1310,647,663,1310,0,32,23.61,55.5
"2011","Coventry 041B","E01009667","Total",1356,645,711,1356,0,21,38.07,35.6
"2011","Coventry 041C","E01009668","Total",1643,793,850,1643,0,32,41.92,39.2
"2011","Coventry 041D","E01009670","Total",1664,847,817,1664,0,35,27.38,60.8
"2011","Coventry 042A","E01009665","Total",1188,601,587,1188,0,28,63.53,18.7
"2011","Coventry 042B","E01009669","Total",1288,638,650,1288,0,30,22.17,58.1
"2011","Coventry 042C","E01009671","Total",4248,2171,2077,1272,2976,106,265.91,16.0
"2011","Coventry 042F","E01033058","Total",2674,1374,1300,2187,487,49,115.17,23.2
"2011","Coventry 043A","E01009588","Total",1538,731,807,1538,0,6,28.47,54.0
"2011","Coventry 043B","E01009592","Total",1633,768,865,1633,0,10,22.16,73.7
"2011","Coventry 043C","E01009596","Total",1524,752,772,1524,0,24,29.54,51.6
"2011","Coventry 043D","E01009597","Total",1788,854,934,1763,25,15,28.01,63.8
"2011","Coventry 043E","E01032587","Total",1747,861,886,1747,0,25,22.83,76.5
"2011","Dudley 001A","E01009763","Total",1857,891,966,1853,4,7,41.81,44.4
"2011","Dudley 001B","E01009764","Total",1425,711,714,1425,0,9,51.60,27.6
"2011","Dudley 001C","E01009767","Total",1468,701,767,1468,0,6,27.40,53.6
"2011","Dudley 001D","E01009769","Total",1579,788,791,1579,0,2,87.41,18.1
"2011","Dudley 001E","E01009770","Total",1453,710,743,1453,0,5,25.51,57.0
"2011","Dudley 002A","E01009773","Total",1543,739,804,1539,4,5,32.33,47.7
"2011","Dudley 002B","E01009777","Total",1451,739,712,1451,0,8,61.70,23.5
"2011","Dudley 002C","E01009778","Total",1550,784,766,1547,3,8,59.36,26.1
"2011","Dudley 002D","E01009895","Total",1407,673,734,1407,0,6,46.27,30.4
"2011","Dudley 003A","E01009896","Total",1486,710,776,1486,0,15,31.83,46.7
"2011","Dudley 003B","E01009897","Total",1455,732,723,1455,0,15,49.15,29.6
"2011","Dudley 003C","E01009898","Total",1477,707,770,1440,37,17,82.09,18.0
"2011","Dudley 003D","E01009901","Total",1397,675,722,1366,31,11,43.51,32.1
"2011","Dudley 003E","E01009902","Total",1269,615,654,1269,0,11,33.57,37.8
"2011","Dudley 004A","E01009765","Total",1604,799,805,1604,0,13,26.65,60.2
"2011","Dudley 004B","E01009766","Total",1584,784,800,1584,0,4,23.61,67.1
"2011","Dudley 004C","E01009768","Total",1387,659,728,1387,0,8,39.56,35.1
"2011","Dudley 004D","E01009771","Total",1392,667,725,1338,54,7,38.67,36.0
"2011","Dudley 004E","E01009775","Total",1600,779,821,1587,13,12,27.73,57.7
"2011","Dudley 004F","E01009776","Total",1534,758,776,1534,0,9,61.16,25.1
"2011","Dudley 005A","E01009758","Total",1703,831,872,1687,16,2,29.75,57.2
"2011","Dudley 005B","E01009760","Total",1317,652,665,1317,0,9,22.89,57.5
"2011","Dudley 005C","E01009772","Total",1343,607,736,1324,19,14,23.05,58.3
"2011","Dudley 005D","E01009774","Total",1577,760,817,1525,52,13,66.11,23.9
"2011","Dudley 005E","E01009788","Total",1578,776,802,1578,0,3,26.80,58.9
"2011","Dudley 006B","E01009756","Total",1411,658,753,1404,7,6,23.62,59.7
"2011","Dudley 006C","E01009757","Total",1652,804,848,1616,36,9,159.67,10.3
"2011","Dudley 006D","E01009759","Total",1291,663,628,1291,0,6,24.60,52.5
"2011","Dudley 006F","E01009762","Total",1398,646,752,1398,0,5,16.92,82.6
"2011","Dudley 006G","E01033187","Total",2338,1109,1229,2338,0,9,81.23,28.8
"2011","Dudley 007A","E01009781","Total",1899,940,959,1899,0,10,45.12,42.1
"2011","Dudley 007B","E01009786","Total",1497,732,765,1497,0,9,24.04,62.3
"2011","Dudley 007C","E01009789","Total",1459,723,736,1459,0,8,38.48,37.9
"2011","Dudley 007D","E01009790","Total",1545,780,765,1545,0,7,29.31,52.7
"2011","Dudley 008A","E01009779","Total",1359,661,698,1359,0,11,28.23,48.1
"2011","Dudley 008B","E01009782","Total",1557,751,806,1551,6,8,41.82,37.2
"2011","Dudley 008C","E01009783","Total",1467,737,730,1467,0,10,41.41,35.4
"2011","Dudley 008D","E01009785","Total",1448,717,731,1448,0,9,78.06,18.5
"2011","Dudley 008E","E01009899","Total",1436,704,732,1436,0,9,35.57,40.4
"2011","Dudley 008F","E01009900","Total",1464,711,753,1464,0,6,59.11,24.8
"2011","Dudley 009A","E01009780","Total",2071,1021,1050,2071,0,22,43.42,47.7
"2011","Dudley 009B","E01009784","Total",1669,823,846,1669,0,24,35.28,47.3
"2011","Dudley 009C","E01009787","Total",1571,785,786,1571,0,26,71.98,21.8
"2011","Dudley 009D","E01009880","Total",1603,785,818,1503,100,13,36.18,44.3
"2011","Dudley 009E","E01009882","Total",1415,712,703,1406,9,10,30.69,46.1
"2011","Dudley 010A","E01009891","Total",1729,835,894,1729,0,7,24.12,71.7
"2011","Dudley 010B","E01009892","Total",1508,745,763,1508,0,11,40.60,37.1
"2011","Dudley 010C","E01009893","Total",1716,817,899,1713,3,10,25.33,67.7
"2011","Dudley 010D","E01009894","Total",1757,835,922,1757,0,15,32.49,54.1
"2011","Dudley 011A","E01009844","Total",1499,751,748,1472,27,5,61.28,24.5
"2011","Dudley 011B","E01009879","Total",2049,995,1054,1997,52,18,37.85,54.1
"2011","Dudley 011C","E01009881","Total",2077,1116,961,2004,73,8,70.61,29.4
"2011","Dudley 011D","E01009885","Total",1561,790,771,1547,14,20,39.45,39.6
"2011","Dudley 012A","E01009816","Total",1473,720,753,1467,6,13,117.69,12.5
"2011","Dudley 012B","E01009817","Total",1283,605,678,1274,9,16,40.68,31.5
"2011","Dudley 012C","E01009819","Total",1560,766,794,1560,0,12,122.86,12.7
"2011","Dudley 012D","E01009820","Total",1548,741,807,1488,60,19,40.14,38.6
"2011","Dudley 013A","E01009748","Total",1636,796,840,1627,9,8,95.98,17.0
"2011","Dudley 013B","E01009839","Total",1646,825,821,1587,59,8,33.25,49.5
"2011","Dudley 013C","E01009883","Total",1368,670,698,1349,19,5,34.50,39.7
"2011","Dudley 013D","E01009884","Total",1548,789,759,1523,25,5,48.04,32.2
"2011","Dudley 013E","E01009886","Total",1592,792,800,1592,0,7,32.69,48.7
"2011","Dudley 014A","E01009814","Total",1329,631,698,1258,71,13,41.75,31.8
"2011","Dudley 014B","E01009815","Total",1325,653,672,1325,0,27,59.32,22.3
"2011","Dudley 014C","E01009818","Total",1139,564,575,1139,0,16,23.40,48.7
"2011","Dudley 014D","E01009821","Total",1400,681,719,1400,0,13,28.81,48.6
"2011","Dudley 014E","E01009822","Total",1504,722,782,1467,37,19,37.52,40.1
"2011","Dudley 015A","E01009887","Total",1783,868,915,1759,24,10,46.81,38.1
"2011","Dudley 015B","E01009888","Total",1615,798,817,1598,17,4,34.98,46.2
"2011","Dudley 015C","E01009889","Total",1838,921,917,1815,23,12,83.94,21.9
"2011","Dudley 015D","E01009890","Total",1693,820,873,1693,0,13,41.73,40.6
"2011","Dudley 016A","E01009749","Total",1454,729,725,1412,42,11,91.37,15.9
"2011","Dudley 016B","E01009750","Total",1521,771,750,1521,0,4,30.85,49.3
"2011","Dudley 016C","E01009823","Total",1401,714,687,1401,0,17,52.81,26.5
"2011","Dudley 016D","E01009824","Total",1648,813,835,1648,0,6,50.66,32.5
"2011","Dudley 017A","E01009751","Total",1498,733,765,1492,6,8,35.25,42.5
"2011","Dudley 017B","E01009752","Total",1504,745,759,1504,0,4,51.98,28.9
"2011","Dudley 017C","E01009753","Total",1578,754,824,1578,0,7,43.16,36.6
"2011","Dudley 017D","E01009754","Total",1641,792,849,1641,0,3,56.82,28.9
"2011","Dudley 017E","E01009841","Total",1605,780,825,1580,25,7,66.45,24.2
"2011","Dudley 018A","E01009840","Total",1435,696,739,1393,42,15,89.10,16.1
"2011","Dudley 018B","E01009842","Total",1837,968,869,1828,9,4,37.32,49.2
"2011","Dudley 018C","E01009843","Total",1569,759,810,1569,0,11,51.39,30.5
"2011","Dudley 018D","E01009871","Total",1844,952,892,1844,0,5,34.44,53.5
"2011","Dudley 018E","E01009875","Total",1594,769,825,1512,82,8,31.15,51.2
"2011","Dudley 019A","E01009825","Total",1435,710,725,1435,0,18,32.01,44.8
"2011","Dudley 019B","E01009826","Total",1469,725,744,1469,0,19,28.65,51.3
"2011","Dudley 019C","E01009827","Total",1600,777,823,1600,0,31,44.05,36.3
"2011","Dudley 019D","E01009828","Total",1378,685,693,1378,0,3,38.70,35.6
"2011","Dudley 019E","E01009829","Total",1547,764,783,1547,0,25,38.90,39.8
"2011","Dudley 019F","E01009830","Total",1607,775,832,1575,32,25,34.86,46.1
"2011","Dudley 020A","E01009872","Total",1499,760,739,1499,0,9,22.20,67.5
"2011","Dudley 020B","E01009873","Total",1509,732,777,1509,0,6,45.76,33.0
"2011","Dudley 020C","E01009874","Total",1615,825,790,1615,0,5,127.16,12.7
"2011","Dudley 020D","E01009876","Total",1668,822,846,1668,0,6,34.75,48.0
"2011","Dudley 020E","E01009877","Total",1566,763,803,1566,0,5,29.95,52.3
"2011","Dudley 021A","E01009911","Total",1354,679,675,1354,0,9,36.24,37.4
"2011","Dudley 021B","E01009912","Total",1708,821,887,1689,19,19,34.06,50.1
"2011","Dudley 021C","E01009913","Total",1544,775,769,1544,0,1,56.17,27.5
"2011","Dudley 021D","E01009914","Total",1429,688,741,1429,0,18,29.97,47.7
"2011","Dudley 021E","E01009915","Total",1721,834,887,1598,123,11,51.40,33.5
"2011","Dudley 021F","E01009916","Total",1695,850,845,1695,0,9,38.20,44.4
"2011","Dudley 022A","E01009741","Total",2291,1219,1072,2291,0,10,104.43,21.9
"2011","Dudley 022B","E01009744","Total",1871,930,941,1861,10,14,63.05,29.7
"2011","Dudley 022C","E01009746","Total",1661,845,816,1622,39,16,91.23,18.2
"2011","Dudley 022D","E01009747","Total",1492,741,751,1475,17,7,32.64,45.7
"2011","Dudley 023A","E01009731","Total",1566,780,786,1538,28,18,33.85,46.3
"2011","Dudley 023B","E01009740","Total",1682,808,874,1682,0,11,59.10,28.5
"2011","Dudley 023C","E01009742","Total",1568,744,824,1568,0,3,35.92,43.7
"2011","Dudley 023D","E01009743","Total",1795,862,933,1794,1,8,46.11,38.9
"2011","Dudley 023E","E01009745","Total",1713,841,872,1698,15,10,30.27,56.6
"2011","Dudley 024A","E01009917","Total",1266,628,638,1266,0,14,15.74,80.4
"2011","Dudley 024B","E01009918","Total",1424,664,760,1424,0,1,31.13,45.7
"2011","Dudley 024C","E01009919","Total",1240,624,616,1240,0,13,17.72,70.0
"2011","Dudley 024D","E01009920","Total",1409,708,701,1409,0,9,26.60,53.0
"2011","Dudley 025A","E01009864","Total",1636,795,841,1636,0,12,29.13,56.2
"2011","Dudley 025B","E01009865","Total",1491,722,769,1491,0,6,36.39,41.0
"2011","Dudley 025C","E01009866","Total",1652,808,844,1647,5,8,31.24,52.9
"2011","Dudley 025D","E01009867","Total",1734,861,873,1734,0,6,66.59,26.0
"2011","Dudley 025E","E01009878","Total",2023,980,1043,1980,43,6,56.57,35.8
"2011","Dudley 026A","E01009791","Total",1509,765,744,1509,0,13,22.34,67.5
"2011","Dudley 026B","E01009792","Total",1583,777,806,1583,0,8,33.26,47.6
"2011","Dudley 026C","E01009795","Total",1657,798,859,1657,0,5,28.86,57.4
"2011","Dudley 026D","E01009796","Total",1510,738,772,1503,7,9,80.45,18.8
"2011","Dudley 026E","E01009798","Total",1702,847,855,1691,11,13,55.97,30.4
"2011","Dudley 027A","E01009719","Total",1443,720,723,1443,0,10,32.25,44.7
"2011","Dudley 027B","E01009722","Total",1370,665,705,1370,0,8,35.35,38.8
"2011","Dudley 027C","E01009727","Total",1353,674,679,1353,0,22,37.31,36.3
"2011","Dudley 027D","E01009728","Total",1351,701,650,1351,0,3,23.29,58.0
"2011","Dudley 027E","E01009729","Total",1570,787,783,1570,0,14,28.59,54.9
"2011","Dudley 028A","E01009720","Total",1416,694,722,1416,0,22,28.18,50.2
"2011","Dudley 028B","E01009723","Total",1258,637,621,1258,0,18,24.46,51.4
"2011","Dudley 028C","E01009724","Total",1497,732,765,1497,0,18,31.37,47.7
"2011","Dudley 028D","E01009730","Total",1488,743,745,1488,0,14,35.63,41.8
"2011","Dudley 029A","E01009903","Total",1458,698,760,1439,19,19,31.31,46.6
"2011","Dudley 029B","E01009904","Total",1447,693,754,1401,46,13,28.93,50.0
"2011","Dudley 029C","E01009909","Total",1362,632,730,1362,0,10,33.30,40.9
"2011","Dudley 029D","E01009910","Total",1579,772,807,1579,0,7,31.61,50.0
"2011","Dudley 030A","E01009793","Total",1387,683,704,1387,0,25,38.62,35.9
"2011","Dudley 030B","E01009794","Total",1477,720,757,1477,0,14,38.23,38.6
"2011","Dudley 030C","E01009797","Total",1348,620,728,1348,0,15,44.45,30.3
"2011","Dudley 030D","E01009801","Total",1664,815,849,1634,30,28,68.89,24.2
"2011","Dudley 031A","E01009721","Total",1898,910,988,1844,54,17,83.12,22.8
"2011","Dudley 031B","E01009725","Total",1439,680,759,1439,0,7,23.30,61.8
"2011","Dudley 031C","E01009726","Total",1332,681,651,1332,0,19,28.27,47.1
"2011","Dudley 031D","E01009834","Total",1605,774,831,1605,0,5,37.41,42.9
"2011","Dudley 032A","E01009833","Total",1392,689,703,1382,10,12,50.27,27.7
"2011","Dudley 032B","E01009835","Total",1563,772,791,1496,67,18,39.42,39.6
"2011","Dudley 032C","E01009869","Total",1590,767,823,1590,0,9,37.76,42.1
"2011","Dudley 032D","E01009870","Total",1460,779,681,1446,14,12,52.82,27.6
"2011","Dudley 033A","E01009809","Total",1628,776,852,1628,0,11,54.29,30.0
"2011","Dudley 033B","E01009813","Total",1600,780,820,1600,0,6,41.32,38.7
"2011","Dudley 033C","E01009861","Total",1549,741,808,1545,4,9,25.64,60.4
"2011","Dudley 033D","E01009862","Total",1759,848,911,1733,26,17,68.97,25.5
"2011","Dudley 033E","E01009863","Total",1844,901,943,1844,0,8,37.13,49.7
"2011","Dudley 033F","E01009868","Total",1560,763,797,1560,0,7,32.52,48.0
"2011","Dudley 034A","E01009734","Total",1528,756,772,1524,4,16,132.14,11.6
"2011","Dudley 034B","E01009735","Total",1495,751,744,1495,0,19,46.59,32.1
"2011","Dudley 034C","E01009736","Total",1395,684,711,1390,5,11,41.58,33.5
"2011","Dudley 034D","E01009737","Total",1479,713,766,1479,0,16,36.18,40.9
"2011","Dudley 034E","E01009738","Total",1558,750,808,1558,0,14,32.40,48.1
"2011","Dudley 035A","E01009856","Total",1983,1008,975,1978,5,24,62.51,31.7
"2011","Dudley 035B","E01009905","Total",1389,671,718,1389,0,24,33.43,41.5
"2011","Dudley 035C","E01009906","Total",1621,866,755,1621,0,6,32.65,49.6
"2011","Dudley 035D","E01009907","Total",1468,707,761,1425,43,18,25.08,58.5
"2011","Dudley 035E","E01009908","Total",1652,814,838,1640,12,38,25.57,64.6
"2011","Dudley 036A","E01009800","Total",1567,737,830,1529,38,15,35.21,44.5
"2011","Dudley 036B","E01009802","Total",1619,788,831,1619,0,15,49.98,32.4
"2011","Dudley 036C","E01009803","Total",1631,803,828,1631,0,28,49.77,32.8
"2011","Dudley 036D","E01009804","Total",1328,662,666,1286,42,22,378.59,3.5
"2011","Dudley 037A","E01009831","Total",1469,748,721,1469,0,5,54.57,26.9
"2011","Dudley 037B","E01009836","Total",1834,910,924,1834,0,6,69.84,26.3
"2011","Dudley 037C","E01009837","Total",1604,811,793,1589,15,8,30.01,53.4
"2011","Dudley 037D","E01009838","Total",1668,845,823,1668,0,8,74.60,22.4
"2011","Dudley 038A","E01009847","Total",1465,724,741,1465,0,12,42.82,34.2
"2011","Dudley 038B","E01009848","Total",1430,698,732,1430,0,21,38.82,36.8
"2011","Dudley 038C","E01009849","Total",1541,751,790,1541,0,17,35.41,43.5
"2011","Dudley 038D","E01009851","Total",1438,689,749,1423,15,27,35.11,41.0
"2011","Dudley 039A","E01009732","Total",1744,861,883,1736,8,19,32.09,54.3
"2011","Dudley 039B","E01009733","Total",1779,887,892,1762,17,7,27.86,63.9
"2011","Dudley 039C","E01009739","Total",1537,756,781,1537,0,12,29.14,52.7
"2011","Dudley 039D","E01009799","Total",1497,723,774,1497,0,14,39.48,37.9
"2011","Dudley 039E","E01009805","Total",1402,689,713,1394,8,21,46.66,30.0
"2011","Dudley 039F","E01009806","Total",1451,713,738,1451,0,21,27.31,53.1
"2011","Dudley 040A","E01009854","Total",1533,751,782,1502,31,31,45.78,33.5
"2011","Dudley 040B","E01009857","Total",1613,785,828,1613,0,14,40.21,40.1
"2011","Dudley 040C","E01009858","Total",1565,912,653,1143,422,48,30.71,51.0
"2011","Dudley 040D","E01009859","Total",1616,790,826,1597,19,23,50.85,31.8
"2011","Dudley 041A","E01009845","Total",1521,755,766,1521,0,32,182.33,8.3
"2011","Dudley 041B","E01009846","Total",1473,719,754,1473,0,33,119.96,12.3
"2011","Dudley 041C","E01009850","Total",1480,710,770,1460,20,25,47.92,30.9
"2011","Dudley 041D","E01009852","Total",1493,720,773,1473,20,35,66.94,22.3
"2011","Dudley 042A","E01009832","Total",1650,780,870,1650,0,10,38.45,42.9
"2011","Dudley 042B","E01009853","Total",1387,668,719,1387,0,24,80.63,17.2
"2011","Dudley 042C","E01009855","Total",1632,780,852,1597,35,38,115.22,14.2
"2011","Dudley 042D","E01009860","Total",1533,768,765,1533,0,18,51.43,29.8
"2011","Dudley 043A","E01009807","Total",1801,876,925,1801,0,22,54.50,33.0
"2011","Dudley 043B","E01009808","Total",1452,695,757,1452,0,30,113.67,12.8
"2011","Dudley 043C","E01009810","Total",1741,842,899,1741,0,20,125.86,13.8
"2011","Dudley 043D","E01009811","Total",1536,752,784,1536,0,30,31.34,49.0
"2011","Dudley 043E","E01009812","Total",1530,754,776,1507,23,22,56.00,27.3
"2011","Sandwell 001A","E01010085","Total",1606,777,829,1507,99,10,58.20,27.6
"2011","Sandwell 001B","E01010086","Total",1742,869,873,1740,2,5,36.64,47.5
"2011","Sandwell 001C","E01010087","Total",1718,853,865,1689,29,10,45.12,38.1
"2011","Sandwell 001D","E01010088","Total",1547,770,777,1547,0,6,23.99,64.5
"2011","Sandwell 001E","E01010089","Total",1867,887,980,1864,3,7,43.18,43.2
"2011","Sandwell 002A","E01009969","Total",1944,904,1040,1944,0,22,65.90,29.5
"2011","Sandwell 002B","E01009970","Total",1498,745,753,1498,0,13,24.64,60.8
"2011","Sandwell 002C","E01009971","Total",1617,749,868,1617,0,10,32.59,49.6
"2011","Sandwell 002D","E01009973","Total",2439,1194,1245,2439,0,25,48.83,49.9
"2011","Sandwell 003A","E01009960","Total",1585,778,807,1585,0,10,28.18,56.2
"2011","Sandwell 003B","E01009961","Total",1238,599,639,1238,0,9,34.96,35.4
"2011","Sandwell 003C","E01009966","Total",1217,588,629,1217,0,2,26.35,46.2
"2011","Sandwell 003D","E01009967","Total",1807,870,937,1807,0,9,84.46,21.4
"2011","Sandwell 003E","E01010092","Total",1907,920,987,1907,0,15,33.88,56.3
"2011","Sandwell 004A","E01009962","Total",1336,614,722,1336,0,7,28.70,46.6
"2011","Sandwell 004B","E01009963","Total",1347,626,721,1347,0,4,28.76,46.8
"2011","Sandwell 004C","E01009964","Total",1524,736,788,1524,0,4,23.72,64.2
"2011","Sandwell 004D","E01009965","Total",1419,715,704,1419,0,3,19.74,71.9
"2011","Sandwell 005A","E01010090","Total",1704,837,867,1623,81,8,104.40,16.3
"2011","Sandwell 005B","E01010091","Total",1516,742,774,1508,8,16,21.59,70.2
"2011","Sandwell 005C","E01010096","Total",1479,711,768,1479,0,6,55.13,26.8
"2011","Sandwell 005D","E01010097","Total",1766,862,904,1721,45,17,72.24,24.4
"2011","Sandwell 006A","E01009968","Total",1471,730,741,1471,0,30,115.33,12.8
"2011","Sandwell 006B","E01009972","Total",1817,896,921,1817,0,24,64.78,28.0
"2011","Sandwell 006C","E01009974","Total",1492,717,775,1492,0,20,48.83,30.6
"2011","Sandwell 006D","E01009975","Total",1640,819,821,1640,0,24,56.66,28.9
"2011","Sandwell 007A","E01010030","Total",1505,743,762,1493,12,2,31.84,47.3
"2011","Sandwell 007B","E01010034","Total",1408,711,697,1408,0,6,39.17,35.9
"2011","Sandwell 007C","E01010035","Total",1368,704,664,1368,0,4,38.73,35.3
"2011","Sandwell 007D","E01010036","Total",1651,817,834,1651,0,3,46.24,35.7
"2011","Sandwell 009A","E01009982","Total",1561,757,804,1534,27,4,27.98,55.8
"2011","Sandwell 009B","E01009983","Total",1460,705,755,1437,23,0,40.13,36.4
"2011","Sandwell 009C","E01010029","Total",1399,666,733,1399,0,5,20.48,68.3
"2011","Sandwell 009D","E01010037","Total",1097,537,560,1097,0,5,18.38,59.7
"2011","Sandwell 010A","E01009991","Total",2204,1054,1150,2103,101,19,50.68,43.5
"2011","Sandwell 010B","E01009994","Total",1545,767,778,1545,0,7,46.12,33.5
"2011","Sandwell 010C","E01009995","Total",1622,794,828,1573,49,7,36.03,45.0
"2011","Sandwell 010D","E01009996","Total",1579,768,811,1579,0,15,28.92,54.6
"2011","Sandwell 010E","E01009997","Total",1734,847,887,1701,33,11,31.84,54.5
"2011","Sandwell 010F","E01009998","Total",1966,936,1030,1966,0,13,54.63,36.0
"2011","Sandwell 011A","E01010008","Total",1588,776,812,1588,0,12,35.89,44.2
"2011","Sandwell 011B","E01010010","Total",1342,643,699,1342,0,12,20.69,64.9
"2011","Sandwell 011C","E01010011","Total",1645,824,821,1645,0,10,25.16,65.4
"2011","Sandwell 011D","E01010012","Total",1400,680,720,1395,5,18,21.70,64.5
"2011","Sandwell 012A","E01010007","Total",1281,621,660,1281,0,19,30.56,41.9
"2011","Sandwell 012B","E01010009","Total",1423,687,736,1423,0,13,72.78,19.6
"2011","Sandwell 012C","E01010013","Total",1247,606,641,1247,0,8,20.44,61.0
"2011","Sandwell 012D","E01010014","Total",1632,780,852,1628,4,9,49.07,33.3
"2011","Sandwell 013A","E01010093","Total",1095,555,540,1095,0,12,33.91,32.3
"2011","Sandwell 013B","E01010094","Total",1465,710,755,1465,0,19,30.11,48.7
"2011","Sandwell 013C","E01010095","Total",1382,703,679,1382,0,8,125.19,11.0
"2011","Sandwell 013D","E01010098","Total",1712,823,889,1712,0,10,49.41,34.6
"2011","Sandwell 013E","E01010099","Total",1636,806,830,1636,0,3,24.87,65.8
"2011","Sandwell 013F","E01010100","Total",1763,854,909,1760,3,12,90.91,19.4
"2011","Sandwell 014A","E01009978","Total",1736,901,835,1736,0,2,32.02,54.2
"2011","Sandwell 014B","E01010031","Total",1566,794,772,1566,0,2,36.92,42.4
"2011","Sandwell 014C","E01010032","Total",1448,688,760,1448,0,2,15.89,91.1
"2011","Sandwell 014D","E01010033","Total",1539,812,727,1523,16,3,30.08,51.2
"2011","Sandwell 014E","E01010074","Total",2335,1122,1213,2274,61,9,90.30,25.9
"2011","Sandwell 015A","E01010066","Total",1498,724,774,1498,0,3,39.31,38.1
"2011","Sandwell 015B","E01010067","Total",1528,812,716,1528,0,8,22.31,68.5
"2011","Sandwell 015C","E01010068","Total",1636,754,882,1557,79,2,26.12,62.6
"2011","Sandwell 015D","E01010070","Total",1589,753,836,1589,0,5,49.08,32.4
"2011","Sandwell 015E","E01010075","Total",1458,732,726,1458,0,10,29.34,49.7
"2011","Sandwell 015F","E01010076","Total",1287,619,668,1287,0,6,38.24,33.7
"2011","Sandwell 016A","E01009976","Total",2510,1225,1285,2510,0,11,49.70,50.5
"2011","Sandwell 016B","E01009977","Total",1763,896,867,1763,0,4,50.72,34.8
"2011","Sandwell 016C","E01009979","Total",1561,758,803,1550,11,5,53.48,29.2
"2011","Sandwell 016D","E01009980","Total",2283,1124,1159,2196,87,9,50.09,45.6
"2011","Sandwell 016E","E01010069","Total",1832,917,915,1832,0,22,89.59,20.4
"2011","Sandwell 016F","E01010071","Total",1728,870,858,1728,0,9,50.75,34.0
"2011","Sandwell 017A","E01009947","Total",1937,947,990,1937,0,13,161.90,12.0
"2011","Sandwell 017B","E01009992","Total",1701,837,864,1697,4,9,26.91,63.2
"2011","Sandwell 017C","E01009993","Total",1876,898,978,1829,47,8,33.47,56.1
"2011","Sandwell 017D","E01010103","Total",1891,952,939,1805,86,18,43.85,43.1
"2011","Sandwell 017E","E01010104","Total",1645,821,824,1629,16,3,55.55,29.6
"2011","Sandwell 017F","E01010105","Total",1483,755,728,1483,0,16,81.05,18.3
"2011","Sandwell 018A","E01009981","Total",1797,899,898,1797,0,15,139.41,12.9
"2011","Sandwell 018C","E01009985","Total",1719,856,863,1719,0,3,30.51,56.3
"2011","Sandwell 018E","E01032887","Total",2757,1438,1319,2734,23,20,88.87,31.0
"2011","Sandwell 019A","E01009986","Total",1367,699,668,1361,6,7,18.48,74.0
"2011","Sandwell 019B","E01009987","Total",1233,644,589,1230,3,5,18.51,66.6
"2011","Sandwell 019C","E01009989","Total",1645,855,790,1645,0,7,94.60,17.4
"2011","Sandwell 019D","E01010106","Total",1557,813,744,1495,62,10,52.54,29.6
"2011","Sandwell 020A","E01009988","Total",1778,878,900,1770,8,7,55.05,32.3
"2011","Sandwell 020B","E01010101","Total",1883,981,902,1825,58,7,185.90,10.1
"2011","Sandwell 020C","E01010102","Total",1754,892,862,1754,0,12,38.52,45.5
"2011","Sandwell 020D","E01010107","Total",1751,944,807,1731,20,11,40.81,42.9
"2011","Sandwell 021A","E01010015","Total",1686,850,836,1686,0,19,120.07,14.0
"2011","Sandwell 021B","E01010016","Total",1626,785,841,1626,0,13,40.59,40.1
"2011","Sandwell 021C","E01010018","Total",2068,1021,1047,2025,43,10,148.59,13.9
"2011","Sandwell 021D","E01010072","Total",2290,1130,1160,2290,0,5,39.75,57.6
"2011","Sandwell 021E","E01010073","Total",1502,729,773,1502,0,7,20.81,72.2
"2011","Sandwell 022A","E01010077","Total",1531,725,806,1531,0,0,37.45,40.9
"2011","Sandwell 022B","E01010079","Total",1523,767,756,1523,0,11,46.54,32.7
"2011","Sandwell 022C","E01010080","Total",1793,897,896,1741,52,2,32.46,55.2
"2011","Sandwell 022D","E01010081","Total",1517,768,749,1517,0,17,26.19,57.9
"2011","Sandwell 022E","E01010082","Total",2303,1172,1131,2303,0,11,42.85,53.7
"2011","Sandwell 022F","E01010083","Total",1704,827,877,1704,0,7,25.77,66.1
"2011","Sandwell 022G","E01010084","Total",1599,751,848,1550,49,15,22.93,69.7
"2011","Sandwell 023A","E01010046","Total",2067,1027,1040,2067,0,18,63.52,32.5
"2011","Sandwell 023B","E01010047","Total",1872,920,952,1850,22,12,98.46,19.0
"2011","Sandwell 023C","E01010048","Total",1678,882,796,1678,0,19,13.11,128.0
"2011","Sandwell 023D","E01010049","Total",1624,831,793,1624,0,7,15.70,103.4
"2011","Sandwell 023E","E01010050","Total",1521,785,736,1521,0,1,17.15,88.7
"2011","Sandwell 023F","E01010052","Total",1410,682,728,1410,0,1,50.38,28.0
"2011","Sandwell 023G","E01010053","Total",1974,963,1011,1917,57,16,92.09,21.4
"2011","Sandwell 024A","E01010017","Total",1895,952,943,1895,0,5,136.58,13.9
"2011","Sandwell 024B","E01010019","Total",1729,890,839,1729,0,7,81.04,21.3
"2011","Sandwell 024C","E01010020","Total",1887,920,967,1887,0,13,40.16,47.0
"2011","Sandwell 024D","E01010021","Total",1700,833,867,1687,13,8,24.45,69.5
"2011","Sandwell 025A","E01010039","Total",1374,660,714,1374,0,7,53.68,25.6
"2011","Sandwell 025B","E01010043","Total",1464,738,726,1464,0,14,98.01,14.9
"2011","Sandwell 025C","E01010044","Total",1395,679,716,1395,0,4,41.15,33.9
"2011","Sandwell 025D","E01010078","Total",1275,625,650,1235,40,12,49.50,25.8
"2011","Sandwell 026A","E01010059","Total",1926,959,967,1926,0,21,22.95,83.9
"2011","Sandwell 026B","E01010061","Total",1828,951,877,1828,0,9,18.49,98.9
"2011","Sandwell 026C","E01010062","Total",1594,778,816,1580,14,8,79.66,20.0
"2011","Sandwell 026D","E01010063","Total",2145,1108,1037,2129,16,23,101.97,21.0
"2011","Sandwell 026E","E01010064","Total",1800,847,953,1777,23,10,38.76,46.4
"2011","Sandwell 026F","E01010065","Total",2690,1311,1379,2690,0,30,28.09,95.8
"2011","Sandwell 027A","E01009934","Total",1455,700,755,1439,16,5,50.78,28.7
"2011","Sandwell 027B","E01009935","Total",1916,961,955,1907,9,8,26.92,71.2
"2011","Sandwell 027C","E01009936","Total",1638,811,827,1638,0,5,27.07,60.5
"2011","Sandwell 027D","E01010004","Total",1558,787,771,1558,0,8,45.57,34.2
"2011","Sandwell 028A","E01010054","Total",1906,930,976,1841,65,15,33.22,57.4
"2011","Sandwell 028B","E01010055","Total",1697,857,840,1697,0,11,13.76,123.3
"2011","Sandwell 028C","E01010056","Total",1600,776,824,1600,0,16,22.00,72.7
"2011","Sandwell 028D","E01010057","Total",1965,955,1010,1888,77,4,15.31,128.3
"2011","Sandwell 028E","E01010060","Total",1972,987,985,1967,5,12,21.16,93.2
"2011","Sandwell 029A","E01010038","Total",1789,862,927,1789,0,5,82.94,21.6
"2011","Sandwell 029B","E01010040","Total",1429,690,739,1429,0,4,46.81,30.5
"2011","Sandwell 029C","E01010041","Total",1690,808,882,1690,0,3,21.04,80.3
"2011","Sandwell 029D","E01010045","Total",1599,756,843,1599,0,7,28.42,56.3
"2011","Sandwell 030A","E01010000","Total",1572,790,782,1542,30,8,47.17,33.3
"2011","Sandwell 030B","E01010002","Total",2112,1082,1030,2082,30,12,41.73,50.6
"2011","Sandwell 030C","E01010003","Total",1499,748,751,1490,9,5,43.20,34.7
"2011","Sandwell 030D","E01010005","Total",1510,762,748,1506,4,16,28.33,53.3
"2011","Sandwell 030E","E01010006","Total",1653,828,825,1646,7,2,37.06,44.6
"2011","Sandwell 031A","E01009938","Total",1703,841,862,1703,0,5,35.56,47.9
"2011","Sandwell 031B","E01009943","Total",1471,692,779,1429,42,9,20.85,70.6
"2011","Sandwell 031C","E01009944","Total",1503,713,790,1503,0,3,24.28,61.9
"2011","Sandwell 031D","E01010051","Total",1232,567,665,1232,0,12,33.71,36.5
"2011","Sandwell 031E","E01010058","Total",1641,789,852,1641,0,13,39.88,41.1
"2011","Sandwell 032A","E01009937","Total",1590,766,824,1541,49,6,20.81,76.4
"2011","Sandwell 032B","E01009939","Total",1761,862,899,1753,8,11,38.32,46.0
"2011","Sandwell 032C","E01009940","Total",1489,724,765,1489,0,7,23.04,64.6
"2011","Sandwell 032D","E01009941","Total",1538,749,789,1533,5,17,25.29,60.8
"2011","Sandwell 032E","E01009942","Total",1648,782,866,1648,0,8,29.01,56.8
"2011","Sandwell 033A","E01009929","Total",1708,828,880,1708,0,3,34.45,49.6
"2011","Sandwell 033B","E01009930","Total",1521,741,780,1499,22,3,22.60,67.3
"2011","Sandwell 033C","E01009931","Total",2242,1107,1135,2240,2,16,55.20,40.6
"2011","Sandwell 033D","E01009932","Total",1691,820,871,1654,37,11,29.81,56.7
"2011","Sandwell 033E","E01009999","Total",1377,683,694,1372,5,5,46.23,29.8
"2011","Sandwell 034A","E01009921","Total",1579,805,774,1579,0,6,16.75,94.3
"2011","Sandwell 034B","E01009922","Total",1267,596,671,1267,0,7,20.18,62.8
"2011","Sandwell 034C","E01009924","Total",1375,656,719,1375,0,12,15.56,88.4
"2011","Sandwell 034D","E01009925","Total",1349,653,696,1349,0,38,74.02,18.2
"2011","Sandwell 034E","E01009926","Total",1413,657,756,1413,0,15,16.00,88.3
"2011","Sandwell 034F","E01009927","Total",1564,797,767,1564,0,9,23.23,67.3
"2011","Sandwell 034G","E01009928","Total",1759,841,918,1696,63,8,21.99,80.0
"2011","Sandwell 035A","E01009933","Total",1494,733,761,1494,0,4,31.80,47.0
"2011","Sandwell 035B","E01009952","Total",1963,1006,957,1963,0,2,24.30,80.8
"2011","Sandwell 035C","E01009955","Total",1929,996,933,1856,73,8,40.05,48.2
"2011","Sandwell 035D","E01009956","Total",1571,784,787,1571,0,8,54.79,28.7
"2011","Sandwell 035E","E01009959","Total",1438,723,715,1438,0,9,42.28,34.0
"2011","Sandwell 035F","E01010042","Total",1787,864,923,1787,0,8,54.10,33.0
"2011","Sandwell 036A","E01009923","Total",1446,700,746,1446,0,13,23.55,61.4
"2011","Sandwell 036B","E01010024","Total",1513,723,790,1513,0,12,24.47,61.8
"2011","Sandwell 036C","E01010026","Total",1727,804,923,1727,0,7,34.05,50.7
"2011","Sandwell 036D","E01010027","Total",1519,746,773,1519,0,18,34.57,43.9
"2011","Sandwell 037A","E01010001","Total",1743,819,924,1717,26,8,33.54,52.0
"2011","Sandwell 037B","E01010022","Total",1550,750,800,1550,0,11,39.38,39.4
"2011","Sandwell 037C","E01010023","Total",1752,844,908,1751,1,23,30.95,56.6
"2011","Sandwell 037D","E01010025","Total",1546,750,796,1546,0,7,69.09,22.4
"2011","Sandwell 037E","E01010028","Total",1394,683,711,1394,0,12,19.18,72.7
"2011","Sandwell 038A","E01009953","Total",1676,848,828,1672,4,10,81.36,20.6
"2011","Sandwell 038B","E01009954","Total",1737,815,922,1678,59,8,75.12,23.1
"2011","Sandwell 038C","E01009957","Total",1658,751,907,1650,8,3,32.04,51.7
"2011","Sandwell 038D","E01009958","Total",1593,789,804,1593,0,23,53.44,29.8
"2011","Sandwell 039A","E01009946","Total",1683,804,879,1647,36,24,34.81,48.3
"2011","Sandwell 039B","E01009948","Total",1472,721,751,1472,0,6,29.85,49.3
"2011","Sandwell 039C","E01009949","Total",1563,765,798,1563,0,13,118.65,13.2
"2011","Sandwell 039D","E01009950","Total",1658,833,825,1655,3,17,34.02,48.7
"2011","Sandwell 039E","E01009951","Total",1897,993,904,1897,0,8,37.89,50.1
"2011","Sandwell 039F","E01032592","Total",1759,834,925,1759,0,13,146.76,12.0
"2011","Solihull 001A","E01010118","Total",1290,632,658,1277,13,27,30.37,42.5
"2011","Solihull 001B","E01010120","Total",1293,579,714,1293,0,2,50.58,25.6
"2011","Solihull 001C","E01010121","Total",1416,715,701,1416,0,13,44.43,31.9
"2011","Solihull 001D","E01010122","Total",1380,673,707,1380,0,12,61.14,22.6
"2011","Solihull 002A","E01010235","Total",1495,727,768,1495,0,8,15.60,95.8
"2011","Solihull 002B","E01010236","Total",1512,699,813,1512,0,6,17.86,84.7
"2011","Solihull 002C","E01010239","Total",1568,747,821,1568,0,7,22.13,70.9
"2011","Solihull 002D","E01010240","Total",1334,627,707,1334,0,7,14.67,90.9
"2011","Solihull 003A","E01010117","Total",1386,686,700,1383,3,15,43.53,31.8
"2011","Solihull 003B","E01010119","Total",1506,732,774,1506,0,14,28.36,53.1
"2011","Solihull 003C","E01010123","Total",1420,696,724,1420,0,14,31.88,44.5
"2011","Solihull 003D","E01010124","Total",1526,770,756,1516,10,10,30.65,49.8
"2011","Solihull 004A","E01010146","Total",1616,714,902,1616,0,15,29.65,54.5
"2011","Solihull 004B","E01010234","Total",1268,592,676,1218,50,2,34.98,36.2
"2011","Solihull 004C","E01010237","Total",1891,898,993,1884,7,9,52.27,36.2
"2011","Solihull 004D","E01010238","Total",1408,687,721,1408,0,1,28.95,48.6
"2011","Solihull 005A","E01010145","Total",1514,752,762,1514,0,4,35.49,42.7
"2011","Solihull 005B","E01010147","Total",1463,708,755,1463,0,11,21.69,67.5
"2011","Solihull 005C","E01010148","Total",1831,846,985,1831,0,17,30.56,59.9
"2011","Solihull 005D","E01010149","Total",1444,722,722,1444,0,6,58.61,24.6
"2011","Solihull 006A","E01010125","Total",1482,726,756,1468,14,8,47.03,31.5
"2011","Solihull 006B","E01010129","Total",1516,713,803,1496,20,10,28.67,52.9
"2011","Solihull 006C","E01010139","Total",1082,520,562,1030,52,9,30.50,35.5
"2011","Solihull 006D","E01010141","Total",1363,729,634,1353,10,13,40.19,33.9
"2011","Solihull 007A","E01010140","Total",1520,710,810,1520,0,1,28.80,52.8
"2011","Solihull 007B","E01010142","Total",1433,692,741,1433,0,6,32.25,44.4
"2011","Solihull 007C","E01010143","Total",1424,681,743,1424,0,1,31.80,44.8
"2011","Solihull 007D","E01010144","Total",1657,800,857,1655,2,4,27.61,60.0
"2011","Solihull 008A","E01010111","Total",1465,734,731,1465,0,7,20.87,70.2
"2011","Solihull 008B","E01010126","Total",1468,710,758,1468,0,2,29.59,49.6
"2011","Solihull 008C","E01010127","Total",1763,902,861,1763,0,2,43.37,40.7
"2011","Solihull 008D","E01010128","Total",1451,691,760,1451,0,3,29.59,49.0
"2011","Solihull 008E","E01010130","Total",1785,864,921,1784,1,4,20.90,85.4
"2011","Solihull 008F","E01010131","Total",1395,664,731,1395,0,4,22.55,61.9
"2011","Solihull 009A","E01010109","Total",1392,699,693,1377,15,11,1213.47,1.1
"2011","Solihull 009B","E01010110","Total",1644,827,817,1505,139,9,169.00,9.7
"2011","Solihull 009C","E01010112","Total",1554,747,807,1535,19,12,30.54,50.9
"2011","Solihull 009D","E01010113","Total",1332,630,702,1308,24,5,19.56,68.1
"2011","Solihull 009E","E01010114","Total",1811,866,945,1807,4,19,68.48,26.4
"2011","Solihull 010A","E01010157","Total",1416,705,711,1416,0,10,19.87,71.3
"2011","Solihull 010B","E01010159","Total",1413,673,740,1413,0,11,22.17,63.7
"2011","Solihull 010C","E01010162","Total",1513,741,772,1513,0,15,34.83,43.4
"2011","Solihull 010D","E01010163","Total",1465,716,749,1465,0,12,45.20,32.4
"2011","Solihull 011A","E01010132","Total",1432,657,775,1432,0,7,104.73,13.7
"2011","Solihull 011B","E01010133","Total",1521,742,779,1521,0,12,37.29,40.8
"2011","Solihull 011C","E01010134","Total",1426,693,733,1426,0,9,28.98,49.2
"2011","Solihull 011D","E01010135","Total",1498,733,765,1498,0,20,59.90,25.0
"2011","Solihull 011E","E01010138","Total",1400,721,679,1400,0,11,101.15,13.8
"2011","Solihull 012A","E01010136","Total",1284,627,657,1281,3,14,25.73,49.9
"2011","Solihull 012B","E01010137","Total",1312,631,681,1312,0,13,25.70,51.1
"2011","Solihull 012C","E01010158","Total",1513,692,821,1461,52,8,39.82,38.0
"2011","Solihull 012D","E01010160","Total",1507,737,770,1507,0,14,34.35,43.9
"2011","Solihull 012E","E01010161","Total",1525,764,761,1525,0,23,42.08,36.2
"2011","Solihull 013A","E01010174","Total",1634,791,843,1634,0,23,41.67,39.2
"2011","Solihull 013B","E01010175","Total",1711,844,867,1676,35,44,53.05,32.3
"2011","Solihull 013C","E01010177","Total",1350,657,693,1350,0,12,30.72,43.9
"2011","Solihull 013D","E01010178","Total",1862,925,937,1693,169,14,39.55,47.1
"2011","Solihull 014A","E01010172","Total",1544,760,784,1544,0,37,34.32,45.0
"2011","Solihull 014B","E01010173","Total",1451,710,741,1451,0,49,44.05,32.9
"2011","Solihull 014C","E01010176","Total",1383,666,717,1327,56,37,94.12,14.7
"2011","Solihull 014D","E01010179","Total",1584,737,847,1544,40,15,53.06,29.9
"2011","Solihull 015A","E01010115","Total",1498,730,768,1498,0,25,1069.24,1.4
"2011","Solihull 015B","E01010116","Total",1467,725,742,1467,0,23,46.40,31.6
"2011","Solihull 015C","E01010227","Total",1891,906,985,1867,24,40,264.50,7.1
"2011","Solihull 015D","E01010228","Total",1636,789,847,1636,0,13,96.29,17.0
"2011","Solihull 015E","E01010232","Total",2045,958,1087,2042,3,15,34.07,60.0
"2011","Solihull 016A","E01010195","Total",1592,781,811,1583,9,47,58.71,27.1
"2011","Solihull 016B","E01010226","Total",1604,703,901,1523,81,8,77.85,20.6
"2011","Solihull 016C","E01010229","Total",1494,750,744,1486,8,30,87.10,17.2
"2011","Solihull 016D","E01010230","Total",1795,838,957,1755,40,19,50.05,35.9
"2011","Solihull 016E","E01010231","Total",1705,831,874,1705,0,40,58.71,29.0
"2011","Solihull 016F","E01010233","Total",1818,911,907,1818,0,16,33.64,54.0
"2011","Solihull 017A","E01010108","Total",1976,969,1007,1976,0,65,1160.21,1.7
"2011","Solihull 017B","E01010164","Total",1587,802,785,1555,32,28,1340.40,1.2
"2011","Solihull 017C","E01010165","Total",1473,695,778,1465,8,10,356.37,4.1
"2011","Solihull 017D","E01010167","Total",1519,754,765,1501,18,42,1866.06,0.8
"2011","Solihull 018A","E01010199","Total",1863,922,941,1863,0,32,38.78,48.0
"2011","Solihull 018B","E01010200","Total",1471,683,788,1434,37,15,27.98,52.6
"2011","Solihull 018C","E01010201","Total",1652,826,826,1652,0,28,36.42,45.4
"2011","Solihull 018D","E01010204","Total",1248,599,649,1248,0,10,44.97,27.8
"2011","Solihull 018E","E01010205","Total",1493,718,775,1493,0,36,39.79,37.5
"2011","Solihull 018F","E01010206","Total",1691,813,878,1691,0,27,30.09,56.2
"2011","Solihull 019A","E01010192","Total",1626,820,806,1518,108,55,130.04,12.5
"2011","Solihull 019B","E01010196","Total",1675,829,846,1675,0,52,82.08,20.4
"2011","Solihull 019C","E01010197","Total",1676,813,863,1676,0,72,61.72,27.2
"2011","Solihull 019D","E01010198","Total",1584,761,823,1584,0,47,107.89,14.7
"2011","Solihull 021A","E01010218","Total",1321,629,692,1282,39,10,21.77,60.7
"2011","Solihull 021B","E01010219","Total",1605,754,851,1605,0,20,35.70,45.0
"2011","Solihull 021C","E01010221","Total",1438,681,757,1436,2,10,46.20,31.1
"2011","Solihull 021D","E01010222","Total",1479,717,762,1460,19,14,30.73,48.1
"2011","Solihull 022A","E01010191","Total",1844,892,952,1844,0,49,56.36,32.7
"2011","Solihull 022B","E01010202","Total",1567,763,804,1567,0,33,30.32,51.7
"2011","Solihull 022C","E01010203","Total",1733,845,888,1725,8,20,49.60,34.9
"2011","Solihull 022D","E01010209","Total",1748,851,897,1719,29,21,62.77,27.8
"2011","Solihull 022E","E01010213","Total",1700,799,901,1552,148,15,89.07,19.1
"2011","Solihull 023A","E01010208","Total",1535,731,804,1528,7,26,33.66,45.6
"2011","Solihull 023B","E01010210","Total",1570,727,843,1567,3,32,52.64,29.8
"2011","Solihull 023C","E01010211","Total",1402,634,768,1402,0,10,35.18,39.9
"2011","Solihull 023D","E01010217","Total",1518,765,753,1515,3,17,34.84,43.6
"2011","Solihull 024A","E01010190","Total",1698,818,880,1698,0,50,141.71,12.0
"2011","Solihull 024B","E01010193","Total",1376,685,691,1376,0,73,32.89,41.8
"2011","Solihull 024C","E01010194","Total",1642,794,848,1642,0,55,31.51,52.1
"2011","Solihull 024D","E01010207","Total",1450,702,748,1450,0,50,66.61,21.8
"2011","Solihull 025A","E01010166","Total",1454,707,747,1450,4,27,794.96,1.8
"2011","Solihull 025B","E01010168","Total",1871,934,937,1871,0,39,1139.15,1.6
"2011","Solihull 025C","E01010169","Total",1622,813,809,1622,0,41,139.99,11.6
"2011","Solihull 025D","E01010170","Total",1524,746,778,1524,0,56,40.63,37.5
"2011","Solihull 025E","E01010171","Total",1344,651,693,1344,0,38,176.44,7.6
"2011","Solihull 026A","E01010151","Total",1574,708,866,1545,29,24,189.05,8.3
"2011","Solihull 026B","E01010152","Total",1378,681,697,1378,0,53,39.63,34.8
"2011","Solihull 026C","E01010153","Total",1544,745,799,1512,32,56,233.87,6.6
"2011","Solihull 026D","E01010154","Total",1665,777,888,1583,82,50,280.11,5.9
"2011","Solihull 026E","E01010155","Total",1556,785,771,1556,0,43,58.76,26.5
"2011","Solihull 026F","E01010156","Total",1558,749,809,1553,5,54,95.94,16.2
"2011","Solihull 027A","E01010212","Total",1419,715,704,1369,50,43,74.27,19.1
"2011","Solihull 027B","E01010214","Total",1217,576,641,1217,0,25,66.23,18.4
"2011","Solihull 027C","E01010215","Total",1623,794,829,1623,0,31,37.61,43.2
"2011","Solihull 027D","E01010216","Total",1524,738,786,1524,0,22,61.58,24.7
"2011","Solihull 028A","E01010150","Total",1625,799,826,1625,0,41,88.52,18.4
"2011","Solihull 028B","E01010184","Total",1429,689,740,1429,0,25,64.32,22.2
"2011","Solihull 028C","E01010185","Total",1557,754,803,1557,0,68,88.27,17.6
"2011","Solihull 028D","E01010186","Total",1923,913,1010,1923,0,48,45.36,42.4
"2011","Solihull 028E","E01010187","Total",1516,771,745,1516,0,74,334.37,4.5
"2011","Solihull 028F","E01010188","Total",1747,872,875,1740,7,64,269.17,6.5
"2011","Solihull 029A","E01010180","Total",1269,624,645,1264,5,29,73.92,17.2
"2011","Solihull 029B","E01010181","Total",1951,963,988,1951,0,35,305.01,6.4
"2011","Solihull 029D","E01010183","Total",1362,693,669,1356,6,28,580.73,2.3
"2011","Solihull 029E","E01010189","Total",1604,800,804,1604,0,42,103.48,15.5
"2011","Solihull 029F","E01032885","Total",1197,644,553,1197,0,15,16.35,73.2
"2011","Solihull 029G","E01032886","Total",1974,1017,957,1974,0,23,609.46,3.2
"2011","Solihull 030A","E01010220","Total",1649,809,840,1649,0,21,33.73,48.9
"2011","Solihull 030B","E01010223","Total",1212,568,644,1209,3,17,35.66,34.0
"2011","Solihull 030C","E01010225","Total",1491,725,766,1491,0,12,22.35,66.7
"2011","Solihull 030D","E01032590","Total",1748,850,898,1748,0,15,48.43,36.1
"2011","Walsall 001A","E01010301","Total",1480,726,754,1480,0,6,31.14,47.5
"2011","Walsall 001B","E01010303","Total",1541,756,785,1497,44,4,129.10,11.9
"2011","Walsall 001C","E01010306","Total",1962,968,994,1945,17,22,117.46,16.7
"2011","Walsall 001D","E01010307","Total",1770,857,913,1770,0,16,225.40,7.9
"2011","Walsall 002A","E01010302","Total",1502,746,756,1502,0,2,55.56,27.0
"2011","Walsall 002B","E01010304","Total",1708,850,858,1704,4,5,64.53,26.5
"2011","Walsall 002C","E01010305","Total",1422,724,698,1390,32,3,42.32,33.6
"2011","Walsall 002D","E01010308","Total",1291,670,621,1268,23,7,58.61,22.0
"2011","Walsall 003A","E01010345","Total",1082,550,532,1082,0,14,49.37,21.9
"2011","Walsall 003B","E01010346","Total",1393,700,693,1393,0,21,24.52,56.8
"2011","Walsall 003C","E01010347","Total",1497,733,764,1497,0,7,30.10,49.7
"2011","Walsall 003D","E01010350","Total",1463,709,754,1463,0,16,138.71,10.5
"2011","Walsall 004A","E01010249","Total",1774,891,883,1773,1,12,250.66,7.1
"2011","Walsall 004B","E01010250","Total",1436,686,750,1381,55,9,127.35,11.3
"2011","Walsall 004C","E01010252","Total",1767,854,913,1767,0,3,40.52,43.6
"2011","Walsall 004D","E01010254","Total",1491,744,747,1471,20,8,34.16,43.6
"2011","Walsall 005A","E01010348","Total",1442,685,757,1434,8,13,26.48,54.5
"2011","Walsall 005B","E01010349","Total",1259,610,649,1259,0,6,33.47,37.6
"2011","Walsall 005C","E01010351","Total",1700,836,864,1680,20,11,55.37,30.7
"2011","Walsall 005D","E01010352","Total",1632,809,823,1601,31,29,64.43,25.3
"2011","Walsall 006A","E01010284","Total",1524,701,823,1524,0,16,47.80,31.9
"2011","Walsall 006B","E01010285","Total",1716,861,855,1716,0,12,67.64,25.4
"2011","Walsall 006C","E01010286","Total",1703,835,868,1703,0,11,30.25,56.3
"2011","Walsall 006D","E01010290","Total",1621,798,823,1621,0,5,134.66,12.0
"2011","Walsall 007A","E01010251","Total",1412,711,701,1412,0,25,115.09,12.3
"2011","Walsall 007B","E01010253","Total",1243,610,633,1224,19,8,26.63,46.7
"2011","Walsall 007C","E01010255","Total",1337,630,707,1337,0,29,100.92,13.2
"2011","Walsall 007D","E01010256","Total",1529,740,789,1529,0,7,64.79,23.6
"2011","Walsall 007E","E01010257","Total",1218,594,624,1218,0,12,23.24,52.4
"2011","Walsall 008A","E01010292","Total",1621,821,800,1571,50,9,57.78,28.1
"2011","Walsall 008B","E01010294","Total",1527,741,786,1527,0,5,52.21,29.2
"2011","Walsall 008C","E01010296","Total",1464,700,764,1454,10,17,29.66,49.4
"2011","Walsall 008D","E01010297","Total",1439,717,722,1439,0,17,38.20,37.7
"2011","Walsall 009A","E01010291","Total",1418,669,749,1418,0,7,79.53,17.8
"2011","Walsall 009B","E01010293","Total",1511,724,787,1511,0,10,31.45,48.0
"2011","Walsall 009C","E01010298","Total",1172,582,590,1172,0,9,19.01,61.7
"2011","Walsall 009D","E01010299","Total",1601,755,846,1601,0,5,27.62,58.0
"2011","Walsall 009E","E01010300","Total",1493,714,779,1492,1,4,21.74,68.7
"2011","Walsall 010A","E01010319","Total",1402,701,701,1402,0,25,25.23,55.6
"2011","Walsall 010B","E01010321","Total",1593,779,814,1593,0,10,57.48,27.7
"2011","Walsall 010C","E01010353","Total",1461,704,757,1461,0,17,44.72,32.7
"2011","Walsall 010D","E01010354","Total",1534,767,767,1534,0,6,31.91,48.1
"2011","Walsall 011A","E01010395","Total",1376,680,696,1376,0,16,28.43,48.4
"2011","Walsall 011B","E01010397","Total",1656,794,862,1656,0,4,29.12,56.9
"2011","Walsall 011C","E01010398","Total",1652,811,841,1652,0,25,34.33,48.1
"2011","Walsall 011D","E01010399","Total",1582,784,798,1577,5,11,24.76,63.9
"2011","Walsall 012A","E01010282","Total",1317,658,659,1317,0,3,33.27,39.6
"2011","Walsall 012B","E01010287","Total",1516,709,807,1384,132,4,35.96,42.2
"2011","Walsall 012C","E01010288","Total",1725,838,887,1653,72,10,22.12,78.0
"2011","Walsall 012D","E01010289","Total",1653,816,837,1653,0,3,30.77,53.7
"2011","Walsall 013B","E01010277","Total",1617,803,814,1614,3,9,35.66,45.3
"2011","Walsall 013D","E01010283","Total",1936,976,960,1932,4,2,26.29,73.6
"2011","Walsall 013E","E01032889","Total",1965,965,1000,1935,30,7,96.68,20.3
"2011","Walsall 014A","E01010393","Total",1497,745,752,1497,0,9,24.58,60.9
"2011","Walsall 014B","E01010394","Total",1448,717,731,1448,0,8,20.67,70.1
"2011","Walsall 014C","E01010396","Total",1602,778,824,1558,44,6,35.37,45.3
"2011","Walsall 014D","E01010400","Total",1884,900,984,1884,0,8,37.47,50.3
"2011","Walsall 015A","E01010241","Total",2219,1053,1166,2160,59,31,475.04,4.7
"2011","Walsall 015B","E01010242","Total",1655,820,835,1648,7,12,28.04,59.0
"2011","Walsall 015C","E01010243","Total",1511,714,797,1511,0,21,41.30,36.6
"2011","Walsall 015D","E01010244","Total",1508,710,798,1508,0,12,30.96,48.7
"2011","Walsall 016A","E01010320","Total",1342,641,701,1342,0,4,177.87,7.5
"2011","Walsall 016B","E01010322","Total",1527,729,798,1527,0,5,109.69,13.9
"2011","Walsall 016C","E01010323","Total",1487,736,751,1479,8,12,32.31,46.0
"2011","Walsall 016D","E01010324","Total",1562,739,823,1507,55,18,99.98,15.6
"2011","Walsall 017A","E01010271","Total",1803,907,896,1803,0,5,84.06,21.4
"2011","Walsall 017B","E01010272","Total",1518,769,749,1518,0,2,15.33,99.0
"2011","Walsall 017C","E01010273","Total",1547,765,782,1547,0,6,78.27,19.8
"2011","Walsall 017D","E01010295","Total",1474,704,770,1474,0,4,31.20,47.2
"2011","Walsall 018B","E01010279","Total",1679,815,864,1679,0,4,33.62,49.9
"2011","Walsall 018D","E01010374","Total",1808,898,910,1740,68,10,42.11,42.9
"2011","Walsall 018E","E01010375","Total",2208,1090,1118,2208,0,17,43.63,50.6
"2011","Walsall 018F","E01032888","Total",2636,1300,1336,2618,18,12,127.40,20.7
"2011","Walsall 019A","E01010378","Total",1261,631,630,1261,0,13,49.49,25.5
"2011","Walsall 019B","E01010379","Total",1324,653,671,1319,5,9,87.36,15.2
"2011","Walsall 019C","E01010382","Total",1540,762,778,1540,0,2,36.85,41.8
"2011","Walsall 019D","E01010383","Total",1422,651,771,1422,0,9,29.51,48.2
"2011","Walsall 020A","E01010376","Total",1364,701,663,1364,0,6,41.18,33.1
"2011","Walsall 020B","E01010377","Total",1547,760,787,1547,0,8,66.16,23.4
"2011","Walsall 020C","E01010380","Total",1505,732,773,1505,0,8,37.16,40.5
"2011","Walsall 020D","E01010381","Total",1486,760,726,1486,0,9,32.77,45.3
"2011","Walsall 021A","E01010267","Total",1710,839,871,1710,0,6,43.40,39.4
"2011","Walsall 021B","E01010268","Total",1783,894,889,1775,8,8,61.06,29.2
"2011","Walsall 021C","E01010274","Total",1579,745,834,1579,0,4,21.92,72.0
"2011","Walsall 021D","E01010275","Total",1522,749,773,1522,0,6,37.95,40.1
"2011","Walsall 022A","E01010245","Total",1541,745,796,1536,5,24,87.19,17.7
"2011","Walsall 022B","E01010246","Total",1567,786,781,1567,0,13,303.14,5.2
"2011","Walsall 022C","E01010247","Total",1659,804,855,1659,0,18,48.00,34.6
"2011","Walsall 022D","E01010248","Total",1638,794,844,1638,0,35,129.37,12.7
"2011","Walsall 022E","E01010388","Total",1442,711,731,1442,0,30,268.83,5.4
"2011","Walsall 023A","E01010258","Total",1746,791,955,1746,0,4,40.02,43.6
"2011","Walsall 023B","E01010259","Total",1633,772,861,1582,51,8,35.79,45.6
"2011","Walsall 023C","E01010260","Total",1594,751,843,1594,0,3,45.54,35.0
"2011","Walsall 023D","E01010266","Total",1398,650,748,1398,0,2,20.76,67.3
"2011","Walsall 024A","E01010317","Total",1600,794,806,1600,0,47,212.15,7.5
"2011","Walsall 024B","E01010318","Total",1540,752,788,1537,3,8,43.23,35.6
"2011","Walsall 024C","E01010325","Total",1675,862,813,1648,27,19,65.90,25.4
"2011","Walsall 024D","E01010369","Total",1830,968,862,1795,35,10,30.07,60.9
"2011","Walsall 025A","E01010401","Total",1463,706,757,1463,0,9,44.16,33.1
"2011","Walsall 025B","E01010403","Total",1738,845,893,1710,28,7,31.25,55.6
"2011","Walsall 025C","E01010404","Total",1814,884,930,1797,17,13,70.99,25.6
"2011","Walsall 025D","E01010407","Total",1658,781,877,1641,17,7,71.38,23.2
"2011","Walsall 025E","E01010408","Total",1548,766,782,1548,0,4,36.64,42.2
"2011","Walsall 026A","E01010269","Total",1654,831,823,1654,0,8,21.24,77.9
"2011","Walsall 026B","E01010270","Total",1782,885,897,1782,0,15,50.05,35.6
"2011","Walsall 026C","E01010362","Total",1758,839,919,1758,0,7,62.69,28.0
"2011","Walsall 026D","E01010363","Total",1887,958,929,1870,17,14,82.60,22.8
"2011","Walsall 027A","E01010402","Total",1704,859,845,1704,0,9,32.48,52.5
"2011","Walsall 027B","E01010405","Total",1683,826,857,1656,27,9,76.79,21.9
"2011","Walsall 027C","E01010406","Total",2573,1280,1293,2568,5,10,96.63,26.6
"2011","Walsall 027D","E01010409","Total",1602,771,831,1602,0,14,20.34,78.8
"2011","Walsall 028A","E01010385","Total",1560,805,755,1560,0,35,57.41,27.2
"2011","Walsall 028B","E01010386","Total",1605,768,837,1601,4,13,45.25,35.5
"2011","Walsall 028C","E01010387","Total",1569,760,809,1569,0,17,29.42,53.3
"2011","Walsall 028D","E01010392","Total",1551,756,795,1521,30,26,83.35,18.6
"2011","Walsall 029A","E01010326","Total",1641,808,833,1641,0,30,62.45,26.3
"2011","Walsall 029B","E01010327","Total",1700,825,875,1676,24,13,16.72,101.7
"2011","Walsall 029C","E01010328","Total",1472,750,722,1472,0,23,67.67,21.8
"2011","Walsall 029D","E01010330","Total",1490,742,748,1489,1,11,33.40,44.6
"2011","Walsall 030A","E01010368","Total",1891,1007,884,1891,0,8,80.68,23.4
"2011","Walsall 030B","E01010370","Total",1833,939,894,1813,20,19,29.37,62.4
"2011","Walsall 030C","E01010371","Total",2282,1256,1026,2282,0,19,47.13,48.4
"2011","Walsall 030D","E01010372","Total",1593,818,775,1585,8,8,18.66,85.4
"2011","Walsall 030E","E01010373","Total",1899,860,1039,1456,443,55,60.97,31.1
"2011","Walsall 031A","E01010361","Total",1508,762,746,1442,66,13,41.47,36.4
"2011","Walsall 031B","E01010364","Total",1533,743,790,1533,0,7,37.04,41.4
"2011","Walsall 031C","E01010365","Total",1496,749,747,1481,15,5,21.15,70.7
"2011","Walsall 031D","E01010366","Total",1760,873,887,1760,0,14,26.72,65.9
"2011","Walsall 031E","E01010367","Total",1724,852,872,1724,0,8,66.19,26.0
"2011","Walsall 032A","E01010384","Total",1491,724,767,1491,0,24,62.62,23.8
"2011","Walsall 032B","E01010389","Total",1487,744,743,1487,0,27,95.76,15.5
"2011","Walsall 032C","E01010390","Total",1728,816,912,1728,0,20,75.17,23.0
"2011","Walsall 032D","E01010391","Total",1984,968,1016,1984,0,15,32.70,60.7
"2011","Walsall 033A","E01010261","Total",1609,777,832,1609,0,2,101.36,15.9
"2011","Walsall 033B","E01010263","Total",1687,870,817,1666,21,11,28.36,59.5
"2011","Walsall 033C","E01010264","Total",1644,787,857,1579,65,14,48.16,34.1
"2011","Walsall 033D","E01010265","Total",1853,936,917,1840,13,8,90.89,20.4
"2011","Walsall 034A","E01010336","Total",1618,815,803,1617,1,7,72.43,22.3
"2011","Walsall 034B","E01010340","Total",1759,873,886,1749,10,13,18.35,95.9
"2011","Walsall 034C","E01010341","Total",1713,852,861,1713,0,10,18.65,91.8
"2011","Walsall 034D","E01010342","Total",1645,805,840,1620,25,7,11.92,138.0
"2011","Walsall 034E","E01010343","Total",1589,811,778,1589,0,17,19.62,81.0
"2011","Walsall 034F","E01010344","Total",1703,836,867,1703,0,7,23.45,72.6
"2011","Walsall 035A","E01010331","Total",1682,841,841,1682,0,31,48.24,34.9
"2011","Walsall 035B","E01010332","Total",1846,903,943,1846,0,38,66.46,27.8
"2011","Walsall 035C","E01010333","Total",1614,798,816,1614,0,22,34.33,47.0
"2011","Walsall 035D","E01010334","Total",1561,750,811,1561,0,27,132.82,11.8
"2011","Walsall 036A","E01010262","Total",1585,781,804,1585,0,9,27.95,56.7
"2011","Walsall 036B","E01010309","Total",1890,939,951,1881,9,9,30.50,62.0
"2011","Walsall 036C","E01010311","Total",1647,814,833,1647,0,17,47.76,34.5
"2011","Walsall 036D","E01010316","Total",1677,817,860,1677,0,3,20.12,83.3
"2011","Walsall 037A","E01010335","Total",1709,820,889,1709,0,8,40.30,42.4
"2011","Walsall 037B","E01010337","Total",1420,671,749,1420,0,6,75.18,18.9
"2011","Walsall 037C","E01010338","Total",1844,929,915,1778,66,9,33.57,54.9
"2011","Walsall 037D","E01010339","Total",1532,731,801,1532,0,7,54.14,28.3
"2011","Walsall 038A","E01010310","Total",1750,886,864,1750,0,5,65.52,26.7
"2011","Walsall 038B","E01010312","Total",1747,873,874,1747,0,4,35.13,49.7
"2011","Walsall 038C","E01010313","Total",1510,726,784,1494,16,4,38.97,38.7
"2011","Walsall 038D","E01010314","Total",1566,779,787,1566,0,5,35.51,44.1
"2011","Walsall 038E","E01010315","Total",1285,637,648,1285,0,6,60.87,21.1
"2011","Walsall 039A","E01010329","Total",1590,769,821,1590,0,24,84.32,18.9
"2011","Walsall 039B","E01010355","Total",1465,704,761,1465,0,14,25.85,56.7
"2011","Walsall 039C","E01010356","Total",1551,763,788,1551,0,14,460.88,3.4
"2011","Walsall 039D","E01010357","Total",1868,920,948,1868,0,23,114.83,16.3
"2011","Walsall 039E","E01010358","Total",1465,702,763,1461,4,9,23.59,62.1
"2011","Walsall 039F","E01010359","Total",1566,735,831,1566,0,19,22.02,71.1
"2011","Walsall 039G","E01010360","Total",1505,734,771,1505,0,17,26.99,55.8
"2011","Wolverhampton 001A","E01010434","Total",1683,806,877,1683,0,9,33.32,50.5
"2011","Wolverhampton 001B","E01010436","Total",1436,697,739,1436,0,15,63.03,22.8
"2011","Wolverhampton 001C","E01010437","Total",1226,617,609,1226,0,6,24.49,50.1
"2011","Wolverhampton 001D","E01010438","Total",1373,678,695,1373,0,11,36.22,37.9
"2011","Wolverhampton 001E","E01010439","Total",1365,650,715,1331,34,9,104.28,13.1
"2011","Wolverhampton 001F","E01010440","Total",1560,739,821,1540,20,4,39.90,39.1
"2011","Wolverhampton 001G","E01010441","Total",1384,659,725,1384,0,12,57.49,24.1
"2011","Wolverhampton 002A","E01010495","Total",1679,797,882,1679,0,12,93.39,18.0
"2011","Wolverhampton 002B","E01010497","Total",1211,598,613,1211,0,17,40.92,29.6
"2011","Wolverhampton 002C","E01010499","Total",1409,685,724,1367,42,20,37.42,37.7
"2011","Wolverhampton 002D","E01010500","Total",1416,669,747,1411,5,9,31.23,45.3
"2011","Wolverhampton 003A","E01010496","Total",1463,674,789,1441,22,12,29.94,48.9
"2011","Wolverhampton 003B","E01010498","Total",1453,729,724,1453,0,17,38.09,38.1
"2011","Wolverhampton 003C","E01010541","Total",1461,710,751,1461,0,7,22.14,66.0
"2011","Wolverhampton 003D","E01010543","Total",1449,693,756,1449,0,5,22.06,65.7
"2011","Wolverhampton 004A","E01010456","Total",1469,670,799,1469,0,4,25.94,56.6
"2011","Wolverhampton 004B","E01010457","Total",1583,791,792,1575,8,5,42.09,37.6
"2011","Wolverhampton 004C","E01010462","Total",1585,750,835,1568,17,10,58.26,27.2
"2011","Wolverhampton 004D","E01010481","Total",1595,756,839,1548,47,9,43.84,36.4
"2011","Wolverhampton 005A","E01010555","Total",1499,733,766,1499,0,7,31.20,48.0
"2011","Wolverhampton 005B","E01010556","Total",1481,732,749,1481,0,5,31.96,46.3
"2011","Wolverhampton 005C","E01010557","Total",1440,725,715,1440,0,9,26.37,54.6
"2011","Wolverhampton 005D","E01010559","Total",1412,682,730,1412,0,8,29.76,47.4
"2011","Wolverhampton 005E","E01010560","Total",1670,823,847,1670,0,4,31.32,53.3
"2011","Wolverhampton 006A","E01010435","Total",1405,678,727,1374,31,7,84.73,16.6
"2011","Wolverhampton 006B","E01010501","Total",1488,688,800,1488,0,8,53.93,27.6
"2011","Wolverhampton 006C","E01010502","Total",1356,656,700,1356,0,18,26.46,51.2
"2011","Wolverhampton 006D","E01010503","Total",1331,655,676,1331,0,1,69.26,19.2
"2011","Wolverhampton 007A","E01010482","Total",1349,639,710,1349,0,8,18.89,71.4
"2011","Wolverhampton 007B","E01010483","Total",1432,661,771,1432,0,2,27.40,52.3
"2011","Wolverhampton 007C","E01010484","Total",1379,657,722,1379,0,11,20.77,66.4
"2011","Wolverhampton 007D","E01010485","Total",1669,750,919,1665,4,4,35.92,46.5
"2011","Wolverhampton 008A","E01010458","Total",1729,814,915,1729,0,10,29.04,59.5
"2011","Wolverhampton 008B","E01010459","Total",1635,813,822,1629,6,4,30.93,52.9
"2011","Wolverhampton 008C","E01010460","Total",1632,805,827,1632,0,25,28.42,57.4
"2011","Wolverhampton 008D","E01010461","Total",1574,746,828,1574,0,11,29.01,54.3
"2011","Wolverhampton 008E","E01010566","Total",1795,838,957,1795,0,17,39.68,45.2
"2011","Wolverhampton 009A","E01010539","Total",1602,773,829,1600,2,7,37.04,43.3
"2011","Wolverhampton 009B","E01010540","Total",1443,689,754,1363,80,26,90.34,16.0
"2011","Wolverhampton 009C","E01010542","Total",1527,741,786,1527,0,9,85.00,18.0
"2011","Wolverhampton 009D","E01010544","Total",1497,744,753,1497,0,26,67.84,22.1
"2011","Wolverhampton 009E","E01010545","Total",1673,844,829,1673,0,21,40.81,41.0
"2011","Wolverhampton 010A","E01010554","Total",1404,675,729,1404,0,9,33.65,41.7
"2011","Wolverhampton 010B","E01010558","Total",1689,834,855,1631,58,7,25.96,65.1
"2011","Wolverhampton 010C","E01010562","Total",1563,795,768,1563,0,14,37.98,41.2
"2011","Wolverhampton 010D","E01010563","Total",1493,735,758,1493,0,5,25.51,58.5
"2011","Wolverhampton 010E","E01010567","Total",1510,737,773,1510,0,7,40.51,37.3
"2011","Wolverhampton 011A","E01010478","Total",1395,726,669,1372,23,7,42.00,33.2
"2011","Wolverhampton 011B","E01010479","Total",1579,724,855,1571,8,9,29.01,54.4
"2011","Wolverhampton 011C","E01010480","Total",1261,631,630,1261,0,6,25.88,48.7
"2011","Wolverhampton 011D","E01010486","Total",1788,848,940,1788,0,6,20.31,88.0
"2011","Wolverhampton 012A","E01010474","Total",1625,767,858,1527,98,6,37.74,43.1
"2011","Wolverhampton 012B","E01010561","Total",1604,790,814,1604,0,4,28.52,56.2
"2011","Wolverhampton 012C","E01010564","Total",1951,1021,930,1951,0,11,220.08,8.9
"2011","Wolverhampton 012D","E01010565","Total",1868,900,968,1868,0,11,44.63,41.9
"2011","Wolverhampton 013A","E01010522","Total",1743,898,845,1743,0,21,116.37,15.0
"2011","Wolverhampton 013B","E01010523","Total",1588,831,757,1579,9,6,32.66,48.6
"2011","Wolverhampton 013C","E01010524","Total",1535,803,732,1535,0,16,27.10,56.6
"2011","Wolverhampton 013D","E01010525","Total",1422,669,753,1422,0,7,23.99,59.3
"2011","Wolverhampton 014A","E01010546","Total",1518,717,801,1389,129,50,92.09,16.5
"2011","Wolverhampton 014B","E01010547","Total",1538,744,794,1456,82,17,68.64,22.4
"2011","Wolverhampton 014C","E01010548","Total",1415,647,768,1415,0,19,36.06,39.2
"2011","Wolverhampton 014D","E01010549","Total",1515,738,777,1515,0,14,33.01,45.9
"2011","Wolverhampton 014E","E01010553","Total",1570,764,806,1565,5,30,65.84,23.8
"2011","Wolverhampton 015A","E01010471","Total",1719,922,797,1719,0,10,32.33,53.2
"2011","Wolverhampton 015B","E01010472","Total",1895,910,985,1895,0,13,45.09,42.0
"2011","Wolverhampton 015C","E01010473","Total",2458,1391,1067,2458,0,12,37.96,64.8
"2011","Wolverhampton 015D","E01010475","Total",1639,831,808,1623,16,25,44.36,36.9
"2011","Wolverhampton 015E","E01010476","Total",1833,958,875,1810,23,11,47.51,38.6
"2011","Wolverhampton 015F","E01010477","Total",1706,817,889,1706,0,9,24.93,68.4
"2011","Wolverhampton 016A","E01010526","Total",1487,732,755,1487,0,11,18.79,79.1
"2011","Wolverhampton 016B","E01010527","Total",1874,1031,843,1874,0,4,19.96,93.9
"2011","Wolverhampton 016C","E01010528","Total",1864,1059,805,1050,814,49,18.81,99.1
"2011","Wolverhampton 016D","E01010529","Total",1618,917,701,1618,0,10,14.29,113.2
"2011","Wolverhampton 017A","E01010506","Total",1659,959,700,1622,37,14,22.89,72.5
"2011","Wolverhampton 017B","E01010508","Total",1413,826,587,1346,67,7,40.78,34.6
"2011","Wolverhampton 017C","E01010510","Total",1589,835,754,1563,26,24,37.15,42.8
"2011","Wolverhampton 017D","E01010511","Total",1625,854,771,1598,27,16,32.67,49.7
"2011","Wolverhampton 017E","E01010512","Total",1443,750,693,1370,73,24,30.19,47.8
"2011","Wolverhampton 018A","E01010442","Total",1305,623,682,1266,39,3,77.07,16.9
"2011","Wolverhampton 018B","E01010443","Total",1711,833,878,1711,0,9,76.52,22.4
"2011","Wolverhampton 018C","E01010444","Total",1320,657,663,1320,0,7,22.42,58.9
"2011","Wolverhampton 018D","E01010445","Total",1373,663,710,1373,0,5,32.73,41.9
"2011","Wolverhampton 018E","E01010447","Total",1819,942,877,1798,21,17,28.21,64.5
"2011","Wolverhampton 018F","E01010448","Total",1528,749,779,1528,0,8,46.04,33.2
"2011","Wolverhampton 019A","E01010509","Total",1478,719,759,1478,0,8,26.46,55.9
"2011","Wolverhampton 019B","E01010550","Total",1595,774,821,1595,0,34,101.02,15.8
"2011","Wolverhampton 019C","E01010551","Total",1628,841,787,1628,0,22,68.46,23.8
"2011","Wolverhampton 019D","E01010552","Total",1847,881,966,1847,0,18,63.20,29.2
"2011","Wolverhampton 020A","E01010463","Total",1635,840,795,1633,2,8,31.56,51.8
"2011","Wolverhampton 020B","E01010464","Total",1598,849,749,1471,127,7,35.76,44.7
"2011","Wolverhampton 020C","E01010465","Total",1641,805,836,1641,0,7,18.65,88.0
"2011","Wolverhampton 020D","E01010466","Total",1492,696,796,1492,0,16,14.62,102.1
"2011","Wolverhampton 020E","E01010470","Total",1408,725,683,1405,3,9,32.53,43.3
"2011","Wolverhampton 020F","E01010521","Total",2547,1418,1129,1886,661,28,172.89,14.7
"2011","Wolverhampton 021A","E01010487","Total",1522,752,770,1522,0,27,31.68,48.0
"2011","Wolverhampton 021B","E01010488","Total",1436,685,751,1436,0,12,30.21,47.5
"2011","Wolverhampton 021C","E01010493","Total",1539,756,783,1539,0,27,34.91,44.1
"2011","Wolverhampton 021D","E01010504","Total",1387,661,726,1218,169,23,86.79,16.0
"2011","Wolverhampton 021E","E01010505","Total",1290,634,656,1264,26,41,63.20,20.4
"2011","Wolverhampton 021F","E01010507","Total",1473,705,768,1416,57,24,44.73,32.9
"2011","Wolverhampton 022A","E01010418","Total",1538,750,788,1538,0,17,33.84,45.4
"2011","Wolverhampton 022B","E01010421","Total",1584,743,841,1584,0,2,22.15,71.5
"2011","Wolverhampton 022C","E01010423","Total",1552,725,827,1552,0,2,26.42,58.7
"2011","Wolverhampton 022D","E01010424","Total",1579,789,790,1579,0,12,33.05,47.8
"2011","Wolverhampton 023A","E01010417","Total",1651,831,820,1651,0,1,29.08,56.8
"2011","Wolverhampton 023B","E01010419","Total",1437,715,722,1437,0,5,29.59,48.6
"2011","Wolverhampton 023C","E01010420","Total",1298,633,665,1298,0,10,37.80,34.3
"2011","Wolverhampton 023D","E01010425","Total",1351,676,675,1351,0,9,24.92,54.2
"2011","Wolverhampton 023E","E01010446","Total",1630,833,797,1630,0,3,58.71,27.8
"2011","Wolverhampton 026A","E01010467","Total",1588,795,793,1487,101,24,32.22,49.3
"2011","Wolverhampton 026B","E01010468","Total",1500,704,796,1500,0,13,28.21,53.2
"2011","Wolverhampton 026C","E01010469","Total",1422,692,730,1415,7,13,30.96,45.9
"2011","Wolverhampton 026D","E01010516","Total",1445,724,721,1445,0,37,41.20,35.1
"2011","Wolverhampton 026E","E01010518","Total",1623,804,819,1603,20,34,41.02,39.6
"2011","Wolverhampton 027A","E01010414","Total",1962,989,973,1956,6,3,111.87,17.5
"2011","Wolverhampton 027B","E01010415","Total",1710,842,868,1710,0,8,30.49,56.1
"2011","Wolverhampton 027C","E01010416","Total",1665,783,882,1665,0,10,25.85,64.4
"2011","Wolverhampton 027D","E01010422","Total",1694,863,831,1639,55,12,53.51,31.7
"2011","Wolverhampton 028A","E01010489","Total",1534,732,802,1515,19,15,27.89,55.0
"2011","Wolverhampton 028B","E01010490","Total",1728,899,829,1728,0,3,26.73,64.6
"2011","Wolverhampton 028C","E01010491","Total",1505,689,816,1505,0,7,38.80,38.8
"2011","Wolverhampton 028D","E01010492","Total",1340,663,677,1340,0,17,22.58,59.3
"2011","Wolverhampton 028E","E01010494","Total",1585,764,821,1585,0,21,33.12,47.9
"2011","Wolverhampton 029A","E01010449","Total",2317,1123,1194,2308,9,17,44.40,52.2
"2011","Wolverhampton 029B","E01010450","Total",1738,876,862,1662,76,9,66.72,26.0
"2011","Wolverhampton 029C","E01010451","Total",1577,807,770,1577,0,7,131.24,12.0
"2011","Wolverhampton 029D","E01010452","Total",1565,781,784,1565,0,8,37.17,42.1
"2011","Wolverhampton 029E","E01010455","Total",1835,916,919,1835,0,15,56.33,32.6
"2011","Wolverhampton 030A","E01010427","Total",1699,847,852,1591,108,7,33.04,51.4
"2011","Wolverhampton 030B","E01010431","Total",1606,805,801,1606,0,24,40.64,39.5
"2011","Wolverhampton 030C","E01010432","Total",1560,782,778,1560,0,38,95.93,16.3
"2011","Wolverhampton 030D","E01010519","Total",1602,779,823,1471,131,23,27.35,58.6
"2011","Wolverhampton 030E","E01010520","Total",1647,813,834,1647,0,24,39.71,41.5
"2011","Wolverhampton 031A","E01010513","Total",1530,689,841,1457,73,20,58.82,26.0
"2011","Wolverhampton 031B","E01010514","Total",1624,831,793,1624,0,10,37.89,42.9
"2011","Wolverhampton 031C","E01010515","Total",1638,814,824,1638,0,15,34.45,47.5
"2011","Wolverhampton 031D","E01010517","Total",1609,784,825,1609,0,16,27.86,57.8
"2011","Wolverhampton 032A","E01010533","Total",1721,843,878,1696,25,17,46.69,36.9
"2011","Wolverhampton 032B","E01010535","Total",1564,744,820,1564,0,15,58.26,26.8
"2011","Wolverhampton 032C","E01010536","Total",1645,813,832,1645,0,8,39.15,42.0
"2011","Wolverhampton 032D","E01010537","Total",1462,713,749,1462,0,10,31.30,46.7
"2011","Wolverhampton 033A","E01010410","Total",1670,810,860,1670,0,4,89.75,18.6
"2011","Wolverhampton 033B","E01010411","Total",1663,838,825,1663,0,11,36.36,45.7
"2011","Wolverhampton 033C","E01010412","Total",2036,1008,1028,2036,0,9,50.18,40.6
"2011","Wolverhampton 033D","E01010413","Total",1710,831,879,1697,13,8,39.56,43.2
"2011","Wolverhampton 034A","E01010531","Total",1762,812,950,1762,0,3,53.84,32.7
"2011","Wolverhampton 034B","E01010532","Total",1653,815,838,1558,95,7,31.98,51.7
"2011","Wolverhampton 034C","E01010534","Total",1592,808,784,1592,0,34,37.46,42.5
"2011","Wolverhampton 034D","E01010538","Total",1638,796,842,1638,0,3,28.73,57.0
"2011","Wolverhampton 035A","E01010426","Total",1544,809,735,1347,197,15,62.26,24.8
"2011","Wolverhampton 035B","E01010428","Total",1444,753,691,1444,0,3,13.03,110.8
"2011","Wolverhampton 035C","E01010429","Total",1290,639,651,1267,23,8,20.24,63.7
"2011","Wolverhampton 035D","E01010430","Total",1710,853,857,1710,0,12,40.44,42.3
"2011","Wolverhampton 035E","E01010433","Total",1169,572,597,1102,67,4,35.92,32.5
"2011","Wolverhampton 035F","E01010453","Total",1925,921,1004,1924,1,17,57.75,33.3
"2011","Wolverhampton 035G","E01010454","Total",1636,826,810,1636,0,14,23.35,70.1
"2011","Wolverhampton 035H","E01010530","Total",1382,704,678,1382,0,21,51.10,27.0
"2011","Bromsgrove 001A","E01032138","Total",1419,692,727,1370,49,35,170.80,8.3
"2011","Bromsgrove 001B","E01032139","Total",1670,813,857,1670,0,41,137.94,12.1
"2011","Bromsgrove 001C","E01032140","Total",1702,796,906,1702,0,43,105.38,16.2
"2011","Bromsgrove 001D","E01032141","Total",1479,721,758,1445,34,41,532.61,2.8
"2011","Bromsgrove 002A","E01032136","Total",1330,678,652,1233,97,35,1187.22,1.1
"2011","Bromsgrove 002B","E01032137","Total",1534,764,770,1496,38,27,849.47,1.8
"2011","Bromsgrove 002C","E01032168","Total",1118,557,561,1079,39,17,151.40,7.4
"2011","Bromsgrove 002D","E01032169","Total",1119,552,567,1081,38,23,1755.98,0.6
"2011","Bromsgrove 002E","E01032176","Total",2165,1072,1093,2165,0,49,2615.61,0.8
"2011","Bromsgrove 003A","E01032126","Total",2078,1018,1060,2048,30,29,216.92,9.6
"2011","Bromsgrove 003B","E01032170","Total",1446,707,739,1446,0,20,217.60,6.6
"2011","Bromsgrove 003C","E01032171","Total",1517,752,765,1517,0,18,29.10,52.1
"2011","Bromsgrove 003D","E01032172","Total",1450,725,725,1450,0,7,40.91,35.4
"2011","Bromsgrove 004A","E01032133","Total",1647,783,864,1647,0,7,25.89,63.6
"2011","Bromsgrove 004B","E01032135","Total",1648,806,842,1648,0,33,42.68,38.6
"2011","Bromsgrove 004C","E01032145","Total",1451,727,724,1436,15,20,125.36,11.6
"2011","Bromsgrove 004D","E01032147","Total",1193,570,623,1193,0,17,25.93,46.0
"2011","Bromsgrove 005A","E01032134","Total",1645,792,853,1465,180,26,708.34,2.3
"2011","Bromsgrove 005B","E01032146","Total",1659,806,853,1659,0,28,250.21,6.6
"2011","Bromsgrove 005C","E01032177","Total",1148,567,581,1125,23,16,201.18,5.7
"2011","Bromsgrove 005D","E01032178","Total",1287,617,670,1287,0,20,550.75,2.3
"2011","Bromsgrove 006A","E01032142","Total",1531,771,760,1531,0,22,124.96,12.3
"2011","Bromsgrove 006B","E01032143","Total",1476,720,756,1343,133,45,616.71,2.4
"2011","Bromsgrove 006C","E01032144","Total",1794,852,942,1774,20,59,298.77,6.0
"2011","Bromsgrove 006D","E01032149","Total",1232,613,619,1232,0,41,122.76,10.0
"2011","Bromsgrove 007A","E01032127","Total",1635,821,814,1584,51,12,95.96,17.0
"2011","Bromsgrove 007B","E01032128","Total",1419,698,721,1419,0,13,33.14,42.8
"2011","Bromsgrove 007C","E01032129","Total",1416,698,718,1416,0,24,69.65,20.3
"2011","Bromsgrove 007D","E01032152","Total",1338,632,706,1336,2,4,48.76,27.4
"2011","Bromsgrove 008A","E01032148","Total",1100,528,572,1066,34,33,441.48,2.5
"2011","Bromsgrove 008B","E01032150","Total",1500,747,753,1489,11,21,197.03,7.6
"2011","Bromsgrove 008C","E01032151","Total",1366,670,696,1350,16,16,133.11,10.3
"2011","Bromsgrove 008D","E01032153","Total",1466,697,769,1428,38,20,124.44,11.8
"2011","Bromsgrove 008E","E01032155","Total",1742,890,852,1742,0,19,96.22,18.1
"2011","Bromsgrove 009A","E01032122","Total",2089,1058,1031,1919,170,40,1665.01,1.3
"2011","Bromsgrove 009B","E01032123","Total",1524,742,782,1524,0,20,1919.97,0.8
"2011","Bromsgrove 009C","E01032124","Total",1499,700,799,1499,0,21,160.18,9.4
"2011","Bromsgrove 009D","E01032125","Total",1452,693,759,1452,0,25,125.29,11.6
"2011","Bromsgrove 010A","E01032154","Total",1805,896,909,1770,35,26,27.60,65.4
"2011","Bromsgrove 010B","E01032159","Total",1757,829,928,1702,55,18,68.83,25.5
"2011","Bromsgrove 010C","E01032160","Total",1687,812,875,1682,5,22,37.70,44.7
"2011","Bromsgrove 010D","E01032161","Total",1447,705,742,1439,8,13,67.59,21.4
"2011","Bromsgrove 011A","E01032156","Total",1793,899,894,1349,444,33,80.29,22.3
"2011","Bromsgrove 011B","E01032157","Total",1728,762,966,1653,75,18,59.37,29.1
"2011","Bromsgrove 011C","E01032173","Total",1676,832,844,1676,0,27,63.34,26.5
"2011","Bromsgrove 011D","E01032175","Total",1607,797,810,1603,4,24,77.68,20.7
"2011","Bromsgrove 012A","E01032158","Total",1454,686,768,1454,0,31,155.40,9.4
"2011","Bromsgrove 012B","E01032162","Total",1915,940,975,1915,0,25,51.13,37.5
"2011","Bromsgrove 012D","E01033059","Total",1592,793,799,1592,0,20,33.69,47.3
"2011","Bromsgrove 012E","E01033061","Total",1906,898,1008,1867,39,46,34.88,54.6
"2011","Bromsgrove 013A","E01032130","Total",2669,1321,1348,2649,20,29,89.63,29.8
"2011","Bromsgrove 013B","E01032131","Total",1709,836,873,1707,2,21,23.86,71.6
"2011","Bromsgrove 013C","E01032132","Total",2167,1043,1124,2167,0,5,39.49,54.9
"2011","Bromsgrove 013D","E01032174","Total",1557,750,807,1554,3,11,57.29,27.2
"2011","Bromsgrove 014C","E01032166","Total",2094,1060,1034,2089,5,17,964.14,2.2
"2011","Bromsgrove 014E","E01033060","Total",2149,1570,579,1104,1045,21,2627.46,0.8
"2011","Bromsgrove 014F","E01033062","Total",2396,1210,1186,2356,40,65,43.65,54.9
"2011","Bromsgrove 014G","E01033243","Total",1245,616,629,1239,6,31,879.17,1.4
"2011","Malvern Hills 001A","E01032193","Total",2172,1070,1102,2170,2,41,4218.70,0.5
"2011","Malvern Hills 001B","E01032212","Total",1918,957,961,1918,0,31,5474.96,0.4
"2011","Malvern Hills 001C","E01032213","Total",1589,817,772,1502,87,42,5303.85,0.3
"2011","Malvern Hills 001D","E01032214","Total",2188,1043,1145,2142,46,26,171.49,12.8
"2011","Malvern Hills 002A","E01032181","Total",2104,1023,1081,2027,77,33,3145.21,0.7
"2011","Malvern Hills 002B","E01032190","Total",1849,915,934,1849,0,41,1641.97,1.1
"2011","Malvern Hills 002C","E01032199","Total",1752,866,886,1752,0,39,3355.58,0.5
"2011","Malvern Hills 002D","E01032223","Total",2142,1082,1060,2031,111,63,3264.00,0.7
"2011","Malvern Hills 003A","E01032179","Total",1675,841,834,1673,2,45,2807.26,0.6
"2011","Malvern Hills 003B","E01032180","Total",1832,909,923,1799,33,48,1893.76,1.0
"2011","Malvern Hills 003C","E01032182","Total",2016,1004,1012,1960,56,40,2195.42,0.9
"2011","Malvern Hills 003D","E01032183","Total",1406,696,710,1396,10,17,513.61,2.7
"2011","Malvern Hills 004A","E01032194","Total",1448,661,787,1431,17,26,195.48,7.4
"2011","Malvern Hills 004B","E01032195","Total",1612,778,834,1612,0,18,42.39,38.0
"2011","Malvern Hills 004C","E01032196","Total",1592,787,805,1546,46,30,147.64,10.8
"2011","Malvern Hills 004D","E01032197","Total",1503,707,796,1492,11,19,53.90,27.9
"2011","Malvern Hills 005A","E01032205","Total",1070,534,536,1066,4,32,2238.81,0.5
"2011","Malvern Hills 005B","E01032206","Total",1180,572,608,1180,0,5,598.47,2.0
"2011","Malvern Hills 005C","E01032207","Total",1441,697,744,1441,0,52,569.82,2.5
"2011","Malvern Hills 005D","E01032217","Total",1571,757,814,1468,103,30,2263.78,0.7
"2011","Malvern Hills 006A","E01032188","Total",1975,944,1031,1975,0,15,47.77,41.3
"2011","Malvern Hills 006B","E01032189","Total",1982,965,1017,1982,0,20,371.07,5.3
"2011","Malvern Hills 006C","E01032220","Total",1492,758,734,1476,16,39,83.36,17.9
"2011","Malvern Hills 006D","E01032221","Total",1385,718,667,1230,155,33,277.60,5.0
"2011","Malvern Hills 006E","E01032222","Total",1389,695,694,1389,0,17,96.12,14.5
"2011","Malvern Hills 007A","E01032201","Total",1588,751,837,1580,8,26,141.82,11.2
"2011","Malvern Hills 007B","E01032202","Total",1735,831,904,1735,0,7,34.70,50.0
"2011","Malvern Hills 007C","E01032203","Total",1494,753,741,1494,0,24,54.20,27.6
"2011","Malvern Hills 007D","E01032204","Total",1608,771,837,1608,0,9,30.06,53.5
"2011","Malvern Hills 008A","E01032191","Total",2312,1121,1191,2267,45,51,2921.24,0.8
"2011","Malvern Hills 008B","E01032192","Total",1600,754,846,1564,36,33,206.56,7.7
"2011","Malvern Hills 008C","E01032211","Total",1779,837,942,1741,38,25,1864.40,1.0
"2011","Malvern Hills 009A","E01032184","Total",1541,712,829,1541,0,32,109.30,14.1
"2011","Malvern Hills 009B","E01032185","Total",1428,688,740,1428,0,23,228.84,6.2
"2011","Malvern Hills 009C","E01032186","Total",1445,600,845,1152,293,22,59.88,24.1
"2011","Malvern Hills 009D","E01032187","Total",1717,810,907,1663,54,16,42.42,40.5
"2011","Malvern Hills 010A","E01032208","Total",1464,725,739,1379,85,37,98.70,14.8
"2011","Malvern Hills 010B","E01032209","Total",1483,753,730,1009,474,43,124.05,12.0
"2011","Malvern Hills 010C","E01032210","Total",1130,517,613,1062,68,21,31.75,35.6
"2011","Malvern Hills 010D","E01032218","Total",1577,792,785,1477,100,23,814.75,1.9
"2011","Malvern Hills 010E","E01032219","Total",1619,817,802,1619,0,46,217.10,7.5
"2011","Malvern Hills 011A","E01032198","Total",2115,1040,1075,1944,171,58,6144.26,0.3
"2011","Malvern Hills 011B","E01032200","Total",2063,999,1064,2009,54,54,2783.66,0.7
"2011","Malvern Hills 011C","E01032215","Total",1123,524,599,1123,0,10,91.66,12.3
"2011","Malvern Hills 011D","E01032216","Total",1527,745,782,1520,7,30,735.76,2.1
"2011","Redditch 001A","E01032226","Total",2005,1007,998,1986,19,21,203.46,9.9
"2011","Redditch 001B","E01032227","Total",1057,530,527,1057,0,19,80.26,13.2
"2011","Redditch 001C","E01032243","Total",1403,676,727,1403,0,17,72.85,19.3
"2011","Redditch 001D","E01032244","Total",1240,609,631,1240,0,5,27.48,45.1
"2011","Redditch 002A","E01032240","Total",1341,670,671,1341,0,3,24.31,55.2
"2011","Redditch 002B","E01032241","Total",1385,681,704,1385,0,6,54.92,25.2
"2011","Redditch 002C","E01032242","Total",1378,663,715,1378,0,4,27.17,50.7
"2011","Redditch 002D","E01032245","Total",1385,688,697,1369,16,4,21.38,64.8
"2011","Redditch 003A","E01032232","Total",1668,811,857,1668,0,8,39.30,42.4
"2011","Redditch 003B","E01032233","Total",2978,1502,1476,2978,0,35,113.71,26.2
"2011","Redditch 003C","E01032234","Total",1819,840,979,1687,132,6,33.95,53.6
"2011","Redditch 003D","E01032235","Total",1817,877,940,1817,0,7,64.28,28.3
"2011","Redditch 004A","E01032224","Total",1779,957,822,1774,5,4,81.65,21.8
"2011","Redditch 004B","E01032225","Total",1148,560,588,1148,0,10,31.06,37.0
"2011","Redditch 004C","E01032239","Total",1812,986,826,1812,0,12,30.92,58.6
"2011","Redditch 004D","E01032262","Total",2139,1097,1042,2133,6,11,71.49,29.9
"2011","Redditch 005A","E01032273","Total",1396,709,687,1392,4,20,59.05,23.6
"2011","Redditch 005B","E01032275","Total",1359,676,683,1356,3,8,51.66,26.3
"2011","Redditch 005C","E01032277","Total",1304,654,650,1304,0,15,18.99,68.7
"2011","Redditch 005D","E01032278","Total",1603,797,806,1603,0,6,25.24,63.5
"2011","Redditch 006A","E01032236","Total",1779,921,858,1774,5,13,42.73,41.6
"2011","Redditch 006B","E01032237","Total",1511,729,782,1490,21,20,77.61,19.5
"2011","Redditch 006C","E01032238","Total",1356,694,662,1356,0,20,95.23,14.2
"2011","Redditch 006D","E01032264","Total",1765,903,862,1765,0,8,47.70,37.0
"2011","Redditch 007A","E01032255","Total",1416,724,692,1416,0,11,36.53,38.8
"2011","Redditch 007B","E01032263","Total",1784,889,895,1784,0,12,95.09,18.8
"2011","Redditch 007C","E01032266","Total",1589,800,789,1589,0,13,96.89,16.4
"2011","Redditch 007D","E01032274","Total",1294,647,647,1294,0,19,113.09,11.4
"2011","Redditch 008A","E01032259","Total",1530,696,834,1412,118,16,34.11,44.9
"2011","Redditch 008B","E01032269","Total",1638,803,835,1633,5,18,43.67,37.5
"2011","Redditch 008C","E01032270","Total",1337,638,699,1298,39,30,41.48,32.2
"2011","Redditch 008D","E01032271","Total",1313,655,658,1313,0,36,204.16,6.4
"2011","Redditch 008E","E01032272","Total",1242,612,630,1242,0,18,54.91,22.6
"2011","Redditch 009A","E01032253","Total",1311,670,641,1271,40,13,116.72,11.2
"2011","Redditch 009B","E01032265","Total",1596,785,811,1596,0,13,104.89,15.2
"2011","Redditch 009C","E01032267","Total",1675,841,834,1675,0,16,50.13,33.4
"2011","Redditch 009D","E01032268","Total",1225,605,620,1225,0,16,32.92,37.2
"2011","Redditch 009E","E01032276","Total",1475,756,719,1475,0,9,38.34,38.5
"2011","Redditch 010A","E01032250","Total",1389,699,690,1389,0,10,15.31,90.7
"2011","Redditch 010B","E01032251","Total",1762,868,894,1762,0,12,49.81,35.4
"2011","Redditch 010C","E01032252","Total",1434,713,721,1434,0,10,48.11,29.8
"2011","Redditch 010D","E01032254","Total",1603,801,802,1603,0,9,43.81,36.6
"2011","Redditch 011A","E01032256","Total",1506,715,791,1506,0,21,56.75,26.5
"2011","Redditch 011B","E01032257","Total",1463,732,731,1463,0,23,60.48,24.2
"2011","Redditch 011C","E01032258","Total",1478,712,766,1472,6,18,68.21,21.7
"2011","Redditch 011D","E01032260","Total",1382,629,753,1369,13,7,22.71,60.9
"2011","Redditch 012A","E01032246","Total",1404,698,706,1404,0,15,29.49,47.6
"2011","Redditch 012B","E01032247","Total",1418,686,732,1414,4,15,30.79,46.1
"2011","Redditch 012C","E01032248","Total",1477,750,727,1477,0,27,54.28,27.2
"2011","Redditch 012D","E01032249","Total",1579,790,789,1579,0,23,35.26,44.8
"2011","Redditch 012E","E01032261","Total",1415,715,700,1410,5,15,40.91,34.6
"2011","Redditch 013A","E01032228","Total",1387,702,685,1359,28,32,2092.44,0.7
"2011","Redditch 013B","E01032229","Total",1483,736,747,1483,0,22,85.76,17.3
"2011","Redditch 013C","E01032230","Total",1464,701,763,1464,0,25,179.49,8.2
"2011","Redditch 013D","E01032231","Total",1718,843,875,1718,0,17,52.04,33.0
"2011","Worcester 001A","E01032296","Total",1650,787,863,1576,74,12,26.85,61.5
"2011","Worcester 001B","E01032297","Total",1605,790,815,1605,0,14,254.08,6.3
"2011","Worcester 001C","E01032298","Total",1794,867,927,1768,26,22,69.68,25.7
"2011","Worcester 001D","E01032299","Total",1539,774,765,1539,0,23,33.88,45.4
"2011","Worcester 001E","E01032300","Total",1587,773,814,1568,19,28,68.65,23.1
"2011","Worcester 002A","E01032303","Total",1175,554,621,1175,0,1,18.48,63.6
"2011","Worcester 002B","E01032304","Total",1447,691,756,1447,0,10,21.60,67.0
"2011","Worcester 002C","E01032331","Total",1386,688,698,1381,5,4,22.09,62.7
"2011","Worcester 002D","E01032332","Total",1197,583,614,1154,43,7,23.58,50.8
"2011","Worcester 003A","E01032330","Total",1217,625,592,1217,0,7,110.79,11.0
"2011","Worcester 003B","E01032334","Total",2350,1162,1188,2350,0,18,44.05,53.3
"2011","Worcester 003C","E01032335","Total",1602,821,781,1602,0,23,100.22,16.0
"2011","Worcester 003D","E01032336","Total",1565,748,817,1565,0,26,105.43,14.8
"2011","Worcester 004A","E01032279","Total",1299,638,661,1294,5,18,20.60,63.1
"2011","Worcester 004B","E01032312","Total",1465,755,710,1465,0,11,22.43,65.3
"2011","Worcester 004C","E01032327","Total",1564,732,832,1547,17,20,39.61,39.5
"2011","Worcester 004D","E01032328","Total",1487,690,797,1487,0,19,40.81,36.4
"2011","Worcester 004E","E01032329","Total",1988,983,1005,1988,0,38,68.98,28.8
"2011","Worcester 005A","E01032301","Total",1428,704,724,1428,0,2,35.78,39.9
"2011","Worcester 005B","E01032302","Total",1241,632,609,1241,0,12,18.91,65.6
"2011","Worcester 005C","E01032310","Total",1462,761,701,1462,0,13,31.41,46.5
"2011","Worcester 005D","E01032311","Total",1525,754,771,1525,0,9,32.53,46.9
"2011","Worcester 005E","E01032313","Total",1348,648,700,1348,0,7,30.72,43.9
"2011","Worcester 005F","E01032333","Total",1962,928,1034,1957,5,6,29.44,66.6
"2011","Worcester 006A","E01032314","Total",1135,555,580,1117,18,18,25.28,44.9
"2011","Worcester 006B","E01032315","Total",2096,985,1111,1264,832,60,51.97,40.3
"2011","Worcester 006C","E01032316","Total",1175,568,607,1129,46,18,47.65,24.7
"2011","Worcester 006D","E01032317","Total",1506,712,794,1502,4,13,38.82,38.8
"2011","Worcester 007A","E01032280","Total",1610,790,820,1579,31,21,31.37,51.3
"2011","Worcester 007B","E01032281","Total",1366,669,697,1360,6,12,19.57,69.8
"2011","Worcester 007C","E01032282","Total",1759,919,840,1669,90,4,30.76,57.2
"2011","Worcester 007E","E01033246","Total",1154,578,576,1154,0,26,84.26,13.7
"2011","Worcester 007F","E01033247","Total",1090,600,490,927,163,17,24.65,44.2
"2011","Worcester 008A","E01032337","Total",1898,922,976,1898,0,36,76.85,24.7
"2011","Worcester 008B","E01032338","Total",2078,1009,1069,2078,0,10,50.10,41.5
"2011","Worcester 008C","E01032339","Total",1663,811,852,1663,0,21,102.42,16.2
"2011","Worcester 009A","E01032318","Total",1584,741,843,1584,0,6,26.33,60.2
"2011","Worcester 009B","E01032319","Total",1710,852,858,1710,0,19,46.41,36.8
"2011","Worcester 009C","E01032320","Total",1816,910,906,1797,19,25,32.82,55.3
"2011","Worcester 009D","E01032321","Total",1492,752,740,1492,0,11,35.00,42.6
"2011","Worcester 009E","E01032322","Total",1818,873,945,1817,1,12,35.16,51.7
"2011","Worcester 010A","E01032305","Total",1655,841,814,1655,0,11,37.80,43.8
"2011","Worcester 010B","E01032306","Total",1534,740,794,1534,0,9,34.40,44.6
"2011","Worcester 010C","E01032307","Total",1791,877,914,1753,38,6,30.58,58.6
"2011","Worcester 010D","E01032309","Total",1580,752,828,1580,0,12,113.92,13.9
"2011","Worcester 011A","E01032285","Total",1693,828,865,1682,11,28,29.58,57.2
"2011","Worcester 011B","E01032292","Total",1629,857,772,1565,64,6,36.80,44.3
"2011","Worcester 011D","E01032294","Total",1446,722,724,1414,32,14,28.59,50.6
"2011","Worcester 011E","E01033248","Total",1015,532,483,981,34,13,35.50,28.6
"2011","Worcester 011F","E01033249","Total",1232,652,580,1208,24,13,31.55,39.0
"2011","Worcester 012A","E01032286","Total",1689,862,827,1689,0,21,103.02,16.4
"2011","Worcester 012B","E01032287","Total",1615,800,815,1552,63,24,27.56,58.6
"2011","Worcester 012C","E01032288","Total",1578,754,824,1551,27,19,134.43,11.7
"2011","Worcester 012D","E01032289","Total",1486,737,749,1474,12,30,103.59,14.3
"2011","Worcester 012E","E01032290","Total",1522,730,792,1502,20,14,62.28,24.4
"2011","Worcester 013A","E01032283","Total",1643,770,873,1624,19,22,70.17,23.4
"2011","Worcester 013B","E01032284","Total",1971,962,1009,1885,86,34,90.37,21.8
"2011","Worcester 013C","E01032295","Total",2419,1240,1179,2414,5,31,79.23,30.5
"2011","Worcester 013D","E01032308","Total",1586,758,828,1521,65,21,56.60,28.0
"2011","Worcester 014A","E01032323","Total",1481,712,769,1481,0,22,48.91,30.3
"2011","Worcester 014B","E01032324","Total",1365,660,705,1355,10,24,34.98,39.0
"2011","Worcester 014C","E01032325","Total",1597,770,827,1597,0,27,78.78,20.3
"2011","Worcester 014D","E01032326","Total",1408,673,735,1408,0,14,29.25,48.1
"2011","Wychavon 001A","E01032354","Total",2452,1188,1264,2349,103,22,2339.56,1.0
"2011","Wychavon 001B","E01032386","Total",1330,663,667,1319,11,25,1082.66,1.2
"2011","Wychavon 001C","E01032387","Total",1384,691,693,1384,0,26,755.73,1.8
"2011","Wychavon 001D","E01032401","Total",1496,737,759,1494,2,42,3600.81,0.4
"2011","Wychavon 002A","E01032368","Total",1228,609,619,1221,7,3,23.09,53.2
"2011","Wychavon 002B","E01032369","Total",1543,732,811,1543,0,14,96.13,16.1
"2011","Wychavon 002C","E01032370","Total",1265,613,652,1265,0,19,67.07,18.9
"2011","Wychavon 002D","E01032371","Total",1348,631,717,1348,0,9,52.46,25.7
"2011","Wychavon 003A","E01032359","Total",1803,830,973,1727,76,12,115.57,15.6
"2011","Wychavon 003B","E01032360","Total",1933,941,992,1933,0,12,56.76,34.1
"2011","Wychavon 003C","E01032361","Total",1694,840,854,1694,0,31,51.77,32.7
"2011","Wychavon 004A","E01032357","Total",1187,567,620,1156,31,9,36.66,32.4
"2011","Wychavon 004B","E01032358","Total",1450,717,733,1450,0,11,28.77,50.4
"2011","Wychavon 004C","E01032365","Total",1803,855,948,1803,0,14,32.42,55.6
"2011","Wychavon 004D","E01032367","Total",1487,683,804,1424,63,38,52.18,28.5
"2011","Wychavon 005A","E01032362","Total",1979,971,1008,1960,19,42,95.57,20.7
"2011","Wychavon 005B","E01032363","Total",1521,765,756,1521,0,39,43.60,34.9
"2011","Wychavon 005C","E01032364","Total",1661,817,844,1661,0,40,46.78,35.5
"2011","Wychavon 005D","E01032366","Total",1602,770,832,1583,19,22,37.74,42.4
"2011","Wychavon 006A","E01032399","Total",1690,830,860,1652,38,32,409.99,4.1
"2011","Wychavon 006B","E01032400","Total",2251,1141,1110,2251,0,48,1050.49,2.1
"2011","Wychavon 006C","E01032404","Total",2360,1201,1159,2360,0,45,3183.72,0.7
"2011","Wychavon 007A","E01032345","Total",1447,727,720,1447,0,27,2375.73,0.6
"2011","Wychavon 007B","E01032346","Total",1331,669,662,1331,0,32,1109.36,1.2
"2011","Wychavon 007C","E01032395","Total",1206,590,616,1206,0,34,3631.27,0.3
"2011","Wychavon 007D","E01032417","Total",1491,719,772,1491,0,34,2850.14,0.5
"2011","Wychavon 008A","E01032392","Total",1518,743,775,1518,0,38,2512.49,0.6
"2011","Wychavon 008B","E01032393","Total",1552,773,779,1552,0,34,294.51,5.3
"2011","Wychavon 008C","E01032394","Total",1187,609,578,1182,5,32,3000.93,0.4
"2011","Wychavon 008D","E01032416","Total",1117,548,569,1079,38,30,2461.93,0.5
"2011","Wychavon 009A","E01032355","Total",1293,630,663,1242,51,41,2746.90,0.5
"2011","Wychavon 009B","E01032356","Total",1123,540,583,1123,0,7,78.39,14.3
"2011","Wychavon 009C","E01032402","Total",1506,719,787,1506,0,23,90.59,16.6
"2011","Wychavon 009D","E01032403","Total",1444,706,738,1414,30,23,1077.46,1.3
"2011","Wychavon 010A","E01032375","Total",1165,574,591,1165,0,27,1840.10,0.6
"2011","Wychavon 010B","E01032382","Total",1244,594,650,1244,0,19,908.36,1.4
"2011","Wychavon 010C","E01032383","Total",1480,726,754,1372,108,26,2044.94,0.7
"2011","Wychavon 010D","E01032410","Total",1354,697,657,1354,0,28,1324.52,1.0
"2011","Wychavon 010E","E01032411","Total",1597,764,833,1542,55,28,1196.51,1.3
"2011","Wychavon 011A","E01032390","Total",1364,677,687,1364,0,35,2549.21,0.5
"2011","Wychavon 011B","E01032391","Total",1097,544,553,1097,0,16,237.54,4.6
"2011","Wychavon 011C","E01032414","Total",1524,737,787,1524,0,28,1006.94,1.5
"2011","Wychavon 011D","E01032415","Total",1643,1001,642,1243,400,15,626.77,2.6
"2011","Wychavon 012A","E01032405","Total",1330,656,674,1330,0,14,252.90,5.3
"2011","Wychavon 012B","E01032406","Total",1389,667,722,1388,1,9,45.46,30.6
"2011","Wychavon 012C","E01032407","Total",1420,705,715,1420,0,20,337.67,4.2
"2011","Wychavon 012D","E01032408","Total",1357,639,718,1357,0,18,59.64,22.8
"2011","Wychavon 012E","E01032409","Total",1569,771,798,1506,63,16,446.58,3.5
"2011","Wychavon 013A","E01032340","Total",1433,711,722,1399,34,22,285.32,5.0
"2011","Wychavon 013B","E01032341","Total",1315,656,659,1297,18,18,475.14,2.8
"2011","Wychavon 013C","E01032349","Total",1513,718,795,1500,13,19,497.48,3.0
"2011","Wychavon 013D","E01032350","Total",1052,526,526,1052,0,19,689.27,1.5
"2011","Wychavon 013E","E01032388","Total",1343,658,685,1343,0,20,377.68,3.6
"2011","Wychavon 013F","E01032389","Total",1267,618,649,1266,1,11,1226.72,1.0
"2011","Wychavon 014A","E01032343","Total",2336,1167,1169,2323,13,17,63.21,37.0
"2011","Wychavon 014B","E01032377","Total",1792,881,911,1758,34,11,68.44,26.2
"2011","Wychavon 014C","E01032378","Total",1705,838,867,1705,0,10,85.86,19.9
"2011","Wychavon 015A","E01032376","Total",1507,748,759,1489,18,29,172.88,8.7
"2011","Wychavon 015B","E01032384","Total",1313,655,658,1313,0,9,29.11,45.1
"2011","Wychavon 015C","E01032385","Total",1225,568,657,1225,0,13,465.87,2.6
"2011","Wychavon 015D","E01032396","Total",1668,822,846,1668,0,23,97.86,17.0
"2011","Wychavon 016A","E01032342","Total",1565,776,789,1547,18,19,55.52,28.2
"2011","Wychavon 016B","E01032344","Total",1448,719,729,1448,0,20,193.67,7.5
"2011","Wychavon 016C","E01032379","Total",1879,945,934,1879,0,32,171.24,11.0
"2011","Wychavon 016D","E01032380","Total",1575,762,813,1533,42,25,36.18,43.5
"2011","Wychavon 017A","E01032381","Total",1903,925,978,1898,5,14,55.06,34.6
"2011","Wychavon 017B","E01032397","Total",1745,854,891,1733,12,17,83.03,21.0
"2011","Wychavon 017C","E01032398","Total",1767,883,884,1761,6,24,23.39,75.5
"2011","Wychavon 018A","E01032351","Total",1503,711,792,1464,39,29,1579.95,1.0
"2011","Wychavon 018B","E01032352","Total",1501,735,766,1485,16,22,1279.32,1.2
"2011","Wychavon 018C","E01032353","Total",1577,732,845,1568,9,19,136.11,11.6
"2011","Wychavon 018D","E01032374","Total",1291,632,659,1291,0,42,1744.25,0.7
"2011","Wychavon 019A","E01032347","Total",1289,646,643,1289,0,23,724.65,1.8
"2011","Wychavon 019B","E01032348","Total",1215,587,628,1215,0,32,746.73,1.6
"2011","Wychavon 019C","E01032372","Total",1452,714,738,1452,0,40,2578.52,0.6
"2011","Wychavon 019D","E01032373","Total",1253,626,627,1253,0,36,851.81,1.5
"2011","Wychavon 019E","E01032412","Total",1229,595,634,1229,0,23,1884.74,0.7
"2011","Wychavon 019F","E01032413","Total",1068,520,548,1067,1,27,1308.74,0.8
"2011","Wyre Forest 001A","E01032431","Total",1441,735,706,1426,15,31,2640.34,0.5
"2011","Wyre Forest 001B","E01032432","Total",1454,840,614,1271,183,21,1854.46,0.8
"2011","Wyre Forest 001C","E01032433","Total",1303,630,673,1290,13,25,776.63,1.7
"2011","Wyre Forest 001D","E01032439","Total",1373,679,694,1369,4,14,426.56,3.2
"2011","Wyre Forest 001E","E01032440","Total",1190,537,653,1163,27,13,375.22,3.2
"2011","Wyre Forest 001F","E01032479","Total",2087,1027,1060,2065,22,26,1374.57,1.5
"2011","Wyre Forest 002A","E01032441","Total",1257,635,622,1257,0,8,19.78,63.5
"2011","Wyre Forest 002B","E01032442","Total",1471,730,741,1471,0,12,42.25,34.8
"2011","Wyre Forest 002C","E01032443","Total",1335,650,685,1326,9,8,39.47,33.8
"2011","Wyre Forest 002D","E01032444","Total",1207,590,617,1184,23,14,47.90,25.2
"2011","Wyre Forest 002E","E01032445","Total",1520,728,792,1516,4,15,35.19,43.2
"2011","Wyre Forest 003A","E01032436","Total",1522,762,760,1522,0,12,44.67,34.1
"2011","Wyre Forest 003B","E01032438","Total",1514,757,757,1514,0,13,47.89,31.6
"2011","Wyre Forest 003C","E01032446","Total",1440,686,754,1407,33,21,30.66,47.0
"2011","Wyre Forest 003D","E01032447","Total",1468,728,740,1426,42,19,25.12,58.4
"2011","Wyre Forest 003E","E01032448","Total",1227,588,639,1227,0,12,43.15,28.4
"2011","Wyre Forest 004A","E01032434","Total",1650,828,822,1650,0,14,33.20,49.7
"2011","Wyre Forest 004B","E01032435","Total",1446,711,735,1440,6,13,32.81,44.1
"2011","Wyre Forest 004C","E01032437","Total",1801,901,900,1801,0,8,66.08,27.3
"2011","Wyre Forest 004D","E01032450","Total",2269,1122,1147,2197,72,18,101.90,22.3
"2011","Wyre Forest 005A","E01032430","Total",1678,842,836,1678,0,31,1763.20,1.0
"2011","Wyre Forest 005B","E01032480","Total",1782,874,908,1782,0,40,538.57,3.3
"2011","Wyre Forest 005C","E01032481","Total",1717,834,883,1657,60,17,1445.76,1.2
"2011","Wyre Forest 005D","E01032482","Total",1399,698,701,1398,1,23,75.85,18.4
"2011","Wyre Forest 006A","E01032451","Total",1531,755,776,1528,3,27,50.97,30.0
"2011","Wyre Forest 006B","E01032452","Total",1567,764,803,1529,38,22,65.41,24.0
"2011","Wyre Forest 006C","E01032453","Total",1681,792,889,1681,0,10,26.57,63.3
"2011","Wyre Forest 006D","E01032454","Total",1666,807,859,1578,88,17,45.39,36.7
"2011","Wyre Forest 007A","E01032449","Total",1594,816,778,1575,19,12,20.29,78.6
"2011","Wyre Forest 007B","E01032464","Total",1495,708,787,1495,0,3,48.58,30.8
"2011","Wyre Forest 007C","E01032465","Total",1495,712,783,1491,4,6,29.52,50.6
"2011","Wyre Forest 007D","E01032466","Total",1391,652,739,1320,71,19,42.08,33.1
"2011","Wyre Forest 007E","E01032467","Total",1158,567,591,1158,0,27,114.28,10.1
"2011","Wyre Forest 007F","E01032468","Total",1168,562,606,1143,25,9,40.94,28.5
"2011","Wyre Forest 008A","E01032474","Total",1703,879,824,1692,11,12,27.14,62.7
"2011","Wyre Forest 008B","E01032475","Total",1658,835,823,1645,13,9,44.48,37.3
"2011","Wyre Forest 008C","E01032476","Total",1399,696,703,1396,3,16,32.01,43.7
"2011","Wyre Forest 008D","E01032477","Total",1193,589,604,1193,0,7,64.40,18.5
"2011","Wyre Forest 008E","E01032478","Total",1529,738,791,1529,0,11,32.30,47.3
"2011","Wyre Forest 009A","E01032469","Total",1738,879,859,1729,9,4,99.03,17.6
"2011","Wyre Forest 009B","E01032470","Total",1818,908,910,1807,11,7,133.98,13.6
"2011","Wyre Forest 009C","E01032471","Total",1608,803,805,1608,0,17,66.87,24.0
"2011","Wyre Forest 010A","E01032418","Total",1315,680,635,1315,0,11,58.91,22.3
"2011","Wyre Forest 010B","E01032419","Total",1313,642,671,1280,33,17,37.37,35.1
"2011","Wyre Forest 010C","E01032420","Total",1261,641,620,1261,0,29,132.14,9.5
"2011","Wyre Forest 010D","E01032421","Total",1243,622,621,1243,0,32,47.82,26.0
"2011","Wyre Forest 010E","E01032422","Total",1447,674,773,1447,0,7,29.96,48.3
"2011","Wyre Forest 011A","E01032427","Total",1563,761,802,1540,23,17,52.56,29.7
"2011","Wyre Forest 011B","E01032428","Total",1635,843,792,1635,0,34,1337.08,1.2
"2011","Wyre Forest 011C","E01032429","Total",1520,732,788,1499,21,26,62.82,24.2
"2011","Wyre Forest 011D","E01032472","Total",1204,614,590,1203,1,28,2642.15,0.5
"2011","Wyre Forest 011E","E01032473","Total",1239,601,638,1222,17,15,971.47,1.3
"2011","Wyre Forest 012A","E01032455","Total",1506,730,776,1506,0,14,114.35,13.2
"2011","Wyre Forest 012B","E01032456","Total",1220,580,640,1196,24,7,41.68,29.3
"2011","Wyre Forest 012C","E01032457","Total",1348,628,720,1276,72,12,117.29,11.5
"2011","Wyre Forest 012D","E01032458","Total",1367,666,701,1367,0,20,62.80,21.8
"2011","Wyre Forest 012E","E01032459","Total",1438,676,762,1438,0,8,149.72,9.6
"2011","Wyre Forest 013A","E01032460","Total",1785,872,913,1785,0,8,57.82,30.9
"2011","Wyre Forest 013B","E01032461","Total",1978,1053,925,1970,8,28,116.01,17.1
"2011","Wyre Forest 013C","E01032462","Total",2224,1086,1138,2224,0,15,283.90,7.8
"2011","Wyre Forest 013D","E01032463","Total",1635,795,840,1635,0,7,73.96,22.1
"2011","Wyre Forest 014A","E01032423","Total",1499,738,761,1499,0,11,102.27,14.7
"2011","Wyre Forest 014B","E01032424","Total",1423,688,735,1423,0,9,24.80,57.4
"2011","Wyre Forest 014C","E01032425","Total",1430,683,747,1424,6,16,129.91,11.0
"2011","Wyre Forest 014D","E01032426","Total",1439,720,719,1436,3,8,28.40,50.7
"2011","Bedford 001A","E01017540","Total",1466,725,741,1465,1,48,5099.27,0.3
"2011","Bedford 001B","E01017541","Total",1286,638,648,1268,18,35,1254.05,1.0
"2011","Bedford 001C","E01017544","Total",1431,669,762,1398,33,55,204.98,7.0
"2011","Bedford 001D","E01017545","Total",1492,741,751,1484,8,50,3799.10,0.4
"2011","Bedford 002A","E01017464","Total",1460,740,720,1460,0,43,1359.93,1.1
"2011","Bedford 002B","E01017465","Total",1426,695,731,1395,31,32,1556.70,0.9
"2011","Bedford 002C","E01017503","Total",1311,645,666,1270,41,19,2116.37,0.6
"2011","Bedford 002D","E01017504","Total",1978,952,1026,1971,7,36,2484.96,0.8
"2011","Bedford 002E","E01017546","Total",1225,603,622,1211,14,36,1630.74,0.8
"2011","Bedford 002F","E01017547","Total",1547,794,753,1547,0,37,2305.63,0.7
"2011","Bedford 003A","E01017478","Total",1715,831,884,1688,27,48,2937.34,0.6
"2011","Bedford 003B","E01017479","Total",1269,607,662,1260,9,18,256.02,5.0
"2011","Bedford 003C","E01017480","Total",2091,963,1128,1923,168,29,100.72,20.8
"2011","Bedford 003D","E01017481","Total",1200,591,609,1198,2,8,482.60,2.5
"2011","Bedford 003E","E01017528","Total",2493,1221,1272,2487,6,52,594.13,4.2
"2011","Bedford 004B","E01017495","Total",2003,969,1034,2003,0,25,1161.06,1.7
"2011","Bedford 004C","E01017496","Total",1473,722,751,1473,0,33,1534.68,1.0
"2011","Bedford 004D","E01017542","Total",1383,692,691,1378,5,28,3163.81,0.4
"2011","Bedford 004E","E01017543","Total",1464,765,699,1427,37,33,3633.25,0.4
"2011","Bedford 004F","E01033431","Total",1462,681,781,1416,46,13,138.11,10.6
"2011","Bedford 004G","E01033432","Total",2249,1078,1171,2211,38,46,1818.40,1.2
"2011","Bedford 005A","E01017453","Total",1330,662,668,1302,28,14,26.40,50.4
"2011","Bedford 005B","E01017454","Total",1473,711,762,1473,0,29,35.72,41.2
"2011","Bedford 005C","E01017455","Total",1458,714,744,1458,0,18,55.24,26.4
"2011","Bedford 005D","E01017456","Total",1432,688,744,1432,0,55,52.62,27.2
"2011","Bedford 005E","E01017457","Total",1180,562,618,1180,0,21,35.02,33.7
"2011","Bedford 005F","E01017458","Total",1280,644,636,1280,0,20,21.44,59.7
"2011","Bedford 006A","E01017529","Total",1295,632,663,1295,0,16,25.53,50.7
"2011","Bedford 006B","E01017530","Total",1410,720,690,1410,0,22,69.58,20.3
"2011","Bedford 006C","E01017531","Total",1354,627,727,1354,0,16,20.87,64.9
"2011","Bedford 006D","E01017532","Total",1271,636,635,1271,0,33,45.72,27.8
"2011","Bedford 006E","E01017533","Total",1209,577,632,1185,24,28,46.80,25.8
"2011","Bedford 006F","E01017534","Total",1533,740,793,1533,0,17,34.40,44.6
"2011","Bedford 007A","E01017488","Total",1451,705,746,1451,0,22,43.03,33.7
"2011","Bedford 007B","E01017489","Total",1581,732,849,1581,0,14,21.94,72.1
"2011","Bedford 007C","E01017490","Total",1383,645,738,1383,0,4,53.83,25.7
"2011","Bedford 007D","E01017491","Total",1548,781,767,1548,0,24,25.14,61.6
"2011","Bedford 007E","E01017492","Total",1470,695,775,1470,0,12,24.08,61.0
"2011","Bedford 007F","E01017493","Total",1657,769,888,1657,0,12,76.51,21.7
"2011","Bedford 008A","E01017459","Total",1688,823,865,1683,5,46,87.11,19.4
"2011","Bedford 008B","E01017460","Total",1586,782,804,1586,0,74,447.08,3.5
"2011","Bedford 008C","E01017461","Total",1904,937,967,1904,0,55,390.01,4.9
"2011","Bedford 008D","E01017462","Total",1621,811,810,1602,19,41,286.41,5.7
"2011","Bedford 008E","E01017463","Total",1345,639,706,1345,0,20,140.09,9.6
"2011","Bedford 009A","E01017482","Total",1344,682,662,1245,99,25,73.44,18.3
"2011","Bedford 009B","E01017483","Total",1988,890,1098,1366,622,42,43.70,45.5
"2011","Bedford 009C","E01017484","Total",1288,759,529,838,450,44,38.89,33.1
"2011","Bedford 009D","E01017485","Total",1388,745,643,1359,29,28,19.09,72.7
"2011","Bedford 010A","E01017497","Total",1407,724,683,1399,8,20,10.29,136.7
"2011","Bedford 010B","E01017498","Total",1277,637,640,1277,0,15,35.68,35.8
"2011","Bedford 010C","E01017499","Total",1334,657,677,1212,122,18,140.09,9.5
"2011","Bedford 010D","E01017500","Total",1147,637,510,1129,18,14,13.27,86.4
"2011","Bedford 010E","E01017501","Total",1362,613,749,1066,296,7,18.85,72.3
"2011","Bedford 010F","E01017502","Total",1721,983,738,1491,230,10,19.15,89.9
"2011","Bedford 011A","E01017524","Total",1560,756,804,1560,0,21,86.27,18.1
"2011","Bedford 011B","E01017525","Total",1206,604,602,1206,0,17,25.11,48.0
"2011","Bedford 011C","E01017526","Total",1455,692,763,1455,0,19,31.52,46.2
"2011","Bedford 011D","E01017527","Total",1174,569,605,1167,7,22,209.06,5.6
"2011","Bedford 012A","E01017466","Total",1921,1074,847,1865,56,15,34.18,56.2
"2011","Bedford 012B","E01017467","Total",1297,615,682,1280,17,14,21.71,59.7
"2011","Bedford 012C","E01017468","Total",1315,642,673,1311,4,26,20.32,64.7
"2011","Bedford 012D","E01017469","Total",1753,865,888,1649,104,39,40.62,43.2
"2011","Bedford 012E","E01017470","Total",1275,611,664,1275,0,20,18.93,67.4
"2011","Bedford 012F","E01017471","Total",1508,802,706,1442,66,14,26.42,57.1
"2011","Bedford 013A","E01017535","Total",1456,707,749,1443,13,42,71.77,20.3
"2011","Bedford 013B","E01017536","Total",2391,1224,1167,2391,0,21,17.59,135.9
"2011","Bedford 013C","E01017537","Total",1369,657,712,1369,0,17,40.49,33.8
"2011","Bedford 013D","E01017538","Total",1815,924,891,1815,0,15,42.29,42.9
"2011","Bedford 013E","E01017539","Total",1521,780,741,1508,13,20,11.37,133.8
"2011","Bedford 014A","E01017518","Total",1534,729,805,1496,38,10,39.42,38.9
"2011","Bedford 014B","E01017519","Total",1578,742,836,1578,0,10,101.49,15.5
"2011","Bedford 014C","E01017520","Total",1461,728,733,1459,2,10,175.30,8.3
"2011","Bedford 014D","E01017521","Total",1528,771,757,1519,9,14,40.56,37.7
"2011","Bedford 014E","E01017522","Total",1811,924,887,1810,1,5,45.85,39.5
"2011","Bedford 014F","E01017523","Total",1556,703,853,1556,0,10,19.96,78.0
"2011","Bedford 015A","E01017472","Total",1462,688,774,1462,0,10,21.07,69.4
"2011","Bedford 015B","E01017473","Total",2252,1143,1109,2251,1,21,65.90,34.2
"2011","Bedford 015C","E01017474","Total",1728,855,873,1728,0,6,18.33,94.3
"2011","Bedford 015D","E01017475","Total",1521,749,772,1521,0,17,49.02,31.0
"2011","Bedford 015E","E01017476","Total",1457,704,753,1457,0,10,43.17,33.8
"2011","Bedford 015F","E01017477","Total",1261,588,673,1261,0,5,28.17,44.8
"2011","Bedford 016A","E01017509","Total",1253,599,654,1221,32,18,19.30,64.9
"2011","Bedford 016B","E01017510","Total",1510,704,806,1507,3,18,57.87,26.1
"2011","Bedford 016C","E01017511","Total",1258,635,623,1258,0,10,50.07,25.1
"2011","Bedford 016D","E01017512","Total",1454,721,733,1424,30,19,61.02,23.8
"2011","Bedford 017A","E01017505","Total",1535,765,770,1517,18,19,25.95,59.2
"2011","Bedford 017B","E01017506","Total",1552,739,813,1552,0,11,27.62,56.2
"2011","Bedford 017C","E01017507","Total",1356,650,706,1349,7,23,20.06,67.6
"2011","Bedford 017D","E01017508","Total",1618,789,829,1610,8,10,23.91,67.7
"2011","Bedford 018A","E01017513","Total",1489,698,791,1483,6,8,18.40,80.9
"2011","Bedford 018B","E01017514","Total",1635,786,849,1635,0,16,34.73,47.1
"2011","Bedford 018C","E01017515","Total",1597,778,819,1570,27,22,40.96,39.0
"2011","Bedford 018D","E01017516","Total",1481,740,741,1481,0,12,494.30,3.0
"2011","Bedford 018E","E01017517","Total",1592,784,808,1592,0,21,47.28,33.7
"2011","Bedford 019A","E01017486","Total",1719,822,897,1719,0,18,1691.91,1.0
"2011","Bedford 019B","E01017487","Total",1808,860,948,1808,0,7,71.89,25.1
"2011","Bedford 019C","E01017548","Total",1862,891,971,1833,29,21,924.58,2.0
"2011","Bedford 019D","E01017549","Total",1408,667,741,1408,0,12,339.78,4.1
"2011","Bedford 019E","E01017550","Total",2702,1321,1381,2692,10,44,603.78,4.5
"2011","Bedford 020A","E01017551","Total",1447,714,733,1447,0,29,859.97,1.7
"2011","Bedford 020B","E01017552","Total",1190,588,602,1189,1,7,648.68,1.8
"2011","Bedford 020C","E01017553","Total",1258,617,641,1258,0,16,79.11,15.9
"2011","Bedford 020D","E01017554","Total",1451,717,734,1451,0,21,45.27,32.1
"2011","Central Bedfordshire 001A","E01017433","Total",1588,780,808,1588,0,11,29.12,54.5
"2011","Central Bedfordshire 001B","E01017434","Total",1684,860,824,1683,1,16,24.18,69.6
"2011","Central Bedfordshire 001C","E01017436","Total",2329,1192,1137,2329,0,23,56.74,41.0
"2011","Central Bedfordshire 002A","E01017430","Total",1392,701,691,1392,0,10,253.22,5.5
"2011","Central Bedfordshire 002B","E01017431","Total",1481,746,735,1474,7,18,447.64,3.3
"2011","Central Bedfordshire 002C","E01017432","Total",1491,715,776,1428,63,21,174.10,8.6
"2011","Central Bedfordshire 002D","E01017435","Total",1692,829,863,1690,2,17,779.74,2.2
"2011","Central Bedfordshire 003A","E01017425","Total",1062,526,536,1062,0,22,2936.98,0.4
"2011","Central Bedfordshire 003B","E01017426","Total",1370,654,716,1370,0,25,1774.89,0.8
"2011","Central Bedfordshire 003C","E01017427","Total",1731,865,866,1725,6,26,1298.61,1.3
"2011","Central Bedfordshire 003D","E01017428","Total",1631,796,835,1631,0,22,173.39,9.4
"2011","Central Bedfordshire 003E","E01017429","Total",1405,714,691,1405,0,18,84.73,16.6
"2011","Central Bedfordshire 004A","E01017412","Total",1520,779,741,1481,39,25,3620.20,0.4
"2011","Central Bedfordshire 004B","E01017422","Total",1516,752,764,1516,0,23,880.33,1.7
"2011","Central Bedfordshire 004C","E01017423","Total",1536,761,775,1536,0,28,1656.40,0.9
"2011","Central Bedfordshire 004D","E01017424","Total",1374,680,694,1374,0,13,1490.81,0.9
"2011","Central Bedfordshire 005A","E01017383","Total",1870,938,932,1862,8,15,33.97,55.0
"2011","Central Bedfordshire 005B","E01017384","Total",1612,775,837,1609,3,6,29.31,55.0
"2011","Central Bedfordshire 005C","E01017385","Total",1653,847,806,1608,45,9,66.90,24.7
"2011","Central Bedfordshire 005D","E01017386","Total",1782,886,896,1782,0,12,170.37,10.5
"2011","Central Bedfordshire 005E","E01017387","Total",1350,645,705,1350,0,19,235.11,5.7
"2011","Central Bedfordshire 005F","E01017388","Total",1344,669,675,1344,0,5,74.97,17.9
"2011","Central Bedfordshire 006A","E01017381","Total",1473,726,747,1473,0,19,369.88,4.0
"2011","Central Bedfordshire 006B","E01017382","Total",1474,698,776,1447,27,10,33.67,43.8
"2011","Central Bedfordshire 006C","E01017389","Total",1944,977,967,1944,0,40,744.53,2.6
"2011","Central Bedfordshire 006D","E01017390","Total",2049,975,1074,2032,17,26,124.99,16.4
"2011","Central Bedfordshire 007A","E01017379","Total",1191,596,595,1191,0,20,950.76,1.3
"2011","Central Bedfordshire 007B","E01017380","Total",1241,608,633,1234,7,33,298.94,4.2
"2011","Central Bedfordshire 007C","E01017394","Total",1540,804,736,1538,2,13,121.88,12.6
"2011","Central Bedfordshire 007F","E01017397","Total",1673,852,821,1673,0,21,136.29,12.3
"2011","Central Bedfordshire 007G","E01033194","Total",2667,1509,1158,2114,553,56,2571.08,1.0
"2011","Central Bedfordshire 008A","E01017410","Total",1199,603,596,1199,0,34,1054.08,1.1
"2011","Central Bedfordshire 008B","E01017411","Total",1514,754,760,1514,0,23,1386.30,1.1
"2011","Central Bedfordshire 008C","E01017419","Total",1612,794,818,1612,0,40,753.76,2.1
"2011","Central Bedfordshire 008D","E01017420","Total",1520,722,798,1520,0,34,302.02,5.0
"2011","Central Bedfordshire 008E","E01017421","Total",1738,864,874,1733,5,29,789.30,2.2
"2011","Central Bedfordshire 009A","E01017416","Total",1981,1003,978,1981,0,18,1666.06,1.2
"2011","Central Bedfordshire 009B","E01017417","Total",2365,1175,1190,2365,0,29,1041.42,2.3
"2011","Central Bedfordshire 009C","E01017418","Total",1557,752,805,1495,62,6,55.96,27.8
"2011","Central Bedfordshire 009D","E01017451","Total",1418,685,733,1416,2,35,3984.32,0.4
"2011","Central Bedfordshire 009E","E01017452","Total",1166,559,607,1166,0,26,834.09,1.4
"2011","Central Bedfordshire 010A","E01017376","Total",1845,933,912,1840,5,15,446.10,4.1
"2011","Central Bedfordshire 010B","E01017377","Total",1971,965,1006,1924,47,30,309.13,6.4
"2011","Central Bedfordshire 010C","E01017378","Total",1768,867,901,1758,10,15,193.45,9.1
"2011","Central Bedfordshire 010D","E01017413","Total",1756,866,890,1756,0,27,738.89,2.4
"2011","Central Bedfordshire 010E","E01017414","Total",1736,873,863,1728,8,18,322.16,5.4
"2011","Central Bedfordshire 010F","E01017415","Total",1852,903,949,1829,23,22,354.48,5.2
"2011","Central Bedfordshire 011A","E01017437","Total",1528,753,775,1526,2,23,179.54,8.5
"2011","Central Bedfordshire 011B","E01017438","Total",1662,826,836,1662,0,17,38.14,43.6
"2011","Central Bedfordshire 011C","E01017439","Total",1676,819,857,1676,0,31,160.00,10.5
"2011","Central Bedfordshire 011D","E01017440","Total",1374,685,689,1341,33,16,76.97,17.9
"2011","Central Bedfordshire 011E","E01017441","Total",1935,989,946,1736,199,37,1674.91,1.2
"2011","Central Bedfordshire 011F","E01017444","Total",1842,924,918,1841,1,26,1815.38,1.0
"2011","Central Bedfordshire 012A","E01017371","Total",1300,621,679,1300,0,23,49.56,26.2
"2011","Central Bedfordshire 012B","E01017372","Total",1472,710,762,1472,0,20,34.17,43.1
"2011","Central Bedfordshire 012C","E01017373","Total",1488,748,740,1488,0,40,919.26,1.6
"2011","Central Bedfordshire 012D","E01017374","Total",1472,733,739,1440,32,34,453.44,3.2
"2011","Central Bedfordshire 012E","E01017375","Total",1443,721,722,1443,0,30,36.67,39.4
"2011","Central Bedfordshire 013A","E01017391","Total",1367,676,691,1353,14,15,185.86,7.4
"2011","Central Bedfordshire 013B","E01017392","Total",1511,740,771,1476,35,37,349.84,4.3
"2011","Central Bedfordshire 013C","E01017393","Total",1745,837,908,1693,52,38,716.24,2.4
"2011","Central Bedfordshire 013D","E01017442","Total",2052,1018,1034,2052,0,22,704.37,2.9
"2011","Central Bedfordshire 013E","E01017443","Total",1805,953,852,1671,134,39,444.74,4.1
"2011","Central Bedfordshire 014A","E01017446","Total",1731,860,871,1731,0,9,49.01,35.3
"2011","Central Bedfordshire 014B","E01017447","Total",2067,1011,1056,2067,0,33,308.61,6.7
"2011","Central Bedfordshire 014D","E01017449","Total",1486,736,750,1486,0,15,410.45,3.6
"2011","Central Bedfordshire 014E","E01033188","Total",1430,693,737,1430,0,14,120.89,11.8
"2011","Central Bedfordshire 014F","E01033189","Total",1542,760,782,1542,0,18,246.70,6.3
"2011","Central Bedfordshire 014G","E01033190","Total",1376,675,701,1376,0,6,27.14,50.7
"2011","Central Bedfordshire 015A","E01017399","Total",1495,756,739,1495,0,21,59.72,25.0
"2011","Central Bedfordshire 015B","E01017400","Total",1496,745,751,1486,10,8,172.85,8.7
"2011","Central Bedfordshire 015C","E01017401","Total",1271,635,636,1271,0,38,43.03,29.5
"2011","Central Bedfordshire 015D","E01017402","Total",1599,806,793,1576,23,23,94.14,17.0
"2011","Central Bedfordshire 016A","E01017403","Total",1419,708,711,1414,5,25,31.78,44.7
"2011","Central Bedfordshire 016B","E01017404","Total",1348,690,658,1348,0,52,371.35,3.6
"2011","Central Bedfordshire 016C","E01017405","Total",1449,720,729,1449,0,19,30.01,48.3
"2011","Central Bedfordshire 016D","E01017406","Total",1555,775,780,1534,21,25,589.08,2.6
"2011","Central Bedfordshire 016E","E01017407","Total",1602,807,795,1602,0,24,31.10,51.5
"2011","Central Bedfordshire 017A","E01017398","Total",2400,1216,1184,2400,0,52,1182.61,2.0
"2011","Central Bedfordshire 017B","E01017408","Total",1072,538,534,1072,0,27,564.42,1.9
"2011","Central Bedfordshire 017C","E01017409","Total",1225,611,614,1225,0,28,148.39,8.3
"2011","Central Bedfordshire 017D","E01017445","Total",1791,868,923,1771,20,50,924.91,1.9
"2011","Central Bedfordshire 017E","E01017450","Total",2300,1164,1136,2284,16,43,1164.14,2.0
"2011","Central Bedfordshire 018A","E01017558","Total",1798,886,912,1791,7,33,39.05,46.0
"2011","Central Bedfordshire 018B","E01017559","Total",1703,822,881,1698,5,48,830.08,2.1
"2011","Central Bedfordshire 018C","E01017560","Total",1491,743,748,1491,0,27,193.53,7.7
"2011","Central Bedfordshire 018D","E01017616","Total",2320,1159,1161,2316,4,43,2342.55,1.0
"2011","Central Bedfordshire 019A","E01017577","Total",2169,1097,1072,2169,0,30,1502.77,1.4
"2011","Central Bedfordshire 019B","E01017615","Total",2097,1039,1058,2057,40,44,2990.43,0.7
"2011","Central Bedfordshire 019C","E01017620","Total",1802,902,900,1802,0,33,1940.89,0.9
"2011","Central Bedfordshire 019D","E01017621","Total",1640,822,818,1640,0,36,56.20,29.2
"2011","Central Bedfordshire 019E","E01017622","Total",1681,837,844,1681,0,21,98.36,17.1
"2011","Central Bedfordshire 020A","E01017603","Total",1501,760,741,1501,0,23,78.93,19.0
"2011","Central Bedfordshire 020B","E01017604","Total",1661,830,831,1661,0,23,29.80,55.7
"2011","Central Bedfordshire 020C","E01017605","Total",1416,686,730,1416,0,11,18.08,78.3
"2011","Central Bedfordshire 020D","E01017606","Total",1514,742,772,1514,0,29,155.59,9.7
"2011","Central Bedfordshire 020E","E01017607","Total",1409,695,714,1307,102,30,143.18,9.8
"2011","Central Bedfordshire 021A","E01017555","Total",1910,943,967,1869,41,24,52.02,36.7
"2011","Central Bedfordshire 021B","E01017556","Total",1579,794,785,1568,11,23,21.16,74.6
"2011","Central Bedfordshire 021C","E01017557","Total",1759,810,949,1759,0,11,46.24,38.0
"2011","Central Bedfordshire 021D","E01017608","Total",1729,828,901,1685,44,16,27.63,62.6
"2011","Central Bedfordshire 021E","E01017609","Total",1668,783,885,1668,0,11,30.63,54.5
"2011","Central Bedfordshire 022A","E01017589","Total",1653,846,807,1641,12,18,28.39,58.2
"2011","Central Bedfordshire 022B","E01017590","Total",1528,783,745,1478,50,29,113.24,13.5
"2011","Central Bedfordshire 022C","E01017591","Total",1696,834,862,1696,0,30,184.02,9.2
"2011","Central Bedfordshire 022D","E01017610","Total",1133,555,578,1133,0,21,75.96,14.9
"2011","Central Bedfordshire 023A","E01017611","Total",1267,623,644,1267,0,29,22.30,56.8
"2011","Central Bedfordshire 023B","E01017612","Total",1325,645,680,1325,0,33,19.96,66.4
"2011","Central Bedfordshire 023C","E01017613","Total",1387,684,703,1387,0,38,27.51,50.4
"2011","Central Bedfordshire 023D","E01017614","Total",1495,766,729,1495,0,24,139.77,10.7
"2011","Central Bedfordshire 025A","E01017600","Total",1939,1001,938,1939,0,6,91.50,21.2
"2011","Central Bedfordshire 025B","E01017601","Total",1487,724,763,1480,7,12,22.84,65.1
"2011","Central Bedfordshire 025C","E01017602","Total",1554,756,798,1554,0,11,25.89,60.0
"2011","Central Bedfordshire 025D","E01017618","Total",1645,797,848,1645,0,15,163.17,10.1
"2011","Central Bedfordshire 025E","E01017619","Total",2171,1080,1091,2171,0,13,109.07,19.9
"2011","Central Bedfordshire 024A","E01017573","Total",1424,715,709,1424,0,18,29.01,49.1
"2011","Central Bedfordshire 024C","E01017575","Total",2478,1245,1233,2478,0,30,258.10,9.6
"2011","Central Bedfordshire 024D","E01017576","Total",1407,688,719,1407,0,18,29.63,47.5
"2011","Central Bedfordshire 024E","E01033191","Total",1417,714,703,1417,0,10,19.77,71.7
"2011","Central Bedfordshire 024F","E01033192","Total",1524,749,775,1524,0,12,14.39,105.9
"2011","Central Bedfordshire 024G","E01033193","Total",1589,799,790,1589,0,23,121.73,13.1
"2011","Central Bedfordshire 026A","E01017578","Total",1749,876,873,1714,35,17,564.06,3.1
"2011","Central Bedfordshire 026B","E01017579","Total",1467,691,776,1467,0,10,95.52,15.4
"2011","Central Bedfordshire 026C","E01017580","Total",2138,1002,1136,2138,0,21,44.99,47.5
"2011","Central Bedfordshire 026D","E01017581","Total",1828,874,954,1764,64,9,111.55,16.4
"2011","Central Bedfordshire 026E","E01017617","Total",1305,655,650,1305,0,15,22.12,59.0
"2011","Central Bedfordshire 027A","E01017582","Total",1518,767,751,1518,0,18,26.95,56.3
"2011","Central Bedfordshire 027B","E01017583","Total",1843,909,934,1841,2,24,38.57,47.8
"2011","Central Bedfordshire 027C","E01017584","Total",1968,936,1032,1899,69,19,132.87,14.8
"2011","Central Bedfordshire 027D","E01017585","Total",1417,725,692,1417,0,35,23.83,59.5
"2011","Central Bedfordshire 028A","E01017566","Total",1498,721,777,1498,0,27,76.11,19.7
"2011","Central Bedfordshire 028B","E01017595","Total",1197,589,608,1197,0,5,32.93,36.3
"2011","Central Bedfordshire 028C","E01017596","Total",1539,736,803,1539,0,8,27.60,55.8
"2011","Central Bedfordshire 028D","E01017597","Total",1448,714,734,1448,0,6,27.33,53.0
"2011","Central Bedfordshire 028E","E01017598","Total",1058,552,506,1058,0,11,24.39,43.4
"2011","Central Bedfordshire 028F","E01017599","Total",2125,1058,1067,2090,35,24,53.80,39.5
"2011","Central Bedfordshire 029A","E01017565","Total",1521,748,773,1521,0,31,46.76,32.5
"2011","Central Bedfordshire 029B","E01017567","Total",1655,812,843,1650,5,22,44.04,37.6
"2011","Central Bedfordshire 029C","E01017568","Total",1850,904,946,1803,47,15,31.04,59.6
"2011","Central Bedfordshire 029D","E01017569","Total",1612,781,831,1581,31,25,22.36,72.1
"2011","Central Bedfordshire 029E","E01017570","Total",1936,970,966,1922,14,13,57.29,33.8
"2011","Central Bedfordshire 030A","E01017592","Total",1540,758,782,1531,9,21,35.04,43.9
"2011","Central Bedfordshire 030B","E01017593","Total",1487,720,767,1487,0,17,56.41,26.4
"2011","Central Bedfordshire 030C","E01017594","Total",2166,1048,1118,2166,0,9,31.47,68.8
"2011","Central Bedfordshire 031A","E01017623","Total",1680,840,840,1675,5,15,28.08,59.8
"2011","Central Bedfordshire 031B","E01017624","Total",1877,892,985,1858,19,36,30.46,61.6
"2011","Central Bedfordshire 031C","E01017625","Total",1609,800,809,1609,0,26,27.51,58.5
"2011","Central Bedfordshire 031D","E01017626","Total",1709,860,849,1709,0,38,42.21,40.5
"2011","Central Bedfordshire 032A","E01017571","Total",1231,591,640,1231,0,12,396.71,3.1
"2011","Central Bedfordshire 032B","E01017572","Total",1354,680,674,1345,9,29,541.01,2.5
"2011","Central Bedfordshire 032C","E01017586","Total",1455,717,738,1455,0,23,969.63,1.5
"2011","Central Bedfordshire 032D","E01017587","Total",1548,780,768,1527,21,45,1657.44,0.9
"2011","Central Bedfordshire 032E","E01017588","Total",1172,560,612,1172,0,11,745.36,1.6
"2011","Central Bedfordshire 033A","E01017561","Total",1497,764,733,1497,0,31,475.25,3.1
"2011","Central Bedfordshire 033B","E01017562","Total",1440,674,766,1440,0,14,807.09,1.8
"2011","Central Bedfordshire 033C","E01017563","Total",1583,766,817,1583,0,17,54.68,29.0
"2011","Central Bedfordshire 033D","E01017564","Total",1406,692,714,1372,34,23,1785.95,0.8
"2011","Luton 001A","E01015706","Total",1406,672,734,1406,0,19,26.25,53.6
"2011","Luton 001B","E01015707","Total",1442,722,720,1442,0,20,39.57,36.4
"2011","Luton 001C","E01015708","Total",1399,720,679,1399,0,39,35.65,39.2
"2011","Luton 001D","E01015709","Total",1466,711,755,1441,25,26,49.51,29.6
"2011","Luton 001E","E01015710","Total",1494,731,763,1494,0,26,32.12,46.5
"2011","Luton 001F","E01015770","Total",1279,652,627,1279,0,16,25.54,50.1
"2011","Luton 002A","E01015801","Total",1761,881,880,1761,0,14,57.02,30.9
"2011","Luton 002B","E01015803","Total",1505,744,761,1505,0,19,28.76,52.3
"2011","Luton 002C","E01015804","Total",1830,917,913,1827,3,13,77.75,23.5
"2011","Luton 002D","E01015805","Total",1335,679,656,1322,13,21,21.07,63.4
"2011","Luton 003A","E01015769","Total",1195,574,621,1195,0,11,18.03,66.3
"2011","Luton 003B","E01015771","Total",1427,683,744,1427,0,11,33.22,43.0
"2011","Luton 003C","E01015772","Total",1475,700,775,1475,0,15,18.14,81.3
"2011","Luton 003D","E01015773","Total",1333,634,699,1333,0,18,15.48,86.1
"2011","Luton 003E","E01015774","Total",1444,673,771,1444,0,9,13.60,106.2
"2011","Luton 003F","E01015802","Total",1518,730,788,1518,0,9,20.98,72.4
"2011","Luton 004A","E01015744","Total",1438,702,736,1438,0,13,30.54,47.1
"2011","Luton 004B","E01015746","Total",1507,710,797,1470,37,22,34.18,44.1
"2011","Luton 004C","E01015747","Total",1434,690,744,1410,24,41,27.75,51.7
"2011","Luton 004D","E01015748","Total",1660,782,878,1641,19,24,34.63,47.9
"2011","Luton 005A","E01015749","Total",1894,915,979,1894,0,26,18.91,100.2
"2011","Luton 005B","E01015751","Total",1721,793,928,1663,58,17,38.93,44.2
"2011","Luton 005C","E01015752","Total",1339,644,695,1339,0,16,23.54,56.9
"2011","Luton 005D","E01015753","Total",1413,711,702,1413,0,11,46.21,30.6
"2011","Luton 005E","E01015754","Total",1773,835,938,1773,0,13,19.82,89.5
"2011","Luton 005F","E01015755","Total",1672,788,884,1605,67,22,32.92,50.8
"2011","Luton 006A","E01015764","Total",1555,754,801,1485,70,16,31.65,49.1
"2011","Luton 006B","E01015765","Total",1649,813,836,1649,0,14,32.52,50.7
"2011","Luton 006C","E01015766","Total",1675,815,860,1675,0,42,23.21,72.2
"2011","Luton 006D","E01015767","Total",1572,808,764,1572,0,25,22.51,69.8
"2011","Luton 006E","E01015768","Total",1453,690,763,1453,0,17,38.39,37.8
"2011","Luton 006F","E01015783","Total",1722,852,870,1722,0,21,21.43,80.4
"2011","Luton 006G","E01015785","Total",2134,1061,1073,2041,93,27,31.03,68.8
"2011","Luton 007A","E01015693","Total",1545,745,800,1537,8,38,38.22,40.4
"2011","Luton 007B","E01015694","Total",1443,710,733,1443,0,27,42.93,33.6
"2011","Luton 007C","E01015695","Total",1592,793,799,1592,0,30,30.33,52.5
"2011","Luton 007D","E01015696","Total",1385,638,747,1333,52,28,18.73,73.9
"2011","Luton 007E","E01015697","Total",1771,837,934,1771,0,43,36.28,48.8
"2011","Luton 007F","E01015745","Total",1590,801,789,1590,0,42,58.90,27.0
"2011","Luton 008A","E01015797","Total",1307,656,651,1307,0,18,166.09,7.9
"2011","Luton 008B","E01015798","Total",1342,641,701,1342,0,17,29.69,45.2
"2011","Luton 008C","E01015799","Total",1388,692,696,1388,0,21,28.89,48.0
"2011","Luton 008D","E01015800","Total",1523,764,759,1523,0,11,21.47,70.9
"2011","Luton 008E","E01015812","Total",1359,666,693,1359,0,20,18.95,71.7
"2011","Luton 008F","E01015813","Total",1314,630,684,1314,0,13,21.95,59.9
"2011","Luton 009A","E01015756","Total",1593,743,850,1593,0,10,22.65,70.3
"2011","Luton 009B","E01015757","Total",1533,716,817,1533,0,15,23.42,65.5
"2011","Luton 009C","E01015758","Total",1494,740,754,1494,0,15,38.88,38.4
"2011","Luton 009D","E01015759","Total",1506,730,776,1506,0,18,20.54,73.3
"2011","Luton 009E","E01015760","Total",1490,715,775,1480,10,13,32.54,45.8
"2011","Luton 009F","E01015761","Total",1652,801,851,1652,0,2,29.20,56.6
"2011","Luton 010A","E01015700","Total",2438,1228,1210,2427,11,29,32.71,74.5
"2011","Luton 010B","E01015701","Total",2219,1144,1075,2219,0,13,19.67,112.8
"2011","Luton 010C","E01015704","Total",2116,1038,1078,2116,0,9,13.11,161.4
"2011","Luton 010D","E01015782","Total",2070,1050,1020,2070,0,22,28.22,73.4
"2011","Luton 010E","E01015784","Total",2200,1111,1089,2200,0,32,21.49,102.4
"2011","Luton 010F","E01015786","Total",2210,1117,1093,2210,0,14,23.17,95.4
"2011","Luton 011A","E01015711","Total",1703,861,842,1703,0,15,25.19,67.6
"2011","Luton 011B","E01015712","Total",1805,930,875,1799,6,12,46.70,38.7
"2011","Luton 011C","E01015715","Total",1822,915,907,1822,0,9,22.36,81.5
"2011","Luton 011D","E01015716","Total",1854,867,987,1721,133,6,24.72,75.0
"2011","Luton 011E","E01015717","Total",1537,762,775,1537,0,16,20.44,75.2
"2011","Luton 011F","E01015750","Total",2186,1105,1081,2182,4,35,29.30,74.6
"2011","Luton 012A","E01015740","Total",1565,781,784,1544,21,18,51.61,30.3
"2011","Luton 012B","E01015775","Total",1609,790,819,1609,0,20,37.79,42.6
"2011","Luton 012C","E01015776","Total",1892,911,981,1892,0,19,35.99,52.6
"2011","Luton 012D","E01015777","Total",1732,861,871,1732,0,12,24.89,69.6
"2011","Luton 012E","E01015778","Total",1726,874,852,1726,0,16,25.50,67.7
"2011","Luton 012F","E01015796","Total",1461,732,729,1461,0,16,67.71,21.6
"2011","Luton 013A","E01015713","Total",1408,709,699,1408,0,13,36.21,38.9
"2011","Luton 013B","E01015714","Total",1727,872,855,1727,0,23,39.28,44.0
"2011","Luton 013C","E01015718","Total",1614,769,845,1606,8,31,31.97,50.5
"2011","Luton 013D","E01015762","Total",1699,846,853,1699,0,15,29.85,56.9
"2011","Luton 013E","E01015763","Total",1552,746,806,1552,0,11,25.68,60.4
"2011","Luton 014A","E01015721","Total",1536,773,763,1536,0,13,24.22,63.4
"2011","Luton 014B","E01015722","Total",1275,621,654,1275,0,12,22.10,57.7
"2011","Luton 014C","E01015806","Total",1318,652,666,1318,0,15,19.50,67.6
"2011","Luton 014D","E01015808","Total",1414,681,733,1414,0,20,240.76,5.9
"2011","Luton 014E","E01015809","Total",1413,736,677,1413,0,29,26.00,54.3
"2011","Luton 014F","E01015810","Total",1391,654,737,1391,0,23,20.62,67.5
"2011","Luton 014G","E01015811","Total",1428,721,707,1424,4,19,201.02,7.1
"2011","Luton 015A","E01015703","Total",2145,1102,1043,2132,13,13,13.95,153.8
"2011","Luton 015B","E01015726","Total",2328,1190,1138,2328,0,19,22.58,103.1
"2011","Luton 015C","E01015731","Total",1971,1020,951,1971,0,29,41.85,47.1
"2011","Luton 015D","E01015787","Total",2013,1010,1003,2012,1,13,42.11,47.8
"2011","Luton 015E","E01015788","Total",2033,1040,993,2033,0,10,18.68,108.8
"2011","Luton 016A","E01015719","Total",1423,722,701,1423,0,10,76.07,18.7
"2011","Luton 016B","E01015720","Total",1525,764,761,1506,19,12,25.27,60.3
"2011","Luton 016C","E01015723","Total",1311,653,658,1311,0,15,43.40,30.2
"2011","Luton 016D","E01015779","Total",1474,712,762,1474,0,22,24.89,59.2
"2011","Luton 016E","E01015780","Total",1645,811,834,1645,0,18,25.20,65.3
"2011","Luton 016F","E01015781","Total",1545,750,795,1545,0,21,22.44,68.9
"2011","Luton 016G","E01015807","Total",1363,652,711,1363,0,20,35.73,38.1
"2011","Luton 017A","E01015698","Total",1885,1005,880,1783,102,9,16.28,115.8
"2011","Luton 017B","E01015699","Total",1838,919,919,1809,29,17,19.30,95.2
"2011","Luton 017C","E01015702","Total",1780,892,888,1754,26,16,17.94,99.2
"2011","Luton 017D","E01015705","Total",1697,903,794,1697,0,12,14.20,119.5
"2011","Luton 017E","E01015725","Total",1751,887,864,1751,0,14,12.29,142.5
"2011","Luton 017F","E01015727","Total",1898,1040,858,1898,0,7,11.76,161.4
"2011","Luton 018A","E01015739","Total",1908,1057,851,1904,4,14,24.70,77.2
"2011","Luton 018B","E01015741","Total",2256,1250,1006,2256,0,8,29.99,75.2
"2011","Luton 018C","E01015742","Total",1769,930,839,1769,0,18,20.97,84.4
"2011","Luton 018D","E01015743","Total",1548,836,712,1527,21,11,27.65,56.0
"2011","Luton 018E","E01015789","Total",1747,971,776,1746,1,20,44.86,38.9
"2011","Luton 018F","E01015794","Total",2505,1366,1139,2060,445,48,50.51,49.6
"2011","Luton 019A","E01015724","Total",2342,1227,1115,2339,3,15,54.86,42.7
"2011","Luton 019B","E01015728","Total",1802,921,881,1802,0,9,59.46,30.3
"2011","Luton 019C","E01015729","Total",1961,1096,865,1900,61,21,18.41,106.5
"2011","Luton 019D","E01015730","Total",2340,1267,1073,2323,17,22,19.84,117.9
"2011","Luton 020A","E01015732","Total",1523,734,789,1523,0,17,116.29,13.1
"2011","Luton 020B","E01015733","Total",1807,846,961,1807,0,13,33.55,53.9
"2011","Luton 020C","E01015734","Total",1855,921,934,1855,0,11,32.43,57.2
"2011","Luton 020D","E01015735","Total",1730,890,840,1724,6,11,14.78,117.1
"2011","Luton 020E","E01015736","Total",1740,840,900,1704,36,19,39.27,44.3
"2011","Luton 020F","E01015737","Total",1535,749,786,1529,6,22,22.66,67.7
"2011","Luton 021A","E01015738","Total",1806,1010,796,1798,8,18,79.70,22.7
"2011","Luton 021B","E01015790","Total",1620,850,770,1620,0,18,84.25,19.2
"2011","Luton 021C","E01015791","Total",2492,1337,1155,2462,30,18,26.46,94.2
"2011","Luton 021D","E01015792","Total",1742,937,805,1742,0,20,14.31,121.7
"2011","Luton 021E","E01015793","Total",1727,914,813,1665,62,19,48.69,35.5
"2011","Luton 021F","E01015795","Total",2154,1272,882,2058,96,12,19.45,110.7
"2011","Peterborough 001A","E01015629","Total",1740,844,896,1719,21,35,554.05,3.1
"2011","Peterborough 001B","E01015635","Total",1534,746,788,1534,0,26,621.68,2.5
"2011","Peterborough 001C","E01015636","Total",1150,573,577,1150,0,24,1275.28,0.9
"2011","Peterborough 001D","E01015679","Total",1792,892,900,1781,11,37,133.05,13.5
"2011","Peterborough 002A","E01015678","Total",1422,708,714,1422,0,11,39.64,35.9
"2011","Peterborough 002B","E01015680","Total",1511,723,788,1511,0,22,44.16,34.2
"2011","Peterborough 002C","E01015681","Total",1552,743,809,1552,0,34,83.23,18.6
"2011","Peterborough 002D","E01015682","Total",1442,716,726,1442,0,23,31.90,45.2
"2011","Peterborough 003A","E01015630","Total",1539,786,753,1539,0,25,3922.71,0.4
"2011","Peterborough 003B","E01015631","Total",1306,660,646,1299,7,18,87.82,14.9
"2011","Peterborough 003C","E01015659","Total",1951,994,957,1951,0,21,31.13,62.7
"2011","Peterborough 003D","E01015684","Total",1491,718,773,1415,76,27,50.32,29.6
"2011","Peterborough 003E","E01015685","Total",1611,783,828,1611,0,21,56.55,28.5
"2011","Peterborough 004A","E01015589","Total",1654,807,847,1654,0,42,2698.80,0.6
"2011","Peterborough 004B","E01015590","Total",1222,602,620,1222,0,47,1814.88,0.7
"2011","Peterborough 004C","E01015626","Total",1485,764,721,1485,0,19,96.11,15.5
"2011","Peterborough 004D","E01015628","Total",2268,1288,980,1788,480,39,2259.22,1.0
"2011","Peterborough 005A","E01015617","Total",1317,650,667,1315,2,10,3933.71,0.3
"2011","Peterborough 005B","E01015618","Total",1084,519,565,1084,0,9,4881.17,0.2
"2011","Peterborough 005C","E01015619","Total",2033,943,1090,2020,13,12,90.57,22.4
"2011","Peterborough 005D","E01015620","Total",1704,845,859,1704,0,15,630.07,2.7
"2011","Peterborough 006A","E01015674","Total",1495,696,799,1495,0,7,32.30,46.3
"2011","Peterborough 006B","E01015675","Total",1582,778,804,1582,0,18,44.47,35.6
"2011","Peterborough 006C","E01015676","Total",1507,752,755,1507,0,16,61.00,24.7
"2011","Peterborough 006D","E01015683","Total",1836,878,958,1831,5,25,59.06,31.1
"2011","Peterborough 006E","E01015686","Total",1505,728,777,1505,0,16,102.21,14.7
"2011","Peterborough 007A","E01015607","Total",1407,648,759,1366,41,9,48.05,29.3
"2011","Peterborough 007B","E01015609","Total",1735,883,852,1735,0,9,23.62,73.5
"2011","Peterborough 007C","E01015656","Total",1541,756,785,1535,6,12,27.55,55.9
"2011","Peterborough 007D","E01015657","Total",1975,958,1017,1975,0,12,202.70,9.7
"2011","Peterborough 007E","E01015658","Total",1553,756,797,1553,0,7,30.14,51.5
"2011","Peterborough 007F","E01015660","Total",1530,745,785,1530,0,7,29.55,51.8
"2011","Peterborough 008A","E01015605","Total",1630,792,838,1630,0,16,42.66,38.2
"2011","Peterborough 008B","E01015608","Total",1559,756,803,1559,0,15,32.48,48.0
"2011","Peterborough 008C","E01015610","Total",1564,765,799,1564,0,3,29.88,52.3
"2011","Peterborough 008D","E01015633","Total",2223,1069,1154,2197,26,11,60.16,37.0
"2011","Peterborough 008E","E01015634","Total",1850,896,954,1850,0,6,33.12,55.9
"2011","Peterborough 009A","E01015593","Total",1430,702,728,1430,0,7,67.65,21.1
"2011","Peterborough 009B","E01015596","Total",1655,797,858,1655,0,12,63.21,26.2
"2011","Peterborough 009C","E01015662","Total",1450,741,709,1450,0,17,18.86,76.9
"2011","Peterborough 009D","E01015663","Total",1451,688,763,1451,0,4,28.59,50.8
"2011","Peterborough 009E","E01015664","Total",1672,811,861,1672,0,15,29.69,56.3
"2011","Peterborough 010A","E01015603","Total",2292,1212,1080,2292,0,19,62.90,36.4
"2011","Peterborough 010B","E01015604","Total",1963,1005,958,1956,7,21,24.98,78.6
"2011","Peterborough 010C","E01015632","Total",2028,1059,969,2028,0,12,28.88,70.2
"2011","Peterborough 010D","E01015661","Total",1749,906,843,1522,227,16,93.67,18.7
"2011","Peterborough 010E","E01015677","Total",1065,513,552,1065,0,5,31.59,33.7
"2011","Peterborough 011A","E01015591","Total",1479,743,736,1479,0,24,41.25,35.9
"2011","Peterborough 011B","E01015592","Total",1529,740,789,1529,0,9,47.46,32.2
"2011","Peterborough 011C","E01015594","Total",1822,906,916,1759,63,27,65.59,27.8
"2011","Peterborough 011D","E01015595","Total",1459,689,770,1459,0,21,25.51,57.2
"2011","Peterborough 011E","E01015597","Total",1573,764,809,1573,0,11,24.24,64.9
"2011","Peterborough 012A","E01015601","Total",2055,1021,1034,2055,0,25,21.44,95.8
"2011","Peterborough 012B","E01015651","Total",2060,1051,1009,2060,0,34,36.38,56.6
"2011","Peterborough 012C","E01015652","Total",2030,1037,993,2030,0,20,26.23,77.4
"2011","Peterborough 012D","E01015653","Total",1818,879,939,1769,49,23,46.17,39.4
"2011","Peterborough 012E","E01015654","Total",2374,1144,1230,2247,127,32,58.62,40.5
"2011","Peterborough 013A","E01015606","Total",1725,843,882,1725,0,10,49.80,34.6
"2011","Peterborough 013B","E01015611","Total",2097,1067,1030,2085,12,17,145.44,14.4
"2011","Peterborough 013C","E01015613","Total",1549,774,775,1537,12,5,30.92,50.1
"2011","Peterborough 013D","E01015614","Total",1799,890,909,1790,9,26,411.98,4.4
"2011","Peterborough 013E","E01015615","Total",1614,798,816,1613,1,16,44.50,36.3
"2011","Peterborough 013F","E01015616","Total",1779,892,887,1779,0,13,189.63,9.4
"2011","Peterborough 014A","E01015599","Total",1881,1010,871,1879,2,11,90.01,20.9
"2011","Peterborough 014B","E01015600","Total",1875,990,885,1875,0,4,16.02,117.0
"2011","Peterborough 014C","E01015602","Total",1947,1033,914,1928,19,18,41.40,47.0
"2011","Peterborough 014D","E01015612","Total",2183,1101,1082,2145,38,8,34.40,63.5
"2011","Peterborough 014E","E01015655","Total",2136,1111,1025,2097,39,37,35.72,59.8
"2011","Peterborough 015A","E01015598","Total",1498,741,757,1494,4,31,77.43,19.3
"2011","Peterborough 015B","E01015687","Total",1590,772,818,1590,0,29,50.89,31.2
"2011","Peterborough 015C","E01015689","Total",1435,701,734,1435,0,44,256.65,5.6
"2011","Peterborough 015D","E01015690","Total",1204,598,606,1196,8,37,104.90,11.5
"2011","Peterborough 015E","E01015691","Total",1391,662,729,1266,125,24,79.50,17.5
"2011","Peterborough 016A","E01015622","Total",2361,1208,1153,2353,8,18,57.98,40.7
"2011","Peterborough 016C","E01015665","Total",1668,829,839,1668,0,24,26.89,62.0
"2011","Peterborough 016D","E01015688","Total",1421,705,716,1374,47,23,70.76,20.1
"2011","Peterborough 016E","E01015692","Total",1421,676,745,1388,33,20,27.14,52.4
"2011","Peterborough 016F","E01033173","Total",1907,961,946,1906,1,14,42.56,44.8
"2011","Peterborough 016G","E01033182","Total",1472,745,727,1472,0,7,22.12,66.5
"2011","Peterborough 017A","E01015621","Total",1975,967,1008,1974,1,9,68.26,28.9
"2011","Peterborough 017B","E01015623","Total",1713,848,865,1713,0,14,33.49,51.1
"2011","Peterborough 017C","E01015624","Total",1627,829,798,1621,6,11,28.14,57.8
"2011","Peterborough 017D","E01015666","Total",1300,611,689,1244,56,15,34.47,37.7
"2011","Peterborough 017E","E01015668","Total",1777,869,908,1750,27,11,106.64,16.7
"2011","Peterborough 018A","E01015627","Total",1740,851,889,1740,0,58,3439.21,0.5
"2011","Peterborough 018B","E01015644","Total",1946,954,992,1946,0,19,235.41,8.3
"2011","Peterborough 018C","E01015645","Total",1634,800,834,1634,0,24,49.72,32.9
"2011","Peterborough 018D","E01015646","Total",1913,923,990,1913,0,45,81.91,23.4
"2011","Peterborough 018E","E01015648","Total",1413,679,734,1413,0,44,214.13,6.6
"2011","Peterborough 019A","E01015667","Total",1324,668,656,1324,0,12,483.91,2.7
"2011","Peterborough 019B","E01015669","Total",1394,689,705,1394,0,11,35.59,39.2
"2011","Peterborough 019C","E01015670","Total",1440,731,709,1440,0,4,30.19,47.7
"2011","Peterborough 019D","E01015671","Total",1573,757,816,1573,0,16,341.37,4.6
"2011","Peterborough 019E","E01015672","Total",1580,771,809,1580,0,12,94.83,16.7
"2011","Peterborough 019F","E01015673","Total",1496,727,769,1496,0,13,27.94,53.5
"2011","Peterborough 021A","E01015637","Total",1462,706,756,1462,0,4,22.63,64.6
"2011","Peterborough 021B","E01015639","Total",1512,732,780,1512,0,10,28.34,53.4
"2011","Peterborough 021C","E01015640","Total",1467,731,736,1463,4,7,66.10,22.2
"2011","Peterborough 021D","E01015641","Total",1259,600,659,1259,0,5,23.47,53.6
"2011","Peterborough 021E","E01015642","Total",1527,755,772,1527,0,16,22.84,66.9
"2011","Peterborough 021F","E01015647","Total",1399,642,757,1399,0,6,87.52,16.0
"2011","Peterborough 022A","E01015638","Total",1557,742,815,1440,117,28,243.37,6.4
"2011","Peterborough 022B","E01015650","Total",2023,1034,989,2023,0,22,92.28,21.9
"2011","Peterborough 022C","E01033174","Total",1221,567,654,1221,0,4,161.42,7.6
"2011","Peterborough 022D","E01033179","Total",1526,702,824,1526,0,29,174.51,8.7
"2011","Peterborough 022E","E01033181","Total",1574,785,789,1574,0,17,36.37,43.3
"2011","Peterborough 023A","E01015643","Total",1375,685,690,1375,0,14,48.59,28.3
"2011","Peterborough 023B","E01033175","Total",1476,757,719,1476,0,16,26.65,55.4
"2011","Peterborough 023C","E01033176","Total",1605,804,801,1531,74,14,262.79,6.1
"2011","Peterborough 023D","E01033177","Total",1419,718,701,1419,0,10,67.90,20.9
"2011","Peterborough 023E","E01033178","Total",1545,739,806,1545,0,19,594.16,2.6
"2011","Peterborough 023F","E01033180","Total",1632,811,821,1632,0,5,129.12,12.6
"2011","Southend-on-Sea 001A","E01015833","Total",1543,766,777,1524,19,13,30.34,50.9
"2011","Southend-on-Sea 001B","E01015834","Total",1464,708,756,1464,0,12,43.40,33.7
"2011","Southend-on-Sea 001C","E01015835","Total",1659,807,852,1624,35,14,49.81,33.3
"2011","Southend-on-Sea 001D","E01015836","Total",1515,729,786,1515,0,10,29.63,51.1
"2011","Southend-on-Sea 001E","E01015837","Total",1683,819,864,1683,0,18,41.56,40.5
"2011","Southend-on-Sea 001F","E01015838","Total",1500,736,764,1500,0,16,29.13,51.5
"2011","Southend-on-Sea 002A","E01015863","Total",2371,1152,1219,2371,0,23,55.56,42.7
"2011","Southend-on-Sea 002B","E01015864","Total",1360,665,695,1360,0,17,49.92,27.2
"2011","Southend-on-Sea 002C","E01015865","Total",1425,692,733,1425,0,10,87.68,16.3
"2011","Southend-on-Sea 002D","E01015866","Total",1532,745,787,1532,0,20,37.91,40.4
"2011","Southend-on-Sea 002E","E01015867","Total",1434,663,771,1423,11,6,29.08,49.3
"2011","Southend-on-Sea 002F","E01015868","Total",1604,822,782,1604,0,26,33.93,47.3
"2011","Southend-on-Sea 003A","E01015814","Total",1423,679,744,1412,11,10,23.44,60.7
"2011","Southend-on-Sea 003B","E01015815","Total",1598,761,837,1563,35,29,46.78,34.2
"2011","Southend-on-Sea 003C","E01015816","Total",1485,714,771,1485,0,5,34.29,43.3
"2011","Southend-on-Sea 003D","E01015817","Total",1573,760,813,1573,0,16,47.41,33.2
"2011","Southend-on-Sea 003E","E01015818","Total",1712,818,894,1712,0,15,31.78,53.9
"2011","Southend-on-Sea 003F","E01015819","Total",1428,692,736,1428,0,17,80.01,17.8
"2011","Southend-on-Sea 004A","E01015857","Total",1543,758,785,1543,0,28,37.55,41.1
"2011","Southend-on-Sea 004B","E01015858","Total",1724,866,858,1724,0,20,54.08,31.9
"2011","Southend-on-Sea 004C","E01015859","Total",1923,959,964,1880,43,14,35.37,54.4
"2011","Southend-on-Sea 004D","E01015860","Total",1540,769,771,1520,20,18,43.67,35.3
"2011","Southend-on-Sea 004E","E01015861","Total",1694,819,875,1638,56,14,53.99,31.4
"2011","Southend-on-Sea 004F","E01015862","Total",1547,749,798,1547,0,8,23.79,65.0
"2011","Southend-on-Sea 005A","E01015820","Total",1485,738,747,1485,0,14,47.94,31.0
"2011","Southend-on-Sea 005B","E01015821","Total",1565,753,812,1565,0,17,26.34,59.4
"2011","Southend-on-Sea 005C","E01015822","Total",1223,584,639,1223,0,20,27.66,44.2
"2011","Southend-on-Sea 005D","E01015823","Total",1659,790,869,1645,14,27,25.72,64.5
"2011","Southend-on-Sea 005E","E01015824","Total",1545,737,808,1545,0,7,37.35,41.4
"2011","Southend-on-Sea 005F","E01015825","Total",1600,795,805,1562,38,14,33.45,47.8
"2011","Southend-on-Sea 005G","E01015826","Total",1398,666,732,1398,0,13,28.02,49.9
"2011","Southend-on-Sea 006A","E01015869","Total",1630,808,822,1630,0,10,21.33,76.4
"2011","Southend-on-Sea 006B","E01015870","Total",1643,802,841,1636,7,9,19.19,85.6
"2011","Southend-on-Sea 006C","E01015871","Total",1617,796,821,1617,0,15,73.86,21.9
"2011","Southend-on-Sea 006D","E01015872","Total",1688,818,870,1688,0,14,18.81,89.7
"2011","Southend-on-Sea 006E","E01015873","Total",1301,617,684,1301,0,8,10.89,119.5
"2011","Southend-on-Sea 006F","E01015874","Total",1669,840,829,1669,0,16,137.27,12.2
"2011","Southend-on-Sea 006G","E01015875","Total",1665,832,833,1655,10,9,69.97,23.8
"2011","Southend-on-Sea 007A","E01015901","Total",1461,709,752,1441,20,9,13.28,110.0
"2011","Southend-on-Sea 007B","E01015902","Total",1682,840,842,1682,0,8,13.42,125.3
"2011","Southend-on-Sea 007C","E01015903","Total",1598,793,805,1598,0,9,12.69,125.9
"2011","Southend-on-Sea 007D","E01015904","Total",1648,801,847,1648,0,21,15.41,106.9
"2011","Southend-on-Sea 007E","E01015905","Total",1428,732,696,1410,18,22,13.41,106.5
"2011","Southend-on-Sea 007F","E01015906","Total",1581,799,782,1581,0,16,10.90,145.0
"2011","Southend-on-Sea 007G","E01015907","Total",1449,726,723,1442,7,19,12.60,115.0
"2011","Southend-on-Sea 008A","E01015908","Total",1611,794,817,1611,0,39,40.94,39.4
"2011","Southend-on-Sea 008B","E01015909","Total",1551,760,791,1506,45,26,23.89,64.9
"2011","Southend-on-Sea 008C","E01015910","Total",1507,755,752,1507,0,53,141.07,10.7
"2011","Southend-on-Sea 008D","E01015911","Total",1306,636,670,1306,0,16,28.41,46.0
"2011","Southend-on-Sea 008E","E01015912","Total",1497,692,805,1497,0,26,33.52,44.7
"2011","Southend-on-Sea 008F","E01015913","Total",1682,835,847,1675,7,22,38.04,44.2
"2011","Southend-on-Sea 009A","E01015883","Total",1383,666,717,1383,0,28,43.15,32.1
"2011","Southend-on-Sea 009B","E01015884","Total",2119,1012,1107,2084,35,25,47.01,45.1
"2011","Southend-on-Sea 009C","E01015885","Total",1656,781,875,1656,0,24,49.70,33.3
"2011","Southend-on-Sea 009D","E01015886","Total",1495,745,750,1495,0,8,25.28,59.1
"2011","Southend-on-Sea 009E","E01015887","Total",1594,759,835,1556,38,20,30.12,52.9
"2011","Southend-on-Sea 009F","E01015888","Total",1463,690,773,1457,6,16,270.06,5.4
"2011","Southend-on-Sea 010A","E01015895","Total",1958,1006,952,1958,0,6,38.73,50.6
"2011","Southend-on-Sea 010B","E01015896","Total",1966,988,978,1870,96,9,26.63,73.8
"2011","Southend-on-Sea 010C","E01015897","Total",2037,992,1045,2017,20,12,25.52,79.8
"2011","Southend-on-Sea 010D","E01015898","Total",1690,828,862,1686,4,7,27.61,61.2
"2011","Southend-on-Sea 010E","E01015899","Total",1899,963,936,1892,7,8,28.53,66.6
"2011","Southend-on-Sea 010F","E01015900","Total",1454,748,706,1454,0,15,13.81,105.3
"2011","Southend-on-Sea 011A","E01015845","Total",1623,769,854,1623,0,24,19.51,83.2
"2011","Southend-on-Sea 011B","E01015846","Total",1756,847,909,1717,39,20,19.77,88.8
"2011","Southend-on-Sea 011C","E01015847","Total",1733,858,875,1733,0,18,16.13,107.4
"2011","Southend-on-Sea 011D","E01015848","Total",1646,787,859,1628,18,15,56.87,28.9
"2011","Southend-on-Sea 011E","E01015849","Total",1669,804,865,1662,7,11,20.66,80.8
"2011","Southend-on-Sea 011F","E01015850","Total",1656,827,829,1651,5,15,18.35,90.2
"2011","Southend-on-Sea 012A","E01015827","Total",1661,815,846,1486,175,28,40.30,41.2
"2011","Southend-on-Sea 012B","E01015828","Total",1632,873,759,1475,157,6,16.19,100.8
"2011","Southend-on-Sea 012C","E01015829","Total",1562,716,846,1452,110,9,17.81,87.7
"2011","Southend-on-Sea 012D","E01015830","Total",1574,749,825,1552,22,37,34.34,45.8
"2011","Southend-on-Sea 012E","E01015831","Total",1998,1065,933,1959,39,19,17.33,115.3
"2011","Southend-on-Sea 012F","E01015832","Total",1618,764,854,1454,164,34,36.08,44.8
"2011","Southend-on-Sea 013A","E01015876","Total",2168,1069,1099,2160,8,20,188.76,11.5
"2011","Southend-on-Sea 013B","E01015877","Total",1785,840,945,1777,8,8,61.30,29.1
"2011","Southend-on-Sea 013C","E01015878","Total",1354,671,683,1354,0,22,27.18,49.8
"2011","Southend-on-Sea 013D","E01015879","Total",1401,659,742,1401,0,8,17.61,79.6
"2011","Southend-on-Sea 013E","E01015880","Total",1452,689,763,1452,0,7,22.21,65.4
"2011","Southend-on-Sea 013F","E01015881","Total",1391,685,706,1391,0,13,31.14,44.7
"2011","Southend-on-Sea 013G","E01015882","Total",1608,777,831,1608,0,9,32.47,49.5
"2011","Southend-on-Sea 014A","E01015839","Total",1679,810,869,1667,12,13,22.35,75.1
"2011","Southend-on-Sea 014B","E01015840","Total",1740,876,864,1688,52,14,20.45,85.1
"2011","Southend-on-Sea 014C","E01015841","Total",2356,1244,1112,2325,31,19,30.35,77.6
"2011","Southend-on-Sea 014D","E01015842","Total",1878,894,984,1877,1,19,13.97,134.4
"2011","Southend-on-Sea 014E","E01015843","Total",1687,798,889,1676,11,17,16.57,101.8
"2011","Southend-on-Sea 014F","E01015844","Total",1790,893,897,1751,39,5,20.96,85.4
"2011","Southend-on-Sea 015A","E01015851","Total",1695,844,851,1614,81,10,40.02,42.4
"2011","Southend-on-Sea 015B","E01015852","Total",1735,898,837,1684,51,8,43.06,40.3
"2011","Southend-on-Sea 015C","E01015853","Total",1820,879,941,1679,141,20,21.28,85.5
"2011","Southend-on-Sea 015D","E01015854","Total",2028,1056,972,1861,167,28,17.18,118.0
"2011","Southend-on-Sea 015E","E01015855","Total",2024,1042,982,2016,8,14,20.38,99.3
"2011","Southend-on-Sea 015F","E01015856","Total",1761,893,868,1705,56,14,22.13,79.6
"2011","Southend-on-Sea 016A","E01015889","Total",1439,695,744,1439,0,34,59.25,24.3
"2011","Southend-on-Sea 016B","E01015890","Total",1516,754,762,1516,0,43,58.10,26.1
"2011","Southend-on-Sea 016C","E01015891","Total",1443,699,744,1402,41,15,35.07,41.1
"2011","Southend-on-Sea 016D","E01015892","Total",1703,819,884,1703,0,35,21.90,77.8
"2011","Southend-on-Sea 016E","E01015893","Total",1579,704,875,1579,0,19,66.35,23.8
"2011","Southend-on-Sea 016F","E01015894","Total",1535,772,763,1531,4,25,33.83,45.4
"2011","Southend-on-Sea 017A","E01015914","Total",1365,687,678,1365,0,37,116.87,11.7
"2011","Southend-on-Sea 017B","E01015915","Total",1462,714,748,1462,0,22,32.61,44.8
"2011","Southend-on-Sea 017C","E01015916","Total",1522,717,805,1501,21,14,22.85,66.6
"2011","Southend-on-Sea 017D","E01015917","Total",1679,795,884,1663,16,14,28.56,58.8
"2011","Southend-on-Sea 017E","E01015918","Total",1419,659,760,1370,49,24,19.95,71.1
"2011","Southend-on-Sea 017F","E01015919","Total",1313,643,670,1313,0,15,22.13,59.3
"2011","Southend-on-Sea 017G","E01015920","Total",1520,714,806,1486,34,15,43.78,34.7
"2011","Thurrock 001A","E01015943","Total",1486,750,736,1486,0,12,355.28,4.2
"2011","Thurrock 001B","E01015944","Total",1242,595,647,1240,2,18,24.66,50.4
"2011","Thurrock 001C","E01015946","Total",1536,757,779,1536,0,15,1566.95,1.0
"2011","Thurrock 001D","E01015997","Total",1389,673,716,1389,0,15,89.74,15.5
"2011","Thurrock 001E","E01015999","Total",1387,716,671,1387,0,13,24.80,55.9
"2011","Thurrock 002A","E01015945","Total",1214,590,624,1211,3,15,94.07,12.9
"2011","Thurrock 002B","E01015983","Total",1455,729,726,1455,0,14,31.90,45.6
"2011","Thurrock 002C","E01015987","Total",1482,698,784,1482,0,12,29.74,49.8
"2011","Thurrock 002D","E01015988","Total",1464,626,838,1420,44,6,24.31,60.2
"2011","Thurrock 002E","E01015998","Total",1598,775,823,1598,0,12,20.12,79.4
"2011","Thurrock 003A","E01015984","Total",1312,643,669,1304,8,9,25.36,51.7
"2011","Thurrock 003B","E01015985","Total",1390,651,739,1390,0,5,24.34,57.1
"2011","Thurrock 003C","E01015986","Total",1504,711,793,1504,0,10,21.24,70.8
"2011","Thurrock 003D","E01015990","Total",1503,739,764,1490,13,26,89.57,16.8
"2011","Thurrock 003E","E01016001","Total",1351,653,698,1351,0,18,17.89,75.5
"2011","Thurrock 004A","E01015977","Total",1865,888,977,1813,52,24,456.61,4.1
"2011","Thurrock 004B","E01015978","Total",1281,637,644,1281,0,24,2850.59,0.4
"2011","Thurrock 004C","E01015979","Total",1373,676,697,1373,0,25,775.51,1.8
"2011","Thurrock 004D","E01015980","Total",1596,785,811,1596,0,23,642.98,2.5
"2011","Thurrock 005A","E01015989","Total",1563,783,780,1563,0,7,45.48,34.4
"2011","Thurrock 005B","E01015991","Total",1425,703,722,1425,0,18,48.77,29.2
"2011","Thurrock 005C","E01015992","Total",1888,948,940,1885,3,15,498.94,3.8
"2011","Thurrock 005D","E01016000","Total",1414,689,725,1411,3,8,34.41,41.1
"2011","Thurrock 005E","E01016002","Total",1368,674,694,1368,0,18,26.02,52.6
"2011","Thurrock 006A","E01015932","Total",1585,787,798,1585,0,15,347.33,4.6
"2011","Thurrock 006B","E01015971","Total",1459,708,751,1459,0,6,878.70,1.7
"2011","Thurrock 006C","E01015972","Total",1704,866,838,1704,0,15,129.87,13.1
"2011","Thurrock 006D","E01015973","Total",1758,857,901,1758,0,3,58.72,29.9
"2011","Thurrock 006E","E01015974","Total",1421,675,746,1413,8,9,32.02,44.4
"2011","Thurrock 006F","E01015975","Total",1559,769,790,1551,8,14,23.98,65.0
"2011","Thurrock 007A","E01015927","Total",1857,889,968,1857,0,10,28.00,66.3
"2011","Thurrock 007B","E01015928","Total",1747,878,869,1739,8,8,92.03,19.0
"2011","Thurrock 007C","E01015929","Total",1503,714,789,1469,34,16,84.32,17.8
"2011","Thurrock 007D","E01015930","Total",1764,905,859,1764,0,13,51.99,33.9
"2011","Thurrock 007E","E01015931","Total",1324,701,623,1324,0,9,24.17,54.8
"2011","Thurrock 007F","E01015976","Total",1779,885,894,1779,0,3,29.04,61.3
"2011","Thurrock 008A","E01015922","Total",1518,738,780,1518,0,15,42.79,35.5
"2011","Thurrock 008B","E01015923","Total",1577,774,803,1577,0,1,49.16,32.1
"2011","Thurrock 008C","E01015924","Total",1551,760,791,1551,0,9,394.13,3.9
"2011","Thurrock 008D","E01015925","Total",1565,778,787,1565,0,11,327.13,4.8
"2011","Thurrock 008E","E01015926","Total",1525,762,763,1524,1,11,71.49,21.3
"2011","Thurrock 009A","E01015957","Total",1539,760,779,1537,2,5,25.30,60.8
"2011","Thurrock 009B","E01015958","Total",1315,677,638,1315,0,12,35.28,37.3
"2011","Thurrock 009C","E01015993","Total",1602,773,829,1599,3,26,178.97,9.0
"2011","Thurrock 009D","E01015994","Total",1556,730,826,1554,2,16,46.57,33.4
"2011","Thurrock 009E","E01015995","Total",1671,836,835,1671,0,31,39.00,42.8
"2011","Thurrock 009F","E01015996","Total",1631,818,813,1631,0,11,24.94,65.4
"2011","Thurrock 010A","E01015963","Total",1189,576,613,1189,0,9,38.12,31.2
"2011","Thurrock 010B","E01015964","Total",1555,760,795,1549,6,11,30.12,51.6
"2011","Thurrock 010C","E01015965","Total",1446,722,724,1446,0,13,91.00,15.9
"2011","Thurrock 010D","E01015966","Total",1580,800,780,1576,4,25,56.96,27.7
"2011","Thurrock 012A","E01015933","Total",1551,715,836,1466,85,3,39.79,39.0
"2011","Thurrock 012B","E01015934","Total",1496,720,776,1496,0,6,33.02,45.3
"2011","Thurrock 012C","E01015935","Total",1604,806,798,1604,0,11,75.89,21.1
"2011","Thurrock 012D","E01015936","Total",1697,806,891,1662,35,9,29.77,57.0
"2011","Thurrock 012E","E01015937","Total",1633,817,816,1633,0,13,71.72,22.8
"2011","Thurrock 012F","E01015938","Total",1884,878,1006,1884,0,7,113.91,16.5
"2011","Thurrock 013A","E01015947","Total",1408,696,712,1408,0,6,15.75,89.4
"2011","Thurrock 013B","E01015948","Total",1538,761,777,1538,0,22,67.19,22.9
"2011","Thurrock 013C","E01015949","Total",1690,808,882,1690,0,12,908.85,1.9
"2011","Thurrock 013D","E01015950","Total",1728,842,886,1703,25,20,733.67,2.4
"2011","Thurrock 014A","E01015960","Total",1470,736,734,1470,0,19,38.25,38.4
"2011","Thurrock 014B","E01015967","Total",1522,754,768,1518,4,14,65.15,23.4
"2011","Thurrock 014C","E01015968","Total",1367,661,706,1367,0,12,25.93,52.7
"2011","Thurrock 014D","E01015969","Total",1737,839,898,1736,1,18,46.84,37.1
"2011","Thurrock 014E","E01015970","Total",1329,687,642,1329,0,17,24.68,53.8
"2011","Thurrock 015A","E01015921","Total",1176,606,570,1164,12,6,118.31,9.9
"2011","Thurrock 015B","E01016011","Total",1513,786,727,1513,0,6,116.74,13.0
"2011","Thurrock 015C","E01016012","Total",2513,1289,1224,2513,0,13,791.58,3.2
"2011","Thurrock 015D","E01016013","Total",2202,1129,1073,2202,0,15,78.20,28.2
"2011","Thurrock 015E","E01016014","Total",2537,1225,1312,2536,1,15,37.66,67.4
"2011","Thurrock 015F","E01016015","Total",1713,880,833,1713,0,14,33.88,50.6
"2011","Thurrock 016A","E01015955","Total",1550,774,776,1532,18,13,92.83,16.7
"2011","Thurrock 016B","E01015956","Total",2059,1013,1046,1977,82,11,34.10,60.4
"2011","Thurrock 016C","E01015959","Total",1667,844,823,1633,34,32,38.32,43.5
"2011","Thurrock 016D","E01015961","Total",1502,761,741,1502,0,11,20.19,74.4
"2011","Thurrock 016E","E01015962","Total",1657,825,832,1611,46,5,22.76,72.8
"2011","Thurrock 017A","E01015951","Total",1681,854,827,1681,0,14,24.30,69.2
"2011","Thurrock 017B","E01015952","Total",2045,1046,999,2045,0,14,19.79,103.3
"2011","Thurrock 017C","E01015953","Total",2082,1129,953,2082,0,7,31.87,65.3
"2011","Thurrock 017D","E01015954","Total",2278,1134,1144,2278,0,9,33.14,68.7
"2011","Thurrock 018A","E01016003","Total",1966,956,1010,1902,64,18,373.11,5.3
"2011","Thurrock 018B","E01016004","Total",1662,759,903,1662,0,7,332.83,5.0
"2011","Thurrock 018C","E01016005","Total",1556,765,791,1556,0,6,19.45,80.0
"2011","Thurrock 018D","E01016006","Total",1694,801,893,1694,0,10,17.90,94.6
"2011","Thurrock 018E","E01016007","Total",1489,750,739,1489,0,9,321.46,4.6
"2011","Thurrock 018F","E01016008","Total",1524,765,759,1524,0,10,17.65,86.3
"2011","Thurrock 018G","E01016009","Total",1707,817,890,1705,2,13,22.88,74.6
"2011","Thurrock 018H","E01016010","Total",1457,707,750,1457,0,13,24.27,60.0
"2011","Thurrock 019A","E01015982","Total",2566,1301,1265,2566,0,38,69.12,37.1
"2011","Thurrock 019B","E01033610","Total",1648,803,845,1648,0,10,34.53,47.7
"2011","Thurrock 019C","E01033611","Total",1631,824,807,1625,6,16,15.32,106.5
"2011","Thurrock 019D","E01033613","Total",1539,718,821,1539,0,8,20.96,73.4
"2011","Thurrock 020A","E01015939","Total",1564,787,777,1564,0,19,21.86,71.5
"2011","Thurrock 020B","E01015941","Total",1448,722,726,1448,0,13,22.14,65.4
"2011","Thurrock 020C","E01015942","Total",1607,802,805,1593,14,17,145.41,11.1
"2011","Thurrock 020D","E01033612","Total",1580,802,778,1580,0,13,22.23,71.1
"2011","Thurrock 020E","E01033614","Total",1872,936,936,1872,0,19,21.99,85.1
"2011","Cambridge 001A","E01017975","Total",1652,824,828,1563,89,8,28.01,59.0
"2011","Cambridge 001B","E01017976","Total",1658,890,768,1651,7,21,34.06,48.7
"2011","Cambridge 001C","E01017977","Total",1617,824,793,1617,0,9,22.09,73.2
"2011","Cambridge 001D","E01017978","Total",1551,773,778,1551,0,12,33.84,45.8
"2011","Cambridge 001E","E01017979","Total",1558,775,783,1504,54,15,17.74,87.8
"2011","Cambridge 001F","E01017980","Total",1106,558,548,1106,0,21,21.33,51.9
"2011","Cambridge 002A","E01017949","Total",1620,848,772,1536,84,28,25.70,63.0
"2011","Cambridge 002B","E01017950","Total",1364,700,664,1333,31,21,16.34,83.5
"2011","Cambridge 002C","E01017951","Total",1467,754,713,1465,2,15,36.13,40.6
"2011","Cambridge 002D","E01017952","Total",1492,758,734,1492,0,13,22.18,67.3
"2011","Cambridge 002E","E01017953","Total",1620,829,791,1620,0,16,26.43,61.3
"2011","Cambridge 002F","E01017954","Total",1507,718,789,1470,37,22,22.60,66.7
"2011","Cambridge 003B","E01017971","Total",1669,867,802,1632,37,21,128.68,13.0
"2011","Cambridge 003C","E01017972","Total",1622,815,807,1610,12,16,31.43,51.6
"2011","Cambridge 003D","E01017973","Total",1759,833,926,1647,112,19,27.24,64.6
"2011","Cambridge 003E","E01017974","Total",1738,889,849,1738,0,11,26.99,64.4
"2011","Cambridge 003F","E01032792","Total",1306,675,631,1306,0,17,26.80,48.7
"2011","Cambridge 003G","E01032802","Total",1311,652,659,1306,5,12,20.25,64.7
"2011","Cambridge 004A","E01018006","Total",1656,826,830,1631,25,23,26.95,61.4
"2011","Cambridge 004B","E01018007","Total",1612,809,803,1607,5,56,50.26,32.1
"2011","Cambridge 004C","E01018008","Total",1641,847,794,1605,36,40,24.15,68.0
"2011","Cambridge 004D","E01018009","Total",1935,1020,915,1795,140,16,28.88,67.0
"2011","Cambridge 004E","E01018010","Total",1785,922,863,1693,92,45,22.32,80.0
"2011","Cambridge 005A","E01017955","Total",1469,709,760,1469,0,34,45.68,32.2
"2011","Cambridge 005B","E01017956","Total",1651,897,754,1240,411,55,198.81,8.3
"2011","Cambridge 005C","E01017957","Total",1522,603,919,1138,384,32,17.10,89.0
"2011","Cambridge 005D","E01017958","Total",5143,2956,2187,682,4461,73,79.46,64.7
"2011","Cambridge 006A","E01017943","Total",1751,921,830,1724,27,28,42.23,41.5
"2011","Cambridge 006B","E01017944","Total",1407,724,683,1405,2,8,38.60,36.5
"2011","Cambridge 006C","E01017945","Total",1726,927,799,1720,6,5,101.24,17.0
"2011","Cambridge 006D","E01017946","Total",1629,827,802,1626,3,17,26.83,60.7
"2011","Cambridge 006E","E01017947","Total",1671,858,813,1670,1,18,156.31,10.7
"2011","Cambridge 006F","E01017948","Total",1723,847,876,1716,7,17,29.39,58.6
"2011","Cambridge 007C","E01017983","Total",1896,987,909,1877,19,26,44.96,42.2
"2011","Cambridge 007D","E01017984","Total",1615,824,791,1595,20,47,281.30,5.7
"2011","Cambridge 007E","E01017985","Total",2605,1304,1301,1655,950,65,64.87,40.2
"2011","Cambridge 007F","E01017986","Total",3647,1870,1777,613,3034,62,98.42,37.1
"2011","Cambridge 007G","E01032797","Total",5254,2948,2306,1495,3759,109,124.41,42.2
"2011","Cambridge 008A","E01017987","Total",1735,877,858,1612,123,59,26.55,65.3
"2011","Cambridge 008B","E01017988","Total",1693,900,793,1507,186,31,19.48,86.9
"2011","Cambridge 008C","E01017989","Total",2201,1114,1087,2054,147,33,21.15,104.1
"2011","Cambridge 008D","E01017990","Total",1247,638,609,1247,0,12,19.89,62.7
"2011","Cambridge 008E","E01017991","Total",1457,748,709,1144,313,14,18.34,79.4
"2011","Cambridge 009A","E01017997","Total",2284,1158,1126,2282,2,21,55.30,41.3
"2011","Cambridge 009B","E01017998","Total",1718,849,869,1718,0,11,15.93,107.8
"2011","Cambridge 009C","E01017999","Total",1801,895,906,1761,40,10,42.86,42.0
"2011","Cambridge 009D","E01018000","Total",1751,909,842,1748,3,12,18.41,95.1
"2011","Cambridge 009E","E01018001","Total",1698,893,805,1697,1,25,16.31,104.1
"2011","Cambridge 010A","E01017965","Total",1707,869,838,1625,82,15,26.18,65.2
"2011","Cambridge 010B","E01017966","Total",2703,1433,1270,2457,246,26,55.87,48.4
"2011","Cambridge 010C","E01017967","Total",1764,888,876,1762,2,25,59.78,29.5
"2011","Cambridge 010D","E01017968","Total",1589,794,795,1588,1,27,26.39,60.2
"2011","Cambridge 010E","E01017969","Total",1623,786,837,1545,78,26,24.82,65.4
"2011","Cambridge 011A","E01017959","Total",1693,860,833,1693,0,29,42.03,40.3
"2011","Cambridge 011B","E01017960","Total",1334,610,724,1334,0,23,158.87,8.4
"2011","Cambridge 011C","E01017961","Total",1199,562,637,1199,0,14,29.77,40.3
"2011","Cambridge 011D","E01017962","Total",1625,811,814,1625,0,15,88.28,18.4
"2011","Cambridge 011E","E01017963","Total",1593,779,814,1593,0,15,25.89,61.5
"2011","Cambridge 011F","E01017964","Total",1336,671,665,1336,0,31,23.30,57.3
"2011","Cambridge 012A","E01018002","Total",1579,781,798,1579,0,31,220.62,7.2
"2011","Cambridge 012B","E01018003","Total",1574,774,800,1573,1,29,190.50,8.3
"2011","Cambridge 012D","E01018005","Total",2037,1012,1025,1508,529,57,70.28,29.0
"2011","Cambridge 012E","E01032794","Total",1276,654,622,1276,0,60,204.62,6.2
"2011","Cambridge 012F","E01032795","Total",1568,758,810,1479,89,25,46.62,33.6
"2011","Cambridge 013A","E01017992","Total",1898,905,993,1895,3,57,40.19,47.2
"2011","Cambridge 013B","E01017993","Total",2118,948,1170,1978,140,87,102.37,20.7
"2011","Cambridge 013C","E01017994","Total",1652,807,845,1652,0,31,37.80,43.7
"2011","Cambridge 013D","E01017995","Total",1476,712,764,1466,10,47,239.30,6.2
"2011","Cambridge 013E","E01017996","Total",1983,981,1002,1309,674,42,32.23,61.5
"2011","East Cambridgeshire 001A","E01018042","Total",1455,685,770,1446,9,4,53.35,27.3
"2011","East Cambridgeshire 001B","E01018043","Total",2121,1051,1070,2051,70,13,962.62,2.2
"2011","East Cambridgeshire 001C","E01018044","Total",1715,895,820,1706,9,12,3981.52,0.4
"2011","East Cambridgeshire 001D","E01018045","Total",1347,682,665,1314,33,14,2272.86,0.6
"2011","East Cambridgeshire 001E","E01018046","Total",2100,1016,1084,2100,0,19,130.66,16.1
"2011","East Cambridgeshire 002A","E01018020","Total",1505,747,758,1497,8,29,5301.45,0.3
"2011","East Cambridgeshire 002B","E01018021","Total",1508,726,782,1492,16,20,427.16,3.5
"2011","East Cambridgeshire 002C","E01018022","Total",1411,724,687,1411,0,13,1796.10,0.8
"2011","East Cambridgeshire 002D","E01018055","Total",2042,1028,1014,2042,0,27,287.57,7.1
"2011","East Cambridgeshire 002E","E01018056","Total",1910,915,995,1910,0,13,2555.79,0.7
"2011","East Cambridgeshire 003A","E01018027","Total",1752,846,906,1719,33,20,660.76,2.7
"2011","East Cambridgeshire 003C","E01018029","Total",2542,1261,1281,2538,4,26,70.70,36.0
"2011","East Cambridgeshire 003D","E01018032","Total",2523,1226,1297,2473,50,52,153.02,16.5
"2011","East Cambridgeshire 003E","E01018033","Total",1932,914,1018,1926,6,7,36.59,52.8
"2011","East Cambridgeshire 003F","E01033426","Total",1510,768,742,1488,22,7,102.69,14.7
"2011","East Cambridgeshire 003G","E01033430","Total",1514,739,775,1514,0,16,23.04,65.7
"2011","East Cambridgeshire 004A","E01018024","Total",1094,548,546,1094,0,20,2553.83,0.4
"2011","East Cambridgeshire 004B","E01018025","Total",1545,775,770,1329,216,26,48.75,31.7
"2011","East Cambridgeshire 004C","E01018026","Total",1391,668,723,1379,12,23,1730.73,0.8
"2011","East Cambridgeshire 004D","E01018030","Total",1036,492,544,1024,12,4,22.11,46.9
"2011","East Cambridgeshire 004F","E01033425","Total",1983,988,995,1983,0,11,65.33,30.4
"2011","East Cambridgeshire 004G","E01033428","Total",1434,717,717,1434,0,19,454.84,3.2
"2011","East Cambridgeshire 005A","E01018036","Total",1643,830,813,1643,0,11,1736.73,0.9
"2011","East Cambridgeshire 005B","E01018037","Total",1393,713,680,1393,0,21,1223.18,1.1
"2011","East Cambridgeshire 005C","E01018038","Total",1570,768,802,1570,0,22,1401.08,1.1
"2011","East Cambridgeshire 005D","E01018039","Total",1323,662,661,1323,0,31,735.80,1.8
"2011","East Cambridgeshire 005E","E01018053","Total",1707,859,848,1694,13,23,2063.66,0.8
"2011","East Cambridgeshire 005F","E01018054","Total",2264,1143,1121,2263,1,40,1824.03,1.2
"2011","East Cambridgeshire 006A","E01018047","Total",1907,934,973,1907,0,13,3871.92,0.5
"2011","East Cambridgeshire 006C","E01018049","Total",1663,833,830,1642,21,18,2179.59,0.8
"2011","East Cambridgeshire 006D","E01018050","Total",1395,691,704,1395,0,22,221.93,6.3
"2011","East Cambridgeshire 006E","E01018051","Total",1693,831,862,1683,10,17,434.42,3.9
"2011","East Cambridgeshire 006F","E01018052","Total",1778,908,870,1778,0,19,43.41,41.0
"2011","East Cambridgeshire 006G","E01033427","Total",1332,684,648,1332,0,13,52.82,25.2
"2011","East Cambridgeshire 006H","E01033429","Total",1931,994,937,1931,0,12,60.13,32.1
"2011","East Cambridgeshire 007A","E01018034","Total",1564,790,774,1564,0,27,1207.96,1.3
"2011","East Cambridgeshire 007B","E01018035","Total",2204,1063,1141,2204,0,35,3588.38,0.6
"2011","East Cambridgeshire 007C","E01018040","Total",1264,631,633,1264,0,28,409.61,3.1
"2011","East Cambridgeshire 007D","E01018041","Total",1114,552,562,1114,0,18,1708.46,0.7
"2011","East Cambridgeshire 008A","E01018013","Total",1748,827,921,1744,4,22,840.24,2.1
"2011","East Cambridgeshire 008B","E01018014","Total",1807,885,922,1798,9,38,132.77,13.6
"2011","East Cambridgeshire 008C","E01018015","Total",1339,660,679,1339,0,30,1455.22,0.9
"2011","East Cambridgeshire 008D","E01018016","Total",1415,712,703,1415,0,10,134.76,10.5
"2011","East Cambridgeshire 009A","E01018011","Total",2615,1264,1351,2476,139,61,4151.02,0.6
"2011","East Cambridgeshire 009B","E01018012","Total",1399,669,730,1355,44,20,182.61,7.7
"2011","East Cambridgeshire 009C","E01018057","Total",2025,974,1051,2015,10,38,4101.55,0.5
"2011","East Cambridgeshire 011A","E01018017","Total",1263,622,641,1263,0,26,2184.05,0.6
"2011","East Cambridgeshire 011B","E01018019","Total",1036,506,530,1036,0,6,364.02,2.8
"2011","East Cambridgeshire 011C","E01018023","Total",2253,1128,1125,2242,11,47,4106.08,0.5
"2011","East Cambridgeshire 011D","E01032611","Total",1803,899,904,1803,0,22,1021.31,1.8
"2011","Fenland 001A","E01018094","Total",1763,848,915,1758,5,11,182.37,9.7
"2011","Fenland 001B","E01018095","Total",1555,760,795,1548,7,8,1900.59,0.8
"2011","Fenland 001C","E01018096","Total",1576,794,782,1576,0,10,546.71,2.9
"2011","Fenland 001D","E01018097","Total",1411,712,699,1402,9,23,2473.60,0.6
"2011","Fenland 002A","E01018063","Total",2331,1163,1168,2262,69,23,80.78,28.9
"2011","Fenland 002B","E01018073","Total",2300,1125,1175,2240,60,16,61.69,37.3
"2011","Fenland 002C","E01018107","Total",1680,815,865,1680,0,13,32.26,52.1
"2011","Fenland 002D","E01018108","Total",2000,999,1001,2000,0,11,45.29,44.2
"2011","Fenland 002E","E01018109","Total",1862,905,957,1815,47,9,38.54,48.3
"2011","Fenland 003A","E01018069","Total",1763,863,900,1763,0,14,56.15,31.4
"2011","Fenland 003B","E01018070","Total",1701,826,875,1701,0,11,85.10,20.0
"2011","Fenland 003C","E01018071","Total",1844,846,998,1703,141,10,38.40,48.0
"2011","Fenland 003E","E01018093","Total",2371,1155,1216,2359,12,30,857.92,2.8
"2011","Fenland 003F","E01018103","Total",1182,587,595,1182,0,3,22.35,52.9
"2011","Fenland 003G","E01018104","Total",1222,620,602,1222,0,13,70.79,17.3
"2011","Fenland 003H","E01033111","Total",1421,691,730,1411,10,16,443.54,3.2
"2011","Fenland 003I","E01033112","Total",1164,590,574,1128,36,0,35.73,32.6
"2011","Fenland 004A","E01018066","Total",1449,684,765,1415,34,11,470.59,3.1
"2011","Fenland 004B","E01018067","Total",1812,894,918,1812,0,9,863.45,2.1
"2011","Fenland 004C","E01018068","Total",1534,776,758,1484,50,18,7339.00,0.2
"2011","Fenland 004D","E01018090","Total",1768,845,923,1768,0,26,2242.57,0.8
"2011","Fenland 004E","E01018091","Total",1423,728,695,1423,0,15,2323.38,0.6
"2011","Fenland 004F","E01018092","Total",1704,839,865,1704,0,23,1491.25,1.1
"2011","Fenland 005A","E01018081","Total",1918,1178,740,1477,441,16,2514.89,0.8
"2011","Fenland 005B","E01018082","Total",1931,945,986,1931,0,20,51.14,37.8
"2011","Fenland 005C","E01018083","Total",1950,962,988,1930,20,12,79.35,24.6
"2011","Fenland 005D","E01018084","Total",2036,994,1042,2004,32,13,294.42,6.9
"2011","Fenland 006A","E01018064","Total",2002,970,1032,2000,2,27,340.64,5.9
"2011","Fenland 006B","E01018072","Total",1697,817,880,1697,0,7,109.20,15.5
"2011","Fenland 006C","E01018074","Total",1221,582,639,1221,0,10,107.78,11.3
"2011","Fenland 006D","E01018075","Total",1239,578,661,1220,19,17,27.10,45.7
"2011","Fenland 006E","E01018098","Total",1241,595,646,1241,0,18,59.24,20.9
"2011","Fenland 006F","E01018099","Total",1265,622,643,1265,0,16,327.87,3.9
"2011","Fenland 006G","E01018100","Total",1199,591,608,1162,37,6,29.54,40.6
"2011","Fenland 006H","E01018101","Total",1333,641,692,1291,42,17,77.73,17.1
"2011","Fenland 007A","E01018077","Total",1759,890,869,1739,20,9,41.91,42.0
"2011","Fenland 007B","E01018078","Total",1640,756,884,1640,0,9,1371.02,1.2
"2011","Fenland 007C","E01018079","Total",1712,797,915,1712,0,9,54.53,31.4
"2011","Fenland 007D","E01018080","Total",2319,1138,1181,2319,0,7,59.58,38.9
"2011","Fenland 008A","E01018058","Total",1548,740,808,1548,0,17,919.68,1.7
"2011","Fenland 008B","E01018059","Total",1332,670,662,1332,0,15,3491.40,0.4
"2011","Fenland 008C","E01018060","Total",1846,937,909,1846,0,33,4496.20,0.4
"2011","Fenland 008D","E01018061","Total",1272,636,636,1272,0,15,355.39,3.6
"2011","Fenland 009A","E01018085","Total",1717,810,907,1592,125,22,158.31,10.8
"2011","Fenland 009B","E01018086","Total",1707,832,875,1707,0,13,2970.13,0.6
"2011","Fenland 009C","E01018087","Total",2038,976,1062,2009,29,21,76.70,26.6
"2011","Fenland 009D","E01018088","Total",1571,748,823,1542,29,16,115.81,13.6
"2011","Fenland 010A","E01018065","Total",2181,1072,1109,2168,13,16,2853.69,0.8
"2011","Fenland 010B","E01018076","Total",2088,1009,1079,2088,0,20,2702.77,0.8
"2011","Fenland 010C","E01018111","Total",2211,1097,1114,2211,0,19,3138.93,0.7
"2011","Fenland 011A","E01018062","Total",2512,1198,1314,2481,31,18,3710.64,0.7
"2011","Fenland 011B","E01018102","Total",2577,1281,1296,2577,0,27,674.38,3.8
"2011","Fenland 011C","E01018105","Total",1155,580,575,1155,0,9,27.19,42.5
"2011","Fenland 011D","E01018106","Total",1551,770,781,1551,0,13,163.28,9.5
"2011","Fenland 011E","E01018110","Total",2658,1334,1324,2650,8,33,1542.47,1.7
"2011","Huntingdonshire 001A","E01018212","Total",1672,819,853,1672,0,20,141.93,11.8
"2011","Huntingdonshire 001B","E01018213","Total",1895,934,961,1883,12,13,2458.33,0.8
"2011","Huntingdonshire 001C","E01018214","Total",1973,956,1017,1973,0,17,50.39,39.2
"2011","Huntingdonshire 001D","E01018215","Total",1398,677,721,1366,32,7,29.49,47.4
"2011","Huntingdonshire 001E","E01018216","Total",2461,1214,1247,2461,0,39,439.55,5.6
"2011","Huntingdonshire 001F","E01018217","Total",1642,800,842,1642,0,25,55.41,29.6
"2011","Huntingdonshire 002A","E01018127","Total",1515,750,765,1515,0,40,2854.00,0.5
"2011","Huntingdonshire 002B","E01018128","Total",1152,554,598,1143,9,19,2149.87,0.5
"2011","Huntingdonshire 002C","E01018200","Total",1648,819,829,1648,0,31,3093.94,0.5
"2011","Huntingdonshire 002D","E01018201","Total",1443,721,722,1443,0,17,91.16,15.8
"2011","Huntingdonshire 003A","E01018156","Total",1680,814,866,1679,1,25,2366.53,0.7
"2011","Huntingdonshire 003B","E01018157","Total",2043,1039,1004,2034,9,33,3638.44,0.6
"2011","Huntingdonshire 003C","E01018158","Total",1680,832,848,1680,0,11,36.42,46.1
"2011","Huntingdonshire 003D","E01018159","Total",1408,711,697,1408,0,34,356.23,4.0
"2011","Huntingdonshire 003E","E01018160","Total",1668,835,833,1646,22,9,41.09,40.6
"2011","Huntingdonshire 004A","E01018191","Total",1195,597,598,1195,0,14,73.65,16.2
"2011","Huntingdonshire 004B","E01018192","Total",1444,739,705,1376,68,18,5833.36,0.2
"2011","Huntingdonshire 004C","E01018193","Total",1188,589,599,1172,16,19,479.34,2.5
"2011","Huntingdonshire 004D","E01018194","Total",1410,707,703,1394,16,27,2358.75,0.6
"2011","Huntingdonshire 004E","E01018195","Total",1299,614,685,1299,0,4,42.16,30.8
"2011","Huntingdonshire 005A","E01018208","Total",1634,811,823,1634,0,24,1253.40,1.3
"2011","Huntingdonshire 005B","E01018209","Total",1480,757,723,1480,0,44,3122.18,0.5
"2011","Huntingdonshire 005C","E01018210","Total",1402,672,730,1402,0,20,28.53,49.1
"2011","Huntingdonshire 005D","E01018211","Total",1838,900,938,1782,56,31,595.44,3.1
"2011","Huntingdonshire 006A","E01018196","Total",1260,629,631,1214,46,16,3628.78,0.3
"2011","Huntingdonshire 006B","E01018197","Total",1500,734,766,1500,0,13,31.42,47.7
"2011","Huntingdonshire 006C","E01018198","Total",1659,837,822,1647,12,27,244.02,6.8
"2011","Huntingdonshire 006D","E01018199","Total",1516,761,755,1516,0,29,2256.27,0.7
"2011","Huntingdonshire 006E","E01018206","Total",1910,938,972,1910,0,32,3143.61,0.6
"2011","Huntingdonshire 006F","E01018207","Total",1530,763,767,1499,31,19,3890.93,0.4
"2011","Huntingdonshire 007A","E01018121","Total",1361,683,678,1359,2,33,1002.63,1.4
"2011","Huntingdonshire 007B","E01018122","Total",1156,580,576,1156,0,14,176.87,6.5
"2011","Huntingdonshire 007C","E01018123","Total",1606,829,777,1592,14,35,425.71,3.8
"2011","Huntingdonshire 007D","E01018124","Total",2003,1003,1000,2001,2,46,963.37,2.1
"2011","Huntingdonshire 008A","E01018143","Total",1651,783,868,1651,0,12,46.51,35.5
"2011","Huntingdonshire 008B","E01018144","Total",1497,736,761,1497,0,4,23.51,63.7
"2011","Huntingdonshire 008C","E01018145","Total",1323,656,667,1323,0,11,35.22,37.6
"2011","Huntingdonshire 008D","E01018146","Total",2170,1074,1096,2150,20,12,217.30,10.0
"2011","Huntingdonshire 008E","E01018147","Total",1736,888,848,1736,0,15,23.72,73.2
"2011","Huntingdonshire 009A","E01018139","Total",1546,747,799,1489,57,14,32.70,47.3
"2011","Huntingdonshire 009B","E01018140","Total",1283,653,630,1283,0,8,26.74,48.0
"2011","Huntingdonshire 009C","E01018141","Total",1604,764,840,1604,0,19,56.28,28.5
"2011","Huntingdonshire 009D","E01018142","Total",1524,738,786,1448,76,7,64.15,23.8
"2011","Huntingdonshire 010B","E01018113","Total",1487,737,750,1463,24,25,1736.63,0.9
"2011","Huntingdonshire 010D","E01018116","Total",1277,673,604,1257,20,43,324.84,3.9
"2011","Huntingdonshire 010E","E01018117","Total",1625,784,841,1625,0,29,335.01,4.9
"2011","Huntingdonshire 010F","E01018118","Total",1960,946,1014,1960,0,55,778.94,2.5
"2011","Huntingdonshire 010G","E01033433","Total",2222,1133,1089,1872,350,31,2093.44,1.1
"2011","Huntingdonshire 011A","E01018161","Total",1381,669,712,1381,0,28,20.35,67.9
"2011","Huntingdonshire 011B","E01018162","Total",1616,790,826,1616,0,38,287.56,5.6
"2011","Huntingdonshire 011C","E01018163","Total",1434,700,734,1434,0,14,46.20,31.0
"2011","Huntingdonshire 011D","E01018164","Total",1281,635,646,1281,0,20,22.29,57.5
"2011","Huntingdonshire 011E","E01018165","Total",1287,638,649,1287,0,10,21.31,60.4
"2011","Huntingdonshire 011F","E01018170","Total",1399,688,711,1399,0,16,30.89,45.3
"2011","Huntingdonshire 011G","E01018171","Total",1471,739,732,1465,6,29,91.14,16.1
"2011","Huntingdonshire 012A","E01018138","Total",1924,982,942,1918,6,10,49.88,38.6
"2011","Huntingdonshire 012B","E01018148","Total",2504,1231,1273,2504,0,48,130.48,19.2
"2011","Huntingdonshire 012C","E01018149","Total",1479,739,740,1479,0,28,23.42,63.2
"2011","Huntingdonshire 012D","E01018150","Total",1724,838,886,1658,66,22,110.70,15.6
"2011","Huntingdonshire 012E","E01018151","Total",1767,892,875,1741,26,17,151.40,11.7
"2011","Huntingdonshire 013A","E01018166","Total",1556,790,766,1556,0,21,35.12,44.3
"2011","Huntingdonshire 013B","E01018167","Total",1465,738,727,1465,0,38,37.22,39.4
"2011","Huntingdonshire 013C","E01018168","Total",1925,960,965,1891,34,6,244.42,7.9
"2011","Huntingdonshire 013D","E01018169","Total",1569,757,812,1569,0,25,104.13,15.1
"2011","Huntingdonshire 014A","E01018131","Total",1553,772,781,1553,0,14,145.18,10.7
"2011","Huntingdonshire 014B","E01018132","Total",1632,800,832,1632,0,19,1769.19,0.9
"2011","Huntingdonshire 014C","E01018133","Total",1676,822,854,1676,0,31,35.35,47.4
"2011","Huntingdonshire 014D","E01018134","Total",1850,881,969,1850,0,50,34.41,53.8
"2011","Huntingdonshire 015A","E01018125","Total",1566,772,794,1542,24,36,3845.67,0.4
"2011","Huntingdonshire 015B","E01018126","Total",1609,808,801,1609,0,55,6556.30,0.2
"2011","Huntingdonshire 015C","E01018152","Total",1506,758,748,1506,0,25,2854.88,0.5
"2011","Huntingdonshire 015D","E01018153","Total",1847,900,947,1802,45,47,3282.34,0.6
"2011","Huntingdonshire 016A","E01018129","Total",1541,764,777,1541,0,19,749.26,2.1
"2011","Huntingdonshire 016B","E01018130","Total",1701,803,898,1701,0,26,295.68,5.8
"2011","Huntingdonshire 016C","E01018202","Total",1443,694,749,1442,1,26,1018.08,1.4
"2011","Huntingdonshire 016D","E01018203","Total",1384,676,708,1384,0,27,297.78,4.6
"2011","Huntingdonshire 016E","E01018204","Total",1392,681,711,1388,4,44,945.87,1.5
"2011","Huntingdonshire 016F","E01018205","Total",1817,908,909,1817,0,44,634.08,2.9
"2011","Huntingdonshire 017A","E01018115","Total",2426,1791,635,1294,1132,34,736.96,3.3
"2011","Huntingdonshire 017B","E01018119","Total",1504,758,746,1504,0,36,2317.36,0.6
"2011","Huntingdonshire 017C","E01018120","Total",1789,835,954,1745,44,28,388.36,4.6
"2011","Huntingdonshire 017D","E01018137","Total",1714,857,857,1714,0,35,1323.20,1.3
"2011","Huntingdonshire 018A","E01018135","Total",2942,1428,1514,2917,25,40,3795.78,0.8
"2011","Huntingdonshire 018B","E01018136","Total",1748,873,875,1743,5,38,3489.84,0.5
"2011","Huntingdonshire 018C","E01018154","Total",1756,865,891,1756,0,31,292.74,6.0
"2011","Huntingdonshire 018D","E01018155","Total",1488,743,745,1456,32,13,166.56,8.9
"2011","Huntingdonshire 019A","E01018187","Total",1924,958,966,1886,38,9,82.65,23.3
"2011","Huntingdonshire 019B","E01018188","Total",1470,714,756,1461,9,16,51.58,28.5
"2011","Huntingdonshire 019C","E01018189","Total",1322,646,676,1322,0,26,137.17,9.6
"2011","Huntingdonshire 019D","E01018190","Total",1556,780,776,1556,0,15,56.63,27.5
"2011","Huntingdonshire 020A","E01018172","Total",1405,658,747,1362,43,20,61.10,23.0
"2011","Huntingdonshire 020B","E01018173","Total",1183,589,594,1183,0,17,17.66,67.0
"2011","Huntingdonshire 020C","E01018174","Total",1572,805,767,1572,0,17,42.50,37.0
"2011","Huntingdonshire 020D","E01018175","Total",1382,708,674,1382,0,35,35.20,39.3
"2011","Huntingdonshire 020E","E01018176","Total",1273,647,626,1273,0,33,98.44,12.9
"2011","Huntingdonshire 021A","E01018181","Total",2762,1383,1379,2762,0,34,65.09,42.4
"2011","Huntingdonshire 021B","E01018182","Total",1489,786,703,1489,0,11,22.83,65.2
"2011","Huntingdonshire 021C","E01018183","Total",1476,720,756,1466,10,14,33.00,44.7
"2011","Huntingdonshire 021D","E01018184","Total",1345,680,665,1345,0,6,26.36,51.0
"2011","Huntingdonshire 021E","E01018185","Total",1650,818,832,1601,49,19,79.25,20.8
"2011","Huntingdonshire 021F","E01018186","Total",1755,876,879,1755,0,6,70.80,24.8
"2011","Huntingdonshire 022A","E01018177","Total",1502,777,725,1500,2,19,119.08,12.6
"2011","Huntingdonshire 022B","E01018178","Total",1475,719,756,1415,60,12,40.43,36.5
"2011","Huntingdonshire 022C","E01018179","Total",1407,705,702,1407,0,3,25.48,55.2
"2011","Huntingdonshire 022D","E01018180","Total",1320,658,662,1320,0,7,23.49,56.2
"2011","South Cambridgeshire 001A","E01018304","Total",1848,891,957,1848,0,26,1451.06,1.3
"2011","South Cambridgeshire 001B","E01018305","Total",1332,654,678,1332,0,28,129.54,10.3
"2011","South Cambridgeshire 001C","E01018306","Total",1530,757,773,1530,0,32,1378.29,1.1
"2011","South Cambridgeshire 001D","E01018307","Total",2167,1100,1067,2165,2,42,431.05,5.0
"2011","South Cambridgeshire 002A","E01018233","Total",1575,779,796,1568,7,30,2744.60,0.6
"2011","South Cambridgeshire 002B","E01018234","Total",1672,818,854,1637,35,38,42.43,39.4
"2011","South Cambridgeshire 002C","E01018235","Total",1684,816,868,1679,5,32,43.66,38.6
"2011","South Cambridgeshire 002D","E01018236","Total",1612,768,844,1573,39,22,650.25,2.5
"2011","South Cambridgeshire 003A","E01018237","Total",1527,765,762,1526,1,32,885.42,1.7
"2011","South Cambridgeshire 003B","E01018266","Total",2657,1337,1320,2657,0,27,1124.60,2.4
"2011","South Cambridgeshire 003C","E01018284","Total",1264,650,614,1264,0,29,1544.94,0.8
"2011","South Cambridgeshire 003D","E01018285","Total",1199,595,604,1199,0,18,66.31,18.1
"2011","South Cambridgeshire 004A","E01018298","Total",1821,1116,705,1396,425,21,2046.37,0.9
"2011","South Cambridgeshire 004B","E01018299","Total",1654,829,825,1650,4,22,81.79,20.2
"2011","South Cambridgeshire 004C","E01018300","Total",1162,597,565,1128,34,14,1087.05,1.1
"2011","South Cambridgeshire 004D","E01018301","Total",1377,687,690,1341,36,19,44.82,30.7
"2011","South Cambridgeshire 005A","E01018221","Total",1659,827,832,1659,0,18,32.71,50.7
"2011","South Cambridgeshire 005B","E01018222","Total",1509,767,742,1503,6,38,142.97,10.6
"2011","South Cambridgeshire 005C","E01018223","Total",1880,925,955,1878,2,41,2304.15,0.8
"2011","South Cambridgeshire 006A","E01018257","Total",1363,630,733,1363,0,19,151.21,9.0
"2011","South Cambridgeshire 006B","E01018258","Total",1626,803,823,1626,0,29,218.95,7.4
"2011","South Cambridgeshire 006C","E01018259","Total",1325,680,645,1324,1,34,482.30,2.7
"2011","South Cambridgeshire 006D","E01018260","Total",1780,838,942,1701,79,40,219.35,8.1
"2011","South Cambridgeshire 006F","E01018262","Total",1459,728,731,1387,72,25,201.28,7.2
"2011","South Cambridgeshire 006G","E01033120","Total",1459,712,747,1455,4,33,143.47,10.2
"2011","South Cambridgeshire 006H","E01033121","Total",1588,826,762,1588,0,18,31.58,50.3
"2011","South Cambridgeshire 007A","E01018272","Total",1332,668,664,1332,0,40,388.32,3.4
"2011","South Cambridgeshire 007B","E01018273","Total",1607,791,816,1587,20,14,167.90,9.6
"2011","South Cambridgeshire 007C","E01018274","Total",1740,895,845,1720,20,23,242.51,7.2
"2011","South Cambridgeshire 007D","E01018297","Total",1682,841,841,1682,0,32,2031.38,0.8
"2011","South Cambridgeshire 009A","E01018224","Total",1428,719,709,1428,0,47,1694.46,0.8
"2011","South Cambridgeshire 009B","E01018225","Total",1078,494,584,1078,0,27,763.32,1.4
"2011","South Cambridgeshire 009C","E01018248","Total",2338,1201,1137,1844,494,52,195.68,11.9
"2011","South Cambridgeshire 009D","E01018249","Total",1007,491,516,1007,0,30,459.42,2.2
"2011","South Cambridgeshire 009E","E01018250","Total",1214,574,640,1214,0,20,61.95,19.6
"2011","South Cambridgeshire 010A","E01018231","Total",2478,1240,1238,2476,2,60,2132.46,1.2
"2011","South Cambridgeshire 010B","E01018232","Total",2346,1126,1220,2346,0,63,786.89,3.0
"2011","South Cambridgeshire 010C","E01018251","Total",1220,619,601,1220,0,17,30.14,40.5
"2011","South Cambridgeshire 010D","E01018252","Total",1450,693,757,1450,0,34,552.59,2.6
"2011","South Cambridgeshire 010E","E01018255","Total",1149,559,590,1149,0,27,1394.50,0.8
"2011","South Cambridgeshire 011A","E01018242","Total",1280,607,673,1280,0,7,112.54,11.4
"2011","South Cambridgeshire 011B","E01018243","Total",1765,860,905,1718,47,35,383.05,4.6
"2011","South Cambridgeshire 011C","E01018244","Total",1628,807,821,1560,68,37,1635.84,1.0
"2011","South Cambridgeshire 011D","E01018286","Total",1612,820,792,1604,8,21,463.04,3.5
"2011","South Cambridgeshire 011E","E01018287","Total",1331,670,661,1331,0,13,22.83,58.3
"2011","South Cambridgeshire 011F","E01018296","Total",1079,556,523,1079,0,22,1985.81,0.5
"2011","South Cambridgeshire 012A","E01018292","Total",1408,703,705,1393,15,42,651.99,2.2
"2011","South Cambridgeshire 012B","E01018293","Total",1481,717,764,1481,0,33,107.65,13.8
"2011","South Cambridgeshire 012C","E01018294","Total",1646,786,860,1646,0,21,130.47,12.6
"2011","South Cambridgeshire 012D","E01018295","Total",1569,776,793,1569,0,39,689.87,2.3
"2011","South Cambridgeshire 013A","E01018245","Total",1700,858,842,1700,0,22,87.69,19.4
"2011","South Cambridgeshire 013B","E01018246","Total",1628,783,845,1628,0,21,474.72,3.4
"2011","South Cambridgeshire 013C","E01018247","Total",1572,799,773,1571,1,31,4764.41,0.3
"2011","South Cambridgeshire 013D","E01018275","Total",2329,1112,1217,2329,0,68,2783.62,0.8
"2011","South Cambridgeshire 014A","E01018240","Total",1232,617,615,1232,0,33,711.09,1.7
"2011","South Cambridgeshire 014B","E01018253","Total",1080,545,535,1080,0,30,554.50,1.9
"2011","South Cambridgeshire 014C","E01018254","Total",1322,656,666,1322,0,23,345.82,3.8
"2011","South Cambridgeshire 014D","E01018256","Total",1507,758,749,1507,0,46,1195.06,1.3
"2011","South Cambridgeshire 014E","E01018291","Total",1218,600,618,1218,0,28,950.15,1.3
"2011","South Cambridgeshire 015A","E01018279","Total",1492,701,791,1463,29,17,119.74,12.5
"2011","South Cambridgeshire 015B","E01018280","Total",1506,775,731,1496,10,28,390.32,3.9
"2011","South Cambridgeshire 015C","E01018281","Total",1564,780,784,1564,0,19,61.09,25.6
"2011","South Cambridgeshire 015D","E01018282","Total",1309,655,654,1309,0,26,54.31,24.1
"2011","South Cambridgeshire 015E","E01018283","Total",1274,620,654,1274,0,15,145.96,8.7
"2011","South Cambridgeshire 016A","E01018218","Total",1770,895,875,1756,14,68,3891.82,0.5
"2011","South Cambridgeshire 016B","E01018219","Total",1405,680,725,1405,0,31,2854.17,0.5
"2011","South Cambridgeshire 016C","E01018220","Total",1507,740,767,1493,14,44,2993.98,0.5
"2011","South Cambridgeshire 016D","E01018263","Total",1478,731,747,1476,2,30,1137.84,1.3
"2011","South Cambridgeshire 016E","E01018264","Total",1606,767,839,1536,70,22,354.03,4.5
"2011","South Cambridgeshire 016F","E01018265","Total",1762,843,919,1760,2,42,934.80,1.9
"2011","South Cambridgeshire 017A","E01018238","Total",1455,729,726,1455,0,32,2146.24,0.7
"2011","South Cambridgeshire 017B","E01018239","Total",1353,641,712,1353,0,39,250.06,5.4
"2011","South Cambridgeshire 017C","E01018288","Total",1155,560,595,1155,0,30,684.84,1.7
"2011","South Cambridgeshire 017D","E01018289","Total",1153,552,601,1151,2,29,2737.22,0.4
"2011","South Cambridgeshire 017E","E01018302","Total",1499,761,738,1499,0,37,1453.05,1.0
"2011","South Cambridgeshire 017F","E01018303","Total",1201,618,583,1200,1,43,312.56,3.8
"2011","South Cambridgeshire 018A","E01018241","Total",1206,605,601,1206,0,29,967.12,1.2
"2011","South Cambridgeshire 018B","E01018267","Total",2328,1134,1194,2328,0,58,151.80,15.3
"2011","South Cambridgeshire 018C","E01018268","Total",1905,932,973,1904,1,48,3739.31,0.5
"2011","South Cambridgeshire 018D","E01018269","Total",1377,663,714,1342,35,10,41.64,33.1
"2011","South Cambridgeshire 018E","E01018270","Total",1120,561,559,1116,4,35,875.41,1.3
"2011","South Cambridgeshire 018F","E01018271","Total",1431,682,749,1326,105,26,635.91,2.3
"2011","South Cambridgeshire 019A","E01018226","Total",1525,850,675,1293,232,20,2222.87,0.7
"2011","South Cambridgeshire 019B","E01018227","Total",1896,914,982,1887,9,35,137.91,13.7
"2011","South Cambridgeshire 019C","E01018228","Total",1667,818,849,1667,0,46,1398.71,1.2
"2011","South Cambridgeshire 019D","E01018290","Total",2404,1188,1216,2403,1,53,3790.07,0.6
"2011","South Cambridgeshire 020A","E01033113","Total",1120,537,583,1120,0,1,46.12,24.3
"2011","South Cambridgeshire 020B","E01033114","Total",1539,784,755,1539,0,18,71.54,21.5
"2011","South Cambridgeshire 020C","E01033115","Total",1407,691,716,1407,0,26,52.58,26.8
"2011","South Cambridgeshire 020D","E01033117","Total",1314,668,646,1314,0,12,213.45,6.2
"2011","South Cambridgeshire 020E","E01033119","Total",1805,902,903,1805,0,13,257.33,7.0
"2011","South Cambridgeshire 021A","E01018276","Total",1431,692,739,1431,0,10,89.14,16.1
"2011","South Cambridgeshire 021B","E01018277","Total",1719,860,859,1719,0,35,3271.18,0.5
"2011","South Cambridgeshire 021C","E01018278","Total",1738,850,888,1722,16,28,1545.34,1.1
"2011","South Cambridgeshire 021D","E01033116","Total",1686,831,855,1686,0,38,1409.15,1.2
"2011","South Cambridgeshire 021E","E01033118","Total",1463,744,719,1461,2,36,2092.34,0.7
"2011","Basildon 001A","E01021237","Total",1384,681,703,1384,0,32,92.96,14.9
"2011","Basildon 001B","E01021238","Total",1387,688,699,1387,0,37,41.11,33.7
"2011","Basildon 001C","E01021242","Total",1227,613,614,1227,0,28,80.02,15.3
"2011","Basildon 001D","E01021250","Total",1548,764,784,1537,11,23,29.76,52.0
"2011","Basildon 001E","E01021251","Total",1587,782,805,1587,0,44,42.54,37.3
"2011","Basildon 002A","E01021245","Total",1449,684,765,1411,38,12,176.48,8.2
"2011","Basildon 002B","E01021246","Total",1478,707,771,1457,21,17,38.07,38.8
"2011","Basildon 002C","E01021248","Total",1433,713,720,1433,0,27,20.59,69.6
"2011","Basildon 002D","E01021249","Total",1559,763,796,1559,0,28,117.19,13.3
"2011","Basildon 002E","E01021252","Total",1428,687,741,1428,0,21,47.80,29.9
"2011","Basildon 003A","E01021239","Total",1443,718,725,1443,0,35,57.98,24.9
"2011","Basildon 003B","E01021240","Total",1628,798,830,1628,0,15,34.61,47.0
"2011","Basildon 003C","E01021241","Total",1573,730,843,1573,0,18,114.87,13.7
"2011","Basildon 003D","E01021243","Total",1689,861,828,1689,0,39,61.03,27.7
"2011","Basildon 003E","E01021247","Total",1482,733,749,1482,0,25,57.86,25.6
"2011","Basildon 004A","E01021244","Total",1446,702,744,1442,4,16,49.64,29.1
"2011","Basildon 004B","E01021253","Total",1699,844,855,1699,0,32,181.76,9.3
"2011","Basildon 004C","E01021255","Total",1363,651,712,1363,0,19,190.41,7.2
"2011","Basildon 004D","E01021256","Total",1465,710,755,1465,0,23,68.25,21.5
"2011","Basildon 004E","E01021258","Total",1589,734,855,1589,0,12,42.89,37.0
"2011","Basildon 005A","E01021334","Total",1704,811,893,1618,86,7,45.62,37.4
"2011","Basildon 005B","E01021336","Total",1628,769,859,1628,0,7,38.60,42.2
"2011","Basildon 005C","E01021338","Total",1455,705,750,1455,0,13,79.55,18.3
"2011","Basildon 005D","E01021339","Total",1389,672,717,1348,41,7,31.50,44.1
"2011","Basildon 006A","E01021264","Total",1448,745,703,1448,0,20,435.75,3.3
"2011","Basildon 006B","E01021329","Total",1494,708,786,1447,47,2,40.39,37.0
"2011","Basildon 006C","E01021330","Total",1589,770,819,1589,0,13,194.21,8.2
"2011","Basildon 006D","E01021332","Total",1429,696,733,1429,0,11,28.35,50.4
"2011","Basildon 006E","E01021333","Total",1553,740,813,1550,3,10,131.82,11.8
"2011","Basildon 007A","E01021335","Total",1428,721,707,1424,4,25,55.32,25.8
"2011","Basildon 007B","E01021337","Total",1410,694,716,1410,0,20,51.18,27.5
"2011","Basildon 007C","E01021340","Total",1610,784,826,1607,3,9,123.65,13.0
"2011","Basildon 007D","E01021341","Total",1611,798,813,1605,6,20,40.18,40.1
"2011","Basildon 007E","E01021345","Total",2003,980,1023,2003,0,25,62.17,32.2
"2011","Basildon 008A","E01021331","Total",1537,755,782,1534,3,10,40.84,37.6
"2011","Basildon 008B","E01021342","Total",1602,755,847,1602,0,11,25.88,61.9
"2011","Basildon 008C","E01021343","Total",1760,844,916,1760,0,14,24.58,71.6
"2011","Basildon 008D","E01021344","Total",2213,1109,1104,2213,0,20,333.25,6.6
"2011","Basildon 008E","E01021346","Total",1959,985,974,1959,0,19,37.03,52.9
"2011","Basildon 009A","E01021254","Total",1457,745,712,1457,0,30,962.99,1.5
"2011","Basildon 009B","E01021257","Total",1517,729,788,1517,0,17,434.28,3.5
"2011","Basildon 009C","E01021259","Total",1530,744,786,1525,5,30,43.02,35.6
"2011","Basildon 009D","E01021260","Total",2388,1135,1253,2388,0,24,662.56,3.6
"2011","Basildon 010A","E01021261","Total",1705,844,861,1705,0,23,185.64,9.2
"2011","Basildon 010B","E01021262","Total",1563,760,803,1546,17,8,106.16,14.7
"2011","Basildon 010C","E01021263","Total",1839,895,944,1831,8,16,35.93,51.2
"2011","Basildon 010D","E01021274","Total",1867,878,989,1791,76,15,40.07,46.6
"2011","Basildon 010E","E01021279","Total",1637,788,849,1612,25,12,63.54,25.8
"2011","Basildon 011A","E01021301","Total",1518,717,801,1518,0,12,34.35,44.2
"2011","Basildon 011B","E01021303","Total",1328,660,668,1328,0,2,19.73,67.3
"2011","Basildon 011C","E01021307","Total",1334,651,683,1331,3,10,90.90,14.7
"2011","Basildon 011D","E01021308","Total",1286,640,646,1286,0,14,23.81,54.0
"2011","Basildon 011E","E01021309","Total",1321,663,658,1321,0,12,123.41,10.7
"2011","Basildon 011F","E01021312","Total",1598,797,801,1481,117,16,962.28,1.7
"2011","Basildon 012A","E01021265","Total",1550,707,843,1550,0,4,20.54,75.5
"2011","Basildon 012B","E01021267","Total",1716,843,873,1716,0,8,158.17,10.8
"2011","Basildon 012C","E01021269","Total",1665,776,889,1665,0,9,80.57,20.7
"2011","Basildon 012D","E01021270","Total",1502,756,746,1502,0,12,39.40,38.1
"2011","Basildon 012E","E01021272","Total",1603,729,874,1602,1,8,27.83,57.6
"2011","Basildon 013A","E01021271","Total",1765,852,913,1765,0,16,20.19,87.4
"2011","Basildon 013B","E01021302","Total",1548,766,782,1527,21,7,32.29,47.9
"2011","Basildon 013C","E01021304","Total",1452,702,750,1413,39,6,17.74,81.8
"2011","Basildon 013D","E01021305","Total",1465,696,769,1465,0,1,27.80,52.7
"2011","Basildon 013E","E01021306","Total",1470,716,754,1470,0,5,41.17,35.7
"2011","Basildon 014A","E01021273","Total",1683,816,867,1683,0,8,33.78,49.8
"2011","Basildon 014B","E01021275","Total",1649,801,848,1635,14,15,41.10,40.1
"2011","Basildon 014C","E01021276","Total",1446,698,748,1446,0,10,29.09,49.7
"2011","Basildon 014D","E01021277","Total",1416,688,728,1416,0,6,266.10,5.3
"2011","Basildon 014E","E01021278","Total",1669,802,867,1669,0,10,113.23,14.7
"2011","Basildon 015A","E01021266","Total",1658,765,893,1658,0,10,24.60,67.4
"2011","Basildon 015B","E01021268","Total",1659,681,978,1347,312,8,198.93,8.3
"2011","Basildon 015C","E01021318","Total",2043,1007,1036,2043,0,4,61.63,33.1
"2011","Basildon 015D","E01021320","Total",1651,794,857,1616,35,16,21.42,77.1
"2011","Basildon 015E","E01021321","Total",1610,733,877,1609,1,5,25.74,62.5
"2011","Basildon 016A","E01021286","Total",1734,843,891,1734,0,8,19.86,87.3
"2011","Basildon 016B","E01021288","Total",1811,801,1010,1811,0,12,17.57,103.1
"2011","Basildon 016C","E01021289","Total",1792,850,942,1792,0,16,43.98,40.7
"2011","Basildon 016D","E01021290","Total",1775,809,966,1775,0,4,25.36,70.0
"2011","Basildon 016E","E01021291","Total",1667,830,837,1667,0,10,29.05,57.4
"2011","Basildon 017A","E01021287","Total",1506,753,753,1506,0,11,21.84,69.0
"2011","Basildon 017B","E01021292","Total",1518,744,774,1518,0,3,24.79,61.2
"2011","Basildon 017C","E01021293","Total",1685,800,885,1685,0,11,29.51,57.1
"2011","Basildon 017D","E01021298","Total",1588,747,841,1588,0,3,24.04,66.1
"2011","Basildon 017E","E01021319","Total",1583,733,850,1583,0,8,105.52,15.0
"2011","Basildon 018A","E01021313","Total",1467,737,730,1461,6,13,99.50,14.7
"2011","Basildon 018B","E01021314","Total",1373,660,713,1373,0,3,26.34,52.1
"2011","Basildon 018C","E01021315","Total",1499,710,789,1490,9,7,21.22,70.6
"2011","Basildon 018D","E01021316","Total",1491,695,796,1491,0,8,32.59,45.8
"2011","Basildon 018E","E01021317","Total",1625,826,799,1625,0,15,20.54,79.1
"2011","Basildon 019A","E01021322","Total",1523,769,754,1521,2,9,26.99,56.4
"2011","Basildon 019B","E01021323","Total",1760,839,921,1760,0,7,26.88,65.5
"2011","Basildon 019C","E01021324","Total",1651,792,859,1651,0,16,24.38,67.7
"2011","Basildon 019D","E01021325","Total",1565,758,807,1565,0,13,23.45,66.7
"2011","Basildon 019E","E01021327","Total",1688,819,869,1688,0,11,25.38,66.5
"2011","Basildon 020A","E01021294","Total",1616,786,830,1616,0,29,60.00,26.9
"2011","Basildon 020B","E01021295","Total",1685,826,859,1685,0,12,40.71,41.4
"2011","Basildon 020C","E01021296","Total",1720,853,867,1720,0,11,32.48,53.0
"2011","Basildon 020D","E01021297","Total",1638,808,830,1612,26,12,76.83,21.3
"2011","Basildon 020E","E01021299","Total",1512,743,769,1512,0,19,173.76,8.7
"2011","Basildon 021A","E01021280","Total",1527,740,787,1527,0,24,26.86,56.9
"2011","Basildon 021B","E01021281","Total",1494,721,773,1435,59,19,37.73,39.6
"2011","Basildon 021C","E01021282","Total",1527,750,777,1527,0,20,349.11,4.4
"2011","Basildon 021D","E01021283","Total",1581,793,788,1581,0,16,23.10,68.4
"2011","Basildon 021E","E01021284","Total",1580,773,807,1547,33,15,117.73,13.4
"2011","Basildon 021F","E01021285","Total",1355,683,672,1355,0,16,29.93,45.3
"2011","Basildon 022A","E01021300","Total",2107,1021,1086,2072,35,20,267.61,7.9
"2011","Basildon 022B","E01021310","Total",1334,721,613,1334,0,4,523.52,2.5
"2011","Basildon 022C","E01021311","Total",1349,684,665,1339,10,3,74.33,18.1
"2011","Basildon 022D","E01021326","Total",1818,886,932,1814,4,11,38.72,47.0
"2011","Basildon 022E","E01021328","Total",1566,764,802,1566,0,11,25.57,61.2
"2011","Braintree 001A","E01021375","Total",1152,559,593,1152,0,30,1269.52,0.9
"2011","Braintree 001B","E01021376","Total",1406,693,713,1406,0,33,1801.48,0.8
"2011","Braintree 001C","E01021414","Total",2145,1060,1085,2145,0,41,4293.59,0.5
"2011","Braintree 001D","E01021430","Total",2175,1102,1073,2172,3,17,1296.81,1.7
"2011","Braintree 002A","E01021398","Total",1493,751,742,1493,0,38,3642.52,0.4
"2011","Braintree 002B","E01021406","Total",2166,1087,1079,2166,0,63,6450.50,0.3
"2011","Braintree 002C","E01021407","Total",2180,1098,1082,2176,4,56,4093.81,0.5
"2011","Braintree 003A","E01021382","Total",1292,622,670,1242,50,35,1869.99,0.7
"2011","Braintree 003B","E01021397","Total",1764,866,898,1731,33,30,793.30,2.2
"2011","Braintree 003C","E01021399","Total",1606,776,830,1606,0,15,70.34,22.8
"2011","Braintree 003D","E01021400","Total",1687,855,832,1687,0,33,1462.98,1.2
"2011","Braintree 004A","E01021387","Total",1968,949,1019,1956,12,15,71.48,27.5
"2011","Braintree 004B","E01021388","Total",1623,784,839,1623,0,14,48.05,33.8
"2011","Braintree 004C","E01021391","Total",1712,817,895,1712,0,6,34.93,49.0
"2011","Braintree 004D","E01021392","Total",1671,792,879,1587,84,10,51.63,32.4
"2011","Braintree 004E","E01021393","Total",1509,772,737,1505,4,13,26.29,57.4
"2011","Braintree 005A","E01021404","Total",2063,1031,1032,2063,0,40,2738.70,0.8
"2011","Braintree 005B","E01021411","Total",1227,591,636,1227,0,35,1411.38,0.9
"2011","Braintree 005C","E01021412","Total",1471,740,731,1440,31,41,3351.65,0.4
"2011","Braintree 005D","E01021413","Total",1269,636,633,1263,6,29,1709.29,0.7
"2011","Braintree 006A","E01021389","Total",1826,945,881,1823,3,8,94.76,19.3
"2011","Braintree 006B","E01021390","Total",1597,736,861,1525,72,20,180.52,8.8
"2011","Braintree 006C","E01021408","Total",1778,862,916,1682,96,36,1611.30,1.1
"2011","Braintree 006D","E01021409","Total",1806,869,937,1806,0,41,1047.18,1.7
"2011","Braintree 006E","E01021410","Total",1657,790,867,1612,45,19,134.92,12.3
"2011","Braintree 007A","E01021349","Total",1424,712,712,1424,0,15,31.38,45.4
"2011","Braintree 007B","E01021351","Total",1584,790,794,1584,0,23,66.67,23.8
"2011","Braintree 007C","E01021352","Total",1677,796,881,1598,79,15,23.59,71.1
"2011","Braintree 007D","E01021355","Total",2010,947,1063,1813,197,12,853.14,2.4
"2011","Braintree 007E","E01021356","Total",1423,694,729,1351,72,26,341.44,4.2
"2011","Braintree 007F","E01021381","Total",1173,595,578,1143,30,14,1406.70,0.8
"2011","Braintree 008A","E01021354","Total",1295,648,647,1295,0,13,31.97,40.5
"2011","Braintree 008B","E01021357","Total",1514,723,791,1496,18,19,49.77,30.4
"2011","Braintree 008C","E01021358","Total",2230,1064,1166,2230,0,24,152.90,14.6
"2011","Braintree 008D","E01021359","Total",2052,961,1091,2016,36,6,55.07,37.3
"2011","Braintree 009A","E01021350","Total",1719,859,860,1681,38,18,50.13,34.3
"2011","Braintree 009B","E01021353","Total",1779,891,888,1779,0,9,30.62,58.1
"2011","Braintree 009D","E01021365","Total",2291,1148,1143,2233,58,19,43.35,52.8
"2011","Braintree 009E","E01033458","Total",1313,654,659,1313,0,8,18.64,70.4
"2011","Braintree 009F","E01033459","Total",1819,910,909,1819,0,15,35.68,51.0
"2011","Braintree 010A","E01021364","Total",1642,799,843,1642,0,16,54.72,30.0
"2011","Braintree 010B","E01021366","Total",1557,767,790,1551,6,32,49.11,31.7
"2011","Braintree 010C","E01021383","Total",2136,1028,1108,2136,0,26,232.44,9.2
"2011","Braintree 010D","E01021405","Total",2299,1124,1175,2294,5,31,846.56,2.7
"2011","Braintree 011A","E01021368","Total",1523,778,745,1517,6,8,69.65,21.9
"2011","Braintree 011B","E01021370","Total",1639,787,852,1610,29,12,23.87,68.7
"2011","Braintree 011C","E01021372","Total",1825,944,881,1825,0,16,42.18,43.3
"2011","Braintree 011D","E01021373","Total",2391,1177,1214,2391,0,11,56.59,42.3
"2011","Braintree 011E","E01021374","Total",1535,729,806,1535,0,12,25.17,61.0
"2011","Braintree 012A","E01021360","Total",2001,982,1019,1951,50,10,84.09,23.8
"2011","Braintree 012B","E01021361","Total",1624,805,819,1624,0,11,1107.88,1.5
"2011","Braintree 012C","E01021367","Total",1508,716,792,1508,0,9,34.83,43.3
"2011","Braintree 012D","E01021369","Total",2887,1413,1474,2887,0,26,57.67,50.1
"2011","Braintree 012E","E01021380","Total",2311,1159,1152,2261,50,33,2290.85,1.0
"2011","Braintree 013A","E01021347","Total",2478,1238,1240,2435,43,38,753.75,3.3
"2011","Braintree 013B","E01021371","Total",1726,823,903,1681,45,17,56.76,30.4
"2011","Braintree 013C","E01021384","Total",2334,1129,1205,2334,0,22,45.53,51.3
"2011","Braintree 013D","E01021385","Total",1331,622,709,1331,0,14,79.90,16.7
"2011","Braintree 013E","E01021386","Total",1650,792,858,1644,6,29,42.74,38.6
"2011","Braintree 014A","E01021377","Total",1756,855,901,1711,45,27,839.89,2.1
"2011","Braintree 014B","E01021378","Total",1610,739,871,1610,0,17,52.66,30.6
"2011","Braintree 014C","E01021379","Total",1835,911,924,1835,0,42,2075.70,0.9
"2011","Braintree 014D","E01021401","Total",1509,760,749,1478,31,24,1241.62,1.2
"2011","Braintree 014E","E01021402","Total",2078,1034,1044,2053,25,43,56.00,37.1
"2011","Braintree 014F","E01021403","Total",1561,794,767,1561,0,13,383.34,4.1
"2011","Braintree 015A","E01021362","Total",1487,772,715,1463,24,13,1237.22,1.2
"2011","Braintree 015B","E01021417","Total",1506,720,786,1506,0,10,79.69,18.9
"2011","Braintree 015C","E01021418","Total",1491,727,764,1491,0,5,173.33,8.6
"2011","Braintree 015D","E01021419","Total",1661,812,849,1655,6,12,30.65,54.2
"2011","Braintree 015E","E01021426","Total",1307,627,680,1307,0,18,38.86,33.6
"2011","Braintree 015F","E01021428","Total",1403,691,712,1403,0,14,40.97,34.2
"2011","Braintree 016A","E01021423","Total",1570,761,809,1570,0,11,24.44,64.2
"2011","Braintree 016B","E01021425","Total",1537,746,791,1537,0,17,29.07,52.9
"2011","Braintree 016C","E01021427","Total",1369,689,680,1369,0,17,298.61,4.6
"2011","Braintree 016D","E01021429","Total",1344,668,676,1344,0,18,64.76,20.8
"2011","Braintree 017A","E01021415","Total",1459,652,807,1381,78,12,110.84,13.2
"2011","Braintree 017B","E01021416","Total",1601,774,827,1531,70,11,114.50,14.0
"2011","Braintree 017C","E01021420","Total",1657,824,833,1657,0,8,33.94,48.8
"2011","Braintree 017E","E01021422","Total",1634,766,868,1634,0,7,36.35,45.0
"2011","Braintree 017F","E01033460","Total",1216,610,606,1215,1,16,86.68,14.0
"2011","Braintree 017G","E01033461","Total",1502,766,736,1502,0,12,22.63,66.4
"2011","Braintree 017H","E01033462","Total",1066,542,524,1041,25,12,26.53,40.2
"2011","Braintree 018A","E01021348","Total",1576,783,793,1576,0,32,3271.50,0.5
"2011","Braintree 018B","E01021394","Total",1444,711,733,1437,7,22,116.44,12.4
"2011","Braintree 018C","E01021395","Total",1470,712,758,1470,0,20,68.78,21.4
"2011","Braintree 018D","E01021396","Total",1462,715,747,1364,98,29,1725.00,0.8
"2011","Braintree 018E","E01021424","Total",2030,989,1041,2030,0,27,188.58,10.8
"2011","Brentwood 001A","E01021441","Total",1505,726,779,1499,6,24,85.42,17.6
"2011","Brentwood 001B","E01021442","Total",1348,658,690,1348,0,29,65.52,20.6
"2011","Brentwood 001C","E01021443","Total",1496,690,806,1411,85,27,2429.97,0.6
"2011","Brentwood 001D","E01021444","Total",1609,792,817,1609,0,23,675.29,2.4
"2011","Brentwood 001E","E01021469","Total",1155,561,594,1155,0,22,787.75,1.5
"2011","Brentwood 001F","E01021470","Total",1079,535,544,1079,0,27,507.36,2.1
"2011","Brentwood 001G","E01021471","Total",1573,776,797,1573,0,31,232.00,6.8
"2011","Brentwood 002A","E01021457","Total",1399,668,731,1399,0,33,1262.45,1.1
"2011","Brentwood 002B","E01021458","Total",1633,762,871,1617,16,22,223.33,7.3
"2011","Brentwood 002C","E01021459","Total",1315,626,689,1315,0,30,89.83,14.6
"2011","Brentwood 002D","E01021460","Total",1619,772,847,1619,0,22,1219.39,1.3
"2011","Brentwood 003A","E01021448","Total",1405,676,729,1405,0,16,24.66,57.0
"2011","Brentwood 003B","E01021449","Total",1596,742,854,1556,40,20,388.51,4.1
"2011","Brentwood 003C","E01021450","Total",2065,1008,1057,2065,0,51,98.05,21.1
"2011","Brentwood 003D","E01021451","Total",1551,732,819,1551,0,20,33.03,47.0
"2011","Brentwood 003E","E01021452","Total",1467,711,756,1467,0,21,76.91,19.1
"2011","Brentwood 004A","E01021431","Total",1566,745,821,1546,20,26,63.53,24.6
"2011","Brentwood 004B","E01021432","Total",1681,800,881,1681,0,21,35.71,47.1
"2011","Brentwood 004C","E01021434","Total",1310,612,698,1230,80,21,24.47,53.5
"2011","Brentwood 004D","E01021461","Total",1450,712,738,1442,8,10,20.18,71.9
"2011","Brentwood 004E","E01021464","Total",1567,750,817,1460,107,22,36.27,43.2
"2011","Brentwood 005A","E01021447","Total",2450,1196,1254,2450,0,63,193.29,12.7
"2011","Brentwood 005B","E01021453","Total",1218,622,596,1177,41,26,45.17,27.0
"2011","Brentwood 005C","E01021455","Total",1352,671,681,1352,0,63,71.60,18.9
"2011","Brentwood 005D","E01021465","Total",1872,958,914,1855,17,50,178.71,10.5
"2011","Brentwood 005E","E01021466","Total",1812,896,916,1812,0,59,92.73,19.5
"2011","Brentwood 005F","E01021467","Total",1748,853,895,1748,0,46,412.52,4.2
"2011","Brentwood 006A","E01021438","Total",2025,984,1041,2025,0,50,84.09,24.1
"2011","Brentwood 006B","E01021462","Total",1393,695,698,1393,0,20,182.28,7.6
"2011","Brentwood 006C","E01021463","Total",1553,724,829,1553,0,20,231.11,6.7
"2011","Brentwood 006D","E01021468","Total",1891,931,960,1891,0,30,1193.96,1.6
"2011","Brentwood 007A","E01021433","Total",1928,892,1036,1923,5,19,53.68,35.9
"2011","Brentwood 007B","E01021436","Total",2201,1085,1116,2095,106,35,69.99,31.4
"2011","Brentwood 007C","E01021439","Total",2312,1140,1172,2312,0,22,46.86,49.3
"2011","Brentwood 007E","E01021475","Total",1516,741,775,1508,8,20,20.47,74.1
"2011","Brentwood 007F","E01033063","Total",1340,649,691,1340,0,9,37.70,35.5
"2011","Brentwood 007G","E01033064","Total",1370,672,698,1370,0,11,18.33,74.7
"2011","Brentwood 008A","E01021435","Total",1858,861,997,1858,0,37,80.18,23.2
"2011","Brentwood 008B","E01021437","Total",1730,787,943,1726,4,9,26.34,65.7
"2011","Brentwood 008C","E01021472","Total",1533,717,816,1430,103,12,50.20,30.5
"2011","Brentwood 008D","E01021473","Total",1351,656,695,1223,128,34,1665.48,0.8
"2011","Brentwood 008E","E01021474","Total",1573,764,809,1573,0,50,90.01,17.5
"2011","Brentwood 009A","E01021445","Total",2175,1066,1109,2143,32,44,1219.85,1.8
"2011","Brentwood 009B","E01021446","Total",1537,764,773,1531,6,19,765.05,2.0
"2011","Brentwood 009C","E01021454","Total",1245,600,645,1245,0,33,34.11,36.5
"2011","Brentwood 009D","E01021456","Total",1229,604,625,1229,0,31,68.41,18.0
"2011","Castle Point 001A","E01021513","Total",1624,798,826,1624,0,14,26.24,61.9
"2011","Castle Point 001B","E01021514","Total",1518,733,785,1518,0,15,18.13,83.7
"2011","Castle Point 001C","E01021515","Total",1352,650,702,1352,0,5,25.21,53.6
"2011","Castle Point 001D","E01021525","Total",1508,757,751,1508,0,11,26.80,56.3
"2011","Castle Point 001E","E01021527","Total",1672,807,865,1672,0,12,32.77,51.0
"2011","Castle Point 002A","E01021509","Total",1366,678,688,1366,0,11,41.08,33.3
"2011","Castle Point 002B","E01021510","Total",1450,701,749,1450,0,19,30.49,47.6
"2011","Castle Point 002C","E01021511","Total",1328,641,687,1304,24,18,64.45,20.6
"2011","Castle Point 002D","E01021528","Total",1612,769,843,1487,125,9,289.88,5.6
"2011","Castle Point 002E","E01021531","Total",1373,666,707,1373,0,21,154.26,8.9
"2011","Castle Point 003A","E01021476","Total",1905,932,973,1905,0,26,51.07,37.3
"2011","Castle Point 003B","E01021477","Total",1540,751,789,1540,0,10,44.44,34.7
"2011","Castle Point 003C","E01021478","Total",1724,837,887,1724,0,21,40.58,42.5
"2011","Castle Point 003D","E01021516","Total",1364,662,702,1364,0,12,42.55,32.1
"2011","Castle Point 004A","E01021479","Total",1525,743,782,1525,0,13,27.43,55.6
"2011","Castle Point 004B","E01021481","Total",1549,763,786,1514,35,29,88.32,17.5
"2011","Castle Point 004C","E01021483","Total",1747,857,890,1747,0,26,266.53,6.6
"2011","Castle Point 004D","E01021512","Total",1564,758,806,1564,0,22,38.25,40.9
"2011","Castle Point 004E","E01021526","Total",1617,782,835,1617,0,27,66.45,24.3
"2011","Castle Point 005A","E01021517","Total",1602,768,834,1599,3,20,66.69,24.0
"2011","Castle Point 005B","E01021519","Total",1471,713,758,1471,0,24,42.25,34.8
"2011","Castle Point 005C","E01021530","Total",1426,710,716,1426,0,13,77.33,18.4
"2011","Castle Point 005D","E01021532","Total",1450,700,750,1450,0,18,216.72,6.7
"2011","Castle Point 006A","E01021482","Total",1627,787,840,1531,96,20,39.72,41.0
"2011","Castle Point 006B","E01021518","Total",1917,894,1023,1917,0,18,357.14,5.4
"2011","Castle Point 006C","E01021520","Total",1563,752,811,1549,14,23,154.45,10.1
"2011","Castle Point 006D","E01021529","Total",1498,715,783,1498,0,16,24.86,60.3
"2011","Castle Point 007A","E01021480","Total",1829,933,896,1829,0,26,91.27,20.0
"2011","Castle Point 007B","E01021521","Total",1422,711,711,1422,0,7,66.59,21.4
"2011","Castle Point 007C","E01021522","Total",1745,854,891,1666,79,15,72.81,24.0
"2011","Castle Point 007D","E01021523","Total",1367,660,707,1367,0,13,63.55,21.5
"2011","Castle Point 007E","E01021524","Total",1586,761,825,1544,42,9,30.67,51.7
"2011","Castle Point 008A","E01021487","Total",1375,680,695,1363,12,10,24.05,57.2
"2011","Castle Point 008B","E01021494","Total",1490,729,761,1490,0,6,22.40,66.5
"2011","Castle Point 008C","E01021504","Total",1514,745,769,1514,0,16,148.54,10.2
"2011","Castle Point 008D","E01021505","Total",1413,709,704,1413,0,13,21.53,65.6
"2011","Castle Point 008E","E01021506","Total",1320,644,676,1320,0,8,22.16,59.6
"2011","Castle Point 009A","E01021492","Total",1743,838,905,1743,0,12,33.28,52.4
"2011","Castle Point 009B","E01021493","Total",1549,743,806,1547,2,8,28.09,55.1
"2011","Castle Point 009C","E01021495","Total",2011,934,1077,2011,0,4,124.55,16.1
"2011","Castle Point 009D","E01021496","Total",1432,730,702,1432,0,6,22.57,63.4
"2011","Castle Point 010A","E01021485","Total",1256,607,649,1256,0,4,26.72,47.0
"2011","Castle Point 010B","E01021486","Total",1274,618,656,1252,22,3,19.13,66.6
"2011","Castle Point 010C","E01021488","Total",1468,687,781,1406,62,7,25.91,56.7
"2011","Castle Point 010D","E01021503","Total",1414,691,723,1414,0,4,690.97,2.0
"2011","Castle Point 010E","E01021507","Total",1600,743,857,1600,0,5,20.25,79.0
"2011","Castle Point 010F","E01021508","Total",1382,694,688,1382,0,8,14.92,92.6
"2011","Castle Point 011A","E01021484","Total",1370,673,697,1366,4,9,25.09,54.6
"2011","Castle Point 011B","E01021498","Total",1488,716,772,1441,47,9,48.96,30.4
"2011","Castle Point 011C","E01021499","Total",1669,849,820,1638,31,8,33.28,50.2
"2011","Castle Point 011D","E01021501","Total",1414,695,719,1414,0,9,198.28,7.1
"2011","Castle Point 011E","E01021502","Total",2225,1130,1095,2225,0,21,71.20,31.2
"2011","Castle Point 012A","E01021489","Total",1416,720,696,1412,4,4,24.87,56.9
"2011","Castle Point 012B","E01021490","Total",1493,734,759,1493,0,13,30.33,49.2
"2011","Castle Point 012C","E01021491","Total",1663,812,851,1639,24,11,67.01,24.8
"2011","Castle Point 012D","E01021497","Total",1495,726,769,1495,0,10,23.52,63.6
"2011","Castle Point 012E","E01021500","Total",1696,817,879,1696,0,10,60.27,28.1
"2011","Chelmsford 001A","E01021538","Total",2709,1312,1397,2709,0,29,1689.25,1.6
"2011","Chelmsford 001B","E01021539","Total",1298,669,629,1298,0,26,1893.37,0.7
"2011","Chelmsford 001C","E01021540","Total",1534,766,768,1534,0,32,1669.80,0.9
"2011","Chelmsford 001D","E01021541","Total",1465,707,758,1446,19,29,298.07,4.9
"2011","Chelmsford 002A","E01021542","Total",2052,1007,1045,1974,78,32,500.40,4.1
"2011","Chelmsford 002B","E01021543","Total",1714,804,910,1607,107,25,95.14,18.0
"2011","Chelmsford 002C","E01021587","Total",1460,719,741,1460,0,24,32.71,44.6
"2011","Chelmsford 002D","E01021590","Total",1472,702,770,1472,0,28,33.08,44.5
"2011","Chelmsford 002E","E01021591","Total",1499,725,774,1499,0,32,28.30,53.0
"2011","Chelmsford 003A","E01021550","Total",1404,714,690,1404,0,38,3704.92,0.4
"2011","Chelmsford 003B","E01021597","Total",1466,726,740,1466,0,11,30.16,48.6
"2011","Chelmsford 003C","E01021598","Total",1476,709,767,1473,3,15,34.97,42.2
"2011","Chelmsford 003D","E01021600","Total",1173,583,590,1173,0,26,23.11,50.8
"2011","Chelmsford 003E","E01021601","Total",1558,740,818,1532,26,15,44.41,35.1
"2011","Chelmsford 004A","E01021616","Total",1441,709,732,1441,0,30,156.84,9.2
"2011","Chelmsford 004B","E01021617","Total",1368,673,695,1368,0,17,31.63,43.3
"2011","Chelmsford 004C","E01021619","Total",1513,757,756,1513,0,25,23.25,65.1
"2011","Chelmsford 004D","E01021620","Total",1450,724,726,1383,67,8,27.72,52.3
"2011","Chelmsford 004E","E01021623","Total",1250,611,639,1250,0,22,36.88,33.9
"2011","Chelmsford 004F","E01021624","Total",1232,605,627,1232,0,20,34.74,35.5
"2011","Chelmsford 005A","E01021536","Total",1576,768,808,1576,0,13,301.54,5.2
"2011","Chelmsford 005B","E01021537","Total",2021,989,1032,1850,171,40,1238.04,1.6
"2011","Chelmsford 005D","E01021568","Total",1586,781,805,1586,0,42,1115.87,1.4
"2011","Chelmsford 005E","E01033142","Total",2174,1063,1111,2174,0,34,104.88,20.7
"2011","Chelmsford 005F","E01033144","Total",1852,910,942,1852,0,37,112.42,16.5
"2011","Chelmsford 006A","E01021576","Total",1637,749,888,1637,0,10,20.72,79.0
"2011","Chelmsford 006B","E01021588","Total",1412,667,745,1412,0,7,22.49,62.8
"2011","Chelmsford 006C","E01021589","Total",1504,736,768,1504,0,22,40.41,37.2
"2011","Chelmsford 006D","E01021592","Total",1592,732,860,1548,44,16,42.02,37.9
"2011","Chelmsford 006E","E01021596","Total",1571,788,783,1571,0,10,24.31,64.6
"2011","Chelmsford 007A","E01021618","Total",1484,728,756,1484,0,24,22.21,66.8
"2011","Chelmsford 007B","E01021621","Total",1551,801,750,1551,0,20,17.61,88.1
"2011","Chelmsford 007C","E01021622","Total",1467,720,747,1466,1,32,76.93,19.1
"2011","Chelmsford 007D","E01021625","Total",1453,702,751,1453,0,24,27.06,53.7
"2011","Chelmsford 007E","E01021626","Total",1415,704,711,1415,0,37,52.27,27.1
"2011","Chelmsford 008A","E01021544","Total",1311,665,646,1311,0,14,83.23,15.8
"2011","Chelmsford 008B","E01021545","Total",1618,779,839,1618,0,13,92.40,17.5
"2011","Chelmsford 008C","E01021546","Total",1458,705,753,1458,0,34,19.68,74.1
"2011","Chelmsford 008D","E01021547","Total",1558,782,776,1558,0,44,58.41,26.7
"2011","Chelmsford 008E","E01021628","Total",1686,812,874,1686,0,16,40.54,41.6
"2011","Chelmsford 008F","E01021629","Total",1659,818,841,1659,0,20,28.06,59.1
"2011","Chelmsford 009A","E01021573","Total",1716,889,827,1716,0,49,36.52,47.0
"2011","Chelmsford 009B","E01021575","Total",1698,828,870,1567,131,21,29.56,57.4
"2011","Chelmsford 009C","E01021599","Total",1837,914,923,1837,0,42,55.98,32.8
"2011","Chelmsford 009E","E01021631","Total",1900,868,1032,1887,13,13,26.50,71.7
"2011","Chelmsford 009F","E01033138","Total",1515,768,747,1515,0,15,127.18,11.9
"2011","Chelmsford 009G","E01033139","Total",1461,755,706,1461,0,7,28.96,50.4
"2011","Chelmsford 010A","E01021574","Total",2350,1222,1128,1996,354,29,55.39,42.4
"2011","Chelmsford 010B","E01021578","Total",1698,879,819,1682,16,12,29.04,58.5
"2011","Chelmsford 010D","E01021582","Total",1848,970,878,1848,0,11,30.60,60.4
"2011","Chelmsford 010E","E01021627","Total",1535,927,608,1261,274,11,25.11,61.1
"2011","Chelmsford 010F","E01033140","Total",1111,575,536,1106,5,5,77.64,14.3
"2011","Chelmsford 010G","E01033141","Total",1023,491,532,1011,12,9,68.01,15.0
"2011","Chelmsford 011A","E01021551","Total",1360,660,700,1360,0,25,2227.21,0.6
"2011","Chelmsford 011B","E01021632","Total",1443,703,740,1443,0,19,34.47,41.9
"2011","Chelmsford 011C","E01021633","Total",1384,657,727,1082,302,35,102.66,13.5
"2011","Chelmsford 011D","E01021634","Total",1521,760,761,1521,0,22,1526.44,1.0
"2011","Chelmsford 011E","E01021635","Total",1383,654,729,1383,0,12,114.04,12.1
"2011","Chelmsford 011F","E01021636","Total",1095,522,573,1090,5,9,63.31,17.3
"2011","Chelmsford 012A","E01021556","Total",1655,815,840,1646,9,22,73.88,22.4
"2011","Chelmsford 012B","E01021577","Total",1471,714,757,1450,21,19,27.04,54.4
"2011","Chelmsford 012C","E01021579","Total",1610,769,841,1499,111,17,19.19,83.9
"2011","Chelmsford 012D","E01021580","Total",1440,727,713,1423,17,35,28.12,51.2
"2011","Chelmsford 012E","E01021584","Total",1227,623,604,1227,0,29,39.38,31.2
"2011","Chelmsford 013A","E01021548","Total",1306,665,641,1306,0,35,67.34,19.4
"2011","Chelmsford 013B","E01021560","Total",1650,781,869,1650,0,20,171.51,9.6
"2011","Chelmsford 013C","E01021561","Total",1788,892,896,1771,17,28,145.73,12.3
"2011","Chelmsford 013D","E01021564","Total",1492,722,770,1479,13,29,35.13,42.5
"2011","Chelmsford 013E","E01021571","Total",1612,781,831,1573,39,35,1053.07,1.5
"2011","Chelmsford 014A","E01021562","Total",1762,836,926,1762,0,20,75.25,23.4
"2011","Chelmsford 014B","E01021563","Total",1685,836,849,1685,0,5,30.10,56.0
"2011","Chelmsford 014C","E01021565","Total",1591,762,829,1591,0,18,31.94,49.8
"2011","Chelmsford 014D","E01021566","Total",1720,840,880,1720,0,31,50.20,34.3
"2011","Chelmsford 014F","E01033137","Total",1577,789,788,1577,0,14,26.67,59.1
"2011","Chelmsford 014G","E01033145","Total",1385,675,710,1385,0,15,81.75,16.9
"2011","Chelmsford 015A","E01021557","Total",1264,637,627,1264,0,12,14.68,86.1
"2011","Chelmsford 015B","E01021558","Total",1266,614,652,1266,0,26,19.88,63.7
"2011","Chelmsford 015C","E01021583","Total",1575,762,813,1575,0,40,29.87,52.7
"2011","Chelmsford 015D","E01021585","Total",1272,621,651,1272,0,8,16.08,79.1
"2011","Chelmsford 015E","E01021586","Total",1550,745,805,1550,0,17,24.40,63.5
"2011","Chelmsford 016A","E01021533","Total",2270,1126,1144,2270,0,44,268.83,8.4
"2011","Chelmsford 016B","E01021535","Total",1790,847,943,1772,18,25,1955.97,0.9
"2011","Chelmsford 016C","E01021569","Total",1611,817,794,1611,0,42,655.99,2.5
"2011","Chelmsford 016D","E01021570","Total",1942,973,969,1907,35,56,493.43,3.9
"2011","Chelmsford 016E","E01021572","Total",1534,742,792,1534,0,8,36.91,41.6
"2011","Chelmsford 017A","E01021552","Total",1538,730,808,1538,0,25,84.05,18.3
"2011","Chelmsford 017B","E01021553","Total",1382,675,707,1382,0,13,23.77,58.1
"2011","Chelmsford 017C","E01021554","Total",1440,720,720,1440,0,19,109.83,13.1
"2011","Chelmsford 017D","E01021555","Total",1378,679,699,1378,0,22,677.22,2.0
"2011","Chelmsford 017E","E01021559","Total",1505,734,771,1505,0,39,287.65,5.2
"2011","Chelmsford 018B","E01021602","Total",1676,829,847,1676,0,40,2351.07,0.7
"2011","Chelmsford 018D","E01021604","Total",2286,1168,1118,2277,9,28,857.20,2.7
"2011","Chelmsford 018E","E01033143","Total",2589,1268,1321,2589,0,52,2254.43,1.1
"2011","Chelmsford 019A","E01021611","Total",1501,772,729,1501,0,21,173.51,8.7
"2011","Chelmsford 019B","E01021612","Total",1527,731,796,1527,0,13,26.04,58.6
"2011","Chelmsford 019C","E01021613","Total",1818,886,932,1818,0,17,61.06,29.8
"2011","Chelmsford 019D","E01021614","Total",1767,907,860,1767,0,25,228.71,7.7
"2011","Chelmsford 019E","E01021615","Total",1474,722,752,1474,0,24,31.69,46.5
"2011","Chelmsford 020A","E01021605","Total",1250,619,631,1250,0,29,120.31,10.4
"2011","Chelmsford 020B","E01021606","Total",1715,831,884,1643,72,42,84.08,20.4
"2011","Chelmsford 020C","E01021607","Total",1517,744,773,1517,0,18,24.98,60.7
"2011","Chelmsford 020D","E01021608","Total",1145,556,589,1145,0,14,13.25,86.4
"2011","Chelmsford 020E","E01021609","Total",1424,710,714,1424,0,30,50.24,28.3
"2011","Chelmsford 020F","E01021610","Total",1315,645,670,1315,0,24,38.63,34.0
"2011","Chelmsford 021A","E01021593","Total",1665,804,861,1575,90,10,43.11,38.6
"2011","Chelmsford 021B","E01021594","Total",1627,816,811,1614,13,21,1735.53,0.9
"2011","Chelmsford 021C","E01021595","Total",1729,854,875,1693,36,10,540.39,3.2
"2011","Colchester 001A","E01021655","Total",1394,685,709,1341,53,46,1536.04,0.9
"2011","Colchester 001B","E01021656","Total",1549,761,788,1548,1,38,712.74,2.2
"2011","Colchester 001C","E01021659","Total",2079,1031,1048,2079,0,48,2238.74,0.9
"2011","Colchester 001D","E01021661","Total",1776,869,907,1718,58,30,238.85,7.4
"2011","Colchester 002A","E01021668","Total",1651,837,814,1651,0,15,36.71,45.0
"2011","Colchester 002B","E01021669","Total",1525,719,806,1525,0,11,21.19,72.0
"2011","Colchester 002C","E01021670","Total",1550,752,798,1550,0,21,31.03,50.0
"2011","Colchester 002D","E01021671","Total",1457,712,745,1399,58,41,83.31,17.5
"2011","Colchester 002F","E01033720","Total",2012,1010,1002,1999,13,25,145.38,13.8
"2011","Colchester 002G","E01033721","Total",1792,898,894,1792,0,28,21.43,83.6
"2011","Colchester 003A","E01021660","Total",1477,748,729,1460,17,32,2206.29,0.7
"2011","Colchester 003B","E01021728","Total",1636,820,816,1636,0,33,720.05,2.3
"2011","Colchester 003C","E01021729","Total",1708,822,886,1708,0,21,314.37,5.4
"2011","Colchester 003D","E01021730","Total",1730,838,892,1676,54,33,651.42,2.7
"2011","Colchester 004A","E01021679","Total",2360,1189,1171,2348,12,15,120.17,19.6
"2011","Colchester 004B","E01021680","Total",2826,1376,1450,2740,86,35,173.78,16.3
"2011","Colchester 004C","E01021681","Total",2690,1349,1341,2690,0,42,229.72,11.7
"2011","Colchester 004D","E01021682","Total",2689,1324,1365,2620,69,18,241.69,11.1
"2011","Colchester 007A","E01021646","Total",2023,988,1035,1954,69,35,55.20,36.6
"2011","Colchester 007B","E01021647","Total",1791,900,891,1783,8,13,87.14,20.6
"2011","Colchester 007C","E01021648","Total",2356,1184,1172,2303,53,28,58.74,40.1
"2011","Colchester 007D","E01021649","Total",1874,916,958,1822,52,13,50.33,37.2
"2011","Colchester 007E","E01021650","Total",1952,987,965,1947,5,11,99.41,19.6
"2011","Colchester 008A","E01021696","Total",1559,733,826,1559,0,3,27.32,57.1
"2011","Colchester 008B","E01021697","Total",1660,828,832,1660,0,14,27.22,61.0
"2011","Colchester 008C","E01021698","Total",1507,751,756,1300,207,20,19.82,76.0
"2011","Colchester 008D","E01021699","Total",1490,681,809,1458,32,3,32.11,46.4
"2011","Colchester 008E","E01021700","Total",1511,704,807,1511,0,9,20.52,73.6
"2011","Colchester 008G","E01033719","Total",1667,822,845,1139,528,22,33.08,50.4
"2011","Colchester 008H","E01033722","Total",1597,826,771,1589,8,6,28.62,55.8
"2011","Colchester 009A","E01021673","Total",1426,654,772,1366,60,28,73.16,19.5
"2011","Colchester 009B","E01021674","Total",1358,653,705,1358,0,12,30.91,43.9
"2011","Colchester 009C","E01021675","Total",1312,641,671,1311,1,26,54.68,24.0
"2011","Colchester 009D","E01021676","Total",1453,678,775,1409,44,37,298.44,4.9
"2011","Colchester 010A","E01021654","Total",1915,930,985,1844,71,35,1100.56,1.7
"2011","Colchester 010B","E01021662","Total",1596,815,781,1578,18,41,1979.85,0.8
"2011","Colchester 010C","E01021663","Total",1099,533,566,1098,1,28,1692.85,0.6
"2011","Colchester 010D","E01021677","Total",1212,611,601,1212,0,17,253.82,4.8
"2011","Colchester 010E","E01021678","Total",1339,688,651,1326,13,14,355.86,3.8
"2011","Colchester 011A","E01021683","Total",2368,1726,642,1044,1324,9,35.72,66.3
"2011","Colchester 011B","E01021684","Total",1515,768,747,1506,9,10,23.30,65.0
"2011","Colchester 011C","E01021685","Total",1917,922,995,1917,0,16,53.53,35.8
"2011","Colchester 011D","E01021686","Total",1848,919,929,1830,18,16,29.84,61.9
"2011","Colchester 011E","E01021687","Total",1630,787,843,1630,0,10,16.85,96.7
"2011","Colchester 011F","E01021688","Total",1404,685,719,1404,0,10,18.29,76.8
"2011","Colchester 012A","E01021718","Total",1521,761,760,1515,6,18,102.34,14.9
"2011","Colchester 012B","E01021719","Total",1541,763,778,1541,0,15,46.86,32.9
"2011","Colchester 012C","E01021720","Total",1561,704,857,1477,84,10,34.76,44.9
"2011","Colchester 012D","E01021721","Total",1985,955,1030,1960,25,38,515.26,3.9
"2011","Colchester 012E","E01021722","Total",1675,796,879,1664,11,18,212.18,7.9
"2011","Colchester 013A","E01021651","Total",1626,825,801,1624,2,23,72.12,22.5
"2011","Colchester 013B","E01021652","Total",1524,777,747,1489,35,45,43.05,35.4
"2011","Colchester 013C","E01021653","Total",1332,678,654,1332,0,51,25.72,51.8
"2011","Colchester 013D","E01021717","Total",1726,845,881,1726,0,19,85.75,20.1
"2011","Colchester 014A","E01021689","Total",1453,693,760,1444,9,19,38.90,37.4
"2011","Colchester 014B","E01021690","Total",1320,645,675,1320,0,31,48.06,27.5
"2011","Colchester 014C","E01021691","Total",1466,709,757,1450,16,41,36.54,40.1
"2011","Colchester 014D","E01021692","Total",1493,715,778,1473,20,35,32.66,45.7
"2011","Colchester 014E","E01021693","Total",1664,794,870,1660,4,33,40.69,40.9
"2011","Colchester 015A","E01021711","Total",1295,608,687,1295,0,7,30.10,43.0
"2011","Colchester 015C","E01021713","Total",1191,590,601,1191,0,6,36.99,32.2
"2011","Colchester 015D","E01021714","Total",1782,907,875,1777,5,17,197.12,9.0
"2011","Colchester 015E","E01021715","Total",1462,719,743,1462,0,17,83.92,17.4
"2011","Colchester 015G","E01033723","Total",2630,1286,1344,2630,0,23,117.51,22.4
"2011","Colchester 016A","E01021657","Total",1582,760,822,1582,0,5,55.18,28.7
"2011","Colchester 016B","E01021658","Total",1051,488,563,1051,0,3,474.01,2.2
"2011","Colchester 016C","E01021664","Total",2045,1000,1045,1997,48,12,70.09,29.2
"2011","Colchester 016D","E01021665","Total",1364,652,712,1364,0,12,38.05,35.8
"2011","Colchester 016E","E01021666","Total",1295,635,660,1295,0,11,28.24,45.9
"2011","Colchester 016F","E01021667","Total",1477,704,773,1423,54,12,295.51,5.0
"2011","Colchester 017A","E01021736","Total",3391,1657,1734,1261,2130,66,387.91,8.7
"2011","Colchester 017B","E01021737","Total",1232,593,639,1229,3,7,100.79,12.2
"2011","Colchester 017C","E01021738","Total",2104,1026,1078,2104,0,29,75.62,27.8
"2011","Colchester 017D","E01021739","Total",1563,773,790,1563,0,26,110.40,14.2
"2011","Colchester 017E","E01021740","Total",1735,838,897,1735,0,17,52.39,33.1
"2011","Colchester 018A","E01021637","Total",1184,610,574,1177,7,9,43.48,27.2
"2011","Colchester 018B","E01021638","Total",1244,594,650,1229,15,8,65.40,19.0
"2011","Colchester 018C","E01021639","Total",1975,1089,886,1740,235,12,294.13,6.7
"2011","Colchester 018D","E01021640","Total",1205,585,620,1205,0,9,19.13,63.0
"2011","Colchester 018E","E01021641","Total",1403,700,703,1403,0,6,30.28,46.3
"2011","Colchester 018F","E01021642","Total",2003,966,1037,2003,0,18,42.45,47.2
"2011","Colchester 019A","E01021643","Total",2448,1189,1259,2448,0,36,2524.84,1.0
"2011","Colchester 019B","E01021644","Total",1710,856,854,1660,50,28,3621.53,0.5
"2011","Colchester 019C","E01021645","Total",1493,757,736,1493,0,32,161.85,9.2
"2011","Colchester 019D","E01021694","Total",1447,716,731,1423,24,28,3270.97,0.4
"2011","Colchester 019E","E01021695","Total",1149,564,585,1103,46,23,703.50,1.6
"2011","Colchester 020A","E01021723","Total",1641,789,852,1626,15,9,160.81,10.2
"2011","Colchester 020B","E01021724","Total",1670,794,876,1667,3,9,65.50,25.5
"2011","Colchester 020C","E01021725","Total",1290,647,643,1290,0,22,451.40,2.9
"2011","Colchester 020D","E01021726","Total",1527,740,787,1520,7,9,74.48,20.5
"2011","Colchester 020E","E01021727","Total",1455,701,754,1455,0,13,81.28,17.9
"2011","Colchester 021A","E01021731","Total",1445,667,778,1434,11,15,57.78,25.0
"2011","Colchester 021B","E01021732","Total",1523,716,807,1523,0,10,38.22,39.8
"2011","Colchester 021C","E01021733","Total",1501,726,775,1501,0,24,806.68,1.9
"2011","Colchester 021D","E01021734","Total",1357,657,700,1357,0,17,94.25,14.4
"2011","Colchester 021E","E01021735","Total",1357,638,719,1357,0,26,64.44,21.1
"2011","Colchester 022D","E01021702","Total",1331,638,693,1331,0,7,26.02,51.2
"2011","Colchester 022E","E01021703","Total",1275,616,659,1275,0,6,24.18,52.7
"2011","Colchester 022F","E01021704","Total",1516,762,754,1478,38,12,28.78,52.7
"2011","Colchester 022G","E01021705","Total",2034,1026,1008,2034,0,28,73.76,27.6
"2011","Colchester 022H","E01021706","Total",1352,634,718,1256,96,11,36.93,36.6
"2011","Colchester 022I","E01021707","Total",1366,641,725,1358,8,16,30.54,44.7
"2011","Colchester 022A","E01021708","Total",1421,697,724,1391,30,29,124.42,11.4
"2011","Colchester 022B","E01021709","Total",1434,720,714,1434,0,18,39.16,36.6
"2011","Colchester 022C","E01021710","Total",1952,942,1010,1937,15,35,83.18,23.5
"2011","Epping Forest 001A","E01021768","Total",2138,1052,1086,2138,0,33,2691.72,0.8
"2011","Epping Forest 001B","E01021795","Total",2014,1018,996,2014,0,35,529.75,3.8
"2011","Epping Forest 001C","E01021797","Total",1314,662,652,1314,0,20,377.67,3.5
"2011","Epping Forest 001D","E01021798","Total",1536,753,783,1536,0,16,93.32,16.5
"2011","Epping Forest 001E","E01021799","Total",1627,766,861,1584,43,14,190.26,8.6
"2011","Epping Forest 002A","E01021741","Total",1970,996,974,1970,0,30,2818.97,0.7
"2011","Epping Forest 002B","E01021792","Total",1205,587,618,1205,0,8,397.18,3.0
"2011","Epping Forest 002C","E01021793","Total",1523,759,764,1523,0,19,324.93,4.7
"2011","Epping Forest 002D","E01021794","Total",1146,545,601,1146,0,18,266.62,4.3
"2011","Epping Forest 002E","E01021801","Total",2193,1081,1112,2187,6,29,704.54,3.1
"2011","Epping Forest 003A","E01021769","Total",2237,1116,1121,2237,0,39,4584.41,0.5
"2011","Epping Forest 003B","E01021796","Total",2122,1053,1069,2122,0,39,4358.62,0.5
"2011","Epping Forest 003C","E01021800","Total",2256,1135,1121,2239,17,42,4811.30,0.5
"2011","Epping Forest 004A","E01021753","Total",1407,685,722,1407,0,20,375.83,3.7
"2011","Epping Forest 004B","E01021754","Total",1538,753,785,1538,0,34,149.29,10.3
"2011","Epping Forest 004C","E01021755","Total",1101,541,560,1101,0,18,97.09,11.3
"2011","Epping Forest 004D","E01021802","Total",2205,1030,1175,2205,0,13,279.59,7.9
"2011","Epping Forest 005A","E01021760","Total",1512,737,775,1512,0,30,144.12,10.5
"2011","Epping Forest 005B","E01021761","Total",1850,869,981,1782,68,22,557.34,3.3
"2011","Epping Forest 005C","E01021762","Total",1380,631,749,1380,0,12,34.43,40.1
"2011","Epping Forest 005D","E01021763","Total",1496,734,762,1495,1,24,59.90,25.0
"2011","Epping Forest 006A","E01021756","Total",1527,756,771,1527,0,28,218.47,7.0
"2011","Epping Forest 006B","E01021757","Total",1626,787,839,1589,37,16,69.45,23.4
"2011","Epping Forest 006C","E01021758","Total",1548,709,839,1521,27,7,65.87,23.5
"2011","Epping Forest 006D","E01021759","Total",1491,716,775,1491,0,16,118.84,12.5
"2011","Epping Forest 007A","E01021811","Total",1364,628,736,1364,0,9,60.93,22.4
"2011","Epping Forest 007B","E01021813","Total",1386,695,691,1386,0,31,28.08,49.4
"2011","Epping Forest 007C","E01021814","Total",1531,706,825,1450,81,7,79.00,19.4
"2011","Epping Forest 007D","E01021815","Total",1547,747,800,1547,0,6,24.94,62.0
"2011","Epping Forest 007E","E01021816","Total",1328,641,687,1262,66,6,25.87,51.3
"2011","Epping Forest 008A","E01021807","Total",1534,764,770,1514,20,10,25.86,59.3
"2011","Epping Forest 008B","E01021808","Total",1486,721,765,1486,0,14,24.41,60.9
"2011","Epping Forest 008C","E01021809","Total",1425,705,720,1400,25,14,35.93,39.7
"2011","Epping Forest 008D","E01021810","Total",1822,892,930,1787,35,13,121.24,15.0
"2011","Epping Forest 008E","E01021817","Total",2491,1231,1260,2491,0,13,124.55,20.0
"2011","Epping Forest 009A","E01021806","Total",2236,1133,1103,2150,86,22,2242.06,1.0
"2011","Epping Forest 009B","E01021812","Total",1241,626,615,1241,0,13,1246.16,1.0
"2011","Epping Forest 009C","E01021818","Total",1758,857,901,1758,0,7,201.57,8.7
"2011","Epping Forest 010A","E01021770","Total",2013,975,1038,2013,0,18,1041.69,1.9
"2011","Epping Forest 010B","E01021803","Total",1327,659,668,1327,0,27,169.63,7.8
"2011","Epping Forest 010C","E01021804","Total",1441,677,764,1357,84,15,631.06,2.3
"2011","Epping Forest 010D","E01021805","Total",1294,628,666,1294,0,39,30.97,41.8
"2011","Epping Forest 011A","E01021774","Total",1409,704,705,1409,0,9,40.44,34.8
"2011","Epping Forest 011B","E01021775","Total",1457,683,774,1457,0,9,138.42,10.5
"2011","Epping Forest 011C","E01021776","Total",1367,642,725,1367,0,7,60.35,22.7
"2011","Epping Forest 011D","E01021777","Total",1372,652,720,1372,0,7,27.16,50.5
"2011","Epping Forest 011E","E01021778","Total",1454,727,727,1454,0,13,23.05,63.1
"2011","Epping Forest 011F","E01021779","Total",1491,727,764,1491,0,15,26.83,55.6
"2011","Epping Forest 012A","E01021786","Total",1253,606,647,1238,15,25,24.60,50.9
"2011","Epping Forest 012B","E01021787","Total",1548,775,773,1548,0,36,330.22,4.7
"2011","Epping Forest 012C","E01021788","Total",1558,748,810,1558,0,31,212.94,7.3
"2011","Epping Forest 012D","E01021789","Total",1575,766,809,1541,34,51,68.71,22.9
"2011","Epping Forest 012E","E01021790","Total",1480,693,787,1466,14,12,35.72,41.4
"2011","Epping Forest 012F","E01021791","Total",1557,768,789,1538,19,33,35.59,43.7
"2011","Epping Forest 013A","E01021771","Total",1523,718,805,1523,0,6,49.72,30.6
"2011","Epping Forest 013B","E01021772","Total",1490,739,751,1490,0,17,28.00,53.2
"2011","Epping Forest 013C","E01021773","Total",1513,711,802,1513,0,15,26.21,57.7
"2011","Epping Forest 013D","E01021783","Total",1554,736,818,1554,0,18,30.36,51.2
"2011","Epping Forest 013E","E01021784","Total",1532,717,815,1532,0,12,44.80,34.2
"2011","Epping Forest 014A","E01021780","Total",1468,709,759,1452,16,36,124.81,11.8
"2011","Epping Forest 014B","E01021781","Total",1475,725,750,1466,9,32,106.35,13.9
"2011","Epping Forest 014C","E01021782","Total",1410,683,727,1410,0,29,30.97,45.5
"2011","Epping Forest 014D","E01021785","Total",1620,773,847,1620,0,15,46.88,34.6
"2011","Epping Forest 015A","E01021742","Total",1375,657,718,1375,0,24,40.76,33.7
"2011","Epping Forest 015B","E01021743","Total",1693,755,938,1623,70,13,46.96,36.1
"2011","Epping Forest 015C","E01021744","Total",1548,765,783,1548,0,24,31.70,48.8
"2011","Epping Forest 015D","E01021745","Total",1525,718,807,1525,0,27,53.40,28.6
"2011","Epping Forest 015E","E01021746","Total",1783,847,936,1783,0,27,77.38,23.0
"2011","Epping Forest 015F","E01021747","Total",1727,813,914,1618,109,39,73.02,23.7
"2011","Epping Forest 015G","E01021748","Total",1729,867,862,1729,0,32,61.99,27.9
"2011","Epping Forest 016A","E01021749","Total",2207,1074,1133,2188,19,37,377.57,5.8
"2011","Epping Forest 016B","E01021750","Total",1269,638,631,1256,13,30,842.16,1.5
"2011","Epping Forest 016C","E01021751","Total",1341,668,673,1341,0,46,82.51,16.3
"2011","Epping Forest 016D","E01021752","Total",1550,737,813,1538,12,27,94.76,16.4
"2011","Epping Forest 017A","E01021764","Total",1770,808,962,1770,0,16,18.33,96.6
"2011","Epping Forest 017B","E01021765","Total",1620,769,851,1620,0,24,59.39,27.3
"2011","Epping Forest 017C","E01021766","Total",1491,719,772,1460,31,36,50.19,29.7
"2011","Epping Forest 017D","E01021767","Total",1739,847,892,1660,79,30,42.85,40.6
"2011","Harlow 001A","E01021854","Total",1639,811,828,1636,3,28,132.10,12.4
"2011","Harlow 001B","E01021855","Total",1394,657,737,1394,0,13,36.05,38.7
"2011","Harlow 001C","E01021856","Total",1421,663,758,1419,2,14,30.45,46.7
"2011","Harlow 001D","E01021857","Total",2514,1229,1285,2500,14,26,404.01,6.2
"2011","Harlow 002A","E01021844","Total",1365,650,715,1365,0,19,28.12,48.5
"2011","Harlow 002B","E01021845","Total",1434,660,774,1434,0,8,74.34,19.3
"2011","Harlow 002C","E01021846","Total",1351,665,686,1351,0,8,66.47,20.3
"2011","Harlow 002D","E01021847","Total",1459,678,781,1408,51,14,24.86,58.7
"2011","Harlow 002E","E01021848","Total",1575,765,810,1575,0,10,169.48,9.3
"2011","Harlow 003A","E01021849","Total",1603,782,821,1603,0,13,38.62,41.5
"2011","Harlow 003B","E01021850","Total",1430,688,742,1430,0,10,19.56,73.1
"2011","Harlow 003C","E01021851","Total",1485,745,740,1485,0,5,22.47,66.1
"2011","Harlow 003D","E01021852","Total",1571,747,824,1546,25,8,38.32,41.0
"2011","Harlow 003E","E01021853","Total",1334,666,668,1332,2,11,126.12,10.6
"2011","Harlow 004A","E01021839","Total",1513,738,775,1513,0,10,96.67,15.7
"2011","Harlow 004B","E01021840","Total",1441,697,744,1441,0,8,296.32,4.9
"2011","Harlow 004C","E01021841","Total",1393,664,729,1379,14,12,87.29,16.0
"2011","Harlow 004D","E01021842","Total",1529,713,816,1529,0,8,31.69,48.2
"2011","Harlow 004E","E01021843","Total",2081,1007,1074,2023,58,11,47.50,43.8
"2011","Harlow 005A","E01021824","Total",1732,855,877,1732,0,6,29.43,58.9
"2011","Harlow 005B","E01021825","Total",1618,788,830,1618,0,6,20.93,77.3
"2011","Harlow 005C","E01021826","Total",1602,796,806,1602,0,13,42.98,37.3
"2011","Harlow 005D","E01021827","Total",1628,764,864,1616,12,18,39.46,41.3
"2011","Harlow 005E","E01021828","Total",2315,1124,1191,2315,0,13,28.40,81.5
"2011","Harlow 006A","E01021819","Total",1546,755,791,1546,0,16,25.43,60.8
"2011","Harlow 006B","E01021820","Total",1507,707,800,1495,12,17,33.41,45.1
"2011","Harlow 006C","E01021822","Total",1621,762,859,1561,60,17,26.86,60.3
"2011","Harlow 006D","E01021823","Total",1712,835,877,1712,0,13,30.63,55.9
"2011","Harlow 006E","E01021870","Total",1308,632,676,1308,0,12,57.23,22.9
"2011","Harlow 007A","E01021831","Total",1426,700,726,1426,0,12,29.41,48.5
"2011","Harlow 007B","E01021868","Total",1599,739,860,1595,4,11,55.10,29.0
"2011","Harlow 007C","E01021869","Total",1351,660,691,1351,0,12,22.13,61.0
"2011","Harlow 007D","E01021871","Total",1471,703,768,1390,81,13,30.73,47.9
"2011","Harlow 007E","E01021872","Total",1815,896,919,1815,0,8,43.76,41.5
"2011","Harlow 008A","E01021821","Total",1337,644,693,1337,0,7,38.53,34.7
"2011","Harlow 008B","E01021834","Total",1497,680,817,1497,0,7,43.51,34.4
"2011","Harlow 008C","E01021835","Total",1492,726,766,1492,0,11,46.33,32.2
"2011","Harlow 008D","E01021836","Total",1441,688,753,1423,18,12,23.35,61.7
"2011","Harlow 008E","E01021837","Total",1439,694,745,1439,0,13,48.58,29.6
"2011","Harlow 009A","E01021829","Total",1468,736,732,1468,0,10,31.26,47.0
"2011","Harlow 009B","E01021830","Total",1183,597,586,1183,0,18,29.89,39.6
"2011","Harlow 009C","E01021832","Total",1247,611,636,1237,10,14,41.82,29.8
"2011","Harlow 009D","E01021833","Total",1219,574,645,1219,0,17,38.49,31.7
"2011","Harlow 009E","E01021865","Total",1338,654,684,1332,6,9,28.48,47.0
"2011","Harlow 010A","E01021838","Total",1491,707,784,1491,0,10,28.35,52.6
"2011","Harlow 010B","E01021858","Total",1492,730,762,1492,0,11,24.80,60.2
"2011","Harlow 010C","E01021859","Total",1461,721,740,1459,2,12,34.00,43.0
"2011","Harlow 010D","E01021860","Total",1526,740,786,1526,0,16,27.76,55.0
"2011","Harlow 010E","E01021861","Total",1300,632,668,1296,4,15,39.21,33.2
"2011","Harlow 011A","E01021862","Total",1448,691,757,1448,0,21,19.44,74.5
"2011","Harlow 011B","E01021863","Total",1591,818,773,1586,5,26,25.92,61.4
"2011","Harlow 011C","E01021864","Total",1437,730,707,1437,0,16,29.60,48.5
"2011","Harlow 011D","E01021866","Total",1338,658,680,1328,10,6,25.87,51.7
"2011","Harlow 011E","E01021867","Total",1416,702,714,1416,0,13,142.23,10.0
"2011","Maldon 001A","E01021908","Total",1977,984,993,1977,0,33,1208.24,1.6
"2011","Maldon 001B","E01021909","Total",1349,673,676,1301,48,26,1566.12,0.9
"2011","Maldon 001C","E01021910","Total",1469,727,742,1469,0,23,1536.15,1.0
"2011","Maldon 001D","E01021911","Total",1247,613,634,1197,50,19,1625.96,0.8
"2011","Maldon 002A","E01021882","Total",2024,976,1048,2000,24,37,2827.65,0.7
"2011","Maldon 002B","E01021883","Total",1636,834,802,1636,0,23,211.08,7.8
"2011","Maldon 002C","E01021912","Total",1999,981,1018,1989,10,41,1011.28,2.0
"2011","Maldon 002D","E01021913","Total",1501,747,754,1500,1,48,2840.85,0.5
"2011","Maldon 003A","E01021884","Total",1413,706,707,1413,0,10,49.37,28.6
"2011","Maldon 003B","E01021885","Total",1131,581,550,1130,1,15,370.75,3.1
"2011","Maldon 003C","E01021886","Total",1479,751,728,1479,0,13,94.86,15.6
"2011","Maldon 003D","E01021887","Total",2213,1057,1156,2191,22,22,102.11,21.7
"2011","Maldon 003E","E01021888","Total",1939,950,989,1854,85,10,65.81,29.5
"2011","Maldon 004A","E01021889","Total",2189,1055,1134,2162,27,14,341.71,6.4
"2011","Maldon 004B","E01021890","Total",1742,871,871,1740,2,14,85.78,20.3
"2011","Maldon 004C","E01021891","Total",1467,665,802,1396,71,10,53.37,27.5
"2011","Maldon 004D","E01021892","Total",1030,469,561,1030,0,8,290.73,3.5
"2011","Maldon 005A","E01021893","Total",1544,755,789,1544,0,18,138.22,11.2
"2011","Maldon 005B","E01021894","Total",1245,585,660,1212,33,15,18.46,67.4
"2011","Maldon 005C","E01021895","Total",1226,583,643,1226,0,12,16.34,75.0
"2011","Maldon 005D","E01021896","Total",1350,680,670,1350,0,31,235.51,5.7
"2011","Maldon 005E","E01021897","Total",1156,566,590,1156,0,18,22.66,51.0
"2011","Maldon 005F","E01021898","Total",1271,619,652,1271,0,9,26.03,48.8
"2011","Maldon 006A","E01021901","Total",1878,939,939,1877,1,16,1959.34,1.0
"2011","Maldon 006B","E01021904","Total",1505,760,745,1478,27,8,268.82,5.6
"2011","Maldon 006C","E01021905","Total",1257,634,623,1256,1,9,137.59,9.1
"2011","Maldon 006D","E01021906","Total",1510,736,774,1478,32,21,2231.45,0.7
"2011","Maldon 006E","E01021907","Total",2182,1104,1078,2136,46,17,5848.20,0.4
"2011","Maldon 007A","E01021873","Total",1373,703,670,1373,0,21,105.71,13.0
"2011","Maldon 007B","E01021874","Total",1348,655,693,1347,1,18,1435.25,0.9
"2011","Maldon 007C","E01021875","Total",1407,701,706,1374,33,4,2212.03,0.6
"2011","Maldon 007D","E01021899","Total",1385,707,678,1385,0,12,261.89,5.3
"2011","Maldon 007E","E01021900","Total",1097,549,548,1097,0,13,433.74,2.5
"2011","Maldon 007F","E01021902","Total",1807,923,884,1806,1,40,1792.29,1.0
"2011","Maldon 007G","E01021903","Total",1612,813,799,1608,4,27,2286.85,0.7
"2011","Maldon 008C","E01021878","Total",1401,686,715,1401,0,13,35.05,40.0
"2011","Maldon 008D","E01021879","Total",1366,680,686,1366,0,18,104.50,13.1
"2011","Maldon 008E","E01021880","Total",1428,712,716,1427,1,13,35.98,39.7
"2011","Maldon 008F","E01021881","Total",1164,578,586,1164,0,14,92.33,12.6
"2011","Maldon 008G","E01033057","Total",2312,1150,1162,2301,11,41,1896.70,1.2
"2011","Rochford 001A","E01021942","Total",1579,778,801,1575,4,10,422.80,3.7
"2011","Rochford 001B","E01021943","Total",1754,846,908,1754,0,27,44.28,39.6
"2011","Rochford 001C","E01021944","Total",1632,815,817,1632,0,13,282.69,5.8
"2011","Rochford 001D","E01021945","Total",1562,778,784,1562,0,15,34.01,45.9
"2011","Rochford 002A","E01021914","Total",2095,1051,1044,2085,10,27,972.32,2.2
"2011","Rochford 002B","E01021927","Total",1353,668,685,1353,0,17,22.68,59.7
"2011","Rochford 002C","E01021928","Total",1543,710,833,1535,8,19,72.04,21.4
"2011","Rochford 002D","E01021929","Total",1640,827,813,1640,0,19,50.95,32.2
"2011","Rochford 002E","E01021931","Total",1338,650,688,1332,6,13,85.71,15.6
"2011","Rochford 003A","E01021933","Total",1365,706,659,1365,0,16,138.63,9.8
"2011","Rochford 003B","E01021934","Total",1416,699,717,1416,0,13,163.42,8.7
"2011","Rochford 003C","E01021935","Total",1353,655,698,1353,0,19,63.16,21.4
"2011","Rochford 003D","E01021936","Total",1697,806,891,1697,0,16,43.40,39.1
"2011","Rochford 003E","E01021937","Total",1648,833,815,1648,0,27,31.05,53.1
"2011","Rochford 003F","E01021938","Total",1495,695,800,1495,0,14,31.27,47.8
"2011","Rochford 003G","E01021939","Total",1686,822,864,1686,0,16,34.75,48.5
"2011","Rochford 003H","E01021940","Total",2120,1061,1059,2120,0,29,125.48,16.9
"2011","Rochford 003I","E01021941","Total",2096,1022,1074,2096,0,33,453.92,4.6
"2011","Rochford 004A","E01021915","Total",1347,669,678,1272,75,12,4058.04,0.3
"2011","Rochford 004B","E01021916","Total",1072,518,554,1072,0,8,342.57,3.1
"2011","Rochford 004C","E01021953","Total",1483,703,780,1483,0,11,97.46,15.2
"2011","Rochford 004D","E01021955","Total",1823,858,965,1822,1,12,37.44,48.7
"2011","Rochford 005A","E01021918","Total",1521,745,776,1521,0,18,78.03,19.5
"2011","Rochford 005B","E01021919","Total",1296,637,659,1296,0,10,25.82,50.2
"2011","Rochford 005C","E01021925","Total",1637,800,837,1637,0,9,31.77,51.5
"2011","Rochford 005D","E01021960","Total",2203,1169,1034,1961,242,31,192.74,11.4
"2011","Rochford 005E","E01021961","Total",1494,718,776,1494,0,21,57.73,25.9
"2011","Rochford 006A","E01021920","Total",2026,1024,1002,2003,23,14,1156.77,1.8
"2011","Rochford 006B","E01021926","Total",2102,1017,1085,2102,0,13,49.60,42.4
"2011","Rochford 006C","E01021957","Total",1471,734,737,1457,14,5,27.77,53.0
"2011","Rochford 006D","E01021958","Total",1243,598,645,1243,0,7,30.41,40.9
"2011","Rochford 006E","E01021959","Total",1701,814,887,1701,0,21,33.93,50.1
"2011","Rochford 007A","E01021930","Total",1375,719,656,1375,0,11,22.67,60.7
"2011","Rochford 007B","E01021932","Total",1536,761,775,1535,1,16,27.09,56.7
"2011","Rochford 007C","E01021952","Total",1410,640,770,1394,16,12,89.81,15.7
"2011","Rochford 007D","E01021954","Total",1520,743,777,1506,14,13,770.84,2.0
"2011","Rochford 007E","E01021956","Total",1459,699,760,1441,18,15,151.14,9.7
"2011","Rochford 008A","E01021950","Total",1465,715,750,1465,0,23,25.16,58.2
"2011","Rochford 008B","E01021951","Total",1272,600,672,1272,0,16,20.37,62.4
"2011","Rochford 008C","E01021962","Total",1256,576,680,1214,42,13,30.44,41.3
"2011","Rochford 008D","E01021963","Total",1363,679,684,1343,20,17,169.59,8.0
"2011","Rochford 008E","E01021964","Total",1572,750,822,1572,0,20,51.12,30.8
"2011","Rochford 008F","E01021966","Total",1755,813,942,1755,0,15,38.23,45.9
"2011","Rochford 009A","E01021946","Total",1556,779,777,1547,9,21,91.03,17.1
"2011","Rochford 009B","E01021947","Total",1197,590,607,1197,0,8,30.99,38.6
"2011","Rochford 009C","E01021948","Total",1335,657,678,1335,0,17,19.33,69.1
"2011","Rochford 009D","E01021949","Total",1518,748,770,1518,0,13,26.71,56.8
"2011","Rochford 009E","E01021965","Total",2293,1131,1162,2293,0,29,123.30,18.6
"2011","Rochford 010A","E01021917","Total",1876,950,926,1828,48,18,2016.14,0.9
"2011","Rochford 010B","E01021921","Total",1501,731,770,1501,0,16,3522.50,0.4
"2011","Rochford 010C","E01021922","Total",1591,766,825,1591,0,13,68.94,23.1
"2011","Rochford 010D","E01021923","Total",1364,673,691,1364,0,25,89.33,15.3
"2011","Rochford 010E","E01021924","Total",1282,641,641,1282,0,22,272.47,4.7
"2011","Tendring 001A","E01021997","Total",1323,695,628,1323,0,3,24.63,53.7
"2011","Tendring 001B","E01021998","Total",1353,680,673,1353,0,4,48.92,27.7
"2011","Tendring 001C","E01021999","Total",1728,801,927,1662,66,15,36.95,46.8
"2011","Tendring 001D","E01022001","Total",1668,836,832,1642,26,16,58.33,28.6
"2011","Tendring 002A","E01022000","Total",1631,775,856,1631,0,10,38.80,42.0
"2011","Tendring 002C","E01022006","Total",1618,756,862,1618,0,9,43.68,37.0
"2011","Tendring 002D","E01022007","Total",1690,840,850,1690,0,6,59.02,28.6
"2011","Tendring 002F","E01033051","Total",2373,1162,1211,2373,0,17,250.71,9.5
"2011","Tendring 003A","E01021978","Total",2233,1102,1131,2212,21,38,2577.38,0.9
"2011","Tendring 003B","E01022013","Total",1554,775,779,1554,0,17,612.41,2.5
"2011","Tendring 003C","E01022014","Total",1359,645,714,1359,0,15,385.70,3.5
"2011","Tendring 003D","E01022015","Total",1389,652,737,1389,0,17,102.81,13.5
"2011","Tendring 003E","E01022019","Total",1492,738,754,1360,132,35,2714.28,0.5
"2011","Tendring 003F","E01022020","Total",1740,804,936,1740,0,12,76.83,22.6
"2011","Tendring 003G","E01022021","Total",1371,666,705,1371,0,13,97.12,14.1
"2011","Tendring 004A","E01021991","Total",1017,514,503,1011,6,16,1342.25,0.8
"2011","Tendring 004B","E01021992","Total",1171,575,596,1158,13,15,488.00,2.4
"2011","Tendring 004C","E01022002","Total",1914,917,997,1908,6,20,65.81,29.1
"2011","Tendring 004D","E01022004","Total",1656,782,874,1625,31,13,110.49,15.0
"2011","Tendring 004E","E01022005","Total",1715,845,870,1705,10,16,87.47,19.6
"2011","Tendring 004F","E01022028","Total",1358,656,702,1347,11,12,1416.58,1.0
"2011","Tendring 005A","E01021971","Total",1042,536,506,1034,8,28,1120.74,0.9
"2011","Tendring 005B","E01021972","Total",1269,643,626,1253,16,25,1666.77,0.8
"2011","Tendring 005C","E01022051","Total",1452,739,713,1390,62,34,2561.52,0.6
"2011","Tendring 005D","E01022052","Total",1440,705,735,1426,14,18,110.05,13.1
"2011","Tendring 006A","E01021985","Total",1332,608,724,1314,18,18,42.82,31.1
"2011","Tendring 006B","E01021986","Total",1445,649,796,1382,63,32,88.49,16.3
"2011","Tendring 006C","E01022054","Total",1479,675,804,1380,99,15,428.57,3.5
"2011","Tendring 006D","E01022055","Total",1307,554,753,1253,54,9,67.05,19.5
"2011","Tendring 006E","E01022056","Total",1586,770,816,1583,3,13,46.99,33.8
"2011","Tendring 007A","E01021973","Total",1139,566,573,1139,0,17,471.56,2.4
"2011","Tendring 007B","E01021974","Total",1161,585,576,1145,16,10,2734.41,0.4
"2011","Tendring 007C","E01022016","Total",1734,840,894,1726,8,9,245.99,7.0
"2011","Tendring 007D","E01022017","Total",1427,718,709,1398,29,13,789.81,1.8
"2011","Tendring 007E","E01022018","Total",1429,689,740,1402,27,11,669.11,2.1
"2011","Tendring 008A","E01021987","Total",1225,557,668,1225,0,22,69.06,17.7
"2011","Tendring 008B","E01021994","Total",1130,520,610,1130,0,8,46.49,24.3
"2011","Tendring 008C","E01021995","Total",1369,638,731,1369,0,8,34.47,39.7
"2011","Tendring 008D","E01021996","Total",1348,592,756,1298,50,19,53.61,25.1
"2011","Tendring 008E","E01022009","Total",1387,675,712,1359,28,29,363.01,3.8
"2011","Tendring 008F","E01022010","Total",1546,727,819,1543,3,20,71.35,21.7
"2011","Tendring 008G","E01022011","Total",1791,863,928,1791,0,19,1048.27,1.7
"2011","Tendring 008H","E01022012","Total",1900,818,1082,1859,41,17,133.29,14.3
"2011","Tendring 009A","E01021967","Total",2009,976,1033,1993,16,26,680.93,3.0
"2011","Tendring 009B","E01021983","Total",1353,671,682,1335,18,18,590.33,2.3
"2011","Tendring 009C","E01021993","Total",2253,1117,1136,2223,30,35,1307.85,1.7
"2011","Tendring 009D","E01022053","Total",1795,903,892,1708,87,20,1312.37,1.4
"2011","Tendring 010A","E01021984","Total",2027,949,1078,2027,0,8,356.77,5.7
"2011","Tendring 010B","E01022039","Total",1478,686,792,1478,0,10,153.89,9.6
"2011","Tendring 010C","E01022040","Total",1727,814,913,1727,0,8,46.28,37.3
"2011","Tendring 010D","E01022041","Total",1457,665,792,1451,6,8,52.85,27.6
"2011","Tendring 011A","E01021979","Total",1484,708,776,1484,0,6,115.32,12.9
"2011","Tendring 011B","E01021980","Total",1765,856,909,1707,58,13,93.84,18.8
"2011","Tendring 011C","E01021981","Total",1690,828,862,1679,11,14,295.25,5.7
"2011","Tendring 011D","E01021982","Total",1784,874,910,1784,0,24,48.46,36.8
"2011","Tendring 011E","E01022046","Total",1576,789,787,1550,26,9,424.26,3.7
"2011","Tendring 012A","E01022008","Total",2051,979,1072,2023,28,11,145.87,14.1
"2011","Tendring 012B","E01022033","Total",1413,667,746,1413,0,8,42.28,33.4
"2011","Tendring 012C","E01022034","Total",1501,689,812,1488,13,4,44.31,33.9
"2011","Tendring 012D","E01022035","Total",1476,680,796,1461,15,19,43.48,33.9
"2011","Tendring 013A","E01021975","Total",1484,693,791,1484,0,19,176.57,8.4
"2011","Tendring 013B","E01021976","Total",1408,675,733,1386,22,10,40.11,35.1
"2011","Tendring 013C","E01021977","Total",1657,788,869,1657,0,15,252.83,6.6
"2011","Tendring 013D","E01022022","Total",1479,740,739,1479,0,7,39.82,37.1
"2011","Tendring 013E","E01022044","Total",1624,780,844,1624,0,10,37.82,42.9
"2011","Tendring 014A","E01022042","Total",1486,690,796,1486,0,16,32.53,45.7
"2011","Tendring 014B","E01022043","Total",1908,959,949,1898,10,10,35.70,53.4
"2011","Tendring 014C","E01022048","Total",1591,718,873,1420,171,10,41.80,38.1
"2011","Tendring 014D","E01022049","Total",1492,705,787,1434,58,22,52.47,28.4
"2011","Tendring 014E","E01022050","Total",1668,769,899,1655,13,15,97.27,17.1
"2011","Tendring 015A","E01022023","Total",1459,700,759,1459,0,8,24.55,59.4
"2011","Tendring 015B","E01022024","Total",1498,678,820,1498,0,8,21.41,70.0
"2011","Tendring 015C","E01022030","Total",1630,773,857,1630,0,5,36.67,44.5
"2011","Tendring 015D","E01022031","Total",1364,662,702,1364,0,10,47.19,28.9
"2011","Tendring 015E","E01022032","Total",1793,830,963,1793,0,9,97.01,18.5
"2011","Tendring 016A","E01021970","Total",1639,746,893,1626,13,9,23.11,70.9
"2011","Tendring 016B","E01022025","Total",1616,817,799,1341,275,10,30.32,53.3
"2011","Tendring 016C","E01022026","Total",1588,778,810,1493,95,15,21.54,73.7
"2011","Tendring 016D","E01022027","Total",1632,781,851,1531,101,14,28.55,57.2
"2011","Tendring 017A","E01021968","Total",1776,838,938,1776,0,15,26.58,66.8
"2011","Tendring 017B","E01021969","Total",1426,658,768,1426,0,4,22.15,64.4
"2011","Tendring 017C","E01022036","Total",1237,579,658,1237,0,6,123.37,10.0
"2011","Tendring 017D","E01022037","Total",1493,664,829,1293,200,12,35.87,41.6
"2011","Tendring 017E","E01022038","Total",1470,691,779,1467,3,10,35.12,41.9
"2011","Tendring 018A","E01021988","Total",1778,913,865,1739,39,4,158.36,11.2
"2011","Tendring 018B","E01021989","Total",1451,685,766,1451,0,5,132.87,10.9
"2011","Tendring 018C","E01021990","Total",1570,741,829,1563,7,5,39.75,39.5
"2011","Tendring 018D","E01022045","Total",1426,683,743,1426,0,3,1085.15,1.3
"2011","Tendring 018E","E01022047","Total",1275,603,672,1270,5,16,1711.69,0.7
"2011","Uttlesford 001A","E01022057","Total",1736,855,881,1734,2,63,3173.28,0.5
"2011","Uttlesford 001B","E01022075","Total",1839,898,941,1792,47,55,345.00,5.3
"2011","Uttlesford 001C","E01022077","Total",1563,767,796,1563,0,48,1380.07,1.1
"2011","Uttlesford 001D","E01022094","Total",1709,834,875,1708,1,55,1762.78,1.0
"2011","Uttlesford 002A","E01022074","Total",1509,719,790,1509,0,18,227.58,6.6
"2011","Uttlesford 002B","E01022076","Total",1686,794,892,1682,4,28,40.64,41.5
"2011","Uttlesford 002C","E01022078","Total",1526,736,790,1526,0,23,71.20,21.4
"2011","Uttlesford 002D","E01022079","Total",1706,819,887,1679,27,32,64.25,26.6
"2011","Uttlesford 002E","E01022080","Total",1584,825,759,1584,0,21,25.01,63.3
"2011","Uttlesford 002F","E01022081","Total",2312,1082,1230,2245,67,50,78.84,29.3
"2011","Uttlesford 002G","E01022082","Total",1779,903,876,1705,74,28,256.26,6.9
"2011","Uttlesford 003A","E01022061","Total",1461,710,751,1461,0,40,1890.88,0.8
"2011","Uttlesford 003B","E01022071","Total",1708,843,865,1707,1,67,3157.47,0.5
"2011","Uttlesford 003C","E01022072","Total",1886,936,950,1883,3,60,2231.42,0.8
"2011","Uttlesford 003D","E01022073","Total",1557,778,779,1557,0,32,344.30,4.5
"2011","Uttlesford 003E","E01022098","Total",1520,753,767,1520,0,56,3419.65,0.4
"2011","Uttlesford 004A","E01022092","Total",1752,875,877,1749,3,31,3520.28,0.5
"2011","Uttlesford 004B","E01022093","Total",1760,837,923,1716,44,35,362.98,4.8
"2011","Uttlesford 004C","E01022097","Total",1900,954,946,1900,0,68,5035.77,0.4
"2011","Uttlesford 004D","E01022099","Total",2407,1316,1091,2163,244,56,3634.30,0.7
"2011","Uttlesford 005A","E01022062","Total",2092,1034,1058,2089,3,53,2237.38,0.9
"2011","Uttlesford 005B","E01022063","Total",1587,778,809,1586,1,29,74.51,21.3
"2011","Uttlesford 005C","E01022083","Total",1699,832,867,1629,70,41,1117.42,1.5
"2011","Uttlesford 005D","E01022084","Total",1608,800,808,1608,0,36,505.91,3.2
"2011","Uttlesford 005E","E01022085","Total",1570,797,773,1570,0,26,31.15,50.4
"2011","Uttlesford 005F","E01022087","Total",1803,893,910,1777,26,20,416.74,4.3
"2011","Uttlesford 005G","E01022089","Total",1552,769,783,1552,0,43,2604.19,0.6
"2011","Uttlesford 006A","E01022086","Total",1369,699,670,1346,23,14,828.64,1.7
"2011","Uttlesford 006B","E01022090","Total",2367,1184,1183,2362,5,25,1904.58,1.2
"2011","Uttlesford 006C","E01022091","Total",2349,1173,1176,2349,0,36,1120.91,2.1
"2011","Uttlesford 006D","E01022095","Total",1577,788,789,1560,17,32,2877.87,0.5
"2011","Uttlesford 007B","E01022067","Total",1800,857,943,1755,45,23,48.63,37.0
"2011","Uttlesford 007C","E01022068","Total",1589,769,820,1588,1,33,1041.78,1.5
"2011","Uttlesford 007D","E01033054","Total",1087,541,546,1087,0,4,19.35,56.2
"2011","Uttlesford 007E","E01033055","Total",1462,706,756,1462,0,32,242.44,6.0
"2011","Uttlesford 007F","E01033056","Total",1329,631,698,1327,2,26,813.50,1.6
"2011","Uttlesford 008A","E01022058","Total",1701,868,833,1701,0,47,2789.98,0.6
"2011","Uttlesford 008B","E01022064","Total",1759,872,887,1742,17,51,2167.73,0.8
"2011","Uttlesford 008D","E01022069","Total",1563,729,834,1493,70,19,166.52,9.4
"2011","Uttlesford 008E","E01022088","Total",1560,776,784,1560,0,38,2573.46,0.6
"2011","Uttlesford 008F","E01033052","Total",1884,936,948,1585,299,52,876.44,2.1
"2011","Uttlesford 008G","E01033053","Total",1882,929,953,1882,0,30,59.45,31.7
"2011","Uttlesford 009A","E01022059","Total",1615,800,815,1614,1,37,2733.94,0.6
"2011","Uttlesford 009B","E01022060","Total",1956,970,986,1946,10,45,1455.50,1.3
"2011","Uttlesford 009C","E01022070","Total",1930,930,1000,1907,23,37,1086.83,1.8
"2011","Uttlesford 009D","E01022096","Total",1853,908,945,1835,18,26,3301.47,0.6
"2011","Broxbourne 001A","E01023316","Total",1446,720,726,1446,0,14,26.14,55.3
"2011","Broxbourne 001B","E01023317","Total",2547,1228,1319,2473,74,35,49.10,51.9
"2011","Broxbourne 001C","E01023318","Total",1612,780,832,1612,0,11,24.27,66.4
"2011","Broxbourne 001D","E01023319","Total",1576,774,802,1576,0,34,71.72,22.0
"2011","Broxbourne 002A","E01023327","Total",1440,685,755,1440,0,13,20.03,71.9
"2011","Broxbourne 002B","E01023328","Total",1380,673,707,1379,1,8,30.02,46.0
"2011","Broxbourne 002C","E01023329","Total",1311,640,671,1311,0,8,21.53,60.9
"2011","Broxbourne 002D","E01023330","Total",1507,752,755,1507,0,6,130.03,11.6
"2011","Broxbourne 002E","E01023331","Total",1549,748,801,1549,0,14,27.11,57.1
"2011","Broxbourne 003A","E01023320","Total",1929,952,977,1921,8,9,58.98,32.7
"2011","Broxbourne 003B","E01023321","Total",1955,948,1007,1950,5,24,194.60,10.0
"2011","Broxbourne 003C","E01023322","Total",1765,887,878,1763,2,14,442.12,4.0
"2011","Broxbourne 003D","E01023323","Total",1591,797,794,1583,8,14,32.34,49.2
"2011","Broxbourne 004A","E01023289","Total",1531,760,771,1531,0,33,213.14,7.2
"2011","Broxbourne 004B","E01023290","Total",1658,811,847,1658,0,36,40.20,41.2
"2011","Broxbourne 004C","E01023291","Total",1552,771,781,1517,35,21,48.18,32.2
"2011","Broxbourne 004D","E01023292","Total",1497,730,767,1497,0,18,110.18,13.6
"2011","Broxbourne 005A","E01023340","Total",1736,855,881,1736,0,22,38.02,45.7
"2011","Broxbourne 005B","E01023341","Total",1783,858,925,1780,3,25,200.23,8.9
"2011","Broxbourne 005C","E01023342","Total",2648,1258,1390,2594,54,27,71.30,37.1
"2011","Broxbourne 005D","E01023343","Total",1871,873,998,1839,32,16,47.01,39.8
"2011","Broxbourne 005E","E01023344","Total",1725,834,891,1725,0,10,46.52,37.1
"2011","Broxbourne 006A","E01023307","Total",1575,760,815,1575,0,20,586.94,2.7
"2011","Broxbourne 006B","E01023308","Total",1703,849,854,1703,0,24,24.60,69.2
"2011","Broxbourne 006C","E01023309","Total",1713,823,890,1713,0,17,29.35,58.4
"2011","Broxbourne 006D","E01023310","Total",2201,1022,1179,2201,0,16,164.21,13.4
"2011","Broxbourne 007A","E01023311","Total",1655,811,844,1655,0,15,448.89,3.7
"2011","Broxbourne 007B","E01023312","Total",1680,852,828,1680,0,24,85.19,19.7
"2011","Broxbourne 007C","E01023313","Total",1640,802,838,1640,0,21,418.18,3.9
"2011","Broxbourne 007D","E01023315","Total",1861,904,957,1861,0,30,63.45,29.3
"2011","Broxbourne 008A","E01023302","Total",1488,711,777,1488,0,7,18.50,80.4
"2011","Broxbourne 008B","E01023303","Total",1560,750,810,1560,0,11,22.75,68.6
"2011","Broxbourne 008C","E01023304","Total",1549,753,796,1549,0,28,51.99,29.8
"2011","Broxbourne 008D","E01023305","Total",1382,666,716,1382,0,6,42.93,32.2
"2011","Broxbourne 008E","E01023306","Total",1467,707,760,1467,0,10,60.94,24.1
"2011","Broxbourne 009A","E01023314","Total",1336,659,677,1336,0,13,54.29,24.6
"2011","Broxbourne 009B","E01023324","Total",1409,657,752,1365,44,13,33.26,42.4
"2011","Broxbourne 009C","E01023325","Total",1421,666,755,1421,0,16,18.68,76.1
"2011","Broxbourne 009D","E01023326","Total",1634,773,861,1627,7,10,23.66,69.1
"2011","Broxbourne 010A","E01023297","Total",1364,684,680,1364,0,11,21.91,62.3
"2011","Broxbourne 010B","E01023298","Total",1578,750,828,1546,32,21,25.05,63.0
"2011","Broxbourne 010C","E01023299","Total",1690,858,832,1688,2,25,65.27,25.9
"2011","Broxbourne 010D","E01023300","Total",1408,618,790,1408,0,6,27.55,51.1
"2011","Broxbourne 010E","E01023301","Total",1606,787,819,1606,0,16,22.15,72.5
"2011","Broxbourne 011A","E01023293","Total",1731,850,881,1728,3,13,359.54,4.8
"2011","Broxbourne 011B","E01023294","Total",1517,694,823,1498,19,22,44.84,33.8
"2011","Broxbourne 011C","E01023295","Total",1422,696,726,1419,3,12,33.81,42.1
"2011","Broxbourne 011D","E01023296","Total",1666,792,874,1660,6,17,40.67,41.0
"2011","Broxbourne 012A","E01023332","Total",2067,953,1114,2067,0,15,54.91,37.6
"2011","Broxbourne 012B","E01023333","Total",1844,901,943,1844,0,27,24.32,75.8
"2011","Broxbourne 012C","E01023334","Total",1703,840,863,1699,4,18,47.23,36.1
"2011","Broxbourne 012D","E01023335","Total",1723,868,855,1723,0,14,73.70,23.4
"2011","Broxbourne 013A","E01023336","Total",2022,946,1076,2022,0,13,26.68,75.8
"2011","Broxbourne 013B","E01023337","Total",1675,829,846,1675,0,14,35.50,47.2
"2011","Broxbourne 013C","E01023338","Total",2201,1070,1131,2201,0,8,101.59,21.7
"2011","Broxbourne 013D","E01023339","Total",1509,722,787,1509,0,9,48.26,31.3
"2011","Dacorum 001A","E01023430","Total",1206,611,595,1177,29,25,1452.45,0.8
"2011","Dacorum 001B","E01023431","Total",1295,646,649,1234,61,38,3323.01,0.4
"2011","Dacorum 001C","E01023432","Total",1448,733,715,1448,0,19,182.34,7.9
"2011","Dacorum 001D","E01023433","Total",1464,709,755,1464,0,14,34.83,42.0
"2011","Dacorum 002A","E01023423","Total",1390,665,725,1342,48,38,212.49,6.5
"2011","Dacorum 002B","E01023424","Total",1390,687,703,1390,0,32,1772.26,0.8
"2011","Dacorum 002C","E01023425","Total",1337,628,709,1337,0,39,36.95,36.2
"2011","Dacorum 002D","E01023426","Total",1546,713,833,1364,182,43,45.77,33.8
"2011","Dacorum 003A","E01023418","Total",1409,682,727,1409,0,18,26.28,53.6
"2011","Dacorum 003B","E01023419","Total",2118,1049,1069,2112,6,41,188.81,11.2
"2011","Dacorum 003C","E01023420","Total",1551,751,800,1551,0,39,37.68,41.2
"2011","Dacorum 004A","E01023352","Total",2447,1196,1251,2439,8,75,1497.21,1.6
"2011","Dacorum 004B","E01023421","Total",1478,733,745,1478,0,36,92.54,16.0
"2011","Dacorum 004C","E01023422","Total",1270,634,636,1270,0,48,1152.66,1.1
"2011","Dacorum 005A","E01023434","Total",1533,765,768,1533,0,29,22.87,67.0
"2011","Dacorum 005B","E01023435","Total",1493,762,731,1493,0,19,26.22,56.9
"2011","Dacorum 005C","E01023436","Total",1208,605,603,1208,0,20,21.97,55.0
"2011","Dacorum 005D","E01023437","Total",1531,748,783,1531,0,17,17.16,89.2
"2011","Dacorum 006A","E01023355","Total",1546,765,781,1537,9,49,707.99,2.2
"2011","Dacorum 006B","E01023356","Total",1125,554,571,1107,18,36,1133.61,1.0
"2011","Dacorum 006C","E01023416","Total",1454,703,751,1454,0,29,1432.83,1.0
"2011","Dacorum 006D","E01023417","Total",1359,643,716,1359,0,19,69.13,19.7
"2011","Dacorum 007A","E01023393","Total",1669,862,807,1669,0,11,25.85,64.6
"2011","Dacorum 007B","E01023394","Total",1376,692,684,1376,0,19,28.91,47.6
"2011","Dacorum 007C","E01023395","Total",1632,826,806,1616,16,15,48.14,33.9
"2011","Dacorum 007D","E01023396","Total",1559,777,782,1559,0,19,52.19,29.9
"2011","Dacorum 007E","E01023397","Total",1338,664,674,1338,0,8,21.20,63.1
"2011","Dacorum 008A","E01023401","Total",1820,878,942,1742,78,17,25.77,70.6
"2011","Dacorum 008B","E01023402","Total",1618,793,825,1618,0,10,38.72,41.8
"2011","Dacorum 008C","E01023403","Total",1504,692,812,1446,58,19,34.92,43.1
"2011","Dacorum 008D","E01023404","Total",1315,631,684,1315,0,8,12.09,108.8
"2011","Dacorum 008E","E01023405","Total",1507,758,749,1504,3,7,30.95,48.7
"2011","Dacorum 009A","E01023361","Total",1701,854,847,1662,39,26,50.02,34.0
"2011","Dacorum 009B","E01023362","Total",1734,829,905,1734,0,63,367.33,4.7
"2011","Dacorum 009C","E01023363","Total",1553,748,805,1553,0,37,51.20,30.3
"2011","Dacorum 009D","E01023364","Total",1294,630,664,1294,0,35,42.95,30.1
"2011","Dacorum 010A","E01023390","Total",2028,1017,1011,2026,2,32,70.95,28.6
"2011","Dacorum 010B","E01023391","Total",1702,808,894,1702,0,32,54.61,31.2
"2011","Dacorum 010C","E01023399","Total",1602,782,820,1595,7,25,115.99,13.8
"2011","Dacorum 011A","E01023392","Total",1626,762,864,1562,64,22,91.43,17.8
"2011","Dacorum 011B","E01023427","Total",1673,838,835,1673,0,15,25.67,65.2
"2011","Dacorum 011C","E01023428","Total",1477,724,753,1477,0,26,121.05,12.2
"2011","Dacorum 011D","E01023429","Total",1801,852,949,1801,0,21,35.43,50.8
"2011","Dacorum 012A","E01023369","Total",1462,702,760,1462,0,14,28.16,51.9
"2011","Dacorum 012B","E01023370","Total",1659,828,831,1645,14,29,36.82,45.1
"2011","Dacorum 012C","E01023371","Total",1509,722,787,1509,0,59,57.84,26.1
"2011","Dacorum 012D","E01023372","Total",1453,695,758,1426,27,69,123.05,11.8
"2011","Dacorum 013A","E01023345","Total",1557,773,784,1557,0,19,184.94,8.4
"2011","Dacorum 013B","E01023346","Total",1309,623,686,1309,0,12,147.61,8.9
"2011","Dacorum 013C","E01023347","Total",1326,621,705,1271,55,20,27.95,47.4
"2011","Dacorum 013D","E01023348","Total",1656,779,877,1542,114,11,37.17,44.6
"2011","Dacorum 014A","E01023365","Total",1264,629,635,1247,17,25,32.87,38.5
"2011","Dacorum 014B","E01023366","Total",1499,743,756,1499,0,22,33.69,44.5
"2011","Dacorum 014C","E01023367","Total",1171,553,618,1117,54,37,427.58,2.7
"2011","Dacorum 014D","E01023368","Total",1716,817,899,1716,0,41,26.70,64.3
"2011","Dacorum 015A","E01023349","Total",1945,920,1025,1939,6,13,33.33,58.4
"2011","Dacorum 015B","E01023350","Total",1629,789,840,1629,0,8,35.37,46.1
"2011","Dacorum 015C","E01023351","Total",1589,768,821,1589,0,14,40.26,39.5
"2011","Dacorum 015D","E01023398","Total",2425,1250,1175,2400,25,32,82.95,29.2
"2011","Dacorum 015E","E01023400","Total",1802,872,930,1681,121,5,35.32,51.0
"2011","Dacorum 016A","E01023383","Total",1497,728,769,1497,0,30,181.05,8.3
"2011","Dacorum 016B","E01023384","Total",1910,930,980,1910,0,31,50.17,38.1
"2011","Dacorum 016C","E01023385","Total",1661,842,819,1661,0,39,28.93,57.4
"2011","Dacorum 017A","E01023409","Total",1497,771,726,1496,1,15,56.54,26.5
"2011","Dacorum 017B","E01023410","Total",1357,654,703,1352,5,35,42.23,32.1
"2011","Dacorum 017C","E01023411","Total",1493,709,784,1493,0,14,29.26,51.0
"2011","Dacorum 017D","E01023412","Total",1270,645,625,1270,0,28,33.33,38.1
"2011","Dacorum 017E","E01023413","Total",1344,649,695,1344,0,12,21.53,62.4
"2011","Dacorum 018B","E01023354","Total",1683,864,819,1683,0,32,119.61,14.1
"2011","Dacorum 018C","E01023379","Total",1605,779,826,1601,4,34,28.55,56.2
"2011","Dacorum 018D","E01023380","Total",1148,562,586,1148,0,25,20.33,56.5
"2011","Dacorum 018E","E01023381","Total",1325,665,660,1325,0,42,37.03,35.8
"2011","Dacorum 018F","E01023382","Total",1488,722,766,1488,0,17,54.21,27.4
"2011","Dacorum 018G","E01033022","Total",1311,689,622,1310,1,13,16.69,78.6
"2011","Dacorum 018H","E01033023","Total",1509,789,720,1469,40,10,53.05,28.4
"2011","Dacorum 019A","E01023386","Total",1522,753,769,1522,0,16,18.78,81.0
"2011","Dacorum 019B","E01023387","Total",1386,648,738,1330,56,17,45.36,30.6
"2011","Dacorum 019C","E01023388","Total",1592,785,807,1592,0,11,27.86,57.1
"2011","Dacorum 019D","E01023389","Total",1683,829,854,1683,0,32,30.44,55.3
"2011","Dacorum 020A","E01023357","Total",1669,831,838,1651,18,12,27.14,61.5
"2011","Dacorum 020B","E01023358","Total",1477,721,756,1477,0,9,46.21,32.0
"2011","Dacorum 020C","E01023359","Total",1823,857,966,1823,0,16,29.33,62.2
"2011","Dacorum 020D","E01023360","Total",1473,753,720,1473,0,21,27.48,53.6
"2011","Dacorum 020E","E01023414","Total",1432,707,725,1432,0,19,28.65,50.0
"2011","Dacorum 020F","E01023415","Total",1381,672,709,1381,0,21,169.77,8.1
"2011","Dacorum 021A","E01023373","Total",1903,1302,601,1153,750,17,70.75,26.9
"2011","Dacorum 021B","E01023374","Total",1418,694,724,1418,0,34,638.30,2.2
"2011","Dacorum 021C","E01023375","Total",1537,779,758,1537,0,35,405.79,3.8
"2011","Dacorum 021D","E01023376","Total",1268,608,660,1268,0,14,29.78,42.6
"2011","Dacorum 021E","E01023377","Total",1212,572,640,1212,0,27,1372.75,0.9
"2011","Dacorum 021F","E01023378","Total",1661,814,847,1628,33,66,450.31,3.7
"2011","Dacorum 022A","E01023406","Total",1915,911,1004,1882,33,24,314.10,6.1
"2011","Dacorum 022B","E01023407","Total",1664,805,859,1664,0,25,319.41,5.2
"2011","Dacorum 022C","E01023408","Total",1635,785,850,1635,0,41,198.80,8.2
"2011","East Hertfordshire 001A","E01023462","Total",1337,686,651,1337,0,46,3195.35,0.4
"2011","East Hertfordshire 001B","E01023464","Total",2170,1078,1092,2164,6,27,502.16,4.3
"2011","East Hertfordshire 001C","E01023465","Total",1450,739,711,1444,6,37,1422.04,1.0
"2011","East Hertfordshire 001D","E01023466","Total",1758,849,909,1717,41,28,51.14,34.4
"2011","East Hertfordshire 002A","E01023467","Total",2395,1189,1206,2392,3,57,1257.33,1.9
"2011","East Hertfordshire 002B","E01023494","Total",1206,583,623,1206,0,31,2922.49,0.4
"2011","East Hertfordshire 002C","E01023495","Total",1291,668,623,1252,39,24,2239.23,0.6
"2011","East Hertfordshire 002D","E01023508","Total",1472,722,750,1472,0,39,3029.21,0.5
"2011","East Hertfordshire 002E","E01023509","Total",1356,685,671,1356,0,23,382.55,3.5
"2011","East Hertfordshire 003A","E01023452","Total",1388,676,712,1388,0,54,35.14,39.5
"2011","East Hertfordshire 003B","E01023453","Total",1470,732,738,1390,80,61,392.40,3.7
"2011","East Hertfordshire 003C","E01023454","Total",1311,631,680,1311,0,32,64.49,20.3
"2011","East Hertfordshire 003D","E01023455","Total",1338,638,700,1292,46,32,36.65,36.5
"2011","East Hertfordshire 003E","E01023463","Total",1203,586,617,1203,0,28,1783.96,0.7
"2011","East Hertfordshire 003F","E01023493","Total",2468,1234,1234,2468,0,65,3848.72,0.6
"2011","East Hertfordshire 004A","E01023449","Total",1620,781,839,1611,9,46,43.30,37.4
"2011","East Hertfordshire 004B","E01023450","Total",1937,974,963,1908,29,28,246.39,7.9
"2011","East Hertfordshire 004C","E01023451","Total",2141,1039,1102,2141,0,48,66.47,32.2
"2011","East Hertfordshire 005A","E01023438","Total",1449,702,747,1449,0,29,41.46,34.9
"2011","East Hertfordshire 005B","E01023439","Total",1358,657,701,1358,0,23,23.26,58.4
"2011","East Hertfordshire 005C","E01023440","Total",1641,797,844,1641,0,47,135.72,12.1
"2011","East Hertfordshire 005D","E01023441","Total",1457,701,756,1187,270,27,30.35,48.0
"2011","East Hertfordshire 005E","E01023442","Total",2095,1039,1056,2095,0,45,51.24,40.9
"2011","East Hertfordshire 006A","E01023498","Total",2653,1309,1344,2653,0,38,349.01,7.6
"2011","East Hertfordshire 006B","E01023506","Total",1406,705,701,1398,8,26,1576.09,0.9
"2011","East Hertfordshire 006C","E01023507","Total",1682,857,825,1577,105,35,2030.14,0.8
"2011","East Hertfordshire 007A","E01023443","Total",1561,758,803,1557,4,25,24.12,64.7
"2011","East Hertfordshire 007B","E01023444","Total",1629,809,820,1619,10,21,34.25,47.6
"2011","East Hertfordshire 007C","E01023445","Total",1733,848,885,1733,0,16,27.45,63.1
"2011","East Hertfordshire 007D","E01023446","Total",2135,1043,1092,2118,17,17,36.83,58.0
"2011","East Hertfordshire 007E","E01023447","Total",1248,572,676,1248,0,13,24.57,50.8
"2011","East Hertfordshire 007F","E01023448","Total",1523,755,768,1519,4,27,41.57,36.6
"2011","East Hertfordshire 008A","E01023456","Total",1435,719,716,1435,0,39,18.62,77.1
"2011","East Hertfordshire 008B","E01023457","Total",1507,724,783,1507,0,20,24.79,60.8
"2011","East Hertfordshire 008C","E01023458","Total",1331,669,662,1331,0,22,47.46,28.0
"2011","East Hertfordshire 008D","E01023459","Total",1389,672,717,1342,47,37,37.23,37.3
"2011","East Hertfordshire 008E","E01023460","Total",1519,766,753,1519,0,23,173.87,8.7
"2011","East Hertfordshire 008F","E01023461","Total",1623,804,819,1623,0,53,48.11,33.7
"2011","East Hertfordshire 009A","E01023491","Total",1279,646,633,1272,7,27,1603.79,0.8
"2011","East Hertfordshire 009B","E01023492","Total",1492,750,742,1468,24,43,1801.12,0.8
"2011","East Hertfordshire 009C","E01023496","Total",1291,585,706,1117,174,29,2358.09,0.5
"2011","East Hertfordshire 009D","E01023497","Total",1571,757,814,1571,0,46,1216.25,1.3
"2011","East Hertfordshire 010A","E01023485","Total",2277,1123,1154,2277,0,54,2860.31,0.8
"2011","East Hertfordshire 010B","E01023486","Total",2514,1226,1288,2514,0,103,2983.58,0.8
"2011","East Hertfordshire 010E","E01033609","Total",2338,1137,1201,2328,10,34,1473.32,1.6
"2011","East Hertfordshire 011A","E01023499","Total",1753,857,896,1750,3,25,387.14,4.5
"2011","East Hertfordshire 011B","E01023500","Total",1734,896,838,1603,131,41,371.55,4.7
"2011","East Hertfordshire 011C","E01023501","Total",1513,723,790,1513,0,24,109.55,13.8
"2011","East Hertfordshire 011D","E01023502","Total",1735,840,895,1735,0,18,66.78,26.0
"2011","East Hertfordshire 011E","E01023503","Total",1723,857,866,1723,0,27,62.48,27.6
"2011","East Hertfordshire 012A","E01023512","Total",1860,899,961,1860,0,35,72.97,25.5
"2011","East Hertfordshire 012B","E01023513","Total",1488,727,761,1488,0,20,50.75,29.3
"2011","East Hertfordshire 012C","E01023514","Total",1792,843,949,1691,101,17,31.33,57.2
"2011","East Hertfordshire 012D","E01023518","Total",2045,1014,1031,1951,94,21,35.88,57.0
"2011","East Hertfordshire 012E","E01023519","Total",1735,840,895,1735,0,20,23.15,74.9
"2011","East Hertfordshire 012F","E01023520","Total",1608,796,812,1608,0,29,33.21,48.4
"2011","East Hertfordshire 013A","E01023510","Total",1513,720,793,1469,44,36,171.79,8.8
"2011","East Hertfordshire 013B","E01023511","Total",1517,755,762,1517,0,13,61.22,24.8
"2011","East Hertfordshire 013C","E01023515","Total",1561,795,766,1554,7,23,59.15,26.4
"2011","East Hertfordshire 013D","E01023516","Total",2085,1065,1020,2085,0,46,53.36,39.1
"2011","East Hertfordshire 013E","E01023517","Total",1595,772,823,1595,0,20,46.00,34.7
"2011","East Hertfordshire 014A","E01023470","Total",1763,846,917,1729,34,19,50.49,34.9
"2011","East Hertfordshire 014B","E01023471","Total",1334,631,703,1319,15,25,388.25,3.4
"2011","East Hertfordshire 014C","E01023472","Total",1343,630,713,1343,0,12,27.72,48.4
"2011","East Hertfordshire 014D","E01023473","Total",1455,722,733,1455,0,44,168.40,8.6
"2011","East Hertfordshire 014E","E01023474","Total",1561,760,801,1557,4,49,45.52,34.3
"2011","East Hertfordshire 015A","E01023487","Total",1374,670,704,1374,0,9,26.20,52.4
"2011","East Hertfordshire 015B","E01023488","Total",1609,752,857,1592,17,22,142.65,11.3
"2011","East Hertfordshire 015C","E01023489","Total",1309,644,665,1309,0,18,43.16,30.3
"2011","East Hertfordshire 015D","E01023490","Total",1272,624,648,1272,0,18,62.84,20.2
"2011","East Hertfordshire 016A","E01023482","Total",1953,954,999,1953,0,31,33.05,59.1
"2011","East Hertfordshire 016B","E01023483","Total",1969,974,995,1969,0,59,110.56,17.8
"2011","East Hertfordshire 016C","E01023484","Total",1531,755,776,1531,0,20,53.45,28.6
"2011","East Hertfordshire 017A","E01023475","Total",1461,711,750,1461,0,24,69.43,21.0
"2011","East Hertfordshire 017B","E01023476","Total",1478,730,748,1473,5,58,275.86,5.4
"2011","East Hertfordshire 017C","E01023477","Total",2096,1075,1021,2090,6,40,49.78,42.1
"2011","East Hertfordshire 017D","E01023478","Total",1708,872,836,1708,0,24,52.45,32.6
"2011","East Hertfordshire 017E","E01023479","Total",1567,778,789,1565,2,30,219.72,7.1
"2011","East Hertfordshire 018A","E01023468","Total",1368,688,680,1368,0,36,256.24,5.3
"2011","East Hertfordshire 018B","E01023469","Total",1510,738,772,1510,0,19,178.91,8.4
"2011","East Hertfordshire 018C","E01023480","Total",1576,767,809,1576,0,28,259.78,6.1
"2011","East Hertfordshire 018D","E01023481","Total",1669,866,803,1213,456,68,1720.31,1.0
"2011","East Hertfordshire 018E","E01023504","Total",1363,648,715,1353,10,22,1046.16,1.3
"2011","East Hertfordshire 018F","E01023505","Total",1714,836,878,1657,57,18,59.82,28.7
"2011","Hertsmere 001A","E01023576","Total",1477,708,769,1404,73,25,459.46,3.2
"2011","Hertsmere 001B","E01023577","Total",1707,795,912,1707,0,27,52.20,32.7
"2011","Hertsmere 001C","E01023578","Total",1590,744,846,1569,21,45,100.13,15.9
"2011","Hertsmere 001D","E01023579","Total",1382,620,762,1382,0,18,38.97,35.5
"2011","Hertsmere 001E","E01023580","Total",1719,814,905,1663,56,30,61.76,27.8
"2011","Hertsmere 002A","E01023567","Total",2058,1008,1050,2056,2,39,302.06,6.8
"2011","Hertsmere 002B","E01023568","Total",1511,722,789,1511,0,27,32.75,46.1
"2011","Hertsmere 002C","E01023569","Total",1622,774,848,1615,7,23,57.40,28.3
"2011","Hertsmere 002D","E01023570","Total",1472,681,791,1472,0,14,95.76,15.4
"2011","Hertsmere 003A","E01023571","Total",1504,717,787,1433,71,22,39.99,37.6
"2011","Hertsmere 003B","E01023572","Total",1447,693,754,1447,0,16,37.13,39.0
"2011","Hertsmere 003C","E01023573","Total",1210,552,658,1210,0,11,19.64,61.6
"2011","Hertsmere 003D","E01023574","Total",1601,745,856,1601,0,18,71.06,22.5
"2011","Hertsmere 003E","E01023575","Total",1582,743,839,1524,58,30,141.72,11.2
"2011","Hertsmere 004A","E01023581","Total",1336,656,680,1336,0,25,36.92,36.2
"2011","Hertsmere 004B","E01023582","Total",1713,795,918,1601,112,26,303.60,5.6
"2011","Hertsmere 004C","E01023583","Total",1425,677,748,1377,48,21,1033.74,1.4
"2011","Hertsmere 004D","E01023584","Total",1032,505,527,1031,1,22,2088.23,0.5
"2011","Hertsmere 005A","E01023523","Total",1726,890,836,1712,14,80,214.92,8.0
"2011","Hertsmere 005B","E01023524","Total",1537,770,767,1537,0,66,430.01,3.6
"2011","Hertsmere 005C","E01023525","Total",1676,825,851,1676,0,53,83.37,20.1
"2011","Hertsmere 005D","E01023526","Total",1780,869,911,1779,1,67,87.59,20.3
"2011","Hertsmere 005E","E01023527","Total",1444,684,760,1444,0,25,115.76,12.5
"2011","Hertsmere 006A","E01023534","Total",1695,839,856,1695,0,19,32.04,52.9
"2011","Hertsmere 006B","E01023535","Total",1694,781,913,1629,65,28,58.00,29.2
"2011","Hertsmere 006C","E01023536","Total",1604,742,862,1594,10,15,37.64,42.6
"2011","Hertsmere 006D","E01023537","Total",1770,866,904,1769,1,26,41.52,42.6
"2011","Hertsmere 006E","E01023538","Total",1676,792,884,1667,9,8,43.18,38.8
"2011","Hertsmere 007A","E01023529","Total",1494,710,784,1494,0,27,27.48,54.4
"2011","Hertsmere 007B","E01023530","Total",1223,582,641,1223,0,5,22.28,54.9
"2011","Hertsmere 007C","E01023531","Total",1964,953,1011,1964,0,28,33.94,57.9
"2011","Hertsmere 007D","E01023532","Total",1649,824,825,1637,12,26,34.48,47.8
"2011","Hertsmere 007E","E01023533","Total",1598,762,836,1598,0,14,50.26,31.8
"2011","Hertsmere 008A","E01023552","Total",1664,804,860,1660,4,27,79.23,21.0
"2011","Hertsmere 008B","E01023553","Total",1687,826,861,1502,185,42,128.91,13.1
"2011","Hertsmere 008C","E01023554","Total",1670,798,872,1670,0,28,65.23,25.6
"2011","Hertsmere 008D","E01023555","Total",1706,855,851,1650,56,28,239.18,7.1
"2011","Hertsmere 009A","E01023544","Total",1187,580,607,1187,0,10,80.02,14.8
"2011","Hertsmere 009B","E01023545","Total",1235,614,621,1202,33,7,42.05,29.4
"2011","Hertsmere 009C","E01023546","Total",1805,883,922,1800,5,31,53.40,33.8
"2011","Hertsmere 009D","E01023547","Total",1679,841,838,1679,0,14,33.89,49.5
"2011","Hertsmere 010A","E01023528","Total",1652,840,812,1511,141,38,1263.37,1.3
"2011","Hertsmere 010B","E01023564","Total",1717,817,900,1656,61,30,192.57,8.9
"2011","Hertsmere 010C","E01023565","Total",1707,846,861,1707,0,37,208.24,8.2
"2011","Hertsmere 010D","E01023566","Total",1686,823,863,1579,107,65,157.58,10.7
"2011","Hertsmere 011A","E01023539","Total",2926,1467,1459,2806,120,18,43.73,66.9
"2011","Hertsmere 011B","E01023540","Total",1696,824,872,1675,21,22,32.20,52.7
"2011","Hertsmere 011C","E01023541","Total",1918,963,955,1918,0,26,55.71,34.4
"2011","Hertsmere 011D","E01023542","Total",1776,886,890,1776,0,27,63.26,28.1
"2011","Hertsmere 011E","E01023543","Total",1366,662,704,1366,0,10,32.99,41.4
"2011","Hertsmere 012A","E01023558","Total",1682,785,897,1632,50,31,111.32,15.1
"2011","Hertsmere 012B","E01023559","Total",1514,754,760,1478,36,46,61.38,24.7
"2011","Hertsmere 012C","E01023560","Total",1482,690,792,1482,0,16,36.44,40.7
"2011","Hertsmere 012D","E01023561","Total",1620,764,856,1620,0,28,40.65,39.9
"2011","Hertsmere 012E","E01023562","Total",1469,735,734,1469,0,37,85.01,17.3
"2011","Hertsmere 012F","E01023563","Total",1496,682,814,1459,37,26,79.86,18.7
"2011","Hertsmere 013A","E01023548","Total",1813,883,930,1762,51,29,117.21,15.5
"2011","Hertsmere 013B","E01023549","Total",1675,742,933,1614,61,19,32.17,52.1
"2011","Hertsmere 013C","E01023550","Total",1691,844,847,1691,0,103,175.13,9.7
"2011","Hertsmere 013D","E01023551","Total",1534,750,784,1510,24,55,236.19,6.5
"2011","Hertsmere 013E","E01023556","Total",1538,764,774,1538,0,31,54.60,28.2
"2011","Hertsmere 013F","E01023557","Total",1522,730,792,1522,0,38,29.49,51.6
"2011","North Hertfordshire 001A","E01023660","Total",2205,1081,1124,2167,38,19,55.77,39.5
"2011","North Hertfordshire 001B","E01023661","Total",1366,670,696,1355,11,6,32.85,41.6
"2011","North Hertfordshire 001C","E01023662","Total",1548,767,781,1548,0,16,33.77,45.8
"2011","North Hertfordshire 002A","E01023654","Total",1554,772,782,1551,3,28,130.96,11.9
"2011","North Hertfordshire 002B","E01023655","Total",1511,741,770,1511,0,35,215.35,7.0
"2011","North Hertfordshire 002C","E01023656","Total",2165,1071,1094,2148,17,30,73.88,29.3
"2011","North Hertfordshire 002D","E01023657","Total",2506,1258,1248,2506,0,26,77.58,32.3
"2011","North Hertfordshire 002E","E01023658","Total",1598,800,798,1598,0,29,191.01,8.4
"2011","North Hertfordshire 002F","E01023659","Total",1328,669,659,1328,0,29,33.15,40.1
"2011","North Hertfordshire 003A","E01023635","Total",1476,705,771,1476,0,6,203.59,7.2
"2011","North Hertfordshire 003B","E01023636","Total",1805,902,903,1805,0,26,206.01,8.8
"2011","North Hertfordshire 003C","E01023637","Total",1700,816,884,1700,0,11,30.93,55.0
"2011","North Hertfordshire 003D","E01023638","Total",1557,750,807,1557,0,20,28.53,54.6
"2011","North Hertfordshire 004A","E01023587","Total",1097,566,531,1097,0,16,18.54,59.2
"2011","North Hertfordshire 004B","E01023588","Total",1342,659,683,1342,0,30,41.76,32.1
"2011","North Hertfordshire 004C","E01023589","Total",1643,858,785,1616,27,32,33.61,48.9
"2011","North Hertfordshire 004D","E01023590","Total",1710,840,870,1666,44,15,81.67,20.9
"2011","North Hertfordshire 004E","E01023591","Total",1510,745,765,1457,53,19,34.50,43.8
"2011","North Hertfordshire 004F","E01023592","Total",1576,756,820,1510,66,15,78.88,20.0
"2011","North Hertfordshire 004G","E01023593","Total",1402,702,700,1402,0,15,32.85,42.7
"2011","North Hertfordshire 005A","E01023585","Total",1167,572,595,1167,0,37,2881.89,0.4
"2011","North Hertfordshire 005B","E01023586","Total",1529,726,803,1528,1,38,903.36,1.7
"2011","North Hertfordshire 005C","E01023597","Total",1218,592,626,1201,17,31,2256.16,0.5
"2011","North Hertfordshire 005D","E01023598","Total",1390,683,707,1381,9,24,4148.10,0.3
"2011","North Hertfordshire 005F","E01023600","Total",1390,663,727,1330,60,15,813.75,1.7
"2011","North Hertfordshire 005G","E01023663","Total",2091,1025,1066,2091,0,60,6209.83,0.3
"2011","North Hertfordshire 005H","E01033024","Total",1619,833,786,1619,0,32,36.80,44.0
"2011","North Hertfordshire 005I","E01033025","Total",1286,619,667,1286,0,6,20.53,62.6
"2011","North Hertfordshire 005J","E01033026","Total",1580,825,755,1526,54,24,488.76,3.2
"2011","North Hertfordshire 005K","E01033027","Total",1471,768,703,1471,0,11,19.64,74.9
"2011","North Hertfordshire 006A","E01023630","Total",1653,758,895,1591,62,16,53.56,30.9
"2011","North Hertfordshire 006B","E01023631","Total",1663,802,861,1663,0,16,39.47,42.1
"2011","North Hertfordshire 006C","E01023632","Total",1373,657,716,1323,50,21,84.93,16.2
"2011","North Hertfordshire 006D","E01023633","Total",1376,681,695,1376,0,10,97.65,14.1
"2011","North Hertfordshire 006E","E01023634","Total",1308,644,664,1308,0,17,71.35,18.3
"2011","North Hertfordshire 007A","E01023649","Total",1253,609,644,1253,0,19,30.07,41.7
"2011","North Hertfordshire 007B","E01023650","Total",1477,726,751,1477,0,11,64.21,23.0
"2011","North Hertfordshire 007C","E01023651","Total",1230,612,618,1230,0,16,60.38,20.4
"2011","North Hertfordshire 007D","E01023652","Total",1451,664,787,1451,0,14,27.84,52.1
"2011","North Hertfordshire 008A","E01023644","Total",1657,799,858,1615,42,43,61.47,27.0
"2011","North Hertfordshire 008B","E01023645","Total",1528,734,794,1510,18,30,44.99,34.0
"2011","North Hertfordshire 008C","E01023646","Total",1389,651,738,1389,0,20,36.29,38.3
"2011","North Hertfordshire 008D","E01023647","Total",1532,755,777,1526,6,37,49.35,31.0
"2011","North Hertfordshire 008E","E01023648","Total",1231,586,645,1143,88,43,265.08,4.6
"2011","North Hertfordshire 009A","E01023639","Total",1357,653,704,1314,43,25,333.81,4.1
"2011","North Hertfordshire 009B","E01023640","Total",1212,571,641,1212,0,6,26.97,44.9
"2011","North Hertfordshire 009C","E01023641","Total",1327,668,659,1327,0,7,116.56,11.4
"2011","North Hertfordshire 009D","E01023642","Total",1326,656,670,1326,0,49,37.55,35.3
"2011","North Hertfordshire 009E","E01023643","Total",1368,672,696,1325,43,19,40.60,33.7
"2011","North Hertfordshire 010A","E01023601","Total",2132,1105,1027,2108,24,22,30.20,70.6
"2011","North Hertfordshire 010B","E01023602","Total",1580,804,776,1580,0,18,28.99,54.5
"2011","North Hertfordshire 010C","E01023603","Total",1572,770,802,1572,0,39,47.00,33.4
"2011","North Hertfordshire 010D","E01023604","Total",1369,697,672,1369,0,22,79.98,17.1
"2011","North Hertfordshire 010E","E01023605","Total",1444,727,717,1444,0,11,191.30,7.5
"2011","North Hertfordshire 011A","E01023617","Total",1488,745,743,1488,0,30,177.52,8.4
"2011","North Hertfordshire 011B","E01023618","Total",1511,734,777,1511,0,21,42.94,35.2
"2011","North Hertfordshire 011C","E01023619","Total",1619,845,774,1619,0,25,53.43,30.3
"2011","North Hertfordshire 011D","E01023620","Total",1324,655,669,1324,0,20,36.51,36.3
"2011","North Hertfordshire 011E","E01023621","Total",1346,654,692,1346,0,16,33.85,39.8
"2011","North Hertfordshire 012A","E01023611","Total",1638,772,866,1638,0,11,34.11,48.0
"2011","North Hertfordshire 012B","E01023612","Total",1794,863,931,1768,26,34,47.60,37.7
"2011","North Hertfordshire 012C","E01023613","Total",1653,798,855,1653,0,10,54.05,30.6
"2011","North Hertfordshire 012D","E01023614","Total",1950,955,995,1950,0,81,72.29,27.0
"2011","North Hertfordshire 012E","E01023615","Total",1583,807,776,1525,58,38,369.66,4.3
"2011","North Hertfordshire 012F","E01023616","Total",2036,964,1072,1932,104,22,81.79,24.9
"2011","North Hertfordshire 013A","E01023606","Total",1640,787,853,1631,9,26,36.33,45.1
"2011","North Hertfordshire 013B","E01023607","Total",1473,705,768,1473,0,18,29.02,50.8
"2011","North Hertfordshire 013C","E01023608","Total",1509,732,777,1509,0,36,36.35,41.5
"2011","North Hertfordshire 013D","E01023609","Total",1570,775,795,1549,21,20,42.58,36.9
"2011","North Hertfordshire 013E","E01023610","Total",1370,658,712,1337,33,47,38.55,35.5
"2011","North Hertfordshire 014A","E01023594","Total",2194,1086,1108,2194,0,35,772.64,2.8
"2011","North Hertfordshire 014B","E01023622","Total",1177,546,631,1109,68,33,1008.47,1.2
"2011","North Hertfordshire 014C","E01023623","Total",1468,727,741,1425,43,34,2178.51,0.7
"2011","North Hertfordshire 014D","E01023624","Total",1331,666,665,1330,1,23,2220.24,0.6
"2011","North Hertfordshire 014E","E01023625","Total",1106,544,562,1079,27,33,2206.16,0.5
"2011","North Hertfordshire 014F","E01023653","Total",2179,1054,1125,2159,20,36,2657.52,0.8
"2011","North Hertfordshire 015A","E01023595","Total",1494,710,784,1494,0,34,440.66,3.4
"2011","North Hertfordshire 015B","E01023596","Total",1099,520,579,1099,0,15,89.73,12.2
"2011","North Hertfordshire 015C","E01023626","Total",2167,1078,1089,2167,0,72,1485.82,1.5
"2011","North Hertfordshire 015D","E01023627","Total",1754,840,914,1643,111,56,1474.10,1.2
"2011","North Hertfordshire 015E","E01023628","Total",1723,854,869,1723,0,46,103.17,16.7
"2011","North Hertfordshire 015F","E01023629","Total",1770,871,899,1770,0,25,380.30,4.7
"2011","St Albans 001A","E01023690","Total",1607,761,846,1584,23,37,151.71,10.6
"2011","St Albans 001B","E01023691","Total",1458,712,746,1458,0,57,52.34,27.9
"2011","St Albans 001C","E01023692","Total",1412,682,730,1245,167,23,38.90,36.3
"2011","St Albans 001D","E01023693","Total",1288,621,667,1288,0,44,39.42,32.7
"2011","St Albans 001E","E01023694","Total",1474,723,751,1474,0,55,47.71,30.9
"2011","St Albans 002A","E01023685","Total",1690,845,845,1690,0,40,57.58,29.4
"2011","St Albans 002B","E01023686","Total",1593,775,818,1530,63,47,38.88,41.0
"2011","St Albans 002C","E01023687","Total",1521,725,796,1521,0,16,87.82,17.3
"2011","St Albans 002D","E01023688","Total",1428,709,719,1428,0,24,29.92,47.7
"2011","St Albans 002E","E01023689","Total",1459,748,711,1320,139,39,51.72,28.2
"2011","St Albans 003A","E01023699","Total",1534,709,825,1472,62,59,39.77,38.6
"2011","St Albans 003B","E01023700","Total",1356,641,715,1322,34,88,86.12,15.7
"2011","St Albans 003C","E01023701","Total",1779,853,926,1755,24,46,125.63,14.2
"2011","St Albans 003D","E01023702","Total",1609,785,824,1609,0,27,26.37,61.0
"2011","St Albans 003E","E01023703","Total",1465,727,738,1457,8,42,32.39,45.2
"2011","St Albans 004A","E01023746","Total",1545,731,814,1545,0,29,150.20,10.3
"2011","St Albans 004B","E01023747","Total",1792,845,947,1787,5,38,76.74,23.4
"2011","St Albans 004C","E01023748","Total",1383,670,713,1383,0,56,1663.07,0.8
"2011","St Albans 004D","E01023749","Total",1690,813,877,1682,8,58,708.73,2.4
"2011","St Albans 005A","E01023695","Total",1578,795,783,1578,0,55,45.40,34.8
"2011","St Albans 005B","E01023696","Total",1736,859,877,1736,0,101,254.24,6.8
"2011","St Albans 005C","E01023697","Total",1855,902,953,1855,0,43,40.49,45.8
"2011","St Albans 005D","E01023698","Total",1606,812,794,1606,0,53,31.62,50.8
"2011","St Albans 006A","E01023722","Total",1429,716,713,1414,15,40,3501.67,0.4
"2011","St Albans 006B","E01023723","Total",1692,826,866,1692,0,18,65.10,26.0
"2011","St Albans 006C","E01023724","Total",1588,742,846,1538,50,22,50.14,31.7
"2011","St Albans 006D","E01023725","Total",1517,743,774,1512,5,54,1334.00,1.1
"2011","St Albans 007A","E01023713","Total",1872,917,955,1872,0,33,121.08,15.5
"2011","St Albans 007B","E01023734","Total",1648,801,847,1648,0,45,107.27,15.4
"2011","St Albans 007C","E01023735","Total",1746,859,887,1746,0,32,58.26,30.0
"2011","St Albans 007D","E01023736","Total",1560,733,827,1492,68,23,1158.01,1.3
"2011","St Albans 008A","E01023709","Total",1658,788,870,1658,0,40,29.94,55.4
"2011","St Albans 008B","E01023710","Total",1564,769,795,1564,0,39,43.73,35.8
"2011","St Albans 008C","E01023711","Total",1588,775,813,1588,0,46,39.53,40.2
"2011","St Albans 008D","E01023712","Total",1687,838,849,1687,0,30,82.04,20.6
"2011","St Albans 009A","E01023669","Total",1681,760,921,1681,0,14,84.10,20.0
"2011","St Albans 009B","E01023670","Total",2172,1002,1170,2046,126,37,38.49,56.4
"2011","St Albans 009C","E01023671","Total",1892,886,1006,1887,5,30,42.51,44.5
"2011","St Albans 009D","E01023672","Total",1958,954,1004,1909,49,36,49.76,39.3
"2011","St Albans 010A","E01023673","Total",1441,728,713,1441,0,56,32.37,44.5
"2011","St Albans 010B","E01023714","Total",1822,884,938,1822,0,78,69.93,26.1
"2011","St Albans 010C","E01023715","Total",1604,768,836,1585,19,46,43.10,37.2
"2011","St Albans 010D","E01023716","Total",2040,1004,1036,2039,1,64,42.17,48.4
"2011","St Albans 011A","E01023666","Total",1714,881,833,1714,0,9,22.01,77.9
"2011","St Albans 011B","E01023674","Total",1862,911,951,1862,0,23,34.33,54.2
"2011","St Albans 011C","E01023675","Total",1409,697,712,1394,15,48,40.89,34.5
"2011","St Albans 011D","E01023676","Total",2173,1077,1096,2156,17,37,52.29,41.6
"2011","St Albans 012A","E01023726","Total",1671,860,811,1671,0,4,18.45,90.6
"2011","St Albans 012B","E01023727","Total",1916,992,924,1859,57,18,44.31,43.2
"2011","St Albans 012C","E01023728","Total",2203,1102,1101,2153,50,51,34.53,63.8
"2011","St Albans 012D","E01023729","Total",1812,931,881,1806,6,28,31.11,58.2
"2011","St Albans 013A","E01023664","Total",1751,878,873,1751,0,32,29.17,60.0
"2011","St Albans 013B","E01023665","Total",1590,796,794,1571,19,28,31.48,50.5
"2011","St Albans 013C","E01023667","Total",1431,703,728,1431,0,14,18.75,76.3
"2011","St Albans 013D","E01023668","Total",1406,736,670,1406,0,36,26.23,53.6
"2011","St Albans 014A","E01023742","Total",1484,731,753,1425,59,26,40.22,36.9
"2011","St Albans 014B","E01023743","Total",1723,866,857,1723,0,49,121.72,14.2
"2011","St Albans 014C","E01023744","Total",1470,724,746,1470,0,40,134.20,11.0
"2011","St Albans 014D","E01023745","Total",1727,856,871,1721,6,31,65.92,26.2
"2011","St Albans 015A","E01023677","Total",1240,649,591,1213,27,23,45.58,27.2
"2011","St Albans 015B","E01023678","Total",1899,959,940,1869,30,27,346.99,5.5
"2011","St Albans 015C","E01023679","Total",1478,736,742,1478,0,24,294.81,5.0
"2011","St Albans 015D","E01023680","Total",1345,670,675,1313,32,22,431.47,3.1
"2011","St Albans 016A","E01023681","Total",1601,833,768,1601,0,11,27.15,59.0
"2011","St Albans 016B","E01023682","Total",1730,845,885,1693,37,41,50.17,34.5
"2011","St Albans 016C","E01023683","Total",1660,798,862,1660,0,27,44.54,37.3
"2011","St Albans 016D","E01023684","Total",1623,798,825,1615,8,32,114.30,14.2
"2011","St Albans 017A","E01023737","Total",1338,634,704,1338,0,15,37.59,35.6
"2011","St Albans 017B","E01023738","Total",1586,818,768,1586,0,11,108.44,14.6
"2011","St Albans 017C","E01023739","Total",1506,711,795,1407,99,15,43.30,34.8
"2011","St Albans 017D","E01023740","Total",1338,676,662,1338,0,14,23.00,58.2
"2011","St Albans 017E","E01023741","Total",1589,758,831,1583,6,23,92.89,17.1
"2011","St Albans 018A","E01023704","Total",1612,792,820,1584,28,21,113.78,14.2
"2011","St Albans 018B","E01023705","Total",1704,835,869,1699,5,8,53.77,31.7
"2011","St Albans 018C","E01023706","Total",1590,763,827,1576,14,25,42.26,37.6
"2011","St Albans 018E","E01023708","Total",1512,737,775,1502,10,11,96.34,15.7
"2011","St Albans 018F","E01033028","Total",1490,727,763,1480,10,20,27.19,54.8
"2011","St Albans 018G","E01033029","Total",1599,807,792,1599,0,22,179.64,8.9
"2011","St Albans 019A","E01023718","Total",1746,874,872,1746,0,35,240.52,7.3
"2011","St Albans 019B","E01023719","Total",1126,543,583,1119,7,4,37.12,30.3
"2011","St Albans 019C","E01023720","Total",1852,951,901,1763,89,13,552.23,3.4
"2011","St Albans 019D","E01023721","Total",1406,690,716,1406,0,24,107.67,13.1
"2011","St Albans 020A","E01023717","Total",1232,605,627,1227,5,14,253.28,4.9
"2011","St Albans 020B","E01023730","Total",1747,858,889,1740,7,37,55.16,31.7
"2011","St Albans 020C","E01023731","Total",1479,729,750,1469,10,34,88.95,16.6
"2011","St Albans 020D","E01023732","Total",1674,796,878,1599,75,32,724.49,2.3
"2011","St Albans 020E","E01023733","Total",1603,771,832,1596,7,46,269.42,5.9
"2011","Stevenage 001A","E01023787","Total",1425,751,674,1425,0,20,22.45,63.5
"2011","Stevenage 001B","E01023788","Total",1597,787,810,1582,15,22,17.45,91.5
"2011","Stevenage 001C","E01023789","Total",1986,980,1006,1986,0,21,57.92,34.3
"2011","Stevenage 001D","E01023790","Total",1738,861,877,1732,6,15,19.49,89.2
"2011","Stevenage 002A","E01023776","Total",2511,1308,1203,2495,16,40,63.16,39.8
"2011","Stevenage 002B","E01023777","Total",1805,905,900,1791,14,22,65.18,27.7
"2011","Stevenage 002C","E01023778","Total",1694,775,919,1694,0,13,30.69,55.2
"2011","Stevenage 002D","E01023799","Total",1378,660,718,1378,0,37,116.14,11.9
"2011","Stevenage 002E","E01023800","Total",1989,959,1030,1839,150,31,169.39,11.7
"2011","Stevenage 002F","E01023801","Total",2417,1168,1249,2417,0,24,50.86,47.5
"2011","Stevenage 003A","E01023771","Total",1601,803,798,1601,0,15,28.11,57.0
"2011","Stevenage 003B","E01023772","Total",1718,879,839,1681,37,10,27.76,61.9
"2011","Stevenage 003C","E01023773","Total",1371,655,716,1371,0,16,21.19,64.7
"2011","Stevenage 003D","E01023774","Total",1639,845,794,1585,54,18,25.69,63.8
"2011","Stevenage 004A","E01023767","Total",1454,742,712,1454,0,24,40.83,35.6
"2011","Stevenage 004B","E01023768","Total",1665,840,825,1665,0,29,23.85,69.8
"2011","Stevenage 004C","E01023769","Total",1695,823,872,1659,36,16,29.96,56.6
"2011","Stevenage 004D","E01023770","Total",1512,782,730,1512,0,15,33.11,45.7
"2011","Stevenage 005A","E01023795","Total",1520,739,781,1520,0,22,54.78,27.7
"2011","Stevenage 005B","E01023796","Total",1474,744,730,1459,15,9,24.45,60.3
"2011","Stevenage 005C","E01023797","Total",1317,646,671,1317,0,17,31.11,42.3
"2011","Stevenage 005D","E01023798","Total",1484,741,743,1484,0,21,208.63,7.1
"2011","Stevenage 006A","E01023775","Total",1912,970,942,1880,32,16,46.48,41.1
"2011","Stevenage 006B","E01023779","Total",1605,778,827,1605,0,9,35.10,45.7
"2011","Stevenage 006C","E01023780","Total",1411,713,698,1411,0,14,26.18,53.9
"2011","Stevenage 006D","E01023781","Total",1681,842,839,1681,0,5,51.21,32.8
"2011","Stevenage 006E","E01023782","Total",1391,720,671,1391,0,20,20.96,66.4
"2011","Stevenage 007A","E01023759","Total",1510,704,806,1510,0,14,22.35,67.6
"2011","Stevenage 007B","E01023760","Total",1543,778,765,1543,0,16,25.62,60.2
"2011","Stevenage 007C","E01023761","Total",2168,1055,1113,2163,5,17,48.32,44.9
"2011","Stevenage 007D","E01023762","Total",1558,783,775,1558,0,15,43.53,35.8
"2011","Stevenage 008A","E01023755","Total",1610,767,843,1610,0,8,63.09,25.5
"2011","Stevenage 008B","E01023756","Total",1668,822,846,1662,6,10,68.55,24.3
"2011","Stevenage 008C","E01023757","Total",1889,892,997,1889,0,9,30.17,62.6
"2011","Stevenage 008D","E01023758","Total",1848,969,879,1848,0,2,97.33,19.0
"2011","Stevenage 009A","E01023750","Total",1284,599,685,1190,94,12,31.55,40.7
"2011","Stevenage 009B","E01023751","Total",1202,595,607,1202,0,3,18.49,65.0
"2011","Stevenage 009C","E01023752","Total",1329,664,665,1329,0,18,29.21,45.5
"2011","Stevenage 009D","E01023753","Total",1475,736,739,1475,0,24,35.48,41.6
"2011","Stevenage 009E","E01023754","Total",1368,665,703,1368,0,12,20.59,66.4
"2011","Stevenage 010A","E01023791","Total",1564,765,799,1564,0,27,82.91,18.9
"2011","Stevenage 010B","E01023792","Total",1638,798,840,1638,0,11,28.53,57.4
"2011","Stevenage 010C","E01023793","Total",1441,700,741,1441,0,11,22.52,64.0
"2011","Stevenage 010D","E01023794","Total",1567,754,813,1567,0,15,35.64,44.0
"2011","Stevenage 011A","E01023783","Total",1665,851,814,1625,40,7,28.30,58.8
"2011","Stevenage 011B","E01023784","Total",1629,777,852,1619,10,34,52.57,31.0
"2011","Stevenage 011C","E01023785","Total",1574,780,794,1574,0,5,29.01,54.3
"2011","Stevenage 011D","E01023786","Total",1527,727,800,1526,1,12,217.24,7.0
"2011","Stevenage 012A","E01023763","Total",1483,744,739,1483,0,19,143.69,10.3
"2011","Stevenage 012B","E01023764","Total",1425,708,717,1411,14,16,25.84,55.1
"2011","Stevenage 012C","E01023765","Total",1472,716,756,1465,7,23,29.02,50.7
"2011","Stevenage 012D","E01023766","Total",1530,718,812,1530,0,10,24.72,61.9
"2011","Three Rivers 001A","E01023802","Total",1723,857,866,1723,0,25,30.39,56.7
"2011","Three Rivers 001B","E01023803","Total",1536,758,778,1526,10,47,83.65,18.4
"2011","Three Rivers 001C","E01023804","Total",1519,736,783,1475,44,17,125.89,12.1
"2011","Three Rivers 001D","E01023807","Total",1510,768,742,1510,0,20,486.47,3.1
"2011","Three Rivers 001E","E01023808","Total",2527,1292,1235,2527,0,25,267.66,9.4
"2011","Three Rivers 002A","E01023829","Total",1708,813,895,1708,0,17,37.51,45.5
"2011","Three Rivers 002B","E01023830","Total",1412,693,719,1411,1,18,51.86,27.2
"2011","Three Rivers 002C","E01023832","Total",1689,827,862,1682,7,18,156.65,10.8
"2011","Three Rivers 002D","E01023833","Total",2362,1163,1199,2318,44,24,136.24,17.3
"2011","Three Rivers 002E","E01023834","Total",1561,759,802,1561,0,17,66.99,23.3
"2011","Three Rivers 003A","E01023823","Total",1385,619,766,1355,30,39,53.47,25.9
"2011","Three Rivers 003B","E01023824","Total",1936,921,1015,1936,0,45,53.82,36.0
"2011","Three Rivers 003C","E01023831","Total",2027,977,1050,2009,18,39,410.38,4.9
"2011","Three Rivers 003D","E01023854","Total",1849,894,955,1849,0,57,2055.56,0.9
"2011","Three Rivers 004A","E01023812","Total",1459,722,737,1459,0,62,107.72,13.5
"2011","Three Rivers 004B","E01023813","Total",1551,729,822,1474,77,56,248.59,6.2
"2011","Three Rivers 004C","E01023814","Total",1162,525,637,1092,70,32,96.48,12.0
"2011","Three Rivers 004D","E01023851","Total",1636,726,910,1508,128,63,197.41,8.3
"2011","Three Rivers 005A","E01023815","Total",1544,767,777,1537,7,62,95.66,16.1
"2011","Three Rivers 005B","E01023816","Total",1293,635,658,1293,0,28,112.37,11.5
"2011","Three Rivers 005C","E01023817","Total",1355,651,704,1355,0,33,171.28,7.9
"2011","Three Rivers 005D","E01023818","Total",1375,665,710,1375,0,60,86.86,15.8
"2011","Three Rivers 006A","E01023819","Total",1580,749,831,1580,0,28,30.30,52.1
"2011","Three Rivers 006B","E01023820","Total",1282,619,663,1282,0,32,114.42,11.2
"2011","Three Rivers 006C","E01023821","Total",1292,629,663,1292,0,35,22.99,56.2
"2011","Three Rivers 006D","E01023822","Total",1361,667,694,1361,0,27,25.01,54.4
"2011","Three Rivers 006E","E01023825","Total",2265,1140,1125,2265,0,38,117.08,19.3
"2011","Three Rivers 006F","E01023826","Total",1461,727,734,1461,0,51,83.76,17.4
"2011","Three Rivers 007A","E01023847","Total",1890,908,982,1878,12,23,32.27,58.6
"2011","Three Rivers 007B","E01023848","Total",1659,831,828,1659,0,9,43.28,38.3
"2011","Three Rivers 007C","E01023850","Total",1412,714,698,1363,49,11,49.78,28.4
"2011","Three Rivers 007D","E01023852","Total",1493,699,794,1410,83,40,35.80,41.7
"2011","Three Rivers 007E","E01023853","Total",2067,1028,1039,2059,8,69,77.70,26.6
"2011","Three Rivers 008A","E01023827","Total",2186,1058,1128,2186,0,17,84.05,26.0
"2011","Three Rivers 008B","E01023828","Total",1507,737,770,1507,0,16,35.91,42.0
"2011","Three Rivers 008C","E01023845","Total",1824,885,939,1790,34,30,165.59,11.0
"2011","Three Rivers 008D","E01023846","Total",1512,749,763,1508,4,47,54.59,27.7
"2011","Three Rivers 009A","E01023835","Total",1407,678,729,1387,20,20,310.94,4.5
"2011","Three Rivers 009B","E01023836","Total",1394,653,741,1394,0,10,20.31,68.6
"2011","Three Rivers 009C","E01023837","Total",1550,745,805,1550,0,23,478.30,3.2
"2011","Three Rivers 009D","E01023838","Total",1251,601,650,1251,0,15,282.78,4.4
"2011","Three Rivers 010A","E01023805","Total",1671,813,858,1665,6,16,38.78,43.1
"2011","Three Rivers 010B","E01023809","Total",1651,776,875,1651,0,15,55.52,29.7
"2011","Three Rivers 010C","E01023810","Total",1736,825,911,1736,0,37,113.48,15.3
"2011","Three Rivers 010D","E01023811","Total",1474,703,771,1452,22,29,65.82,22.4
"2011","Three Rivers 011A","E01023839","Total",2249,1090,1159,2249,0,91,112.97,19.9
"2011","Three Rivers 011B","E01023840","Total",1671,828,843,1416,255,95,104.70,16.0
"2011","Three Rivers 011C","E01023841","Total",1612,831,781,1612,0,65,347.19,4.6
"2011","Three Rivers 011D","E01023849","Total",1435,710,725,1435,0,41,643.22,2.2
"2011","Three Rivers 012A","E01023806","Total",2190,1061,1129,2190,0,17,89.46,24.5
"2011","Three Rivers 012B","E01023842","Total",1576,729,847,1521,55,14,30.36,51.9
"2011","Three Rivers 012C","E01023843","Total",1929,909,1020,1921,8,18,25.90,74.5
"2011","Three Rivers 012D","E01023844","Total",1611,782,829,1610,1,10,56.17,28.7
"2011","Watford 001A","E01023904","Total",1993,943,1050,1985,8,30,31.24,63.8
"2011","Watford 001B","E01023905","Total",1882,899,983,1882,0,15,65.65,28.7
"2011","Watford 001C","E01023906","Total",1485,737,748,1485,0,17,22.61,65.7
"2011","Watford 001D","E01023907","Total",1723,862,861,1689,34,18,47.93,35.9
"2011","Watford 002A","E01023890","Total",1279,633,646,1246,33,22,47.09,27.2
"2011","Watford 002B","E01023891","Total",1440,719,721,1440,0,12,20.14,71.5
"2011","Watford 002C","E01023892","Total",1312,604,708,1312,0,13,20.33,64.5
"2011","Watford 002D","E01023893","Total",1710,812,898,1704,6,19,31.99,53.5
"2011","Watford 002E","E01023894","Total",1454,705,749,1454,0,27,19.34,75.2
"2011","Watford 003A","E01023873","Total",1287,609,678,1286,1,10,21.50,59.9
"2011","Watford 003B","E01023874","Total",1320,643,677,1306,14,12,70.59,18.7
"2011","Watford 003C","E01023875","Total",1840,901,939,1840,0,25,38.09,48.3
"2011","Watford 003D","E01023876","Total",1738,797,941,1738,0,11,24.69,70.4
"2011","Watford 003E","E01023877","Total",1647,773,874,1647,0,15,44.56,37.0
"2011","Watford 004A","E01023868","Total",1728,851,877,1728,0,24,29.84,57.9
"2011","Watford 004B","E01023869","Total",1377,710,667,1367,10,20,20.24,68.0
"2011","Watford 004C","E01023870","Total",1483,723,760,1483,0,10,32.26,46.0
"2011","Watford 004D","E01023871","Total",1190,576,614,1133,57,9,29.49,40.4
"2011","Watford 004E","E01023872","Total",1706,854,852,1706,0,16,23.66,72.1
"2011","Watford 005A","E01023895","Total",1604,819,785,1604,0,16,61.54,26.1
"2011","Watford 005B","E01023896","Total",1341,652,689,1341,0,29,41.36,32.4
"2011","Watford 005C","E01023897","Total",1586,806,780,1586,0,23,51.54,30.8
"2011","Watford 005D","E01023898","Total",1569,798,771,1569,0,23,21.23,73.9
"2011","Watford 006A","E01023855","Total",1813,931,882,1813,0,14,25.71,70.5
"2011","Watford 006B","E01023856","Total",2279,1138,1141,2279,0,17,18.85,120.9
"2011","Watford 006C","E01023857","Total",1656,840,816,1656,0,8,19.80,83.6
"2011","Watford 006D","E01023858","Total",1696,867,829,1696,0,11,19.37,87.6
"2011","Watford 007A","E01023878","Total",1944,967,977,1944,0,65,63.54,30.6
"2011","Watford 007B","E01023879","Total",2218,1085,1133,2116,102,26,40.55,54.7
"2011","Watford 007C","E01023880","Total",1831,899,932,1748,83,31,26.22,69.8
"2011","Watford 007D","E01023881","Total",1613,784,829,1550,63,27,48.70,33.1
"2011","Watford 008A","E01023886","Total",2709,1378,1331,2709,0,44,84.83,31.9
"2011","Watford 008B","E01023887","Total",1698,855,843,1698,0,47,230.03,7.4
"2011","Watford 008C","E01023888","Total",1597,795,802,1580,17,51,65.33,24.4
"2011","Watford 008D","E01023889","Total",1774,867,907,1774,0,71,50.68,35.0
"2011","Watford 009A","E01023859","Total",2112,1102,1010,2072,40,5,26.98,78.3
"2011","Watford 009B","E01023860","Total",1835,967,868,1827,8,14,61.90,29.6
"2011","Watford 009C","E01023861","Total",2231,1215,1016,2191,40,24,43.94,50.8
"2011","Watford 009D","E01023862","Total",1965,975,990,1963,2,7,59.37,33.1
"2011","Watford 010A","E01023899","Total",1548,796,752,1501,47,17,15.29,101.2
"2011","Watford 010B","E01023900","Total",1728,915,813,1728,0,23,11.00,157.1
"2011","Watford 010C","E01023901","Total",1909,966,943,1909,0,20,19.76,96.6
"2011","Watford 010D","E01023902","Total",1510,736,774,1510,0,25,39.23,38.5
"2011","Watford 010E","E01023903","Total",1563,816,747,1554,9,18,9.61,162.6
"2011","Watford 011A","E01023863","Total",1727,892,835,1720,7,20,18.00,95.9
"2011","Watford 011B","E01023864","Total",1556,734,822,1455,101,5,37.85,41.1
"2011","Watford 011C","E01023865","Total",1661,776,885,1661,0,15,36.34,45.7
"2011","Watford 011D","E01023866","Total",1553,703,850,1553,0,17,71.32,21.8
"2011","Watford 011E","E01023867","Total",2129,1089,1040,2105,24,21,28.86,73.8
"2011","Watford 012A","E01023882","Total",1564,757,807,1556,8,54,34.06,45.9
"2011","Watford 012B","E01023883","Total",1660,801,859,1656,4,19,42.80,38.8
"2011","Watford 012C","E01023884","Total",1709,853,856,1709,0,26,33.18,51.5
"2011","Watford 012D","E01023885","Total",1819,903,916,1801,18,50,42.47,42.8
"2011","Welwyn Hatfield 001A","E01023965","Total",1416,705,711,1416,0,44,183.60,7.7
"2011","Welwyn Hatfield 001B","E01023966","Total",1588,778,810,1573,15,28,118.68,13.4
"2011","Welwyn Hatfield 001C","E01023967","Total",1362,661,701,1314,48,17,241.91,5.6
"2011","Welwyn Hatfield 001D","E01023971","Total",1629,798,831,1629,0,60,346.76,4.7
"2011","Welwyn Hatfield 002B","E01023968","Total",1277,629,648,1265,12,36,345.12,3.7
"2011","Welwyn Hatfield 002C","E01023969","Total",1370,671,699,1363,7,31,815.38,1.7
"2011","Welwyn Hatfield 002D","E01023970","Total",1390,674,716,1379,11,18,97.30,14.3
"2011","Welwyn Hatfield 002E","E01033310","Total",1665,839,826,1665,0,26,24.05,69.2
"2011","Welwyn Hatfield 002F","E01033313","Total",1487,740,747,1469,18,27,1266.90,1.2
"2011","Welwyn Hatfield 003A","E01023959","Total",1432,681,751,1432,0,41,129.07,11.1
"2011","Welwyn Hatfield 003B","E01023960","Total",1572,761,811,1566,6,11,51.15,30.7
"2011","Welwyn Hatfield 003C","E01023961","Total",1427,653,774,1427,0,18,30.48,46.8
"2011","Welwyn Hatfield 003D","E01023962","Total",1492,702,790,1492,0,15,98.02,15.2
"2011","Welwyn Hatfield 004A","E01023912","Total",1441,689,752,1441,0,14,103.11,14.0
"2011","Welwyn Hatfield 004B","E01023913","Total",1348,665,683,1348,0,12,68.10,19.8
"2011","Welwyn Hatfield 004C","E01023914","Total",1654,792,862,1654,0,17,35.41,46.7
"2011","Welwyn Hatfield 004D","E01023915","Total",1521,742,779,1521,0,19,61.25,24.8
"2011","Welwyn Hatfield 005A","E01023950","Total",1585,803,782,1580,5,43,89.24,17.8
"2011","Welwyn Hatfield 005B","E01023951","Total",1577,808,769,1577,0,12,42.72,36.9
"2011","Welwyn Hatfield 005C","E01023952","Total",1724,843,881,1676,48,13,35.55,48.5
"2011","Welwyn Hatfield 005D","E01023953","Total",1428,722,706,1428,0,27,34.38,41.5
"2011","Welwyn Hatfield 006A","E01023916","Total",1704,810,894,1704,0,28,115.62,14.7
"2011","Welwyn Hatfield 006B","E01023917","Total",1720,819,901,1720,0,29,54.66,31.5
"2011","Welwyn Hatfield 006C","E01023918","Total",1728,767,961,1728,0,27,63.47,27.2
"2011","Welwyn Hatfield 006D","E01023919","Total",1654,786,868,1593,61,54,125.51,13.2
"2011","Welwyn Hatfield 007A","E01023954","Total",1770,866,904,1670,100,6,92.24,19.2
"2011","Welwyn Hatfield 007B","E01023955","Total",1382,651,731,1382,0,10,22.29,62.0
"2011","Welwyn Hatfield 007C","E01023956","Total",1355,641,714,1355,0,7,16.61,81.6
"2011","Welwyn Hatfield 007D","E01023957","Total",1485,705,780,1485,0,10,22.84,65.0
"2011","Welwyn Hatfield 007E","E01023958","Total",1439,675,764,1439,0,6,29.84,48.2
"2011","Welwyn Hatfield 008A","E01023943","Total",1527,730,797,1521,6,19,30.64,49.8
"2011","Welwyn Hatfield 008B","E01023944","Total",2068,1020,1048,2068,0,16,49.16,42.1
"2011","Welwyn Hatfield 008C","E01023945","Total",1594,780,814,1594,0,21,91.56,17.4
"2011","Welwyn Hatfield 008D","E01023946","Total",1551,751,800,1551,0,36,45.70,33.9
"2011","Welwyn Hatfield 009A","E01023939","Total",1224,598,626,1179,45,14,35.82,34.2
"2011","Welwyn Hatfield 009B","E01023940","Total",1741,855,886,1741,0,14,63.34,27.5
"2011","Welwyn Hatfield 009C","E01023941","Total",2794,1389,1405,2794,0,26,62.98,44.4
"2011","Welwyn Hatfield 009D","E01023942","Total",1682,777,905,1670,12,13,30.38,55.4
"2011","Welwyn Hatfield 010A","E01023929","Total",1613,795,818,1613,0,9,32.57,49.5
"2011","Welwyn Hatfield 010B","E01023930","Total",1628,840,788,1628,0,9,24.50,66.4
"2011","Welwyn Hatfield 010D","E01023938","Total",2854,1482,1372,1534,1320,40,124.99,22.8
"2011","Welwyn Hatfield 010E","E01033308","Total",2892,1415,1477,1483,1409,38,68.63,42.1
"2011","Welwyn Hatfield 010F","E01033311","Total",1523,769,754,1523,0,12,128.05,11.9
"2011","Welwyn Hatfield 010G","E01033314","Total",2102,1024,1078,2102,0,21,124.00,17.0
"2011","Welwyn Hatfield 011A","E01023924","Total",1661,910,751,1597,64,16,43.67,38.0
"2011","Welwyn Hatfield 011B","E01023925","Total",1246,588,658,1215,31,25,1923.38,0.6
"2011","Welwyn Hatfield 011C","E01023926","Total",1739,895,844,1739,0,21,176.44,9.9
"2011","Welwyn Hatfield 011D","E01023927","Total",1725,847,878,1725,0,10,29.58,58.3
"2011","Welwyn Hatfield 012A","E01023920","Total",1637,844,793,1559,78,10,26.87,60.9
"2011","Welwyn Hatfield 012B","E01023921","Total",2072,1050,1022,2070,2,13,39.67,52.2
"2011","Welwyn Hatfield 012C","E01023922","Total",1768,886,882,1768,0,16,26.47,66.8
"2011","Welwyn Hatfield 012D","E01023923","Total",1847,939,908,1847,0,27,48.07,38.4
"2011","Welwyn Hatfield 013A","E01023932","Total",1708,923,785,1708,0,25,32.57,52.4
"2011","Welwyn Hatfield 013B","E01023934","Total",1469,784,685,1469,0,24,19.62,74.9
"2011","Welwyn Hatfield 013C","E01023935","Total",1334,703,631,1334,0,10,32.87,40.6
"2011","Welwyn Hatfield 013D","E01023936","Total",2274,1156,1118,2173,101,26,35.48,64.1
"2011","Welwyn Hatfield 013E","E01023937","Total",1334,713,621,1333,1,13,53.31,25.0
"2011","Welwyn Hatfield 014A","E01023933","Total",1510,747,763,1510,0,7,24.29,62.2
"2011","Welwyn Hatfield 014B","E01023963","Total",2236,1085,1151,2236,0,23,157.21,14.2
"2011","Welwyn Hatfield 014C","E01023964","Total",1505,711,794,1411,94,35,949.44,1.6
"2011","Welwyn Hatfield 015A","E01023908","Total",1542,767,775,1542,0,43,184.88,8.3
"2011","Welwyn Hatfield 015B","E01023909","Total",1389,578,811,1179,210,55,275.57,5.0
"2011","Welwyn Hatfield 015C","E01023910","Total",1371,665,706,1371,0,44,1428.72,1.0
"2011","Welwyn Hatfield 015D","E01023911","Total",1572,705,867,1572,0,33,231.09,6.8
"2011","Welwyn Hatfield 016A","E01023947","Total",1607,816,791,1606,1,35,1231.51,1.3
"2011","Welwyn Hatfield 016B","E01023948","Total",1610,776,834,1610,0,45,63.15,25.5
"2011","Welwyn Hatfield 016C","E01023949","Total",1964,975,989,1964,0,59,247.98,7.9
"2011","Breckland 001A","E01026436","Total",2261,1093,1168,2235,26,39,3317.68,0.7
"2011","Breckland 001C","E01026461","Total",1336,654,682,1281,55,23,1554.98,0.9
"2011","Breckland 001E","E01026483","Total",1142,569,573,1113,29,19,3169.61,0.4
"2011","Breckland 001F","E01033042","Total",2372,1315,1057,2095,277,38,2709.70,0.9
"2011","Breckland 002A","E01026442","Total",2163,1071,1092,2128,35,31,5786.09,0.4
"2011","Breckland 002B","E01026443","Total",2112,1061,1051,2095,17,44,5824.21,0.4
"2011","Breckland 002C","E01026445","Total",2220,1084,1136,2220,0,27,5547.96,0.4
"2011","Breckland 002D","E01026462","Total",2240,1089,1151,2200,40,26,2758.41,0.8
"2011","Breckland 003A","E01026428","Total",2758,1326,1432,2711,47,36,373.98,7.4
"2011","Breckland 003B","E01026429","Total",1495,721,774,1495,0,12,30.41,49.2
"2011","Breckland 003C","E01026430","Total",1793,851,942,1678,115,21,1052.27,1.7
"2011","Breckland 003D","E01026431","Total",1138,534,604,1087,51,11,87.89,12.9
"2011","Breckland 004A","E01026446","Total",1923,956,967,1911,12,18,1548.47,1.2
"2011","Breckland 004B","E01026452","Total",1672,816,856,1648,24,23,1159.78,1.4
"2011","Breckland 004C","E01026453","Total",1586,805,781,1531,55,30,3536.43,0.4
"2011","Breckland 004D","E01026454","Total",1668,822,846,1668,0,20,49.58,33.6
"2011","Breckland 005A","E01026425","Total",1945,938,1007,1916,29,12,68.15,28.5
"2011","Breckland 005B","E01026426","Total",2372,1194,1178,2356,16,22,107.90,22.0
"2011","Breckland 005C","E01026427","Total",2198,1026,1172,2173,25,27,235.13,9.3
"2011","Breckland 005D","E01026432","Total",1470,717,753,1464,6,16,48.10,30.6
"2011","Breckland 005E","E01026433","Total",1470,712,758,1470,0,11,56.65,25.9
"2011","Breckland 005F","E01026434","Total",1970,954,1016,1970,0,10,90.72,21.7
"2011","Breckland 006A","E01026479","Total",1489,707,782,1489,0,24,1891.33,0.8
"2011","Breckland 006B","E01026480","Total",1463,706,757,1451,12,25,239.13,6.1
"2011","Breckland 006C","E01026481","Total",1228,613,615,1188,40,12,1657.18,0.7
"2011","Breckland 006D","E01026484","Total",1371,674,697,1370,1,27,2514.76,0.5
"2011","Breckland 006E","E01026485","Total",1089,549,540,1089,0,22,3398.71,0.3
"2011","Breckland 007A","E01026455","Total",1901,847,1054,1786,115,8,2313.76,0.8
"2011","Breckland 007B","E01026456","Total",1169,546,623,1090,79,17,408.33,2.9
"2011","Breckland 007C","E01026457","Total",1272,591,681,1237,35,5,84.48,15.1
"2011","Breckland 007D","E01026458","Total",1498,704,794,1498,0,9,41.23,36.3
"2011","Breckland 007E","E01026459","Total",1418,671,747,1390,28,14,109.33,13.0
"2011","Breckland 008A","E01026437","Total",1180,571,609,1178,2,18,851.18,1.4
"2011","Breckland 008B","E01026438","Total",1027,502,525,1027,0,15,2454.39,0.4
"2011","Breckland 008C","E01026451","Total",2057,973,1084,2027,30,25,1868.76,1.1
"2011","Breckland 008D","E01026495","Total",1287,615,672,1287,0,6,1310.31,1.0
"2011","Breckland 008E","E01026496","Total",1090,531,559,1068,22,12,2000.12,0.5
"2011","Breckland 009A","E01026486","Total",1532,741,791,1520,12,9,194.34,7.9
"2011","Breckland 009B","E01026487","Total",1589,800,789,1573,16,18,139.69,11.4
"2011","Breckland 009C","E01026488","Total",1169,574,595,1068,101,9,39.29,29.8
"2011","Breckland 009D","E01026489","Total",1344,660,684,1340,4,8,108.70,12.4
"2011","Breckland 009E","E01026490","Total",1568,732,836,1568,0,6,237.97,6.6
"2011","Breckland 010A","E01026419","Total",1218,613,605,1211,7,19,2622.52,0.5
"2011","Breckland 010B","E01026420","Total",1132,582,550,1132,0,11,1114.42,1.0
"2011","Breckland 010D","E01026464","Total",1266,627,639,1266,0,19,2454.80,0.5
"2011","Breckland 010E","E01026491","Total",2148,1048,1100,2148,0,26,8554.16,0.3
"2011","Breckland 010F","E01033040","Total",1985,1415,570,1116,869,9,205.78,9.6
"2011","Breckland 010G","E01033041","Total",1061,543,518,1021,40,5,449.62,2.4
"2011","Breckland 011A","E01026422","Total",1946,958,988,1946,0,18,646.73,3.0
"2011","Breckland 011B","E01026423","Total",1814,878,936,1784,30,9,428.68,4.2
"2011","Breckland 011C","E01026447","Total",1511,728,783,1511,0,14,81.27,18.6
"2011","Breckland 011D","E01026449","Total",1959,968,991,1888,71,27,932.80,2.1
"2011","Breckland 011E","E01026450","Total",1779,871,908,1731,48,11,48.16,36.9
"2011","Breckland 012A","E01026424","Total",2078,1026,1052,2050,28,29,9761.95,0.2
"2011","Breckland 012B","E01026444","Total",2013,988,1025,2013,0,27,10688.71,0.2
"2011","Breckland 012C","E01026492","Total",1291,639,652,1291,0,11,536.33,2.4
"2011","Breckland 012D","E01026493","Total",1172,619,553,1108,64,7,6347.72,0.2
"2011","Breckland 013A","E01026421","Total",1730,841,889,1704,26,45,2179.43,0.8
"2011","Breckland 013B","E01026435","Total",2242,1127,1115,2160,82,49,4760.94,0.5
"2011","Breckland 013C","E01026448","Total",2251,1135,1116,2240,11,45,939.32,2.4
"2011","Breckland 014A","E01026439","Total",1533,761,772,1533,0,22,590.62,2.6
"2011","Breckland 014B","E01026440","Total",1191,603,588,1186,5,13,6009.06,0.2
"2011","Breckland 014C","E01026441","Total",1578,772,806,1532,46,22,3671.66,0.4
"2011","Breckland 014D","E01026494","Total",2208,1110,1098,2208,0,21,3555.07,0.6
"2011","Breckland 015A","E01026465","Total",1796,887,909,1796,0,20,40.51,44.3
"2011","Breckland 015B","E01026466","Total",1914,967,947,1914,0,7,144.08,13.3
"2011","Breckland 015C","E01026467","Total",2200,1056,1144,2189,11,18,672.09,3.3
"2011","Breckland 016A","E01026468","Total",2373,1157,1216,2232,141,12,88.04,27.0
"2011","Breckland 016B","E01026469","Total",1584,806,778,1584,0,17,35.96,44.0
"2011","Breckland 016C","E01026470","Total",2758,1424,1334,2758,0,17,68.59,40.2
"2011","Breckland 016D","E01026471","Total",1240,613,627,1240,0,7,24.97,49.7
"2011","Breckland 016E","E01026472","Total",1206,605,601,1206,0,6,30.85,39.1
"2011","Breckland 016F","E01026473","Total",1474,741,733,1474,0,8,24.30,60.7
"2011","Breckland 017A","E01026474","Total",1691,802,889,1690,1,15,770.24,2.2
"2011","Breckland 017B","E01026475","Total",1471,732,739,1471,0,16,71.19,20.7
"2011","Breckland 017C","E01026476","Total",1485,760,725,1475,10,6,22.49,66.0
"2011","Breckland 017D","E01026477","Total",1447,707,740,1447,0,10,60.86,23.8
"2011","Breckland 017E","E01026478","Total",1701,842,859,1688,13,7,900.63,1.9
"2011","Broadland 001A","E01026499","Total",1520,702,818,1498,22,17,60.59,25.1
"2011","Broadland 001B","E01026500","Total",1701,816,885,1701,0,21,72.27,23.5
"2011","Broadland 001C","E01026501","Total",1607,788,819,1523,84,18,2137.30,0.8
"2011","Broadland 001D","E01026502","Total",1161,588,573,1143,18,24,2504.76,0.5
"2011","Broadland 001E","E01026503","Total",1389,658,731,1389,0,30,306.83,4.5
"2011","Broadland 002A","E01026522","Total",1437,707,730,1424,13,26,3258.33,0.4
"2011","Broadland 002B","E01026523","Total",1862,944,918,1862,0,19,3325.43,0.6
"2011","Broadland 002C","E01026524","Total",1443,716,727,1440,3,21,2880.49,0.5
"2011","Broadland 002D","E01026525","Total",1068,539,529,1068,0,27,4363.76,0.2
"2011","Broadland 002E","E01026547","Total",1419,702,717,1419,0,24,1717.35,0.8
"2011","Broadland 002F","E01026548","Total",1290,609,681,1290,0,27,191.54,6.7
"2011","Broadland 003A","E01026514","Total",1533,761,772,1497,36,19,1093.18,1.4
"2011","Broadland 003B","E01026515","Total",1082,548,534,1079,3,11,891.25,1.2
"2011","Broadland 003C","E01026516","Total",1248,605,643,1242,6,7,647.92,1.9
"2011","Broadland 003D","E01026517","Total",1439,680,759,1366,73,29,1515.93,0.9
"2011","Broadland 004A","E01026533","Total",1190,592,598,1190,0,19,716.46,1.7
"2011","Broadland 004B","E01026534","Total",1639,819,820,1623,16,11,1858.42,0.9
"2011","Broadland 004C","E01026535","Total",1674,835,839,1656,18,16,989.33,1.7
"2011","Broadland 004D","E01026536","Total",1693,835,858,1668,25,24,1497.05,1.1
"2011","Broadland 004E","E01026537","Total",1541,743,798,1475,66,13,39.81,38.7
"2011","Broadland 005A","E01026549","Total",1724,850,874,1720,4,15,732.71,2.4
"2011","Broadland 005B","E01026550","Total",1131,560,571,1131,0,10,615.75,1.8
"2011","Broadland 005C","E01026551","Total",1188,580,608,1128,60,6,34.58,34.4
"2011","Broadland 005D","E01026552","Total",1399,707,692,1395,4,6,85.61,16.3
"2011","Broadland 006A","E01026562","Total",1231,608,623,1184,47,18,31.60,39.0
"2011","Broadland 006B","E01026563","Total",1410,692,718,1407,3,15,65.14,21.6
"2011","Broadland 006C","E01026564","Total",1631,837,794,1488,143,15,200.72,8.1
"2011","Broadland 006D","E01026565","Total",1165,572,593,1165,0,8,15.68,74.3
"2011","Broadland 006E","E01026566","Total",1484,714,770,1440,44,23,341.39,4.3
"2011","Broadland 006F","E01026567","Total",1638,801,837,1634,4,21,81.37,20.1
"2011","Broadland 006G","E01026568","Total",1583,760,823,1580,3,32,133.93,11.8
"2011","Broadland 007A","E01026518","Total",1395,690,705,1395,0,15,82.19,17.0
"2011","Broadland 007B","E01026519","Total",1707,831,876,1707,0,11,157.79,10.8
"2011","Broadland 007C","E01026520","Total",1115,538,577,1077,38,9,160.82,6.9
"2011","Broadland 007D","E01026521","Total",1272,573,699,1175,97,18,155.56,8.2
"2011","Broadland 008A","E01026545","Total",1633,808,825,1592,41,10,569.71,2.9
"2011","Broadland 008B","E01026546","Total",1502,739,763,1502,0,27,534.29,2.8
"2011","Broadland 008C","E01026578","Total",1972,950,1022,1931,41,16,751.82,2.6
"2011","Broadland 008D","E01026579","Total",1486,740,746,1474,12,20,891.82,1.7
"2011","Broadland 008E","E01026580","Total",1636,785,851,1535,101,22,975.43,1.7
"2011","Broadland 009A","E01026540","Total",1444,670,774,1444,0,10,42.61,33.9
"2011","Broadland 009B","E01026541","Total",2428,1174,1254,2402,26,32,98.06,24.8
"2011","Broadland 009C","E01026542","Total",1477,735,742,1475,2,23,34.85,42.4
"2011","Broadland 009D","E01026543","Total",1422,690,732,1422,0,8,84.69,16.8
"2011","Broadland 009E","E01026544","Total",1687,854,833,1675,12,16,62.00,27.2
"2011","Broadland 010A","E01026526","Total",1421,699,722,1421,0,15,30.95,45.9
"2011","Broadland 010B","E01026527","Total",1454,675,779,1454,0,4,45.33,32.1
"2011","Broadland 010C","E01026528","Total",1388,652,736,1311,77,5,59.11,23.5
"2011","Broadland 010D","E01026529","Total",1544,746,798,1543,1,18,187.87,8.2
"2011","Broadland 011A","E01026530","Total",1705,865,840,1705,0,12,58.62,29.1
"2011","Broadland 011B","E01026531","Total",1698,840,858,1690,8,15,84.40,20.1
"2011","Broadland 011C","E01026532","Total",1747,860,887,1689,58,6,57.42,30.4
"2011","Broadland 012A","E01026553","Total",1387,668,719,1348,39,11,39.15,35.4
"2011","Broadland 012B","E01026554","Total",1165,548,617,1165,0,15,196.80,5.9
"2011","Broadland 012C","E01026555","Total",1510,728,782,1510,0,13,44.70,33.8
"2011","Broadland 012D","E01026556","Total",1421,682,739,1421,0,12,34.93,40.7
"2011","Broadland 013A","E01026557","Total",1375,671,704,1368,7,12,36.89,37.3
"2011","Broadland 013B","E01026558","Total",1276,616,660,1276,0,11,186.09,6.9
"2011","Broadland 013C","E01026559","Total",1479,742,737,1479,0,16,62.46,23.7
"2011","Broadland 013D","E01026560","Total",1340,652,688,1340,0,3,53.59,25.0
"2011","Broadland 013E","E01026561","Total",1388,678,710,1366,22,13,202.01,6.9
"2011","Broadland 014A","E01026504","Total",1532,727,805,1501,31,32,3457.29,0.4
"2011","Broadland 014B","E01026505","Total",1372,637,735,1356,16,22,1243.95,1.1
"2011","Broadland 014C","E01026506","Total",1367,656,711,1365,2,25,350.49,3.9
"2011","Broadland 014D","E01026507","Total",1323,640,683,1323,0,16,93.69,14.1
"2011","Broadland 014E","E01026512","Total",1297,627,670,1280,17,7,834.89,1.6
"2011","Broadland 014F","E01026513","Total",1346,657,689,1344,2,17,104.50,12.9
"2011","Broadland 015A","E01026569","Total",1427,688,739,1427,0,9,100.80,14.2
"2011","Broadland 015B","E01026570","Total",1574,738,836,1574,0,15,58.25,27.0
"2011","Broadland 015C","E01026571","Total",1469,712,757,1469,0,15,43.49,33.8
"2011","Broadland 015D","E01026572","Total",1456,708,748,1456,0,17,51.61,28.2
"2011","Broadland 015E","E01026573","Total",1370,672,698,1370,0,10,33.10,41.4
"2011","Broadland 016A","E01026574","Total",1734,835,899,1734,0,31,41.53,41.8
"2011","Broadland 016B","E01026575","Total",1736,847,889,1638,98,11,126.09,13.8
"2011","Broadland 016C","E01026576","Total",2098,1050,1048,2057,41,20,112.25,18.7
"2011","Broadland 016D","E01026577","Total",1692,848,844,1658,34,41,141.14,12.0
"2011","Broadland 017A","E01026508","Total",1438,686,752,1408,30,18,47.52,30.3
"2011","Broadland 017B","E01026509","Total",1593,794,799,1580,13,27,955.68,1.7
"2011","Broadland 017C","E01026510","Total",1618,769,849,1542,76,26,546.26,3.0
"2011","Broadland 017D","E01026511","Total",1141,565,576,1141,0,22,2178.68,0.5
"2011","Broadland 018A","E01026497","Total",1467,720,747,1467,0,14,271.13,5.4
"2011","Broadland 018B","E01026498","Total",1357,641,716,1323,34,16,666.84,2.0
"2011","Broadland 018C","E01026538","Total",1568,757,811,1526,42,20,2069.27,0.8
"2011","Broadland 018D","E01026539","Total",1677,853,824,1675,2,18,3322.99,0.5
"2011","Great Yarmouth 001A","E01026605","Total",1680,784,896,1570,110,23,498.44,3.4
"2011","Great Yarmouth 001B","E01026606","Total",1567,746,821,1548,19,26,1363.78,1.1
"2011","Great Yarmouth 001C","E01026607","Total",1595,800,795,1595,0,24,205.23,7.8
"2011","Great Yarmouth 001D","E01026627","Total",1388,671,717,1388,0,26,218.42,6.4
"2011","Great Yarmouth 001E","E01026628","Total",1395,694,701,1381,14,14,316.89,4.4
"2011","Great Yarmouth 001F","E01026629","Total",1493,720,773,1473,20,21,609.50,2.4
"2011","Great Yarmouth 002A","E01026608","Total",1257,625,632,1257,0,10,907.09,1.4
"2011","Great Yarmouth 002B","E01026609","Total",1169,566,603,1169,0,25,3363.10,0.3
"2011","Great Yarmouth 002C","E01026636","Total",1549,775,774,1525,24,19,1923.87,0.8
"2011","Great Yarmouth 002D","E01026637","Total",2007,988,1019,1965,42,20,790.56,2.5
"2011","Great Yarmouth 002E","E01026638","Total",1562,742,820,1562,0,15,389.05,4.0
"2011","Great Yarmouth 003A","E01026589","Total",1424,701,723,1412,12,14,38.72,36.8
"2011","Great Yarmouth 003B","E01026590","Total",1382,664,718,1382,0,10,38.80,35.6
"2011","Great Yarmouth 003C","E01026591","Total",1745,819,926,1745,0,16,69.90,25.0
"2011","Great Yarmouth 003D","E01026592","Total",1449,695,754,1449,0,4,52.44,27.6
"2011","Great Yarmouth 003E","E01026593","Total",1314,655,659,1314,0,16,727.31,1.8
"2011","Great Yarmouth 003F","E01026594","Total",1762,841,921,1720,42,7,145.49,12.1
"2011","Great Yarmouth 004A","E01026599","Total",1432,722,710,1408,24,4,16.24,88.2
"2011","Great Yarmouth 004B","E01026639","Total",1562,786,776,1536,26,14,87.84,17.8
"2011","Great Yarmouth 004C","E01026640","Total",1577,732,845,1577,0,10,90.94,17.3
"2011","Great Yarmouth 004D","E01026641","Total",1507,714,793,1507,0,6,32.27,46.7
"2011","Great Yarmouth 005A","E01026595","Total",1708,789,919,1638,70,4,50.03,34.1
"2011","Great Yarmouth 005B","E01026596","Total",1691,806,885,1654,37,2,577.28,2.9
"2011","Great Yarmouth 005C","E01026597","Total",1862,933,929,1845,17,6,51.02,36.5
"2011","Great Yarmouth 005D","E01026598","Total",1605,820,785,1546,59,1,39.02,41.1
"2011","Great Yarmouth 006A","E01026622","Total",1642,822,820,1642,0,4,141.35,11.6
"2011","Great Yarmouth 006B","E01026623","Total",1542,851,691,1470,72,11,21.79,70.8
"2011","Great Yarmouth 006C","E01026624","Total",1798,911,887,1748,50,11,14.12,127.3
"2011","Great Yarmouth 006D","E01026625","Total",1795,919,876,1795,0,10,15.16,118.4
"2011","Great Yarmouth 006E","E01026626","Total",1904,972,932,1863,41,6,62.68,30.4
"2011","Great Yarmouth 007A","E01026600","Total",1477,730,747,1477,0,17,48.80,30.3
"2011","Great Yarmouth 007B","E01026633","Total",1861,952,909,1848,13,11,101.41,18.4
"2011","Great Yarmouth 007C","E01026634","Total",1543,773,770,1543,0,6,40.58,38.0
"2011","Great Yarmouth 007D","E01026635","Total",2253,1132,1121,2237,16,11,142.87,15.8
"2011","Great Yarmouth 008A","E01026581","Total",1686,856,830,1686,0,14,109.00,15.5
"2011","Great Yarmouth 008B","E01026582","Total",1938,941,997,1926,12,10,275.28,7.0
"2011","Great Yarmouth 008C","E01026583","Total",1328,641,687,1286,42,10,28.52,46.6
"2011","Great Yarmouth 008D","E01026584","Total",1496,752,744,1496,0,1,66.67,22.4
"2011","Great Yarmouth 009A","E01026601","Total",1490,715,775,1490,0,7,16.69,89.3
"2011","Great Yarmouth 009B","E01026602","Total",1481,718,763,1481,0,16,38.37,38.6
"2011","Great Yarmouth 009C","E01026603","Total",1664,800,864,1657,7,3,27.62,60.2
"2011","Great Yarmouth 009D","E01026604","Total",1577,799,778,1575,2,10,25.75,61.2
"2011","Great Yarmouth 009E","E01026632","Total",1676,795,881,1655,21,10,41.82,40.1
"2011","Great Yarmouth 010A","E01026610","Total",1533,749,784,1528,5,14,15.87,96.6
"2011","Great Yarmouth 010B","E01026611","Total",1513,722,791,1383,130,15,60.77,24.9
"2011","Great Yarmouth 010C","E01026612","Total",2502,1201,1301,2495,7,29,109.85,22.8
"2011","Great Yarmouth 010D","E01026630","Total",1737,833,904,1737,0,14,32.36,53.7
"2011","Great Yarmouth 010E","E01026631","Total",1718,883,835,1716,2,16,28.17,61.0
"2011","Great Yarmouth 011A","E01026617","Total",1277,632,645,1273,4,6,49.37,25.9
"2011","Great Yarmouth 011B","E01026618","Total",1592,770,822,1574,18,17,41.33,38.5
"2011","Great Yarmouth 011C","E01026619","Total",1498,711,787,1493,5,4,26.76,56.0
"2011","Great Yarmouth 011D","E01026620","Total",1436,671,765,1400,36,2,22.15,64.8
"2011","Great Yarmouth 011E","E01026621","Total",1453,731,722,1453,0,11,28.92,50.2
"2011","Great Yarmouth 012A","E01026613","Total",1296,645,651,1296,0,19,956.56,1.4
"2011","Great Yarmouth 012B","E01026614","Total",1602,796,806,1579,23,15,695.89,2.3
"2011","Great Yarmouth 012C","E01026615","Total",1355,679,676,1348,7,17,476.82,2.8
"2011","Great Yarmouth 012D","E01026616","Total",1226,610,616,1226,0,10,56.31,21.8
"2011","Great Yarmouth 013A","E01026585","Total",1284,615,669,1284,0,10,32.20,39.9
"2011","Great Yarmouth 013B","E01026586","Total",1048,491,557,1048,0,8,42.57,24.6
"2011","Great Yarmouth 013C","E01026587","Total",1748,867,881,1748,0,13,392.53,4.5
"2011","Great Yarmouth 013D","E01026588","Total",2626,1289,1337,2608,18,26,528.69,5.0
"2011","King's Lynn and West Norfolk 001A","E01026680","Total",1457,633,824,1424,33,7,63.69,22.9
"2011","King's Lynn and West Norfolk 001B","E01026681","Total",1409,695,714,1401,8,28,2584.92,0.5
"2011","King's Lynn and West Norfolk 001C","E01026682","Total",1258,567,691,1127,131,35,55.03,22.9
"2011","King's Lynn and West Norfolk 001D","E01026683","Total",1296,626,670,1279,17,12,96.02,13.5
"2011","King's Lynn and West Norfolk 002A","E01026645","Total",1293,627,666,1289,4,38,3774.18,0.3
"2011","King's Lynn and West Norfolk 002B","E01026646","Total",1714,823,891,1714,0,32,6068.01,0.3
"2011","King's Lynn and West Norfolk 002C","E01026656","Total",1937,926,1011,1884,53,35,7098.56,0.3
"2011","King's Lynn and West Norfolk 002D","E01026695","Total",2128,1083,1045,2128,0,50,7678.97,0.3
"2011","King's Lynn and West Norfolk 003A","E01026676","Total",1678,785,893,1644,34,21,755.78,2.2
"2011","King's Lynn and West Norfolk 003B","E01026677","Total",1504,697,807,1478,26,10,62.64,24.0
"2011","King's Lynn and West Norfolk 003C","E01026678","Total",1568,752,816,1519,49,18,558.04,2.8
"2011","King's Lynn and West Norfolk 003D","E01026701","Total",1587,739,848,1574,13,11,373.60,4.2
"2011","King's Lynn and West Norfolk 003E","E01026702","Total",1280,594,686,1245,35,13,76.80,16.7
"2011","King's Lynn and West Norfolk 003F","E01026703","Total",1165,575,590,1165,0,34,5410.37,0.2
"2011","King's Lynn and West Norfolk 004A","E01026653","Total",1740,811,929,1740,0,11,562.84,3.1
"2011","King's Lynn and West Norfolk 004B","E01026654","Total",1555,717,838,1535,20,7,41.67,37.3
"2011","King's Lynn and West Norfolk 004C","E01026655","Total",1345,620,725,1343,2,16,845.22,1.6
"2011","King's Lynn and West Norfolk 004D","E01026718","Total",2256,1092,1164,2256,0,40,9782.69,0.2
"2011","King's Lynn and West Norfolk 005A","E01026691","Total",1174,577,597,1158,16,44,1937.58,0.6
"2011","King's Lynn and West Norfolk 005B","E01026692","Total",1271,609,662,1271,0,35,68.51,18.6
"2011","King's Lynn and West Norfolk 005C","E01026708","Total",1355,658,697,1355,0,19,638.93,2.1
"2011","King's Lynn and West Norfolk 005D","E01026709","Total",1915,906,1009,1879,36,40,112.23,17.1
"2011","King's Lynn and West Norfolk 005E","E01026710","Total",1193,587,606,1151,42,24,963.60,1.2
"2011","King's Lynn and West Norfolk 006A","E01026669","Total",1624,767,857,1623,1,15,41.07,39.5
"2011","King's Lynn and West Norfolk 006B","E01026670","Total",1624,777,847,1525,99,11,25.02,64.9
"2011","King's Lynn and West Norfolk 006C","E01026671","Total",1407,712,695,1407,0,18,34.25,41.1
"2011","King's Lynn and West Norfolk 006D","E01026672","Total",1493,725,768,1493,0,22,38.75,38.5
"2011","King's Lynn and West Norfolk 006E","E01026673","Total",1533,760,773,1533,0,14,116.60,13.1
"2011","King's Lynn and West Norfolk 007A","E01026687","Total",1575,778,797,1543,32,5,50.58,31.1
"2011","King's Lynn and West Norfolk 007B","E01026688","Total",1485,694,791,1485,0,10,321.33,4.6
"2011","King's Lynn and West Norfolk 007C","E01026689","Total",1525,762,763,1525,0,8,18.75,81.3
"2011","King's Lynn and West Norfolk 007D","E01026690","Total",1487,724,763,1478,9,8,68.17,21.8
"2011","King's Lynn and West Norfolk 008A","E01026647","Total",2171,1072,1099,2171,0,23,1258.75,1.7
"2011","King's Lynn and West Norfolk 008B","E01026711","Total",1522,728,794,1522,0,9,3676.10,0.4
"2011","King's Lynn and West Norfolk 008C","E01026712","Total",1639,793,846,1639,0,16,242.50,6.8
"2011","King's Lynn and West Norfolk 008D","E01026713","Total",1537,770,767,1500,37,18,1942.82,0.8
"2011","King's Lynn and West Norfolk 009A","E01026666","Total",1904,894,1010,1891,13,8,69.68,27.3
"2011","King's Lynn and West Norfolk 009B","E01026667","Total",1622,790,832,1533,89,18,50.48,32.1
"2011","King's Lynn and West Norfolk 009C","E01026668","Total",1589,794,795,1558,31,23,59.24,26.8
"2011","King's Lynn and West Norfolk 009D","E01026693","Total",1907,955,952,1890,17,10,66.51,28.7
"2011","King's Lynn and West Norfolk 010A","E01026662","Total",2483,1229,1254,2483,0,10,46.26,53.7
"2011","King's Lynn and West Norfolk 010B","E01026663","Total",1794,865,929,1787,7,11,27.22,65.9
"2011","King's Lynn and West Norfolk 010C","E01026664","Total",2202,1062,1140,2202,0,15,44.34,49.7
"2011","King's Lynn and West Norfolk 010D","E01026714","Total",2027,973,1054,1946,81,36,186.12,10.9
"2011","King's Lynn and West Norfolk 011A","E01026698","Total",1950,953,997,1895,55,9,67.58,28.9
"2011","King's Lynn and West Norfolk 011B","E01026699","Total",1505,754,751,1505,0,2,38.92,38.7
"2011","King's Lynn and West Norfolk 011C","E01026700","Total",1406,771,635,1400,6,7,14.29,98.4
"2011","King's Lynn and West Norfolk 011D","E01026704","Total",1828,884,944,1828,0,12,836.48,2.2
"2011","King's Lynn and West Norfolk 011E","E01026705","Total",1575,772,803,1575,0,6,353.14,4.5
"2011","King's Lynn and West Norfolk 011F","E01026706","Total",1568,772,796,1568,0,15,155.99,10.1
"2011","King's Lynn and West Norfolk 012A","E01026665","Total",2240,1080,1160,2218,22,46,4101.52,0.5
"2011","King's Lynn and West Norfolk 012B","E01026674","Total",1117,525,592,1117,0,19,1250.16,0.9
"2011","King's Lynn and West Norfolk 012C","E01026675","Total",1220,594,626,1216,4,15,1019.85,1.2
"2011","King's Lynn and West Norfolk 012D","E01026694","Total",2431,1197,1234,2427,4,32,6883.13,0.4
"2011","King's Lynn and West Norfolk 013A","E01026684","Total",1209,596,613,1160,49,9,2569.44,0.5
"2011","King's Lynn and West Norfolk 013B","E01026685","Total",1276,612,664,1276,0,9,677.15,1.9
"2011","King's Lynn and West Norfolk 013C","E01026719","Total",2322,1180,1142,2318,4,24,2325.80,1.0
"2011","King's Lynn and West Norfolk 013D","E01026720","Total",1324,680,644,1324,0,21,1545.27,0.9
"2011","King's Lynn and West Norfolk 013E","E01026721","Total",1317,649,668,1299,18,14,1643.34,0.8
"2011","King's Lynn and West Norfolk 014A","E01026642","Total",1338,635,703,1287,51,23,1975.44,0.7
"2011","King's Lynn and West Norfolk 014B","E01026643","Total",1400,710,690,1400,0,20,3776.20,0.4
"2011","King's Lynn and West Norfolk 014C","E01026644","Total",2798,1706,1092,2011,787,61,1112.98,2.5
"2011","King's Lynn and West Norfolk 014D","E01026723","Total",1619,804,815,1619,0,21,634.71,2.6
"2011","King's Lynn and West Norfolk 014E","E01026724","Total",1665,794,871,1625,40,22,766.09,2.2
"2011","King's Lynn and West Norfolk 014F","E01026725","Total",1450,706,744,1450,0,18,1300.58,1.1
"2011","King's Lynn and West Norfolk 015A","E01026696","Total",1196,579,617,1164,32,5,1326.39,0.9
"2011","King's Lynn and West Norfolk 015B","E01026697","Total",1271,617,654,1264,7,19,1547.60,0.8
"2011","King's Lynn and West Norfolk 015C","E01026722","Total",2455,1182,1273,2455,0,21,684.14,3.6
"2011","King's Lynn and West Norfolk 015D","E01026726","Total",2102,1064,1038,2099,3,28,3597.07,0.6
"2011","King's Lynn and West Norfolk 016A","E01026659","Total",1572,808,764,1572,0,14,871.16,1.8
"2011","King's Lynn and West Norfolk 016B","E01026660","Total",1648,792,856,1648,0,17,441.33,3.7
"2011","King's Lynn and West Norfolk 016C","E01026661","Total",1480,718,762,1474,6,12,1085.82,1.4
"2011","King's Lynn and West Norfolk 016D","E01026715","Total",1421,676,745,1421,0,13,390.38,3.6
"2011","King's Lynn and West Norfolk 016E","E01026716","Total",1871,916,955,1853,18,21,4430.81,0.4
"2011","King's Lynn and West Norfolk 016F","E01026717","Total",1535,787,748,1535,0,19,4369.13,0.4
"2011","King's Lynn and West Norfolk 017C","E01026686","Total",2017,957,1060,1995,22,16,109.77,18.4
"2011","King's Lynn and West Norfolk 017D","E01026707","Total",2079,976,1103,2079,0,14,169.86,12.2
"2011","King's Lynn and West Norfolk 017E","E01033036","Total",1615,778,837,1615,0,22,89.30,18.1
"2011","King's Lynn and West Norfolk 017F","E01033037","Total",1514,736,778,1514,0,14,50.14,30.2
"2011","King's Lynn and West Norfolk 017G","E01033038","Total",1761,820,941,1681,80,10,47.20,37.3
"2011","King's Lynn and West Norfolk 017H","E01033039","Total",1008,485,523,987,21,19,54.09,18.6
"2011","King's Lynn and West Norfolk 018A","E01026679","Total",2409,1214,1195,2409,0,47,6225.35,0.4
"2011","King's Lynn and West Norfolk 018B","E01026727","Total",2504,1219,1285,2503,1,36,6538.89,0.4
"2011","King's Lynn and West Norfolk 018C","E01026728","Total",2276,1102,1174,2276,0,32,2791.98,0.8
"2011","King's Lynn and West Norfolk 019A","E01026648","Total",1506,737,769,1506,0,14,3196.83,0.5
"2011","King's Lynn and West Norfolk 019B","E01026649","Total",1566,783,783,1545,21,15,1246.36,1.3
"2011","King's Lynn and West Norfolk 019C","E01026650","Total",1203,584,619,1203,0,10,7089.02,0.2
"2011","King's Lynn and West Norfolk 019D","E01026651","Total",2332,1161,1171,2320,12,20,3672.45,0.6
"2011","King's Lynn and West Norfolk 019E","E01026652","Total",1324,665,659,1324,0,9,1811.85,0.7
"2011","North Norfolk 001A","E01026770","Total",1987,917,1070,1830,157,25,115.79,17.2
"2011","North Norfolk 001B","E01026771","Total",1596,737,859,1565,31,24,65.44,24.4
"2011","North Norfolk 001C","E01026772","Total",1722,827,895,1717,5,30,99.89,17.2
"2011","North Norfolk 001D","E01026773","Total",2062,972,1090,2046,16,21,90.38,22.8
"2011","North Norfolk 002A","E01026739","Total",2044,969,1075,2001,43,51,5691.44,0.4
"2011","North Norfolk 002B","E01026763","Total",1383,675,708,1355,28,20,4033.88,0.3
"2011","North Norfolk 002C","E01026764","Total",1195,557,638,1181,14,17,590.48,2.0
"2011","North Norfolk 002D","E01026765","Total",1330,655,675,1330,0,18,4106.41,0.3
"2011","North Norfolk 003A","E01026734","Total",1159,604,555,1093,66,10,34.02,34.1
"2011","North Norfolk 003B","E01026735","Total",1199,562,637,1146,53,11,36.08,33.2
"2011","North Norfolk 003C","E01026736","Total",1290,606,684,1279,11,10,169.38,7.6
"2011","North Norfolk 003D","E01026777","Total",1123,528,595,1123,0,11,60.17,18.7
"2011","North Norfolk 003E","E01026778","Total",1441,628,813,1338,103,15,112.00,12.9
"2011","North Norfolk 003F","E01026779","Total",1471,706,765,1444,27,4,23.06,63.8
"2011","North Norfolk 004A","E01026741","Total",1894,910,984,1856,38,33,3046.36,0.6
"2011","North Norfolk 004B","E01026742","Total",1579,728,851,1256,323,29,391.22,4.0
"2011","North Norfolk 004C","E01026743","Total",2231,1029,1202,2229,2,29,827.72,2.7
"2011","North Norfolk 005A","E01026762","Total",2401,1165,1236,2298,103,29,1585.42,1.5
"2011","North Norfolk 005B","E01026766","Total",2231,1104,1127,2231,0,39,2787.75,0.8
"2011","North Norfolk 005C","E01026781","Total",2125,1053,1072,2104,21,41,1191.80,1.8
"2011","North Norfolk 006A","E01026731","Total",1062,500,562,955,107,10,278.42,3.8
"2011","North Norfolk 006B","E01026732","Total",1253,620,633,1253,0,26,3324.29,0.4
"2011","North Norfolk 006C","E01026733","Total",2322,1127,1195,2320,2,33,6074.90,0.4
"2011","North Norfolk 006D","E01026737","Total",2344,1164,1180,2344,0,50,4931.48,0.5
"2011","North Norfolk 007A","E01026738","Total",2456,1207,1249,2454,2,29,2984.27,0.8
"2011","North Norfolk 007B","E01026750","Total",1363,634,729,1322,41,20,84.88,16.1
"2011","North Norfolk 007C","E01026751","Total",1395,635,760,1371,24,17,174.48,8.0
"2011","North Norfolk 007D","E01026752","Total",1433,708,725,1413,20,10,1471.47,1.0
"2011","North Norfolk 008A","E01026729","Total",2244,1113,1131,2184,60,50,5616.00,0.4
"2011","North Norfolk 008B","E01026730","Total",2439,1197,1242,2439,0,19,1196.33,2.0
"2011","North Norfolk 008C","E01026788","Total",1265,629,636,1265,0,20,2969.59,0.4
"2011","North Norfolk 009A","E01026780","Total",2521,1239,1282,2521,0,30,5861.21,0.4
"2011","North Norfolk 009B","E01026782","Total",2167,1050,1117,2154,13,35,6567.82,0.3
"2011","North Norfolk 009C","E01026787","Total",1040,519,521,1040,0,20,1671.78,0.6
"2011","North Norfolk 010A","E01026753","Total",1575,741,834,1575,0,13,44.74,35.2
"2011","North Norfolk 010B","E01026754","Total",1413,667,746,1413,0,9,120.75,11.7
"2011","North Norfolk 010C","E01026755","Total",1215,580,635,1175,40,10,336.45,3.6
"2011","North Norfolk 010D","E01026756","Total",1233,576,657,1223,10,13,32.74,37.7
"2011","North Norfolk 010E","E01026757","Total",1583,776,807,1537,46,9,156.43,10.1
"2011","North Norfolk 010F","E01026758","Total",1374,660,714,1374,0,14,30.63,44.9
"2011","North Norfolk 010G","E01026759","Total",1339,614,725,1279,60,11,569.81,2.3
"2011","North Norfolk 010H","E01026760","Total",1334,642,692,1251,83,8,169.60,7.9
"2011","North Norfolk 010I","E01026761","Total",1568,759,809,1553,15,12,266.11,5.9
"2011","North Norfolk 011A","E01026745","Total",1649,772,877,1647,2,18,98.61,16.7
"2011","North Norfolk 011B","E01026746","Total",1657,810,847,1638,19,15,480.33,3.4
"2011","North Norfolk 011C","E01026747","Total",1329,656,673,1306,23,6,71.35,18.6
"2011","North Norfolk 011D","E01026748","Total",1430,692,738,1430,0,6,177.37,8.1
"2011","North Norfolk 011E","E01026749","Total",1552,717,835,1491,61,13,75.93,20.4
"2011","North Norfolk 012A","E01026740","Total",2386,1149,1237,2345,41,27,3547.15,0.7
"2011","North Norfolk 012B","E01026767","Total",1253,627,626,1215,38,13,1634.24,0.8
"2011","North Norfolk 012C","E01026768","Total",1681,1117,564,1186,495,12,1163.64,1.4
"2011","North Norfolk 012D","E01026789","Total",1223,603,620,1200,23,19,2297.45,0.5
"2011","North Norfolk 012E","E01026790","Total",1161,571,590,1143,18,13,1620.11,0.7
"2011","North Norfolk 013A","E01026774","Total",1451,707,744,1451,0,19,795.19,1.8
"2011","North Norfolk 013B","E01026775","Total",1273,580,693,1265,8,7,79.32,16.0
"2011","North Norfolk 013C","E01026776","Total",1588,790,798,1542,46,10,489.25,3.2
"2011","North Norfolk 013D","E01026786","Total",2190,1107,1083,2164,26,32,4603.30,0.5
"2011","North Norfolk 014A","E01026744","Total",1948,927,1021,1947,1,12,1491.57,1.3
"2011","North Norfolk 014B","E01026769","Total",2130,1008,1122,2105,25,28,2927.36,0.7
"2011","North Norfolk 014C","E01026783","Total",1801,882,919,1753,48,9,1484.41,1.2
"2011","North Norfolk 014D","E01026784","Total",1045,524,521,1045,0,12,1647.51,0.6
"2011","North Norfolk 014E","E01026785","Total",1351,675,676,1313,38,13,1656.11,0.8
"2011","Norwich 001A","E01026797","Total",2402,1243,1159,2400,2,18,363.68,6.6
"2011","Norwich 001B","E01026798","Total",1533,781,752,1533,0,11,22.57,67.9
"2011","Norwich 001C","E01026799","Total",1459,728,731,1459,0,8,24.09,60.6
"2011","Norwich 001D","E01026800","Total",1991,1036,955,1991,0,19,35.78,55.6
"2011","Norwich 001E","E01026801","Total",1606,778,828,1560,46,14,36.43,44.1
"2011","Norwich 001F","E01026802","Total",1605,783,822,1536,69,11,84.64,19.0
"2011","Norwich 002A","E01026828","Total",1744,842,902,1744,0,10,120.07,14.5
"2011","Norwich 002B","E01026829","Total",2093,1031,1062,2063,30,7,37.79,55.4
"2011","Norwich 002C","E01026830","Total",1276,649,627,1252,24,7,29.22,43.7
"2011","Norwich 002D","E01026831","Total",1242,647,595,1242,0,9,15.76,78.8
"2011","Norwich 002E","E01026832","Total",1415,689,726,1415,0,5,22.58,62.7
"2011","Norwich 002F","E01026833","Total",1382,723,659,1382,0,3,23.91,57.8
"2011","Norwich 002G","E01026834","Total",1503,712,791,1503,0,3,25.68,58.5
"2011","Norwich 003A","E01026841","Total",1453,761,692,1428,25,3,12.84,113.2
"2011","Norwich 003B","E01026842","Total",1648,832,816,1628,20,10,27.44,60.1
"2011","Norwich 003C","E01026843","Total",1905,887,1018,1871,34,7,35.72,53.3
"2011","Norwich 003D","E01026844","Total",1741,878,863,1741,0,7,29.51,59.0
"2011","Norwich 003E","E01026845","Total",1561,775,786,1561,0,3,14.04,111.2
"2011","Norwich 003F","E01026846","Total",1626,818,808,1609,17,12,15.30,106.3
"2011","Norwich 004A","E01026803","Total",1438,653,785,1388,50,4,23.26,61.8
"2011","Norwich 004B","E01026804","Total",1429,679,750,1429,0,7,58.52,24.4
"2011","Norwich 004C","E01026805","Total",1421,681,740,1421,0,7,31.88,44.6
"2011","Norwich 004D","E01026806","Total",1503,942,561,1127,376,9,45.95,32.7
"2011","Norwich 004E","E01026807","Total",1252,614,638,1252,0,8,22.39,55.9
"2011","Norwich 004F","E01026808","Total",1320,653,667,1320,0,1,21.72,60.8
"2011","Norwich 004G","E01026809","Total",1492,754,738,1483,9,7,26.24,56.9
"2011","Norwich 005A","E01026791","Total",1475,741,734,1475,0,10,20.52,71.9
"2011","Norwich 005B","E01026792","Total",1445,695,750,1445,0,12,35.61,40.6
"2011","Norwich 005C","E01026793","Total",1817,861,956,1817,0,14,29.22,62.2
"2011","Norwich 005D","E01026794","Total",2065,1029,1036,2021,44,9,75.62,27.3
"2011","Norwich 005F","E01026796","Total",1643,789,854,1636,7,11,37.28,44.1
"2011","Norwich 005G","E01033435","Total",1845,889,956,1845,0,20,52.00,35.5
"2011","Norwich 005H","E01033436","Total",1393,668,725,1383,10,13,73.69,18.9
"2011","Norwich 006A","E01026863","Total",1814,895,919,1814,0,19,78.56,23.1
"2011","Norwich 006B","E01026864","Total",1547,768,779,1547,0,11,137.63,11.2
"2011","Norwich 006C","E01026865","Total",1949,961,988,1949,0,12,33.91,57.5
"2011","Norwich 006D","E01026866","Total",1574,779,795,1574,0,18,50.03,31.5
"2011","Norwich 006E","E01026867","Total",1592,776,816,1592,0,15,28.00,56.9
"2011","Norwich 006F","E01026868","Total",1628,796,832,1623,5,3,26.67,61.0
"2011","Norwich 006G","E01026869","Total",1400,700,700,1400,0,1,18.13,77.2
"2011","Norwich 007A","E01026822","Total",2031,1037,994,1958,73,18,75.71,26.8
"2011","Norwich 007B","E01026823","Total",1906,1015,891,1800,106,26,46.52,41.0
"2011","Norwich 007C","E01026824","Total",1471,724,747,1471,0,8,23.41,62.8
"2011","Norwich 007D","E01026825","Total",1276,659,617,1276,0,9,24.19,52.7
"2011","Norwich 007E","E01026826","Total",1456,724,732,1406,50,2,34.14,42.6
"2011","Norwich 007F","E01026827","Total",1501,722,779,1501,0,2,32.64,46.0
"2011","Norwich 009A","E01026835","Total",1502,710,792,1453,49,22,18.54,81.0
"2011","Norwich 009B","E01026836","Total",1566,762,804,1566,0,41,25.74,60.8
"2011","Norwich 009C","E01026837","Total",1471,745,726,1448,23,43,22.43,65.6
"2011","Norwich 009D","E01026838","Total",1551,696,855,1551,0,26,22.12,70.1
"2011","Norwich 009E","E01026839","Total",1596,742,854,1592,4,12,11.55,138.2
"2011","Norwich 009F","E01026840","Total",1611,786,825,1604,7,21,15.53,103.7
"2011","Norwich 010A","E01026858","Total",1512,709,803,1508,4,20,33.07,45.7
"2011","Norwich 010B","E01026859","Total",1659,776,883,1659,0,17,27.29,60.8
"2011","Norwich 010C","E01026860","Total",4313,1994,2319,1098,3215,114,155.69,27.7
"2011","Norwich 010D","E01026861","Total",1493,699,794,1493,0,11,40.12,37.2
"2011","Norwich 010E","E01026862","Total",1302,614,688,1302,0,24,29.03,44.9
"2011","Norwich 011A","E01026852","Total",1295,598,697,1234,61,32,41.10,31.5
"2011","Norwich 011B","E01026853","Total",1751,926,825,1746,5,16,29.79,58.8
"2011","Norwich 011D","E01026855","Total",1568,796,772,1564,4,24,30.72,51.0
"2011","Norwich 011E","E01026856","Total",1821,852,969,1821,0,33,15.67,116.2
"2011","Norwich 011F","E01026857","Total",1515,710,805,1515,0,32,50.47,30.0
"2011","Norwich 011G","E01033434","Total",1076,572,504,1076,0,13,11.53,93.3
"2011","Norwich 011H","E01033437","Total",1378,663,715,1334,44,13,17.65,78.1
"2011","Norwich 012A","E01026810","Total",1389,640,749,1374,15,35,123.43,11.3
"2011","Norwich 012B","E01026811","Total",1544,747,797,1525,19,50,97.92,15.8
"2011","Norwich 012C","E01026812","Total",1425,698,727,1425,0,36,94.02,15.2
"2011","Norwich 012D","E01026813","Total",1426,694,732,1426,0,31,91.75,15.5
"2011","Norwich 012E","E01026814","Total",1522,738,784,1502,20,21,42.49,35.8
"2011","Norwich 012F","E01026815","Total",1475,681,794,1450,25,56,45.75,32.2
"2011","Norwich 013A","E01026816","Total",1741,837,904,1699,42,10,28.22,61.7
"2011","Norwich 013B","E01026817","Total",1415,670,745,1415,0,12,61.81,22.9
"2011","Norwich 013C","E01026818","Total",1462,708,754,1462,0,10,65.13,22.4
"2011","Norwich 013D","E01026819","Total",1439,690,749,1439,0,10,20.61,69.8
"2011","Norwich 013E","E01026820","Total",1727,822,905,1727,0,8,45.39,38.0
"2011","Norwich 013F","E01026821","Total",1542,727,815,1542,0,8,98.09,15.7
"2011","Norwich 014A","E01033438","Total",1397,691,706,1350,47,14,50.41,27.7
"2011","Norwich 014B","E01033439","Total",1440,759,681,1357,83,10,62.26,23.1
"2011","Norwich 014C","E01033440","Total",1070,608,462,1070,0,10,16.18,66.1
"2011","Norwich 014D","E01033441","Total",1229,680,549,1229,0,8,85.17,14.4
"2011","Norwich 015A","E01026848","Total",1856,877,979,1823,33,11,38.91,47.7
"2011","Norwich 015B","E01026849","Total",1738,924,814,1677,61,23,55.19,31.5
"2011","Norwich 015C","E01026850","Total",1827,929,898,1827,0,18,41.34,44.2
"2011","South Norfolk 001A","E01026916","Total",2028,1019,1009,2028,0,13,74.06,27.4
"2011","South Norfolk 001B","E01026917","Total",1481,721,760,1481,0,11,46.06,32.2
"2011","South Norfolk 001C","E01026918","Total",1689,862,827,1686,3,6,64.47,26.2
"2011","South Norfolk 001E","E01026924","Total",1514,742,772,1514,0,18,362.31,4.2
"2011","South Norfolk 001F","E01026925","Total",2102,1019,1083,2091,11,7,69.65,30.2
"2011","South Norfolk 001G","E01033538","Total",2165,1070,1095,2164,1,14,457.06,4.7
"2011","South Norfolk 001H","E01033540","Total",1484,738,746,1484,0,17,165.36,9.0
"2011","South Norfolk 002A","E01026881","Total",1335,641,694,1335,0,19,670.11,2.0
"2011","South Norfolk 002B","E01026882","Total",2072,982,1090,2053,19,55,293.25,7.1
"2011","South Norfolk 002C","E01026883","Total",1645,787,858,1602,43,33,1233.72,1.3
"2011","South Norfolk 002D","E01026895","Total",1514,760,754,1438,76,22,624.92,2.4
"2011","South Norfolk 002E","E01026896","Total",1203,581,622,1201,2,27,2471.77,0.5
"2011","South Norfolk 003A","E01026905","Total",1025,476,549,1025,0,10,31.50,32.5
"2011","South Norfolk 003B","E01026906","Total",1375,666,709,1348,27,36,303.94,4.5
"2011","South Norfolk 003C","E01026907","Total",1832,874,958,1832,0,29,114.81,16.0
"2011","South Norfolk 003D","E01026908","Total",1459,697,762,1402,57,22,641.43,2.3
"2011","South Norfolk 004A","E01026909","Total",1420,684,736,1387,33,16,112.19,12.7
"2011","South Norfolk 004B","E01026910","Total",1488,730,758,1488,0,34,2364.08,0.6
"2011","South Norfolk 004C","E01026947","Total",1315,640,675,1287,28,28,2880.91,0.5
"2011","South Norfolk 004D","E01026948","Total",1993,993,1000,1299,694,51,1671.28,1.2
"2011","South Norfolk 005A","E01026870","Total",1553,728,825,1543,10,24,59.38,26.2
"2011","South Norfolk 005B","E01026871","Total",1296,629,667,1296,0,21,80.42,16.1
"2011","South Norfolk 005C","E01026921","Total",1366,669,697,1366,0,26,714.11,1.9
"2011","South Norfolk 005D","E01026922","Total",1499,707,792,1469,30,15,130.46,11.5
"2011","South Norfolk 006A","E01026875","Total",1142,560,582,1142,0,20,1406.20,0.8
"2011","South Norfolk 006B","E01026876","Total",1520,704,816,1489,31,24,2318.25,0.7
"2011","South Norfolk 006C","E01026926","Total",1555,746,809,1555,0,22,562.90,2.8
"2011","South Norfolk 006D","E01026927","Total",1837,904,933,1837,0,27,113.24,16.2
"2011","South Norfolk 006E","E01026928","Total",1434,684,750,1409,25,16,468.27,3.1
"2011","South Norfolk 006F","E01026936","Total",1392,664,728,1392,0,34,650.18,2.1
"2011","South Norfolk 006G","E01026937","Total",1475,696,779,1472,3,40,1923.82,0.8
"2011","South Norfolk 007A","E01026884","Total",1157,548,609,1157,0,9,254.40,4.5
"2011","South Norfolk 007B","E01026885","Total",1435,733,702,1434,1,25,2773.22,0.5
"2011","South Norfolk 007C","E01026933","Total",2789,1338,1451,2739,50,36,255.36,10.9
"2011","South Norfolk 007D","E01026945","Total",2234,1096,1138,2234,0,41,129.07,17.3
"2011","South Norfolk 007E","E01026946","Total",1076,517,559,1076,0,14,34.56,31.1
"2011","South Norfolk 008A","E01026879","Total",1228,605,623,1167,61,22,1621.92,0.8
"2011","South Norfolk 008B","E01026880","Total",1485,723,762,1436,49,37,1486.73,1.0
"2011","South Norfolk 008C","E01026911","Total",1108,511,597,1098,10,10,76.73,14.4
"2011","South Norfolk 008D","E01026912","Total",1540,762,778,1535,5,38,1293.91,1.2
"2011","South Norfolk 008E","E01026929","Total",1304,639,665,1287,17,14,1875.79,0.7
"2011","South Norfolk 008F","E01026930","Total",1535,786,749,1520,15,36,1282.01,1.2
"2011","South Norfolk 009A","E01026913","Total",1639,798,841,1636,3,16,1002.98,1.6
"2011","South Norfolk 009B","E01026914","Total",1518,719,799,1468,50,34,1862.63,0.8
"2011","South Norfolk 009C","E01026915","Total",1964,951,1013,1964,0,32,194.92,10.1
"2011","South Norfolk 009D","E01026919","Total",1524,718,806,1489,35,12,749.70,2.0
"2011","South Norfolk 009E","E01026920","Total",1134,539,595,1134,0,32,1072.86,1.1
"2011","South Norfolk 009F","E01026941","Total",1250,630,620,1217,33,43,2304.61,0.5
"2011","South Norfolk 009G","E01026942","Total",1149,569,580,1149,0,14,370.76,3.1
"2011","South Norfolk 010A","E01026898","Total",1392,685,707,1392,0,20,1698.24,0.8
"2011","South Norfolk 010B","E01026899","Total",1479,725,754,1464,15,23,2652.92,0.6
"2011","South Norfolk 010C","E01026943","Total",1537,788,749,1537,0,26,4757.61,0.3
"2011","South Norfolk 010D","E01026944","Total",1189,595,594,1186,3,18,1873.46,0.6
"2011","South Norfolk 011A","E01026877","Total",1537,761,776,1537,0,25,2760.17,0.6
"2011","South Norfolk 011B","E01026878","Total",1200,588,612,1200,0,13,1164.17,1.0
"2011","South Norfolk 011C","E01026897","Total",2701,1338,1363,2680,21,43,2695.57,1.0
"2011","South Norfolk 011D","E01026938","Total",1983,953,1030,1975,8,23,138.57,14.3
"2011","South Norfolk 011E","E01026939","Total",1735,900,835,1714,21,9,1348.09,1.3
"2011","South Norfolk 011F","E01026940","Total",1801,882,919,1798,3,21,942.76,1.9
"2011","South Norfolk 012A","E01026892","Total",1306,639,667,1288,18,20,1709.64,0.8
"2011","South Norfolk 012B","E01026893","Total",1027,515,512,996,31,26,743.95,1.4
"2011","South Norfolk 012C","E01026894","Total",2444,1174,1270,2410,34,33,4153.27,0.6
"2011","South Norfolk 012D","E01026903","Total",1198,603,595,1198,0,31,2207.56,0.5
"2011","South Norfolk 012E","E01026904","Total",1362,655,707,1362,0,18,2374.38,0.6
"2011","South Norfolk 013A","E01026872","Total",2200,1117,1083,2194,6,26,3335.92,0.7
"2011","South Norfolk 013B","E01026900","Total",1446,682,764,1446,0,11,116.51,12.4
"2011","South Norfolk 013C","E01026901","Total",1333,621,712,1333,0,11,1171.52,1.1
"2011","South Norfolk 013D","E01026902","Total",1862,935,927,1832,30,14,84.60,22.0
"2011","South Norfolk 014A","E01026873","Total",1265,630,635,1255,10,23,2275.71,0.6
"2011","South Norfolk 014B","E01026874","Total",1545,761,784,1521,24,27,3763.62,0.4
"2011","South Norfolk 014C","E01026886","Total",1342,663,679,1335,7,14,1720.56,0.8
"2011","South Norfolk 014D","E01026887","Total",1472,746,726,1453,19,18,1430.87,1.0
"2011","South Norfolk 014E","E01026934","Total",1028,514,514,1027,1,8,173.08,5.9
"2011","South Norfolk 014F","E01026935","Total",1329,642,687,1306,23,18,2701.37,0.5
"2011","South Norfolk 015A","E01026888","Total",1617,741,876,1581,36,14,229.68,7.0
"2011","South Norfolk 015B","E01026889","Total",1522,719,803,1522,0,15,62.41,24.4
"2011","South Norfolk 015D","E01026891","Total",1646,798,848,1613,33,7,76.65,21.5
"2011","South Norfolk 015E","E01026931","Total",1214,605,609,1186,28,16,402.49,3.0
"2011","South Norfolk 015F","E01026932","Total",1236,612,624,1236,0,13,119.63,10.3
"2011","South Norfolk 015G","E01033539","Total",1391,691,700,1391,0,9,131.86,10.5
"2011","South Norfolk 015H","E01033541","Total",1396,682,714,1396,0,9,31.57,44.2
"2011","Babergh 001A","E01029876","Total",2181,1126,1055,2079,102,49,3254.18,0.7
"2011","Babergh 001B","E01029898","Total",1722,822,900,1713,9,25,1200.32,1.4
"2011","Babergh 001C","E01029907","Total",2162,1054,1108,2133,29,53,5545.93,0.4
"2011","Babergh 002A","E01029881","Total",2057,1018,1039,2032,25,51,4094.05,0.5
"2011","Babergh 002B","E01029884","Total",1556,783,773,1555,1,14,355.45,4.4
"2011","Babergh 002C","E01029885","Total",2145,1078,1067,2131,14,28,1037.32,2.1
"2011","Babergh 003A","E01029900","Total",1622,784,838,1622,0,17,1414.66,1.1
"2011","Babergh 003B","E01029901","Total",2152,1064,1088,2098,54,33,1273.79,1.7
"2011","Babergh 003C","E01029917","Total",1893,916,977,1893,0,22,92.53,20.5
"2011","Babergh 004A","E01029892","Total",1835,884,951,1811,24,15,44.58,41.2
"2011","Babergh 004B","E01029893","Total",2686,1324,1362,2642,44,33,977.40,2.7
"2011","Babergh 004C","E01029894","Total",1163,578,585,1163,0,29,41.24,28.2
"2011","Babergh 004D","E01029895","Total",1189,575,614,1189,0,32,625.02,1.9
"2011","Babergh 004E","E01029896","Total",1380,638,742,1378,2,20,38.18,36.1
"2011","Babergh 004F","E01029911","Total",2191,1082,1109,2189,2,53,4311.21,0.5
"2011","Babergh 005A","E01029877","Total",1295,639,656,1247,48,35,2274.20,0.6
"2011","Babergh 005B","E01029878","Total",1198,577,621,1141,57,17,303.95,3.9
"2011","Babergh 005C","E01029879","Total",1515,756,759,1475,40,29,2107.73,0.7
"2011","Babergh 005D","E01029908","Total",1629,792,837,1629,0,26,149.09,10.9
"2011","Babergh 005E","E01029909","Total",1556,762,794,1556,0,13,49.79,31.3
"2011","Babergh 005F","E01029910","Total",1157,580,577,1157,0,12,18.70,61.9
"2011","Babergh 006A","E01029880","Total",1699,845,854,1699,0,44,2697.38,0.6
"2011","Babergh 006B","E01029921","Total",1270,635,635,1270,0,30,526.15,2.4
"2011","Babergh 006C","E01029922","Total",1306,639,667,1282,24,24,2421.32,0.5
"2011","Babergh 006D","E01029923","Total",1399,690,709,1399,0,18,153.51,9.1
"2011","Babergh 007A","E01029912","Total",1615,756,859,1580,35,13,29.10,55.5
"2011","Babergh 007B","E01029913","Total",1083,500,583,1083,0,2,90.79,11.9
"2011","Babergh 007C","E01029914","Total",1620,803,817,1620,0,14,25.92,62.5
"2011","Babergh 007D","E01029915","Total",1223,582,641,1163,60,21,32.31,37.9
"2011","Babergh 007E","E01029916","Total",1313,626,687,1313,0,9,70.76,18.6
"2011","Babergh 007F","E01029918","Total",1107,575,532,1077,30,12,57.40,19.3
"2011","Babergh 007G","E01029919","Total",1485,700,785,1418,67,16,350.01,4.2
"2011","Babergh 007H","E01029920","Total",1724,786,938,1687,37,19,43.22,39.9
"2011","Babergh 008A","E01029886","Total",1294,594,700,1164,130,9,42.00,30.8
"2011","Babergh 008B","E01029887","Total",1800,889,911,1795,5,20,50.86,35.4
"2011","Babergh 008C","E01029888","Total",1203,586,617,1203,0,7,24.75,48.6
"2011","Babergh 008D","E01029889","Total",1349,669,680,1349,0,18,84.27,16.0
"2011","Babergh 008E","E01029890","Total",1337,672,665,1337,0,18,356.21,3.8
"2011","Babergh 008F","E01029891","Total",1925,978,947,1925,0,36,90.94,21.2
"2011","Babergh 009A","E01029875","Total",2170,1092,1078,2170,0,66,2984.45,0.7
"2011","Babergh 009B","E01029899","Total",1772,852,920,1765,7,42,1778.41,1.0
"2011","Babergh 009C","E01029902","Total",2150,1095,1055,2133,17,83,4045.53,0.5
"2011","Babergh 009D","E01029906","Total",1845,863,982,1787,58,66,2727.29,0.7
"2011","Babergh 010A","E01029870","Total",1165,557,608,1165,0,18,80.10,14.5
"2011","Babergh 010B","E01029872","Total",1401,708,693,1401,0,22,686.23,2.0
"2011","Babergh 010C","E01029882","Total",1561,773,788,1499,62,31,607.95,2.6
"2011","Babergh 010D","E01029883","Total",1980,1000,980,1980,0,50,1794.40,1.1
"2011","Babergh 010E","E01029903","Total",1403,698,705,1403,0,24,660.24,2.1
"2011","Babergh 010F","E01029904","Total",1444,718,726,1444,0,21,118.65,12.2
"2011","Babergh 010G","E01029905","Total",1087,527,560,1087,0,32,1759.61,0.6
"2011","Babergh 011A","E01029871","Total",1352,641,711,1352,0,44,1484.82,0.9
"2011","Babergh 011B","E01029873","Total",2157,1063,1094,2128,29,34,2318.05,0.9
"2011","Babergh 011C","E01029874","Total",1750,862,888,1750,0,20,404.76,4.3
"2011","Babergh 011D","E01029897","Total",2467,1198,1269,1909,558,92,1570.95,1.6
"2011","Forest Heath 001A","E01029926","Total",1664,818,846,1664,0,9,74.28,22.4
"2011","Forest Heath 001B","E01029927","Total",2360,1180,1180,2339,21,14,85.30,27.7
"2011","Forest Heath 001C","E01029928","Total",1829,918,911,1824,5,12,4223.67,0.4
"2011","Forest Heath 001D","E01029929","Total",2238,1118,1120,2238,0,12,130.52,17.1
"2011","Forest Heath 001E","E01029930","Total",1545,785,760,1506,39,7,3049.82,0.5
"2011","Forest Heath 002C","E01029942","Total",1473,738,735,1455,18,11,223.64,6.6
"2011","Forest Heath 002E","E01029944","Total",1671,829,842,1671,0,11,286.97,5.8
"2011","Forest Heath 002F","E01033453","Total",3414,1939,1475,2374,1040,15,4562.71,0.7
"2011","Forest Heath 003E","E01029945","Total",1922,975,947,1906,16,17,2386.70,0.8
"2011","Forest Heath 003F","E01032523","Total",1315,706,609,1164,151,9,499.02,2.6
"2011","Forest Heath 003G","E01032524","Total",983,481,502,983,0,5,2133.87,0.5
"2011","Forest Heath 003H","E01032525","Total",2833,1434,1399,2829,4,10,3090.11,0.9
"2011","Forest Heath 003I","E01032526","Total",1627,840,787,1627,0,16,2446.48,0.7
"2011","Forest Heath 004A","E01029938","Total",1401,725,676,1401,0,20,25.98,53.9
"2011","Forest Heath 004B","E01029939","Total",1540,772,768,1532,8,14,119.08,12.9
"2011","Forest Heath 004C","E01029940","Total",1433,701,732,1433,0,9,98.39,14.6
"2011","Forest Heath 004D","E01029946","Total",2112,1039,1073,2112,0,16,640.61,3.3
"2011","Forest Heath 004E","E01029947","Total",2202,1089,1113,2140,62,19,272.22,8.1
"2011","Forest Heath 005A","E01029941","Total",1824,931,893,1824,0,24,7160.39,0.3
"2011","Forest Heath 005C","E01029957","Total",1663,810,853,1650,13,34,2469.07,0.7
"2011","Forest Heath 005D","E01033451","Total",1475,717,758,1475,0,3,62.34,23.7
"2011","Forest Heath 005E","E01033452","Total",1394,722,672,1394,0,13,946.26,1.5
"2011","Forest Heath 005F","E01033454","Total",1255,651,604,1255,0,13,140.00,9.0
"2011","Forest Heath 006A","E01029937","Total",1960,1004,956,1921,39,29,1178.68,1.7
"2011","Forest Heath 006B","E01029953","Total",1424,692,732,1424,0,14,85.42,16.7
"2011","Forest Heath 006C","E01029954","Total",2439,1216,1223,2413,26,25,237.24,10.3
"2011","Forest Heath 006D","E01029955","Total",1817,885,932,1816,1,22,106.17,17.1
"2011","Forest Heath 006E","E01029956","Total",1356,692,664,1356,0,9,64.47,21.0
"2011","Forest Heath 008A","E01029925","Total",1714,871,843,1698,16,13,150.72,11.4
"2011","Forest Heath 008B","E01029949","Total",1404,679,725,1385,19,15,54.52,25.8
"2011","Forest Heath 008C","E01029950","Total",1785,897,888,1784,1,2,36.17,49.4
"2011","Forest Heath 008D","E01029951","Total",1393,684,709,1384,9,11,661.62,2.1
"2011","Forest Heath 008E","E01029952","Total",1261,602,659,1177,84,4,34.40,36.7
"2011","Forest Heath 008F","E01032612","Total",2022,1013,1009,2021,1,14,34.22,59.1
"2011","Ipswich 001A","E01030032","Total",1506,725,781,1506,0,5,21.69,69.4
"2011","Ipswich 001B","E01030033","Total",1534,756,778,1534,0,16,59.60,25.7
"2011","Ipswich 001C","E01030034","Total",1414,687,727,1414,0,13,168.66,8.4
"2011","Ipswich 001D","E01030035","Total",1842,902,940,1840,2,9,85.71,21.5
"2011","Ipswich 001E","E01030036","Total",1743,835,908,1743,0,9,28.21,61.8
"2011","Ipswich 002A","E01029973","Total",1515,735,780,1515,0,37,51.21,29.6
"2011","Ipswich 002B","E01029974","Total",1568,769,799,1524,44,26,33.67,46.6
"2011","Ipswich 002C","E01029975","Total",1294,626,668,1294,0,11,19.07,67.9
"2011","Ipswich 002D","E01029976","Total",1549,783,766,1549,0,8,28.46,54.4
"2011","Ipswich 002E","E01029977","Total",1537,751,786,1537,0,19,42.94,35.8
"2011","Ipswich 003A","E01030027","Total",2059,1047,1012,2059,0,9,52.28,39.4
"2011","Ipswich 003B","E01030028","Total",1631,792,839,1631,0,11,44.58,36.6
"2011","Ipswich 003C","E01030029","Total",1637,818,819,1637,0,12,44.11,37.1
"2011","Ipswich 003D","E01030030","Total",2001,1004,997,2001,0,8,24.62,81.3
"2011","Ipswich 003E","E01030031","Total",1551,753,798,1551,0,8,94.71,16.4
"2011","Ipswich 004A","E01029997","Total",1591,770,821,1589,2,22,33.52,47.5
"2011","Ipswich 004B","E01029998","Total",1902,926,976,1898,4,19,42.41,44.8
"2011","Ipswich 004C","E01029999","Total",1708,847,861,1705,3,31,35.92,47.6
"2011","Ipswich 004D","E01030000","Total",1569,775,794,1569,0,19,22.02,71.3
"2011","Ipswich 004E","E01030001","Total",1554,735,819,1511,43,23,130.90,11.9
"2011","Ipswich 005A","E01030007","Total",1650,798,852,1605,45,36,52.96,31.2
"2011","Ipswich 005B","E01030008","Total",1303,611,692,1249,54,52,104.28,12.5
"2011","Ipswich 005C","E01030009","Total",1481,736,745,1320,161,38,49.38,30.0
"2011","Ipswich 005D","E01030010","Total",1854,924,930,1846,8,26,43.82,42.3
"2011","Ipswich 005E","E01030011","Total",1588,767,821,1588,0,62,143.32,11.1
"2011","Ipswich 006A","E01030022","Total",2199,1140,1059,2199,0,14,25.35,86.7
"2011","Ipswich 006B","E01030023","Total",1886,999,887,1883,3,3,24.84,75.9
"2011","Ipswich 006C","E01030024","Total",2341,1386,955,1947,394,18,18.69,125.3
"2011","Ipswich 006D","E01030025","Total",1788,896,892,1686,102,18,25.16,71.1
"2011","Ipswich 006E","E01030026","Total",1724,849,875,1713,11,8,23.12,74.6
"2011","Ipswich 007A","E01029958","Total",1420,715,705,1404,16,26,18.00,78.9
"2011","Ipswich 007C","E01029960","Total",1795,864,931,1784,11,19,28.84,62.2
"2011","Ipswich 007D","E01029961","Total",1523,744,779,1504,19,19,20.37,74.8
"2011","Ipswich 007E","E01029962","Total",1594,828,766,1594,0,25,16.84,94.7
"2011","Ipswich 007F","E01033124","Total",1105,563,542,633,472,17,26.47,41.7
"2011","Ipswich 007G","E01033125","Total",1022,577,445,1017,5,8,38.98,26.2
"2011","Ipswich 007H","E01033129","Total",1241,705,536,1172,69,7,39.72,31.2
"2011","Ipswich 008A","E01030002","Total",1913,924,989,1875,38,20,32.43,59.0
"2011","Ipswich 008B","E01030003","Total",1736,823,913,1681,55,11,24.40,71.1
"2011","Ipswich 008C","E01030004","Total",1341,657,684,1299,42,11,28.83,46.5
"2011","Ipswich 008D","E01030005","Total",2316,1123,1193,2281,35,14,57.00,40.6
"2011","Ipswich 008E","E01030006","Total",1828,893,935,1828,0,17,20.00,91.4
"2011","Ipswich 009A","E01029963","Total",1541,764,777,1531,10,36,71.53,21.5
"2011","Ipswich 009B","E01029964","Total",1341,704,637,1326,15,16,27.02,49.6
"2011","Ipswich 009C","E01029965","Total",1474,705,769,1460,14,15,55.31,26.6
"2011","Ipswich 009D","E01029966","Total",1402,712,690,1389,13,20,48.76,28.8
"2011","Ipswich 009E","E01029967","Total",1297,605,692,1297,0,17,41.81,31.0
"2011","Ipswich 010A","E01029984","Total",1527,750,777,1498,29,7,97.74,15.6
"2011","Ipswich 010B","E01029985","Total",2305,1211,1094,2297,8,9,111.49,20.7
"2011","Ipswich 010C","E01029986","Total",1573,764,809,1573,0,9,56.11,28.0
"2011","Ipswich 010D","E01029987","Total",1562,763,799,1562,0,4,27.14,57.6
"2011","Ipswich 010E","E01029988","Total",1859,1037,822,1799,60,8,49.89,37.3
"2011","Ipswich 011B","E01029990","Total",1617,837,780,1617,0,17,22.21,72.8
"2011","Ipswich 011C","E01029991","Total",1633,825,808,1633,0,14,67.96,24.0
"2011","Ipswich 011D","E01029992","Total",1328,637,691,1328,0,7,28.57,46.5
"2011","Ipswich 011E","E01033123","Total",1799,918,881,1787,12,11,37.48,48.0
"2011","Ipswich 011F","E01033126","Total",1422,820,602,1422,0,7,33.32,42.7
"2011","Ipswich 012A","E01029968","Total",1477,752,725,1471,6,13,20.45,72.2
"2011","Ipswich 012B","E01029969","Total",1470,700,770,1320,150,16,61.45,23.9
"2011","Ipswich 012C","E01029970","Total",1735,869,866,1735,0,14,34.18,50.8
"2011","Ipswich 012D","E01029971","Total",1465,690,775,1419,46,11,26.11,56.1
"2011","Ipswich 012F","E01033122","Total",1441,763,678,1427,14,4,34.52,41.7
"2011","Ipswich 012G","E01033130","Total",1044,570,474,1034,10,8,12.50,83.5
"2011","Ipswich 013A","E01030012","Total",1120,564,556,1120,0,0,17.84,62.8
"2011","Ipswich 013B","E01030013","Total",1397,647,750,1382,15,9,25.16,55.5
"2011","Ipswich 013C","E01030014","Total",1400,676,724,1400,0,3,28.19,49.7
"2011","Ipswich 013D","E01030015","Total",1310,647,663,1310,0,9,26.70,49.1
"2011","Ipswich 013E","E01030016","Total",1433,706,727,1433,0,15,23.77,60.3
"2011","Ipswich 014B","E01029994","Total",1616,781,835,1616,0,11,31.31,51.6
"2011","Ipswich 014C","E01029995","Total",1602,797,805,1580,22,22,37.14,43.1
"2011","Ipswich 014D","E01029996","Total",1701,853,848,1701,0,10,27.24,62.4
"2011","Ipswich 014E","E01033127","Total",1528,749,779,1526,2,8,212.54,7.2
"2011","Ipswich 014F","E01033128","Total",1102,539,563,1102,0,10,64.46,17.1
"2011","Ipswich 014G","E01033131","Total",1442,669,773,1429,13,3,40.62,35.5
"2011","Ipswich 015A","E01030017","Total",1365,663,702,1365,0,5,30.46,44.8
"2011","Ipswich 015B","E01030018","Total",1464,746,718,1464,0,10,25.00,58.6
"2011","Ipswich 015C","E01030019","Total",1555,764,791,1517,38,19,69.18,22.5
"2011","Ipswich 015D","E01030020","Total",1500,727,773,1500,0,13,30.84,48.6
"2011","Ipswich 015E","E01030021","Total",1392,669,723,1392,0,14,41.51,33.5
"2011","Ipswich 016A","E01029978","Total",1321,654,667,1321,0,6,19.62,67.3
"2011","Ipswich 016B","E01029979","Total",1650,797,853,1643,7,6,30.98,53.3
"2011","Ipswich 016C","E01029980","Total",1625,743,882,1625,0,7,171.43,9.5
"2011","Ipswich 016D","E01029981","Total",1166,576,590,1166,0,9,43.82,26.6
"2011","Ipswich 016E","E01029982","Total",1461,723,738,1461,0,10,27.28,53.6
"2011","Ipswich 016F","E01029983","Total",1569,784,785,1569,0,8,23.73,66.1
"2011","Mid Suffolk 001A","E01030052","Total",2154,1032,1122,2133,21,25,1785.08,1.2
"2011","Mid Suffolk 001B","E01030058","Total",2060,1006,1054,2033,27,34,5041.67,0.4
"2011","Mid Suffolk 001C","E01030064","Total",2308,1146,1162,2231,77,36,2899.54,0.8
"2011","Mid Suffolk 001D","E01030088","Total",1167,572,595,1167,0,31,1711.88,0.7
"2011","Mid Suffolk 002A","E01030039","Total",1462,737,725,1446,16,45,2308.83,0.6
"2011","Mid Suffolk 002B","E01030054","Total",1253,622,631,1253,0,26,2672.44,0.5
"2011","Mid Suffolk 002C","E01030055","Total",1398,694,704,1368,30,28,1570.81,0.9
"2011","Mid Suffolk 002D","E01030066","Total",1585,763,822,1585,0,30,1696.18,0.9
"2011","Mid Suffolk 002E","E01030067","Total",1273,615,658,1271,2,20,1652.36,0.8
"2011","Mid Suffolk 002F","E01030068","Total",1688,841,847,1687,1,26,1758.65,1.0
"2011","Mid Suffolk 003A","E01030053","Total",2292,1145,1147,2292,0,32,5006.78,0.5
"2011","Mid Suffolk 003B","E01030082","Total",2557,1285,1272,2557,0,45,3903.91,0.7
"2011","Mid Suffolk 003C","E01030090","Total",2429,1213,1216,2429,0,65,6184.82,0.4
"2011","Mid Suffolk 004A","E01030040","Total",1195,565,630,1176,19,26,2130.54,0.6
"2011","Mid Suffolk 004B","E01030049","Total",1691,828,863,1689,2,49,1968.60,0.9
"2011","Mid Suffolk 004C","E01030050","Total",2038,996,1042,2038,0,27,137.65,14.8
"2011","Mid Suffolk 004D","E01030084","Total",1611,800,811,1611,0,40,722.74,2.2
"2011","Mid Suffolk 004E","E01030085","Total",1621,797,824,1621,0,43,138.51,11.7
"2011","Mid Suffolk 005A","E01030037","Total",1211,609,602,1211,0,15,1403.95,0.9
"2011","Mid Suffolk 005B","E01030038","Total",1228,618,610,1214,14,26,923.89,1.3
"2011","Mid Suffolk 005C","E01030059","Total",2254,1116,1138,2254,0,41,3137.17,0.7
"2011","Mid Suffolk 005D","E01030081","Total",2263,1124,1139,2263,0,34,1514.17,1.5
"2011","Mid Suffolk 006A","E01030051","Total",1696,841,855,1696,0,21,165.15,10.3
"2011","Mid Suffolk 006B","E01030056","Total",2181,1073,1108,2181,0,40,1868.13,1.2
"2011","Mid Suffolk 006C","E01030065","Total",2080,1026,1054,2080,0,42,3094.72,0.7
"2011","Mid Suffolk 006D","E01030086","Total",1177,578,599,1177,0,30,912.64,1.3
"2011","Mid Suffolk 006E","E01030089","Total",1995,979,1016,1993,2,36,748.29,2.7
"2011","Mid Suffolk 007A","E01030048","Total",2369,1122,1247,2366,3,56,2299.00,1.0
"2011","Mid Suffolk 007B","E01030057","Total",2323,1167,1156,2323,0,48,5457.72,0.4
"2011","Mid Suffolk 007C","E01030083","Total",2326,1168,1158,2321,5,59,3595.95,0.6
"2011","Mid Suffolk 007D","E01030087","Total",1363,695,668,1363,0,30,3189.00,0.4
"2011","Mid Suffolk 008A","E01030073","Total",1502,699,803,1502,0,18,54.94,27.3
"2011","Mid Suffolk 008B","E01030077","Total",1503,693,810,1432,71,10,42.39,35.5
"2011","Mid Suffolk 008C","E01030079","Total",1632,750,882,1599,33,14,37.66,43.3
"2011","Mid Suffolk 008D","E01030080","Total",1641,791,850,1641,0,20,75.81,21.6
"2011","Mid Suffolk 009A","E01030063","Total",2364,1128,1236,2200,164,44,2585.41,0.9
"2011","Mid Suffolk 009B","E01030069","Total",1310,664,646,1310,0,43,1699.45,0.8
"2011","Mid Suffolk 009C","E01030072","Total",1604,787,817,1565,39,14,56.61,28.3
"2011","Mid Suffolk 009D","E01030075","Total",1668,832,836,1668,0,33,36.97,45.1
"2011","Mid Suffolk 010A","E01030060","Total",1636,779,857,1636,0,19,509.51,3.2
"2011","Mid Suffolk 010B","E01030071","Total",1467,706,761,1438,29,9,82.88,17.7
"2011","Mid Suffolk 010D","E01030076","Total",1489,752,737,1486,3,19,68.28,21.8
"2011","Mid Suffolk 010E","E01030078","Total",1717,877,840,1717,0,14,119.08,14.4
"2011","Mid Suffolk 010F","E01033316","Total",1572,757,815,1572,0,10,50.27,31.3
"2011","Mid Suffolk 010G","E01033317","Total",1573,795,778,1573,0,12,53.53,29.4
"2011","Mid Suffolk 010H","E01033319","Total",1912,950,962,1912,0,20,77.44,24.7
"2011","Mid Suffolk 011A","E01030041","Total",2165,1092,1073,2122,43,47,3682.35,0.6
"2011","Mid Suffolk 011B","E01030043","Total",1235,624,611,1227,8,15,345.71,3.6
"2011","Mid Suffolk 011C","E01030061","Total",1556,750,806,1527,29,11,66.50,23.4
"2011","Mid Suffolk 011D","E01030062","Total",1336,638,698,1336,0,16,65.81,20.3
"2011","Mid Suffolk 011E","E01030070","Total",2200,1449,751,1459,741,43,1241.26,1.8
"2011","Mid Suffolk 012A","E01030042","Total",1567,784,783,1567,0,26,1674.43,0.9
"2011","Mid Suffolk 012B","E01030044","Total",1148,556,592,1148,0,4,108.50,10.6
"2011","Mid Suffolk 012C","E01030045","Total",1804,878,926,1740,64,20,935.83,1.9
"2011","Mid Suffolk 012D","E01030046","Total",1624,803,821,1590,34,19,1780.57,0.9
"2011","Mid Suffolk 012E","E01030047","Total",1258,617,641,1258,0,12,55.15,22.8
"2011","St Edmundsbury 001A","E01030095","Total",1179,589,590,1179,0,21,1666.23,0.7
"2011","St Edmundsbury 001B","E01030096","Total",1443,713,730,1443,0,26,1820.08,0.8
"2011","St Edmundsbury 001C","E01030097","Total",1201,595,606,1201,0,16,1565.91,0.8
"2011","St Edmundsbury 001D","E01030145","Total",1412,702,710,1393,19,21,492.30,2.9
"2011","St Edmundsbury 001E","E01030146","Total",1095,540,555,1095,0,17,1141.06,1.0
"2011","St Edmundsbury 002A","E01030094","Total",1412,678,734,1412,0,25,5910.97,0.2
"2011","St Edmundsbury 002B","E01030121","Total",2365,1138,1227,2278,87,43,1364.35,1.7
"2011","St Edmundsbury 002C","E01030132","Total",1956,1297,659,1247,709,30,794.70,2.5
"2011","St Edmundsbury 002D","E01030133","Total",1464,716,748,1464,0,17,3638.81,0.4
"2011","St Edmundsbury 003A","E01030130","Total",1293,613,680,1293,0,12,57.30,22.6
"2011","St Edmundsbury 003B","E01030131","Total",1299,641,658,1299,0,5,18.19,71.4
"2011","St Edmundsbury 003C","E01030139","Total",1725,856,869,1725,0,11,31.05,55.6
"2011","St Edmundsbury 003D","E01030140","Total",1277,646,631,1277,0,11,48.27,26.5
"2011","St Edmundsbury 003E","E01030141","Total",1607,773,834,1601,6,7,26.45,60.8
"2011","St Edmundsbury 004A","E01030103","Total",2030,956,1074,1929,101,44,1309.28,1.6
"2011","St Edmundsbury 004B","E01030104","Total",2191,1109,1082,2172,19,38,1504.70,1.5
"2011","St Edmundsbury 004C","E01030138","Total",2341,1171,1170,2341,0,47,4297.27,0.5
"2011","St Edmundsbury 005B","E01030127","Total",1246,628,618,1237,9,22,83.07,15.0
"2011","St Edmundsbury 005C","E01030128","Total",1472,747,725,1472,0,23,25.51,57.7
"2011","St Edmundsbury 005D","E01030129","Total",1427,721,706,1427,0,31,68.69,20.8
"2011","St Edmundsbury 005E","E01033044","Total",1458,726,732,1458,0,15,30.64,47.6
"2011","St Edmundsbury 005F","E01033045","Total",1072,526,546,1072,0,15,34.39,31.2
"2011","St Edmundsbury 005G","E01033050","Total",1293,649,644,1293,0,15,76.61,16.9
"2011","St Edmundsbury 006A","E01030091","Total",1782,860,922,1724,58,33,52.57,33.9
"2011","St Edmundsbury 006B","E01030093","Total",1532,763,769,1504,28,27,73.67,20.8
"2011","St Edmundsbury 006D","E01030137","Total",1591,794,797,1579,12,17,71.57,22.2
"2011","St Edmundsbury 006E","E01033043","Total",1224,600,624,1215,9,14,27.69,44.2
"2011","St Edmundsbury 006F","E01033046","Total",1123,600,523,1104,19,19,14.96,75.1
"2011","St Edmundsbury 006G","E01033047","Total",1176,603,573,1132,44,25,41.36,28.4
"2011","St Edmundsbury 007A","E01030092","Total",1679,796,883,1679,0,19,41.21,40.7
"2011","St Edmundsbury 007B","E01030123","Total",1596,817,779,1596,0,23,32.42,49.2
"2011","St Edmundsbury 007C","E01030124","Total",1530,746,784,1530,0,34,92.92,16.5
"2011","St Edmundsbury 007D","E01030125","Total",1511,714,797,1511,0,23,37.03,40.8
"2011","St Edmundsbury 007E","E01030148","Total",1260,623,637,1228,32,14,50.00,25.2
"2011","St Edmundsbury 007F","E01030149","Total",1477,705,772,1477,0,26,46.48,31.8
"2011","St Edmundsbury 008A","E01030098","Total",2317,1109,1208,2317,0,38,3127.91,0.7
"2011","St Edmundsbury 008B","E01030100","Total",2090,1018,1072,2055,35,48,3778.48,0.6
"2011","St Edmundsbury 008C","E01030119","Total",2255,1116,1139,2245,10,42,2647.57,0.9
"2011","St Edmundsbury 008D","E01030134","Total",1188,569,619,1099,89,20,1878.88,0.6
"2011","St Edmundsbury 008E","E01030135","Total",1458,745,713,1292,166,30,4716.63,0.3
"2011","St Edmundsbury 009B","E01030142","Total",1712,819,893,1660,52,43,173.79,9.9
"2011","St Edmundsbury 009C","E01030143","Total",1592,817,775,1592,0,18,30.24,52.6
"2011","St Edmundsbury 009D","E01030144","Total",1235,584,651,1235,0,20,138.02,8.9
"2011","St Edmundsbury 009E","E01030147","Total",1458,707,751,1437,21,24,53.52,27.2
"2011","St Edmundsbury 009F","E01033048","Total",1274,613,661,1210,64,15,202.31,6.3
"2011","St Edmundsbury 009G","E01033049","Total",1192,524,668,1114,78,15,20.61,57.8
"2011","St Edmundsbury 010A","E01030099","Total",1984,979,1005,1966,18,32,4816.75,0.4
"2011","St Edmundsbury 010B","E01030101","Total",2028,954,1074,2015,13,36,926.32,2.2
"2011","St Edmundsbury 010C","E01030150","Total",2192,1094,1098,2192,0,61,4544.24,0.5
"2011","St Edmundsbury 011A","E01030120","Total",3002,1916,1086,2118,884,28,3625.50,0.8
"2011","St Edmundsbury 011B","E01030122","Total",2017,985,1032,1950,67,13,1458.52,1.4
"2011","St Edmundsbury 011C","E01030151","Total",2234,1220,1014,1955,279,63,5872.25,0.4
"2011","St Edmundsbury 012A","E01030109","Total",1864,913,951,1843,21,10,39.58,47.1
"2011","St Edmundsbury 012B","E01030110","Total",2839,1356,1483,2839,0,15,102.21,27.8
"2011","St Edmundsbury 012C","E01030111","Total",1392,694,698,1392,0,26,38.66,36.0
"2011","St Edmundsbury 012D","E01030112","Total",1701,886,815,1679,22,14,46.27,36.8
"2011","St Edmundsbury 013A","E01030115","Total",2364,1160,1204,2364,0,7,220.80,10.7
"2011","St Edmundsbury 013B","E01030116","Total",2299,1143,1156,2251,48,20,149.18,15.4
"2011","St Edmundsbury 013C","E01030117","Total",1632,822,810,1625,7,15,37.06,44.0
"2011","St Edmundsbury 013D","E01030118","Total",1679,834,845,1676,3,15,29.75,56.4
"2011","St Edmundsbury 014A","E01030105","Total",1797,914,883,1789,8,6,31.77,56.6
"2011","St Edmundsbury 014B","E01030106","Total",2454,1233,1221,2454,0,9,130.91,18.7
"2011","St Edmundsbury 014C","E01030107","Total",1620,807,813,1616,4,12,41.31,39.2
"2011","St Edmundsbury 014D","E01030108","Total",1885,937,948,1885,0,11,49.74,37.9
"2011","St Edmundsbury 014E","E01030113","Total",1900,942,958,1890,10,13,99.93,19.0
"2011","St Edmundsbury 014F","E01030114","Total",1615,833,782,1600,15,14,79.99,20.2
"2011","Suffolk Coastal 001A","E01030201","Total",2076,1041,1035,2076,0,52,8058.78,0.3
"2011","Suffolk Coastal 001B","E01030219","Total",1966,956,1010,1919,47,54,4965.69,0.4
"2011","Suffolk Coastal 001C","E01030222","Total",1901,911,990,1843,58,35,5472.99,0.3
"2011","Suffolk Coastal 002A","E01030154","Total",2144,1052,1092,2118,26,67,5115.32,0.4
"2011","Suffolk Coastal 002B","E01030172","Total",1657,800,857,1657,0,37,1623.47,1.0
"2011","Suffolk Coastal 002C","E01030173","Total",1685,802,883,1445,240,36,273.49,6.2
"2011","Suffolk Coastal 002D","E01030174","Total",1402,672,730,1338,64,38,3112.22,0.5
"2011","Suffolk Coastal 002E","E01030176","Total",1977,962,1015,1977,0,44,5550.41,0.4
"2011","Suffolk Coastal 003A","E01030186","Total",1449,710,739,1412,37,17,783.07,1.9
"2011","Suffolk Coastal 003B","E01030208","Total",1269,627,642,1269,0,16,2484.58,0.5
"2011","Suffolk Coastal 003C","E01030209","Total",1520,719,801,1491,29,13,400.71,3.8
"2011","Suffolk Coastal 003D","E01030210","Total",2124,1011,1113,2113,11,24,144.45,14.7
"2011","Suffolk Coastal 003E","E01030212","Total",1911,903,1008,1911,0,43,3870.97,0.5
"2011","Suffolk Coastal 004A","E01030152","Total",2001,888,1113,1935,66,32,1504.58,1.3
"2011","Suffolk Coastal 004B","E01030153","Total",1224,585,639,1219,5,11,259.54,4.7
"2011","Suffolk Coastal 004C","E01030187","Total",1581,765,816,1563,18,22,1452.65,1.1
"2011","Suffolk Coastal 004D","E01030188","Total",1639,806,833,1623,16,16,39.53,41.5
"2011","Suffolk Coastal 004E","E01030189","Total",1691,805,886,1625,66,16,237.22,7.1
"2011","Suffolk Coastal 005A","E01030193","Total",1638,823,815,1638,0,55,1428.51,1.1
"2011","Suffolk Coastal 005B","E01030194","Total",1612,738,874,1612,0,11,234.11,6.9
"2011","Suffolk Coastal 005C","E01030195","Total",1633,800,833,1618,15,49,94.78,17.2
"2011","Suffolk Coastal 005D","E01030220","Total",2156,1025,1131,2120,36,18,481.45,4.5
"2011","Suffolk Coastal 006A","E01030175","Total",2306,1125,1181,2301,5,65,1808.78,1.3
"2011","Suffolk Coastal 006B","E01030200","Total",2272,1139,1133,2272,0,61,4404.17,0.5
"2011","Suffolk Coastal 006C","E01030221","Total",1965,962,1003,1932,33,59,2549.65,0.8
"2011","Suffolk Coastal 007C","E01030199","Total",1830,897,933,1828,2,38,6896.72,0.3
"2011","Suffolk Coastal 007F","E01033443","Total",1739,1058,681,1384,355,31,748.26,2.3
"2011","Suffolk Coastal 007G","E01033445","Total",1703,804,899,1656,47,15,204.60,8.3
"2011","Suffolk Coastal 007H","E01033446","Total",2473,1463,1010,2012,461,36,6843.41,0.4
"2011","Suffolk Coastal 007I","E01033448","Total",1275,617,658,1253,22,27,4912.34,0.3
"2011","Suffolk Coastal 007J","E01033449","Total",1685,823,862,1650,35,21,1357.70,1.2
"2011","Suffolk Coastal 008A","E01030155","Total",2073,1031,1042,2024,49,36,77.36,26.8
"2011","Suffolk Coastal 008B","E01030185","Total",2121,985,1136,2073,48,31,130.17,16.3
"2011","Suffolk Coastal 008C","E01030203","Total",1967,890,1077,1909,58,59,236.08,8.3
"2011","Suffolk Coastal 008D","E01030211","Total",1935,853,1082,1914,21,39,59.14,32.7
"2011","Suffolk Coastal 009A","E01030179","Total",2686,1295,1391,2656,30,38,97.25,27.6
"2011","Suffolk Coastal 009B","E01030180","Total",1398,686,712,1398,0,28,67.99,20.6
"2011","Suffolk Coastal 009C","E01030183","Total",1965,962,1003,1965,0,20,74.58,26.3
"2011","Suffolk Coastal 009D","E01030184","Total",1771,852,919,1771,0,11,102.67,17.2
"2011","Suffolk Coastal 009E","E01030207","Total",1475,726,749,1470,5,30,296.61,5.0
"2011","Suffolk Coastal 010A","E01030181","Total",1993,1005,988,1920,73,50,33.87,58.8
"2011","Suffolk Coastal 010C","E01030190","Total",1795,896,899,1790,5,18,848.34,2.1
"2011","Suffolk Coastal 010D","E01030191","Total",1621,806,815,1621,0,33,84.52,19.2
"2011","Suffolk Coastal 010E","E01030192","Total",1481,738,743,1481,0,49,121.38,12.2
"2011","Suffolk Coastal 010F","E01030198","Total",1294,641,653,1294,0,43,1735.34,0.7
"2011","Suffolk Coastal 010G","E01033442","Total",1622,770,852,1622,0,23,85.85,18.9
"2011","Suffolk Coastal 010H","E01033444","Total",1509,747,762,1509,0,25,17.64,85.5
"2011","Suffolk Coastal 010I","E01033447","Total",1458,705,753,1458,0,17,72.64,20.1
"2011","Suffolk Coastal 011A","E01030196","Total",1690,840,850,1690,0,41,67.50,25.0
"2011","Suffolk Coastal 011B","E01030197","Total",1618,810,808,1565,53,36,2668.92,0.6
"2011","Suffolk Coastal 011C","E01030204","Total",1850,924,926,1850,0,38,137.66,13.4
"2011","Suffolk Coastal 011D","E01030205","Total",1314,649,665,1314,0,33,33.77,38.9
"2011","Suffolk Coastal 011E","E01030206","Total",1546,764,782,1546,0,43,88.58,17.5
"2011","Suffolk Coastal 012A","E01030171","Total",1942,962,980,1907,35,18,240.58,8.1
"2011","Suffolk Coastal 012B","E01030214","Total",1327,675,652,1327,0,14,95.91,13.8
"2011","Suffolk Coastal 012C","E01030215","Total",1315,670,645,1312,3,14,233.06,5.6
"2011","Suffolk Coastal 012D","E01030216","Total",1485,704,781,1462,23,24,405.53,3.7
"2011","Suffolk Coastal 012E","E01030217","Total",1316,664,652,1316,0,25,1447.48,0.9
"2011","Suffolk Coastal 012F","E01030218","Total",1480,726,754,1475,5,20,862.58,1.7
"2011","Suffolk Coastal 013C","E01030158","Total",1431,700,731,1431,0,25,414.18,3.5
"2011","Suffolk Coastal 013D","E01030159","Total",1499,717,782,1499,0,19,37.14,40.4
"2011","Suffolk Coastal 013E","E01030164","Total",1516,707,809,1461,55,29,41.61,36.4
"2011","Suffolk Coastal 013F","E01030166","Total",1519,716,803,1464,55,35,73.58,20.6
"2011","Suffolk Coastal 013G","E01033450","Total",2379,1112,1267,2379,0,31,96.44,24.7
"2011","Suffolk Coastal 014A","E01030160","Total",1406,682,724,1406,0,19,310.48,4.5
"2011","Suffolk Coastal 014B","E01030161","Total",1393,657,736,1393,0,12,43.24,32.2
"2011","Suffolk Coastal 014C","E01030168","Total",1459,700,759,1459,0,18,35.30,41.3
"2011","Suffolk Coastal 014D","E01030169","Total",1546,775,771,1546,0,9,23.71,65.2
"2011","Suffolk Coastal 014E","E01030170","Total",1703,787,916,1703,0,7,96.80,17.6
"2011","Suffolk Coastal 015A","E01030162","Total",1391,654,737,1245,146,5,26.96,51.6
"2011","Suffolk Coastal 015B","E01030163","Total",1525,761,764,1480,45,13,158.40,9.6
"2011","Suffolk Coastal 015C","E01030165","Total",1580,773,807,1539,41,36,33.53,47.1
"2011","Suffolk Coastal 015D","E01030167","Total",1400,657,743,1337,63,25,27.91,50.2
"2011","Waveney 001A","E01030240","Total",1565,740,825,1548,17,21,108.50,14.4
"2011","Waveney 001B","E01030241","Total",1440,705,735,1434,6,10,454.78,3.2
"2011","Waveney 001C","E01030242","Total",1395,698,697,1388,7,21,110.61,12.6
"2011","Waveney 001D","E01030259","Total",1132,558,574,1096,36,25,1273.47,0.9
"2011","Waveney 001E","E01030260","Total",1436,930,506,988,448,15,1791.82,0.8
"2011","Waveney 002A","E01030261","Total",1419,695,724,1416,3,3,38.36,37.0
"2011","Waveney 002B","E01030262","Total",1241,581,660,1241,0,7,46.22,26.8
"2011","Waveney 002C","E01030277","Total",1192,564,628,1192,0,9,23.76,50.2
"2011","Waveney 002D","E01030279","Total",1391,669,722,1384,7,6,21.91,63.5
"2011","Waveney 002E","E01030281","Total",2406,1163,1243,2365,41,26,78.01,30.8
"2011","Waveney 003A","E01030266","Total",1676,806,870,1615,61,13,109.64,15.3
"2011","Waveney 003B","E01030267","Total",1358,673,685,1358,0,13,89.42,15.2
"2011","Waveney 003C","E01030271","Total",1456,711,745,1456,0,11,46.80,31.1
"2011","Waveney 003D","E01030278","Total",1578,743,835,1578,0,4,39.74,39.7
"2011","Waveney 003E","E01030280","Total",1400,696,704,1400,0,18,39.06,35.8
"2011","Waveney 004A","E01030246","Total",1412,695,717,1412,0,6,17.92,78.8
"2011","Waveney 004B","E01030248","Total",1487,731,756,1471,16,19,14.21,104.6
"2011","Waveney 004C","E01030249","Total",1646,806,840,1646,0,22,25.18,65.4
"2011","Waveney 004D","E01030250","Total",1806,885,921,1806,0,14,34.07,53.0
"2011","Waveney 004E","E01030264","Total",1427,699,728,1427,0,3,31.93,44.7
"2011","Waveney 004F","E01030265","Total",1446,696,750,1438,8,4,20.29,71.3
"2011","Waveney 005A","E01030255","Total",1357,673,684,1357,0,11,50.97,26.6
"2011","Waveney 005B","E01030263","Total",1365,691,674,1365,0,10,79.90,17.1
"2011","Waveney 005C","E01030270","Total",1542,769,773,1499,43,10,54.88,28.1
"2011","Waveney 005D","E01030289","Total",1445,697,748,1445,0,10,75.66,19.1
"2011","Waveney 005E","E01030290","Total",1508,738,770,1508,0,10,39.13,38.5
"2011","Waveney 006A","E01030233","Total",1512,748,764,1512,0,22,46.53,32.5
"2011","Waveney 006B","E01030235","Total",1482,703,779,1444,38,12,78.65,18.8
"2011","Waveney 006C","E01030268","Total",1353,655,698,1353,0,20,47.13,28.7
"2011","Waveney 006D","E01030269","Total",1621,776,845,1552,69,15,79.04,20.5
"2011","Waveney 006E","E01030288","Total",1414,683,731,1414,0,13,45.93,30.8
"2011","Waveney 007A","E01030247","Total",1467,731,736,1422,45,8,90.01,16.3
"2011","Waveney 007B","E01030254","Total",1463,701,762,1463,0,16,16.49,88.7
"2011","Waveney 007C","E01030256","Total",1511,762,749,1344,167,20,32.01,47.2
"2011","Waveney 007D","E01030258","Total",1528,804,724,1485,43,10,50.63,30.2
"2011","Waveney 007E","E01030276","Total",1229,583,646,1223,6,14,26.46,46.4
"2011","Waveney 008A","E01030257","Total",1580,752,828,1490,90,9,46.78,33.8
"2011","Waveney 008B","E01030274","Total",1187,547,640,1168,19,10,47.57,25.0
"2011","Waveney 008C","E01030275","Total",1131,560,571,1131,0,17,36.14,31.3
"2011","Waveney 008D","E01030287","Total",1425,672,753,1425,0,7,36.60,38.9
"2011","Waveney 008E","E01030291","Total",1477,674,803,1477,0,2,26.46,55.8
"2011","Waveney 009A","E01030234","Total",1592,737,855,1592,0,14,35.66,44.6
"2011","Waveney 009B","E01030236","Total",1737,831,906,1737,0,14,76.52,22.7
"2011","Waveney 009C","E01030237","Total",2902,1430,1472,2830,72,31,667.90,4.3
"2011","Waveney 009D","E01030238","Total",1848,889,959,1848,0,19,43.43,42.6
"2011","Waveney 010A","E01030223","Total",1715,815,900,1715,0,15,65.07,26.4
"2011","Waveney 010B","E01030224","Total",1675,777,898,1585,90,19,125.34,13.4
"2011","Waveney 010C","E01030225","Total",1615,768,847,1604,11,6,427.28,3.8
"2011","Waveney 010D","E01030227","Total",1441,682,759,1441,0,11,33.17,43.4
"2011","Waveney 010E","E01030228","Total",1773,833,940,1746,27,18,111.20,15.9
"2011","Waveney 011A","E01030226","Total",1904,947,957,1904,0,24,51.95,36.7
"2011","Waveney 011B","E01030286","Total",2185,1083,1102,2181,4,41,5991.17,0.4
"2011","Waveney 011C","E01030292","Total",1485,739,746,1485,0,21,97.90,15.2
"2011","Waveney 011D","E01030293","Total",1700,828,872,1700,0,10,1132.56,1.5
"2011","Waveney 011E","E01030294","Total",1488,711,777,1488,0,18,397.15,3.7
"2011","Waveney 012A","E01030239","Total",2018,1010,1008,2018,0,22,32.22,62.6
"2011","Waveney 012B","E01030251","Total",1572,764,808,1572,0,17,311.53,5.0
"2011","Waveney 012C","E01030252","Total",1745,851,894,1723,22,17,613.86,2.8
"2011","Waveney 012D","E01030253","Total",1788,870,918,1788,0,17,411.44,4.3
"2011","Waveney 012E","E01030272","Total",1496,697,799,1494,2,23,68.87,21.7
"2011","Waveney 012F","E01030273","Total",1520,730,790,1515,5,10,46.45,32.7
"2011","Waveney 013A","E01030230","Total",1830,857,973,1733,97,21,251.68,7.3
"2011","Waveney 013B","E01030231","Total",1568,762,806,1568,0,11,142.91,11.0
"2011","Waveney 013C","E01030232","Total",1729,853,876,1689,40,14,675.69,2.6
"2011","Waveney 013D","E01030285","Total",2242,1129,1113,2239,3,45,7452.77,0.3
"2011","Waveney 014A","E01030282","Total",1098,471,627,1082,16,16,267.55,4.1
"2011","Waveney 014B","E01030283","Total",1359,643,716,1266,93,20,1049.33,1.3
"2011","Waveney 014C","E01030284","Total",1223,561,662,1222,1,8,105.02,11.6
"2011","Waveney 014D","E01030295","Total",2224,1101,1123,2218,6,44,6287.14,0.4
"2011","Waveney 015A","E01030229","Total",2150,1064,1086,2148,2,27,4126.14,0.5
"2011","Waveney 015B","E01030243","Total",1461,708,753,1461,0,15,129.17,11.3
"2011","Waveney 015C","E01030244","Total",1677,770,907,1603,74,18,177.35,9.5
"2011","Waveney 015D","E01030245","Total",1588,747,841,1588,0,17,140.17,11.3
"2011","Camden 001A","E01000907","Total",1430,663,767,1430,0,17,10.72,133.4
"2011","Camden 001B","E01000908","Total",1581,686,895,1581,0,17,17.50,90.3
"2011","Camden 001C","E01000909","Total",1614,766,848,1614,0,47,22.86,70.6
"2011","Camden 001D","E01000912","Total",1589,734,855,1589,0,14,89.61,17.7
"2011","Camden 001E","E01000913","Total",1710,840,870,1702,8,51,161.70,10.6
"2011","Camden 002A","E01000893","Total",1566,745,821,1566,0,27,52.78,29.7
"2011","Camden 002B","E01000894","Total",1389,680,709,1376,13,42,22.17,62.7
"2011","Camden 002C","E01000895","Total",1630,811,819,1629,1,24,9.81,166.2
"2011","Camden 002D","E01000896","Total",1692,822,870,1692,0,37,15.11,112.0
"2011","Camden 002E","E01000899","Total",1667,822,845,1606,61,49,108.26,15.4
"2011","Camden 003A","E01000910","Total",1472,718,754,1472,0,36,13.02,113.1
"2011","Camden 003B","E01000911","Total",1559,738,821,1549,10,14,8.81,177.0
"2011","Camden 003C","E01000921","Total",1966,940,1026,1963,3,12,12.44,158.0
"2011","Camden 003D","E01000923","Total",1494,689,805,1436,58,19,8.54,174.9
"2011","Camden 003E","E01000928","Total",1681,843,838,1620,61,20,25.25,66.6
"2011","Camden 004A","E01000878","Total",1624,766,858,1246,378,22,19.21,84.5
"2011","Camden 004B","E01000879","Total",1458,714,744,1305,153,25,17.73,82.2
"2011","Camden 004C","E01000880","Total",1602,767,835,1558,44,21,20.37,78.6
"2011","Camden 004D","E01000884","Total",1469,724,745,1462,7,43,24.52,59.9
"2011","Camden 004E","E01000885","Total",1484,694,790,1410,74,33,30.43,48.8
"2011","Camden 005A","E01000871","Total",1664,821,843,1653,11,44,30.63,54.3
"2011","Camden 005B","E01000872","Total",1902,965,937,1896,6,11,14.69,129.5
"2011","Camden 005C","E01000873","Total",1639,816,823,1639,0,21,12.20,134.3
"2011","Camden 005D","E01000874","Total",1559,746,813,1559,0,13,8.56,182.1
"2011","Camden 005E","E01000877","Total",1574,786,788,1546,28,14,11.05,142.4
"2011","Camden 006A","E01000886","Total",1445,704,741,1445,0,28,10.31,140.2
"2011","Camden 006B","E01000887","Total",1486,705,781,1478,8,16,9.99,148.7
"2011","Camden 006C","E01000888","Total",1605,793,812,1605,0,23,9.42,170.4
"2011","Camden 006D","E01000892","Total",1843,880,963,1843,0,27,12.23,150.7
"2011","Camden 006E","E01000903","Total",1439,709,730,1418,21,9,10.19,141.2
"2011","Camden 007A","E01000889","Total",1670,798,872,1670,0,24,11.73,142.4
"2011","Camden 007B","E01000890","Total",1640,806,834,1625,15,17,7.63,214.9
"2011","Camden 007C","E01000891","Total",1575,752,823,1534,41,17,7.76,203.0
"2011","Camden 007D","E01000901","Total",1977,939,1038,1821,156,14,10.60,186.5
"2011","Camden 007E","E01000922","Total",1547,761,786,1537,10,9,19.11,81.0
"2011","Camden 007F","E01000927","Total",1738,836,902,1732,6,15,10.06,172.8
"2011","Camden 008A","E01000881","Total",1510,784,726,1451,59,13,14.78,102.2
"2011","Camden 008B","E01000882","Total",1513,745,768,1512,1,18,12.19,124.1
"2011","Camden 008C","E01000883","Total",1326,635,691,1319,7,16,14.05,94.4
"2011","Camden 008D","E01000897","Total",1597,759,838,1595,2,26,19.80,80.7
"2011","Camden 008E","E01000898","Total",1729,836,893,1688,41,17,17.05,101.4
"2011","Camden 009A","E01000866","Total",2030,942,1088,2030,0,23,14.55,139.5
"2011","Camden 009B","E01000870","Total",1693,779,914,1693,0,10,12.67,133.6
"2011","Camden 009C","E01000924","Total",1637,785,852,1637,0,15,9.83,166.5
"2011","Camden 009D","E01000925","Total",1563,736,827,1552,11,18,8.28,188.8
"2011","Camden 009E","E01000926","Total",1791,866,925,1791,0,21,9.24,193.8
"2011","Camden 010A","E01000969","Total",2032,979,1053,2032,0,22,16.68,121.8
"2011","Camden 010B","E01000970","Total",1444,719,725,1444,0,4,6.90,209.3
"2011","Camden 010C","E01000971","Total",1478,699,779,1478,0,18,8.03,184.1
"2011","Camden 010D","E01000972","Total",2009,976,1033,2009,0,18,14.00,143.5
"2011","Camden 010E","E01000973","Total",1885,899,986,1883,2,8,23.55,80.0
"2011","Camden 011A","E01000842","Total",1444,687,757,1368,76,14,10.52,137.3
"2011","Camden 011B","E01000844","Total",1772,903,869,1772,0,5,11.39,155.6
"2011","Camden 011C","E01000848","Total",1588,773,815,1580,8,12,10.10,157.2
"2011","Camden 011D","E01000849","Total",1569,748,821,1569,0,27,7.77,201.9
"2011","Camden 012A","E01000900","Total",1801,859,942,1795,6,24,9.94,181.2
"2011","Camden 012B","E01000902","Total",1451,687,764,1451,0,8,8.41,172.5
"2011","Camden 012C","E01000904","Total",2120,1063,1057,2120,0,13,11.65,182.0
"2011","Camden 012D","E01000905","Total",2044,951,1093,1965,79,23,8.60,237.7
"2011","Camden 012E","E01000906","Total",1532,682,850,1532,0,28,13.76,111.3
"2011","Camden 013A","E01000875","Total",1654,874,780,1646,8,8,11.70,141.4
"2011","Camden 013B","E01000876","Total",1748,877,871,1748,0,14,11.68,149.7
"2011","Camden 013C","E01000931","Total",1910,889,1021,1902,8,20,14.71,129.8
"2011","Camden 013D","E01000932","Total",1838,932,906,1825,13,11,6.61,278.1
"2011","Camden 013E","E01000974","Total",1707,831,876,1702,5,17,11.48,148.7
"2011","Camden 014A","E01000843","Total",1678,777,901,1678,0,13,8.33,201.4
"2011","Camden 014B","E01000845","Total",1464,689,775,1444,20,21,11.80,124.1
"2011","Camden 014C","E01000846","Total",1501,699,802,1499,2,35,8.27,181.5
"2011","Camden 014D","E01000847","Total",1686,815,871,1684,2,24,9.85,171.2
"2011","Camden 015A","E01000864","Total",1537,733,804,1537,0,15,9.76,157.5
"2011","Camden 015B","E01000865","Total",1505,748,757,977,528,27,10.87,138.5
"2011","Camden 015C","E01000867","Total",1608,788,820,1608,0,3,8.09,198.8
"2011","Camden 015D","E01000868","Total",1442,744,698,1442,0,8,8.37,172.3
"2011","Camden 015E","E01000869","Total",2110,1053,1057,2098,12,8,11.45,184.3
"2011","Camden 016A","E01000962","Total",1592,732,860,1592,0,3,9.53,167.1
"2011","Camden 016B","E01000964","Total",1577,751,826,1577,0,14,12.62,125.0
"2011","Camden 016C","E01000965","Total",1522,712,810,1522,0,16,10.75,141.6
"2011","Camden 016D","E01000966","Total",1512,743,769,1508,4,17,13.04,116.0
"2011","Camden 016E","E01000968","Total",1505,719,786,1504,1,15,8.15,184.7
"2011","Camden 017A","E01000960","Total",1774,828,946,1774,0,17,11.36,156.2
"2011","Camden 017B","E01000961","Total",1591,736,855,1591,0,38,11.94,133.2
"2011","Camden 017C","E01000963","Total",1923,883,1040,1864,59,37,19.27,99.8
"2011","Camden 017D","E01000967","Total",1409,653,756,1409,0,35,37.21,37.9
"2011","Camden 018A","E01000857","Total",1447,705,742,1443,4,22,8.12,178.2
"2011","Camden 018B","E01000858","Total",1861,910,951,1861,0,22,21.79,85.4
"2011","Camden 018C","E01000859","Total",1586,757,829,1586,0,38,9.67,164.0
"2011","Camden 018D","E01000860","Total",1307,621,686,1307,0,16,20.59,63.5
"2011","Camden 018E","E01000862","Total",1712,871,841,1712,0,39,17.00,100.7
"2011","Camden 019A","E01000856","Total",1645,815,830,1645,0,10,11.87,138.6
"2011","Camden 019B","E01000861","Total",1574,818,756,1574,0,11,11.40,138.1
"2011","Camden 019C","E01000957","Total",1729,884,845,1729,0,6,11.67,148.2
"2011","Camden 019D","E01000958","Total",2264,1019,1245,2108,156,26,24.22,93.5
"2011","Camden 019E","E01000959","Total",1670,806,864,1670,0,26,7.32,228.1
"2011","Camden 020A","E01000929","Total",1675,784,891,1675,0,21,9.78,171.3
"2011","Camden 020B","E01000930","Total",1910,896,1014,1910,0,16,11.62,164.4
"2011","Camden 020C","E01000933","Total",1671,838,833,1671,0,10,10.90,153.3
"2011","Camden 020D","E01000934","Total",1619,753,866,1542,77,19,8.71,185.9
"2011","Camden 020E","E01000935","Total",1415,631,784,1415,0,23,6.21,227.9
"2011","Camden 021A","E01000863","Total",1481,781,700,1383,98,11,16.14,91.8
"2011","Camden 021B","E01000946","Total",1516,705,811,1475,41,20,48.93,31.0
"2011","Camden 021C","E01000947","Total",1954,1073,881,1925,29,32,15.60,125.3
"2011","Camden 021D","E01000948","Total",1736,890,846,1708,28,35,19.66,88.3
"2011","Camden 022A","E01000952","Total",1729,830,899,1728,1,12,8.70,198.7
"2011","Camden 022B","E01000953","Total",1643,762,881,1643,0,16,60.32,27.2
"2011","Camden 022C","E01000954","Total",1656,781,875,1656,0,11,5.55,298.4
"2011","Camden 022D","E01000955","Total",1595,765,830,1505,90,14,6.39,249.6
"2011","Camden 022E","E01000956","Total",1532,743,789,1532,0,14,15.88,96.5
"2011","Camden 023A","E01000944","Total",1899,1168,731,1899,0,9,5.84,325.2
"2011","Camden 023B","E01000945","Total",1821,852,969,1493,328,14,27.12,67.1
"2011","Camden 023C","E01000949","Total",1633,754,879,1578,55,13,6.22,262.5
"2011","Camden 023D","E01000950","Total",1431,716,715,1431,0,16,6.79,210.8
"2011","Camden 023E","E01000951","Total",1538,760,778,1538,0,12,4.82,319.1
"2011","Camden 024A","E01000936","Total",1839,898,941,1360,479,21,8.88,207.1
"2011","Camden 024B","E01000938","Total",1752,924,828,1726,26,10,8.16,214.7
"2011","Camden 024C","E01000939","Total",1223,593,630,1197,26,9,7.86,155.6
"2011","Camden 024D","E01000940","Total",1130,571,559,1124,6,14,4.87,232.0
"2011","Camden 025A","E01000853","Total",1631,798,833,1596,35,10,5.86,278.3
"2011","Camden 025B","E01000937","Total",1504,735,769,943,561,8,12.55,119.8
"2011","Camden 025C","E01000941","Total",1230,640,590,1203,27,9,4.34,283.4
"2011","Camden 025D","E01000942","Total",2111,1043,1068,1181,930,17,7.30,289.2
"2011","Camden 025E","E01000943","Total",1054,522,532,991,63,4,7.00,150.6
"2011","Camden 026A","E01000850","Total",1694,919,775,1281,413,16,19.53,86.7
"2011","Camden 026B","E01000851","Total",2383,1327,1056,1645,738,28,13.35,178.5
"2011","Camden 026C","E01000852","Total",1587,725,862,976,611,21,12.46,127.4
"2011","Camden 026D","E01000854","Total",1833,1037,796,1643,190,12,18.87,97.1
"2011","Camden 027A","E01000915","Total",1527,785,742,1527,0,15,7.41,206.1
"2011","Camden 027B","E01000916","Total",1796,942,854,1718,78,17,14.73,121.9
"2011","Camden 027C","E01000917","Total",1888,1004,884,1855,33,9,7.56,249.7
"2011","Camden 027D","E01000920","Total",1946,1040,906,1921,25,20,13.54,143.7
"2011","Camden 028A","E01000855","Total",1764,880,884,1714,50,19,32.05,55.0
"2011","Camden 028B","E01000914","Total",1762,928,834,1753,9,20,44.77,39.4
"2011","Camden 028C","E01000918","Total",2090,1125,965,1885,205,11,16.82,124.3
"2011","Camden 028D","E01000919","Total",2014,1084,930,1658,356,17,15.28,131.8
"2011","City of London 001A","E01000001","Total",1465,767,698,1465,0,21,12.98,112.9
"2011","City of London 001B","E01000002","Total",1436,767,669,1436,0,22,22.84,62.9
"2011","City of London 001C","E01000003","Total",1346,714,632,1250,96,12,5.91,227.7
"2011","City of London 001E","E01000005","Total",985,528,457,985,0,5,18.96,52.0
"2011","City of London 001F","E01032739","Total",1044,648,396,1002,42,11,165.36,6.3
"2011","City of London 001G","E01032740","Total",1099,667,432,1049,50,7,63.73,17.2
"2011","Hackney 001A","E01001808","Total",1838,923,915,1838,0,29,12.70,144.7
"2011","Hackney 001B","E01001809","Total",1977,985,992,1969,8,42,11.41,173.3
"2011","Hackney 001C","E01001814","Total",1660,843,817,1658,2,20,11.40,145.6
"2011","Hackney 001D","E01001823","Total",1765,882,883,1765,0,35,15.08,117.0
"2011","Hackney 001E","E01001825","Total",1598,815,783,1598,0,28,10.62,150.5
"2011","Hackney 002A","E01001714","Total",1490,732,758,1468,22,8,15.04,99.1
"2011","Hackney 002D","E01001811","Total",1503,728,775,1494,9,16,8.48,177.2
"2011","Hackney 002E","E01001813","Total",1250,600,650,1241,9,9,9.78,127.8
"2011","Hackney 002F","E01033701","Total",1849,956,893,1818,31,15,24.96,74.1
"2011","Hackney 003A","E01001799","Total",1582,811,771,1582,0,19,10.60,149.2
"2011","Hackney 003B","E01001802","Total",1294,619,675,1240,54,19,10.48,123.5
"2011","Hackney 003C","E01001804","Total",1528,748,780,1512,16,22,11.08,137.9
"2011","Hackney 003D","E01001807","Total",1806,928,878,1804,2,19,11.72,154.1
"2011","Hackney 003E","E01001812","Total",1746,854,892,1746,0,27,24.70,70.7
"2011","Hackney 004A","E01001725","Total",1909,949,960,1909,0,27,9.45,202.0
"2011","Hackney 004B","E01001726","Total",1357,654,703,1357,0,26,5.07,267.7
"2011","Hackney 004C","E01001800","Total",1597,781,816,1596,1,4,8.48,188.3
"2011","Hackney 004D","E01001824","Total",1517,769,748,1517,0,34,21.57,70.3
"2011","Hackney 004E","E01001826","Total",1740,878,862,1728,12,26,11.28,154.3
"2011","Hackney 006A","E01001723","Total",1944,1000,944,1944,0,26,11.82,164.5
"2011","Hackney 006B","E01001724","Total",2219,1084,1135,2219,0,16,11.65,190.5
"2011","Hackney 006C","E01001727","Total",1920,957,963,1911,9,32,10.67,179.9
"2011","Hackney 006D","E01001768","Total",1825,901,924,1819,6,19,10.17,179.4
"2011","Hackney 006E","E01001769","Total",1594,774,820,1581,13,11,12.35,129.1
"2011","Hackney 007A","E01001715","Total",1321,690,631,1316,5,12,7.65,172.7
"2011","Hackney 007B","E01001716","Total",1318,696,622,1260,58,10,8.03,164.1
"2011","Hackney 007C","E01001717","Total",1222,579,643,1222,0,8,9.77,125.1
"2011","Hackney 007D","E01001718","Total",1787,931,856,1787,0,7,10.39,172.0
"2011","Hackney 007E","E01001719","Total",1139,563,576,1136,3,9,6.36,179.1
"2011","Hackney 007F","E01001720","Total",1736,844,892,1720,16,11,10.07,172.4
"2011","Hackney 008A","E01001742","Total",1810,841,969,1810,0,16,12.51,144.7
"2011","Hackney 008B","E01001801","Total",1664,762,902,1614,50,24,14.78,112.6
"2011","Hackney 008C","E01001803","Total",1863,908,955,1863,0,19,16.40,113.6
"2011","Hackney 008D","E01001806","Total",1546,714,832,1546,0,14,32.58,47.5
"2011","Hackney 009A","E01001741","Total",1490,695,795,1490,0,16,8.69,171.5
"2011","Hackney 009B","E01001805","Total",1206,585,621,1206,0,11,14.74,81.8
"2011","Hackney 009C","E01001829","Total",1794,840,954,1794,0,21,11.16,160.8
"2011","Hackney 009D","E01001831","Total",1677,838,839,1677,0,8,11.07,151.5
"2011","Hackney 009E","E01001832","Total",1619,793,826,1607,12,18,10.20,158.7
"2011","Hackney 010A","E01001764","Total",1688,849,839,1688,0,11,10.51,160.6
"2011","Hackney 010B","E01001765","Total",1717,849,868,1717,0,5,12.57,136.6
"2011","Hackney 010D","E01001767","Total",1603,792,811,1593,10,12,10.59,151.4
"2011","Hackney 010E","E01001770","Total",1738,882,856,1732,6,5,12.95,134.2
"2011","Hackney 010F","E01033703","Total",1410,699,711,1395,15,3,6.54,215.6
"2011","Hackney 010G","E01033713","Total",1346,694,652,1324,22,6,26.17,51.4
"2011","Hackney 011A","E01001792","Total",1780,884,896,1735,45,7,17.53,101.5
"2011","Hackney 011B","E01001793","Total",1685,839,846,1685,0,13,16.01,105.2
"2011","Hackney 011C","E01001794","Total",1909,906,1003,1794,115,17,12.75,149.7
"2011","Hackney 011D","E01001795","Total",1464,711,753,1464,0,18,10.15,144.2
"2011","Hackney 011E","E01001796","Total",1647,862,785,1647,0,17,9.18,179.4
"2011","Hackney 012A","E01001736","Total",1656,808,848,1656,0,5,8.97,184.6
"2011","Hackney 012B","E01001737","Total",1842,942,900,1838,4,11,10.02,183.8
"2011","Hackney 012C","E01001738","Total",1758,881,877,1755,3,18,9.11,193.0
"2011","Hackney 012D","E01001739","Total",2090,1002,1088,2039,51,12,12.20,171.3
"2011","Hackney 013A","E01001786","Total",1825,875,950,1825,0,24,113.08,16.1
"2011","Hackney 013B","E01001787","Total",1589,752,837,1589,0,8,22.23,71.5
"2011","Hackney 013C","E01001788","Total",1582,734,848,1582,0,12,11.45,138.2
"2011","Hackney 013D","E01001790","Total",1343,658,685,1343,0,10,5.51,243.7
"2011","Hackney 014A","E01001740","Total",1566,760,806,1566,0,10,8.65,181.0
"2011","Hackney 014B","E01001747","Total",2137,1085,1052,2137,0,14,14.23,150.2
"2011","Hackney 014C","E01001830","Total",1904,990,914,1904,0,11,10.32,184.5
"2011","Hackney 014D","E01001833","Total",2143,1021,1122,2132,11,11,11.61,184.6
"2011","Hackney 014E","E01001834","Total",2059,1023,1036,2059,0,11,9.51,216.5
"2011","Hackney 014F","E01001835","Total",1249,630,619,1249,0,8,7.32,170.6
"2011","Hackney 015A","E01001733","Total",1822,923,899,1815,7,10,14.53,125.4
"2011","Hackney 015B","E01001785","Total",1486,677,809,1486,0,14,9.06,164.0
"2011","Hackney 015C","E01001789","Total",1739,842,897,1739,0,14,9.67,179.8
"2011","Hackney 015D","E01001791","Total",1534,737,797,1529,5,20,10.41,147.4
"2011","Hackney 016A","E01001745","Total",2249,1114,1135,2249,0,11,11.22,200.4
"2011","Hackney 016B","E01001746","Total",1656,783,873,1656,0,25,4.91,337.3
"2011","Hackney 016C","E01001757","Total",1717,791,926,1717,0,19,4.98,344.8
"2011","Hackney 016D","E01001758","Total",2087,1027,1060,2087,0,8,12.49,167.1
"2011","Hackney 016E","E01001759","Total",1804,913,891,1804,0,15,10.31,175.0
"2011","Hackney 016F","E01001761","Total",1779,864,915,1779,0,17,10.72,166.0
"2011","Hackney 017A","E01001731","Total",2300,1153,1147,2299,1,15,17.34,132.6
"2011","Hackney 017B","E01001734","Total",1821,932,889,1814,7,5,13.43,135.6
"2011","Hackney 017C","E01001760","Total",1754,862,892,1754,0,13,14.42,121.6
"2011","Hackney 017D","E01001762","Total",1765,861,904,1765,0,6,14.23,124.0
"2011","Hackney 018A","E01001846","Total",1216,573,643,1216,0,10,54.25,22.4
"2011","Hackney 018B","E01001847","Total",1129,574,555,1110,19,8,10.56,106.9
"2011","Hackney 018C","E01001848","Total",1654,816,838,1605,49,16,15.16,109.1
"2011","Hackney 018D","E01001849","Total",2364,1202,1162,2335,29,13,49.57,47.7
"2011","Hackney 019A","E01001729","Total",2021,1035,986,2021,0,27,12.76,158.4
"2011","Hackney 019B","E01001730","Total",1921,990,931,1921,0,8,13.07,147.0
"2011","Hackney 019C","E01001732","Total",1715,833,882,1715,0,7,6.47,265.1
"2011","Hackney 019D","E01001735","Total",1632,774,858,1632,0,9,13.34,122.3
"2011","Hackney 019E","E01001838","Total",1746,848,898,1746,0,24,6.89,253.4
"2011","Hackney 019F","E01001850","Total",1810,825,985,1810,0,28,7.11,254.6
"2011","Hackney 020A","E01001748","Total",2306,1208,1098,2287,19,15,17.69,130.4
"2011","Hackney 020B","E01001749","Total",1717,838,879,1717,0,22,10.65,161.2
"2011","Hackney 020C","E01001763","Total",1642,794,848,1642,0,12,10.86,151.2
"2011","Hackney 020D","E01001816","Total",1625,790,835,1625,0,13,13.63,119.2
"2011","Hackney 020E","E01001819","Total",1577,769,808,1577,0,34,13.60,116.0
"2011","Hackney 021B","E01001744","Total",1879,906,973,1879,0,14,13.52,139.0
"2011","Hackney 021C","E01001750","Total",1838,905,933,1838,0,12,14.57,126.1
"2011","Hackney 021D","E01001751","Total",1547,807,740,1547,0,8,15.37,100.7
"2011","Hackney 021E","E01001756","Total",2155,1075,1080,2155,0,13,16.22,132.9
"2011","Hackney 021F","E01033698","Total",1259,614,645,1259,0,8,6.03,208.8
"2011","Hackney 021G","E01033699","Total",1217,653,564,1217,0,3,9.42,129.2
"2011","Hackney 021H","E01033700","Total",1566,846,720,1510,56,4,11.00,142.4
"2011","Hackney 021I","E01033707","Total",1303,651,652,1303,0,6,10.35,125.9
"2011","Hackney 022A","E01001836","Total",1866,903,963,1866,0,24,13.18,141.6
"2011","Hackney 022B","E01001840","Total",1676,794,882,1676,0,13,10.86,154.3
"2011","Hackney 022C","E01001841","Total",1411,694,717,1411,0,23,13.70,103.0
"2011","Hackney 022D","E01001844","Total",2006,997,1009,1888,118,29,15.56,128.9
"2011","Hackney 022E","E01001845","Total",1555,753,802,1555,0,10,11.05,140.7
"2011","Hackney 023B","E01001837","Total",1488,722,766,1478,10,14,11.14,133.6
"2011","Hackney 023C","E01001839","Total",2211,1034,1177,2102,109,6,10.76,205.5
"2011","Hackney 023D","E01001842","Total",1589,769,820,1589,0,12,6.46,246.0
"2011","Hackney 023E","E01001843","Total",1244,580,664,1244,0,14,7.41,167.9
"2011","Hackney 023F","E01033704","Total",1631,849,782,1631,0,3,21.89,74.5
"2011","Hackney 023G","E01033712","Total",1578,745,833,1578,0,4,16.23,97.2
"2011","Hackney 024A","E01001772","Total",1046,537,509,1046,0,18,6.56,159.5
"2011","Hackney 024B","E01001774","Total",2095,1019,1076,2082,13,9,17.96,116.6
"2011","Hackney 024C","E01001775","Total",1776,871,905,1776,0,24,12.68,140.1
"2011","Hackney 024D","E01001815","Total",1774,845,929,1774,0,14,10.90,162.8
"2011","Hackney 024E","E01001820","Total",1463,714,749,1463,0,11,8.48,172.5
"2011","Hackney 024F","E01001821","Total",1460,711,749,1460,0,9,6.87,212.5
"2011","Hackney 025A","E01001752","Total",2307,1183,1124,2307,0,17,12.78,180.5
"2011","Hackney 025B","E01001753","Total",1629,825,804,1629,0,9,7.47,218.1
"2011","Hackney 025C","E01001754","Total",2379,1237,1142,2379,0,16,12.23,194.5
"2011","Hackney 025D","E01001755","Total",1788,870,918,1754,34,27,10.18,175.6
"2011","Hackney 025E","E01001773","Total",2052,1026,1026,2052,0,17,12.21,168.1
"2011","Hackney 025F","E01001776","Total",1439,748,691,1439,0,13,10.16,141.6
"2011","Hackney 026A","E01001779","Total",2437,1241,1196,2428,9,44,13.86,175.8
"2011","Hackney 026B","E01001781","Total",1667,851,816,1667,0,14,15.13,110.2
"2011","Hackney 026C","E01001782","Total",2300,1213,1087,2300,0,23,13.67,168.3
"2011","Hackney 026D","E01001783","Total",1897,957,940,1897,0,16,6.14,309.0
"2011","Hackney 027B","E01001777","Total",2358,1194,1164,2358,0,17,15.44,152.7
"2011","Hackney 027D","E01001780","Total",1825,977,848,1825,0,15,10.97,166.4
"2011","Hackney 027E","E01001784","Total",2273,1047,1226,1869,404,40,7.60,299.1
"2011","Hackney 027F","E01033706","Total",1539,857,682,1539,0,5,13.50,114.0
"2011","Hackney 027G","E01033708","Total",1599,978,621,1509,90,6,35.73,44.8
"2011","Hackney 027H","E01033709","Total",1670,861,809,1599,71,15,8.78,190.2
"2011","Hackney 027I","E01033711","Total",1105,596,509,943,162,0,7.71,143.3
"2011","Hackney 028A","E01001798","Total",1785,876,909,1785,0,21,10.51,169.8
"2011","Hackney 028B","E01001828","Total",2057,1005,1052,2057,0,19,11.12,185.0
"2011","Hackney 028C","E01033702","Total",1193,597,596,1193,0,15,10.01,119.2
"2011","Hackney 028D","E01033705","Total",1417,656,761,1417,0,21,16.02,88.5
"2011","Hackney 028E","E01033710","Total",1159,590,569,1159,0,4,4.23,274.0
"2011","Hackney 029A","E01001722","Total",2028,978,1050,2028,0,17,10.58,191.7
"2011","Hackney 029B","E01001728","Total",2015,938,1077,2015,0,20,9.14,220.5
"2011","Hackney 029C","E01001822","Total",1785,880,905,1780,5,25,8.40,212.5
"2011","Hackney 029D","E01001827","Total",1916,928,988,1916,0,30,17.16,111.7
"2011","Hammersmith and Fulham 001A","E01001874","Total",2055,911,1144,2052,3,10,97.42,21.1
"2011","Hammersmith and Fulham 001B","E01001875","Total",1854,855,999,1854,0,12,16.89,109.8
"2011","Hammersmith and Fulham 001C","E01001876","Total",2232,1170,1062,1898,334,14,89.48,24.9
"2011","Hammersmith and Fulham 001D","E01001877","Total",1345,645,700,1338,7,5,126.25,10.7
"2011","Hammersmith and Fulham 001E","E01001878","Total",1689,769,920,1689,0,8,14.02,120.5
"2011","Hammersmith and Fulham 002A","E01001955","Total",1807,854,953,1807,0,7,21.88,82.6
"2011","Hammersmith and Fulham 002B","E01001957","Total",1616,787,829,1616,0,17,7.27,222.3
"2011","Hammersmith and Fulham 002C","E01001958","Total",1671,757,914,1671,0,17,4.54,368.1
"2011","Hammersmith and Fulham 002D","E01001961","Total",1564,701,863,1564,0,13,7.07,221.2
"2011","Hammersmith and Fulham 003A","E01001954","Total",1525,712,813,1525,0,20,8.77,173.9
"2011","Hammersmith and Fulham 003B","E01001956","Total",1593,760,833,1585,8,26,13.43,118.6
"2011","Hammersmith and Fulham 003C","E01001959","Total",1728,826,902,1727,1,16,19.37,89.2
"2011","Hammersmith and Fulham 003D","E01001960","Total",1885,920,965,1875,10,11,8.09,233.0
"2011","Hammersmith and Fulham 004A","E01001943","Total",1954,984,970,1926,28,9,44.53,43.9
"2011","Hammersmith and Fulham 004B","E01001944","Total",1689,840,849,1689,0,7,6.48,260.6
"2011","Hammersmith and Fulham 004C","E01001945","Total",1752,818,934,1750,2,23,11.52,152.1
"2011","Hammersmith and Fulham 004D","E01001946","Total",1633,780,853,1633,0,23,12.35,132.2
"2011","Hammersmith and Fulham 005A","E01001862","Total",1768,921,847,1763,5,14,9.14,193.4
"2011","Hammersmith and Fulham 005B","E01001940","Total",1601,750,851,1590,11,5,8.10,197.7
"2011","Hammersmith and Fulham 005C","E01001941","Total",1677,861,816,1671,6,14,14.46,116.0
"2011","Hammersmith and Fulham 005D","E01001942","Total",1869,991,878,1866,3,17,9.29,201.2
"2011","Hammersmith and Fulham 006A","E01001858","Total",1793,909,884,1603,190,24,12.48,143.7
"2011","Hammersmith and Fulham 006B","E01001860","Total",1769,944,825,1749,20,14,8.64,204.7
"2011","Hammersmith and Fulham 006C","E01001861","Total",1498,700,798,1486,12,13,7.51,199.5
"2011","Hammersmith and Fulham 006D","E01001863","Total",1531,760,771,1517,14,24,8.30,184.5
"2011","Hammersmith and Fulham 006E","E01001864","Total",1578,785,793,1578,0,13,7.43,212.4
"2011","Hammersmith and Fulham 007A","E01001852","Total",1792,896,896,1792,0,15,7.54,237.7
"2011","Hammersmith and Fulham 007B","E01001853","Total",1533,732,801,1533,0,40,8.22,186.5
"2011","Hammersmith and Fulham 007C","E01001854","Total",1732,843,889,1716,16,17,6.61,262.0
"2011","Hammersmith and Fulham 007D","E01001857","Total",1477,706,771,1473,4,6,7.05,209.5
"2011","Hammersmith and Fulham 008A","E01001859","Total",2541,1184,1357,2541,0,15,10.73,236.8
"2011","Hammersmith and Fulham 008B","E01001865","Total",1682,887,795,1648,34,30,11.69,143.9
"2011","Hammersmith and Fulham 008C","E01001927","Total",1504,811,693,1503,1,48,20.04,75.0
"2011","Hammersmith and Fulham 008D","E01001930","Total",1854,889,965,1719,135,33,25.42,72.9
"2011","Hammersmith and Fulham 009A","E01001895","Total",1594,805,789,1587,7,18,8.69,183.4
"2011","Hammersmith and Fulham 009B","E01001896","Total",1548,823,725,1503,45,15,8.40,184.3
"2011","Hammersmith and Fulham 009C","E01001897","Total",1461,731,730,1461,0,32,9.61,152.0
"2011","Hammersmith and Fulham 009D","E01001929","Total",1260,613,647,1260,0,16,8.53,147.7
"2011","Hammersmith and Fulham 010A","E01001851","Total",1632,775,857,1618,14,32,9.91,164.7
"2011","Hammersmith and Fulham 010B","E01001855","Total",1677,791,886,1654,23,17,7.68,218.4
"2011","Hammersmith and Fulham 010C","E01001856","Total",1675,824,851,1659,16,31,8.27,202.5
"2011","Hammersmith and Fulham 010D","E01001869","Total",1334,628,706,1301,33,47,23.24,57.4
"2011","Hammersmith and Fulham 010E","E01001873","Total",1450,692,758,1450,0,10,6.17,235.0
"2011","Hammersmith and Fulham 011A","E01001928","Total",1724,855,869,1712,12,52,18.74,92.0
"2011","Hammersmith and Fulham 011B","E01001931","Total",1498,722,776,1498,0,13,6.81,220.0
"2011","Hammersmith and Fulham 011C","E01001932","Total",1621,895,726,1612,9,23,17.92,90.5
"2011","Hammersmith and Fulham 011D","E01001933","Total",1324,647,677,1324,0,33,18.19,72.8
"2011","Hammersmith and Fulham 012A","E01001866","Total",1579,746,833,1575,4,26,14.99,105.3
"2011","Hammersmith and Fulham 012B","E01001867","Total",1362,607,755,1285,77,14,8.79,154.9
"2011","Hammersmith and Fulham 012C","E01001868","Total",1341,636,705,1341,0,5,5.98,224.2
"2011","Hammersmith and Fulham 012D","E01001870","Total",1932,992,940,1923,9,20,10.12,190.9
"2011","Hammersmith and Fulham 012E","E01001871","Total",1604,813,791,1591,13,13,13.10,122.4
"2011","Hammersmith and Fulham 012F","E01001872","Total",1614,806,808,1585,29,15,7.07,228.3
"2011","Hammersmith and Fulham 013A","E01001893","Total",1244,604,640,1244,0,12,7.84,158.7
"2011","Hammersmith and Fulham 013B","E01001894","Total",1320,669,651,1244,76,18,15.63,84.5
"2011","Hammersmith and Fulham 013C","E01001898","Total",1591,831,760,1554,37,12,28.62,55.6
"2011","Hammersmith and Fulham 013D","E01001899","Total",1380,629,751,1380,0,14,12.48,110.6
"2011","Hammersmith and Fulham 013E","E01001900","Total",1785,872,913,1698,87,7,13.62,131.1
"2011","Hammersmith and Fulham 014A","E01001889","Total",1390,714,676,1390,0,18,14.38,96.7
"2011","Hammersmith and Fulham 014B","E01001910","Total",1512,765,747,1504,8,8,8.02,188.5
"2011","Hammersmith and Fulham 014C","E01001913","Total",1545,770,775,1545,0,1,10.89,141.9
"2011","Hammersmith and Fulham 014D","E01001914","Total",1715,874,841,1703,12,11,6.69,256.4
"2011","Hammersmith and Fulham 015A","E01001885","Total",1319,603,716,1319,0,8,5.53,238.5
"2011","Hammersmith and Fulham 015B","E01001908","Total",1636,845,791,1625,11,2,4.32,378.7
"2011","Hammersmith and Fulham 015C","E01001909","Total",1822,918,904,1814,8,17,8.79,207.3
"2011","Hammersmith and Fulham 015D","E01001911","Total",1761,837,924,1761,0,15,15.62,112.7
"2011","Hammersmith and Fulham 015E","E01001912","Total",1598,843,755,1598,0,19,9.49,168.4
"2011","Hammersmith and Fulham 016A","E01001886","Total",1572,766,806,1572,0,14,9.77,160.9
"2011","Hammersmith and Fulham 016B","E01001887","Total",1519,751,768,1519,0,6,10.87,139.7
"2011","Hammersmith and Fulham 016C","E01001890","Total",1815,903,912,1783,32,10,13.05,139.1
"2011","Hammersmith and Fulham 016D","E01001892","Total",1366,675,691,1366,0,11,7.10,192.4
"2011","Hammersmith and Fulham 017A","E01001880","Total",1497,715,782,1491,6,13,12.68,118.1
"2011","Hammersmith and Fulham 017B","E01001881","Total",1615,775,840,1588,27,14,11.31,142.8
"2011","Hammersmith and Fulham 017C","E01001882","Total",1762,830,932,1752,10,10,7.89,223.3
"2011","Hammersmith and Fulham 017D","E01001883","Total",1485,736,749,1477,8,26,13.22,112.3
"2011","Hammersmith and Fulham 017E","E01001884","Total",1843,909,934,1843,0,10,8.07,228.4
"2011","Hammersmith and Fulham 018A","E01001888","Total",1614,810,804,1614,0,23,9.77,165.2
"2011","Hammersmith and Fulham 018B","E01001891","Total",2030,989,1041,2023,7,17,17.40,116.7
"2011","Hammersmith and Fulham 018C","E01001917","Total",1462,708,754,1462,0,30,10.90,134.1
"2011","Hammersmith and Fulham 018D","E01001918","Total",1519,691,828,1519,0,26,10.45,145.4
"2011","Hammersmith and Fulham 018E","E01001919","Total",1630,756,874,1630,0,56,14.31,113.9
"2011","Hammersmith and Fulham 019A","E01001879","Total",1475,717,758,1473,2,6,8.04,183.5
"2011","Hammersmith and Fulham 019B","E01001901","Total",1625,781,844,1621,4,18,8.45,192.3
"2011","Hammersmith and Fulham 019C","E01001902","Total",1699,824,875,1699,0,8,7.26,234.0
"2011","Hammersmith and Fulham 019D","E01001903","Total",1649,838,811,1649,0,10,11.03,149.5
"2011","Hammersmith and Fulham 020A","E01001920","Total",1513,796,717,1509,4,18,16.48,91.8
"2011","Hammersmith and Fulham 020B","E01001921","Total",1536,765,771,1523,13,38,9.82,156.4
"2011","Hammersmith and Fulham 020C","E01001922","Total",1605,768,837,1605,0,64,19.08,84.1
"2011","Hammersmith and Fulham 020D","E01001923","Total",1479,717,762,1479,0,46,11.31,130.8
"2011","Hammersmith and Fulham 020E","E01001924","Total",1596,756,840,1596,0,56,9.83,162.4
"2011","Hammersmith and Fulham 021A","E01001947","Total",1448,647,801,1448,0,17,5.51,262.8
"2011","Hammersmith and Fulham 021B","E01001948","Total",2012,931,1081,1986,26,25,11.50,175.0
"2011","Hammersmith and Fulham 021C","E01001949","Total",1547,745,802,1547,0,21,8.04,192.4
"2011","Hammersmith and Fulham 021D","E01001950","Total",1596,769,827,1596,0,24,10.78,148.1
"2011","Hammersmith and Fulham 021E","E01001951","Total",1609,750,859,1609,0,19,10.27,156.7
"2011","Hammersmith and Fulham 021F","E01001953","Total",1366,656,710,1351,15,12,9.23,148.0
"2011","Hammersmith and Fulham 022A","E01001904","Total",1587,763,824,1587,0,14,14.11,112.5
"2011","Hammersmith and Fulham 022B","E01001905","Total",1702,807,895,1702,0,22,8.57,198.6
"2011","Hammersmith and Fulham 022C","E01001906","Total",1439,669,770,1439,0,12,6.25,230.2
"2011","Hammersmith and Fulham 022D","E01001907","Total",1303,600,703,1297,6,38,6.68,195.1
"2011","Hammersmith and Fulham 023A","E01001935","Total",2059,958,1101,2059,0,19,10.79,190.8
"2011","Hammersmith and Fulham 023C","E01001939","Total",2321,1165,1156,2021,300,28,32.51,71.4
"2011","Hammersmith and Fulham 023D","E01032788","Total",1106,489,617,1099,7,14,11.65,94.9
"2011","Hammersmith and Fulham 023E","E01032789","Total",1151,529,622,1151,0,20,2.99,384.9
"2011","Hammersmith and Fulham 023F","E01032790","Total",1118,539,579,1118,0,32,7.90,141.5
"2011","Hammersmith and Fulham 024A","E01001915","Total",1482,706,776,1482,0,67,42.30,35.0
"2011","Hammersmith and Fulham 024B","E01001916","Total",1390,642,748,1390,0,69,35.83,38.8
"2011","Hammersmith and Fulham 024C","E01001926","Total",1456,726,730,1456,0,35,9.06,160.7
"2011","Hammersmith and Fulham 024D","E01001952","Total",1623,788,835,1623,0,12,9.69,167.5
"2011","Hammersmith and Fulham 025A","E01001925","Total",1628,794,834,1628,0,54,14.19,114.7
"2011","Hammersmith and Fulham 025B","E01001934","Total",1622,781,841,1622,0,32,18.21,89.1
"2011","Hammersmith and Fulham 025C","E01001937","Total",1823,905,918,1823,0,24,19.42,93.9
"2011","Hammersmith and Fulham 025D","E01001938","Total",1560,746,814,1560,0,13,10.69,145.9
"2011","Haringey 001A","E01001969","Total",1888,900,988,1888,0,13,14.40,131.1
"2011","Haringey 001B","E01001971","Total",2012,1033,979,2002,10,15,12.69,158.6
"2011","Haringey 001C","E01001974","Total",2198,1118,1080,2198,0,14,17.61,124.8
"2011","Haringey 001D","E01001975","Total",1717,845,872,1710,7,13,11.69,146.9
"2011","Haringey 002A","E01002036","Total",1619,817,802,1618,1,18,17.15,94.4
"2011","Haringey 002B","E01002037","Total",1832,1025,807,1728,104,7,79.63,23.0
"2011","Haringey 002C","E01002039","Total",1610,738,872,1610,0,23,7.55,213.2
"2011","Haringey 002D","E01002040","Total",2062,1049,1013,2043,19,15,14.81,139.2
"2011","Haringey 004A","E01001962","Total",1758,861,897,1758,0,17,51.38,34.2
"2011","Haringey 004B","E01001970","Total",1981,965,1016,1972,9,24,21.14,93.7
"2011","Haringey 004C","E01001972","Total",1672,844,828,1672,0,19,20.81,80.3
"2011","Haringey 004D","E01001973","Total",2257,1087,1170,2246,11,15,40.06,56.3
"2011","Haringey 005A","E01002090","Total",1601,790,811,1601,0,14,22.57,70.9
"2011","Haringey 005B","E01002093","Total",1795,826,969,1795,0,14,22.81,78.7
"2011","Haringey 005C","E01002096","Total",1645,772,873,1645,0,10,18.43,89.3
"2011","Haringey 005D","E01002097","Total",1693,763,930,1693,0,21,10.85,156.0
"2011","Haringey 006A","E01002091","Total",1802,811,991,1802,0,11,20.80,86.6
"2011","Haringey 006B","E01002092","Total",1697,807,890,1697,0,14,20.64,82.2
"2011","Haringey 006C","E01002094","Total",1554,715,839,1554,0,19,25.26,61.5
"2011","Haringey 006D","E01002095","Total",1644,747,897,1644,0,12,28.36,58.0
"2011","Haringey 007A","E01002098","Total",1349,651,698,1349,0,9,19.59,68.9
"2011","Haringey 007B","E01002101","Total",1916,1041,875,1916,0,10,20.57,93.1
"2011","Haringey 007C","E01002102","Total",1882,878,1004,1877,5,17,31.84,59.1
"2011","Haringey 007D","E01002105","Total",2052,1030,1022,2052,0,17,13.11,156.5
"2011","Haringey 008A","E01002099","Total",2108,1019,1089,2108,0,14,15.82,133.2
"2011","Haringey 008B","E01002100","Total",1909,940,969,1909,0,12,14.14,135.0
"2011","Haringey 008C","E01002103","Total",1862,960,902,1856,6,18,17.17,108.4
"2011","Haringey 008D","E01002104","Total",1436,702,734,1431,5,14,16.97,84.6
"2011","Haringey 009A","E01001963","Total",1820,913,907,1820,0,35,51.12,35.6
"2011","Haringey 009B","E01001964","Total",1588,784,804,1588,0,29,63.16,25.1
"2011","Haringey 009C","E01001965","Total",1627,782,845,1627,0,28,12.35,131.7
"2011","Haringey 009D","E01001966","Total",1513,758,755,1506,7,43,51.57,29.3
"2011","Haringey 010A","E01002027","Total",1537,738,799,1537,0,12,11.03,139.3
"2011","Haringey 010B","E01002028","Total",1767,871,896,1767,0,8,11.99,147.4
"2011","Haringey 010C","E01002032","Total",1813,866,947,1813,0,15,10.53,172.2
"2011","Haringey 010D","E01002033","Total",1908,905,1003,1908,0,24,12.26,155.6
"2011","Haringey 011A","E01001976","Total",1628,783,845,1614,14,12,10.34,157.4
"2011","Haringey 011B","E01001977","Total",1580,772,808,1576,4,16,9.06,174.4
"2011","Haringey 011C","E01001978","Total",1905,967,938,1862,43,11,13.22,144.1
"2011","Haringey 011D","E01001979","Total",2199,1102,1097,2187,12,20,19.58,112.3
"2011","Haringey 012A","E01002074","Total",2122,1042,1080,2099,23,15,13.26,160.0
"2011","Haringey 012B","E01002077","Total",2079,1027,1052,2079,0,15,14.12,147.2
"2011","Haringey 012C","E01002079","Total",1642,782,860,1630,12,22,10.50,156.4
"2011","Haringey 012D","E01002081","Total",1769,870,899,1769,0,19,13.91,127.2
"2011","Haringey 013A","E01002082","Total",1508,727,781,1508,0,20,19.24,78.4
"2011","Haringey 013B","E01002086","Total",1646,822,824,1589,57,13,24.48,67.2
"2011","Haringey 013C","E01002088","Total",1853,930,923,1853,0,9,21.05,88.0
"2011","Haringey 013D","E01002089","Total",1520,760,760,1520,0,24,4.64,327.6
"2011","Haringey 014A","E01001967","Total",1655,756,899,1607,48,47,17.57,94.2
"2011","Haringey 014B","E01001968","Total",1834,903,931,1834,0,39,14.12,129.9
"2011","Haringey 014C","E01001996","Total",1625,794,831,1625,0,48,24.44,66.5
"2011","Haringey 014D","E01001997","Total",1579,787,792,1570,9,8,19.07,82.8
"2011","Haringey 015A","E01002075","Total",1777,868,909,1775,2,21,37.31,47.6
"2011","Haringey 015B","E01002076","Total",1888,905,983,1888,0,19,10.86,173.8
"2011","Haringey 015C","E01002078","Total",2194,1098,1096,2194,0,17,28.25,77.7
"2011","Haringey 015D","E01002080","Total",1593,891,702,1593,0,13,62.94,25.3
"2011","Haringey 016A","E01002026","Total",1619,777,842,1619,0,11,11.76,137.7
"2011","Haringey 016B","E01002029","Total",1725,790,935,1590,135,17,23.52,73.3
"2011","Haringey 016C","E01002030","Total",1640,863,777,1640,0,17,27.85,58.9
"2011","Haringey 016D","E01002031","Total",1930,974,956,1911,19,11,14.03,137.6
"2011","Haringey 017A","E01001991","Total",1693,750,943,1609,84,15,12.53,135.1
"2011","Haringey 017B","E01001992","Total",1709,850,859,1701,8,40,40.06,42.7
"2011","Haringey 017C","E01001993","Total",1686,818,868,1686,0,62,27.53,61.2
"2011","Haringey 017D","E01001995","Total",2412,1106,1306,2412,0,24,41.80,57.7
"2011","Haringey 018A","E01001980","Total",1986,1061,925,1983,3,14,11.08,179.2
"2011","Haringey 018B","E01001981","Total",1761,883,878,1758,3,13,9.73,181.0
"2011","Haringey 018C","E01001982","Total",1772,912,860,1763,9,11,10.15,174.6
"2011","Haringey 018D","E01001983","Total",1652,796,856,1652,0,15,9.98,165.5
"2011","Haringey 019A","E01002083","Total",1440,729,711,1440,0,19,15.39,93.6
"2011","Haringey 019B","E01002084","Total",1623,838,785,1617,6,13,30.55,53.1
"2011","Haringey 019C","E01002085","Total",2168,1079,1089,2168,0,13,13.05,166.1
"2011","Haringey 019D","E01002087","Total",1614,848,766,1586,28,14,11.44,141.1
"2011","Haringey 020B","E01002014","Total",1719,850,869,1711,8,8,16.97,101.3
"2011","Haringey 020C","E01002015","Total",1480,713,767,1480,0,19,12.09,122.4
"2011","Haringey 020D","E01002018","Total",1420,681,739,1420,0,19,12.15,116.9
"2011","Haringey 020E","E01033085","Total",1780,921,859,1780,0,8,15.63,113.9
"2011","Haringey 020F","E01033086","Total",1091,506,585,1091,0,1,6.03,180.9
"2011","Haringey 021A","E01002020","Total",1564,745,819,1564,0,16,29.27,53.4
"2011","Haringey 021B","E01002022","Total",1921,935,986,1829,92,34,20.41,94.1
"2011","Haringey 021C","E01002023","Total",1474,704,770,1474,0,52,16.32,90.3
"2011","Haringey 021D","E01002025","Total",1717,866,851,1717,0,56,39.93,43.0
"2011","Haringey 022A","E01002013","Total",1401,642,759,1401,0,20,12.09,115.9
"2011","Haringey 022B","E01002019","Total",1309,625,684,1309,0,41,25.19,52.0
"2011","Haringey 022C","E01002021","Total",1479,696,783,1479,0,41,18.54,79.8
"2011","Haringey 022D","E01002024","Total",1320,640,680,1320,0,27,15.50,85.2
"2011","Haringey 023A","E01001998","Total",2058,1100,958,2058,0,15,15.53,132.5
"2011","Haringey 023B","E01001999","Total",2001,1030,971,2001,0,16,14.64,136.7
"2011","Haringey 023C","E01002003","Total",2160,1047,1113,2160,0,10,22.18,97.4
"2011","Haringey 023D","E01002004","Total",1889,974,915,1881,8,9,11.87,159.1
"2011","Haringey 024A","E01002067","Total",1694,836,858,1694,0,14,14.46,117.2
"2011","Haringey 024B","E01002069","Total",1937,950,987,1937,0,17,15.97,121.3
"2011","Haringey 024C","E01002070","Total",2038,1019,1019,2032,6,9,16.18,126.0
"2011","Haringey 024D","E01002073","Total",1763,884,879,1762,1,13,11.10,158.8
"2011","Haringey 025A","E01002066","Total",1843,815,1028,1843,0,22,19.70,93.6
"2011","Haringey 025B","E01002068","Total",1822,974,848,1822,0,7,29.74,61.3
"2011","Haringey 025C","E01002071","Total",1615,787,828,1615,0,12,10.78,149.8
"2011","Haringey 025D","E01002072","Total",1868,906,962,1678,190,21,18.17,102.8
"2011","Haringey 026A","E01002043","Total",2020,1032,988,2017,3,10,10.89,185.5
"2011","Haringey 026B","E01002045","Total",2199,1219,980,2199,0,15,13.93,157.9
"2011","Haringey 026C","E01002046","Total",1725,843,882,1686,39,23,16.94,101.8
"2011","Haringey 026D","E01002049","Total",1881,914,967,1881,0,27,12.49,150.6
"2011","Haringey 027A","E01002042","Total",1459,766,693,1416,43,11,24.14,60.4
"2011","Haringey 027B","E01002044","Total",1729,893,836,1722,7,7,8.95,193.2
"2011","Haringey 027C","E01002047","Total",1670,824,846,1651,19,17,10.16,164.4
"2011","Haringey 027D","E01002048","Total",1955,1044,911,1920,35,11,12.23,159.9
"2011","Haringey 028A","E01002016","Total",1959,930,1029,1959,0,17,16.90,115.9
"2011","Haringey 028B","E01002017","Total",1809,946,863,1667,142,15,13.68,132.2
"2011","Haringey 028C","E01002059","Total",1671,825,846,1671,0,16,23.47,71.2
"2011","Haringey 028D","E01002060","Total",1759,855,904,1759,0,24,12.55,140.2
"2011","Haringey 029A","E01002050","Total",1895,957,938,1895,0,26,10.89,174.0
"2011","Haringey 029B","E01002051","Total",1683,853,830,1678,5,11,12.25,137.4
"2011","Haringey 029C","E01002052","Total",2020,993,1027,2020,0,30,21.39,94.4
"2011","Haringey 029D","E01002055","Total",1658,849,809,1658,0,40,9.56,173.4
"2011","Haringey 030A","E01001994","Total",1784,871,913,1779,5,39,34.01,52.5
"2011","Haringey 030B","E01002008","Total",1571,728,843,1534,37,49,64.36,24.4
"2011","Haringey 030C","E01002010","Total",1658,771,887,1619,39,25,59.65,27.8
"2011","Haringey 030D","E01002011","Total",1718,908,810,1718,0,28,64.89,26.5
"2011","Haringey 031A","E01002000","Total",1697,829,868,1692,5,14,16.17,104.9
"2011","Haringey 031B","E01002001","Total",1661,866,795,1661,0,9,10.63,156.3
"2011","Haringey 031C","E01002002","Total",1806,976,830,1785,21,14,65.14,27.7
"2011","Haringey 031D","E01002058","Total",1690,877,813,1690,0,6,15.45,109.4
"2011","Haringey 032A","E01002053","Total",1745,863,882,1737,8,13,14.31,121.9
"2011","Haringey 032B","E01002054","Total",1732,876,856,1732,0,15,8.29,208.9
"2011","Haringey 032C","E01002056","Total",1964,1007,957,1964,0,12,21.20,92.6
"2011","Haringey 032D","E01002057","Total",1581,780,801,1581,0,18,15.86,99.7
"2011","Haringey 033A","E01001984","Total",1590,820,770,1590,0,10,19.93,79.8
"2011","Haringey 033B","E01001985","Total",1690,832,858,1667,23,25,18.82,89.8
"2011","Haringey 033C","E01001987","Total",1847,940,907,1821,26,39,30.54,60.5
"2011","Haringey 033D","E01001989","Total",1725,812,913,1725,0,39,28.68,60.1
"2011","Haringey 034A","E01001986","Total",1635,795,840,1635,0,34,13.49,121.2
"2011","Haringey 034B","E01001988","Total",1771,844,927,1762,9,16,17.33,102.2
"2011","Haringey 034C","E01001990","Total",2137,1136,1001,2137,0,21,15.20,140.6
"2011","Haringey 034D","E01002062","Total",1874,958,916,1874,0,19,19.85,94.4
"2011","Haringey 035A","E01002005","Total",1688,883,805,1686,2,4,9.42,179.2
"2011","Haringey 035B","E01002006","Total",1602,765,837,1602,0,17,11.02,145.4
"2011","Haringey 035C","E01002007","Total",1676,827,849,1676,0,38,16.84,99.5
"2011","Haringey 035D","E01002009","Total",1719,881,838,1567,152,30,23.71,72.5
"2011","Haringey 036A","E01002061","Total",1687,842,845,1687,0,20,16.74,100.8
"2011","Haringey 036B","E01002063","Total",1587,787,800,1587,0,19,14.11,112.5
"2011","Haringey 036C","E01002064","Total",1514,736,778,1514,0,8,9.33,162.3
"2011","Haringey 036D","E01002065","Total",1666,856,810,1633,33,7,13.41,124.2
"2011","Haringey 037A","E01002034","Total",1859,938,921,1858,1,12,28.26,65.8
"2011","Haringey 037B","E01002038","Total",1653,808,845,1653,0,10,13.88,119.1
"2011","Haringey 037C","E01002041","Total",1886,921,965,1877,9,12,12.72,148.3
"2011","Haringey 037D","E01032575","Total",1908,891,1017,1889,19,15,14.48,131.8
"2011","Islington 001A","E01002755","Total",1326,640,686,1326,0,26,9.81,135.2
"2011","Islington 001B","E01002756","Total",1332,642,690,1326,6,21,11.52,115.6
"2011","Islington 001C","E01002758","Total",1576,783,793,1561,15,12,11.94,132.0
"2011","Islington 001D","E01002804","Total",1669,813,856,1642,27,15,11.01,151.6
"2011","Islington 001E","E01002807","Total",1734,781,953,1732,2,9,9.21,188.3
"2011","Islington 001F","E01002811","Total",1545,728,817,1545,0,18,10.21,151.3
"2011","Islington 002A","E01002753","Total",1429,686,743,1429,0,13,8.14,175.6
"2011","Islington 002B","E01002754","Total",1508,719,789,1508,0,28,12.31,122.5
"2011","Islington 002C","E01002757","Total",1433,646,787,1427,6,21,9.10,157.5
"2011","Islington 002D","E01002759","Total",1647,771,876,1600,47,7,10.63,154.9
"2011","Islington 002E","E01002760","Total",1543,714,829,1543,0,26,9.04,170.7
"2011","Islington 002F","E01002772","Total",1848,913,935,1848,0,4,10.40,177.7
"2011","Islington 003A","E01002735","Total",1645,832,813,1645,0,7,10.84,151.8
"2011","Islington 003B","E01002805","Total",1569,792,777,1569,0,6,12.81,122.5
"2011","Islington 003C","E01002806","Total",1595,758,837,1595,0,6,11.19,142.5
"2011","Islington 003D","E01002808","Total",1907,916,991,1891,16,9,13.12,145.4
"2011","Islington 003E","E01002809","Total",1640,808,832,1640,0,12,8.89,184.5
"2011","Islington 003F","E01002810","Total",1652,816,836,1650,2,5,8.26,200.0
"2011","Islington 004A","E01002768","Total",1604,755,849,1604,0,13,10.37,154.7
"2011","Islington 004B","E01002770","Total",1541,755,786,1483,58,7,20.97,73.5
"2011","Islington 004C","E01002771","Total",1483,684,799,1483,0,14,11.98,123.8
"2011","Islington 004D","E01002773","Total",1386,670,716,1386,0,4,9.66,143.5
"2011","Islington 004E","E01002774","Total",2110,1014,1096,2110,0,15,17.86,118.1
"2011","Islington 005A","E01002732","Total",1845,936,909,1813,32,13,13.55,136.2
"2011","Islington 005B","E01002734","Total",1692,847,845,1692,0,9,11.78,143.6
"2011","Islington 005C","E01002736","Total",1580,751,829,1435,145,15,7.32,215.8
"2011","Islington 005D","E01002737","Total",1957,916,1041,1957,0,10,7.69,254.5
"2011","Islington 005E","E01002751","Total",1796,913,883,1796,0,23,7.78,230.8
"2011","Islington 006A","E01002742","Total",1561,789,772,1561,0,28,10.68,146.2
"2011","Islington 006B","E01002747","Total",1635,882,753,1635,0,11,10.27,159.2
"2011","Islington 006C","E01002748","Total",1467,726,741,1467,0,12,14.13,103.8
"2011","Islington 006D","E01002749","Total",1316,608,708,1316,0,4,8.32,158.2
"2011","Islington 006F","E01033493","Total",1301,737,564,1301,0,3,3.62,359.4
"2011","Islington 006G","E01033494","Total",1498,754,744,1498,0,15,10.66,140.5
"2011","Islington 007A","E01002730","Total",1781,900,881,1781,0,14,14.11,126.2
"2011","Islington 007B","E01002731","Total",2466,1311,1155,2466,0,17,17.45,141.3
"2011","Islington 007C","E01002733","Total",1392,664,728,1392,0,12,8.89,156.6
"2011","Islington 007D","E01002763","Total",1437,739,698,1249,188,16,9.87,145.6
"2011","Islington 008A","E01002769","Total",2053,952,1101,1955,98,42,21.50,95.5
"2011","Islington 008B","E01002785","Total",1968,978,990,1968,0,46,14.22,138.4
"2011","Islington 008C","E01002788","Total",1851,935,916,1836,15,18,12.26,151.0
"2011","Islington 008D","E01002789","Total",1874,915,959,1873,1,37,13.37,140.2
"2011","Islington 009A","E01002738","Total",1785,845,940,1733,52,43,25.52,69.9
"2011","Islington 009B","E01002741","Total",1513,718,795,1513,0,12,10.64,142.2
"2011","Islington 009C","E01002743","Total",1672,819,853,1604,68,32,9.73,171.8
"2011","Islington 009D","E01002744","Total",1442,749,693,1442,0,13,9.90,145.7
"2011","Islington 009E","E01002752","Total",1522,703,819,1522,0,16,9.02,168.7
"2011","Islington 010A","E01002764","Total",1779,879,900,1779,0,16,13.26,134.2
"2011","Islington 010B","E01002783","Total",1487,751,736,1413,74,10,9.82,151.4
"2011","Islington 010C","E01002784","Total",1795,889,906,1735,60,14,12.93,138.8
"2011","Islington 010D","E01002786","Total",1805,909,896,1805,0,14,10.88,165.9
"2011","Islington 010E","E01002787","Total",1620,647,973,1296,324,19,11.09,146.1
"2011","Islington 011C","E01002762","Total",1949,967,982,1940,9,9,16.01,121.7
"2011","Islington 011D","E01002767","Total",2044,961,1083,2044,0,10,11.89,171.9
"2011","Islington 011E","E01033486","Total",1036,490,546,1022,14,11,6.67,155.3
"2011","Islington 011F","E01033487","Total",1226,619,607,1226,0,5,2.44,502.5
"2011","Islington 011G","E01033488","Total",1205,571,634,1205,0,6,10.06,119.8
"2011","Islington 011H","E01033491","Total",1680,866,814,1680,0,9,18.75,89.6
"2011","Islington 011I","E01033492","Total",1348,710,638,1348,0,6,14.95,90.2
"2011","Islington 012A","E01002777","Total",1626,776,850,1626,0,14,11.78,138.0
"2011","Islington 012B","E01002778","Total",1787,847,940,1787,0,12,10.50,170.2
"2011","Islington 012C","E01002779","Total",1891,893,998,1687,204,14,11.05,171.1
"2011","Islington 012D","E01002781","Total",1350,650,700,1341,9,17,9.12,148.0
"2011","Islington 012E","E01002782","Total",1533,738,795,1533,0,13,8.81,174.0
"2011","Islington 013A","E01002739","Total",1835,884,951,1835,0,23,11.74,156.3
"2011","Islington 013B","E01002740","Total",1826,911,915,1826,0,38,22.18,82.3
"2011","Islington 013C","E01002745","Total",1467,697,770,1467,0,18,10.67,137.5
"2011","Islington 013D","E01002795","Total",1997,1004,993,1997,0,16,17.61,113.4
"2011","Islington 013E","E01002796","Total",1039,496,543,1039,0,12,7.79,133.4
"2011","Islington 014A","E01002716","Total",2300,1006,1294,2300,0,12,13.06,176.1
"2011","Islington 014B","E01002718","Total",1661,829,832,1661,0,9,9.92,167.4
"2011","Islington 014C","E01002721","Total",1667,802,865,1667,0,10,12.12,137.5
"2011","Islington 014D","E01002775","Total",1429,689,740,1429,0,12,11.83,120.8
"2011","Islington 014E","E01002776","Total",1661,791,870,1661,0,12,11.59,143.3
"2011","Islington 014F","E01002780","Total",1640,771,869,1640,0,26,7.90,207.6
"2011","Islington 015A","E01002708","Total",1979,979,1000,1859,120,19,33.73,58.7
"2011","Islington 015B","E01002712","Total",1780,1172,608,1192,588,9,11.48,155.1
"2011","Islington 015C","E01002713","Total",1559,743,816,1559,0,4,14.33,108.8
"2011","Islington 015D","E01002765","Total",2513,1196,1317,2257,256,20,17.08,147.1
"2011","Islington 015E","E01002766","Total",1794,855,939,1794,0,16,13.67,131.2
"2011","Islington 016A","E01002717","Total",1315,648,667,1315,0,14,12.44,105.7
"2011","Islington 016B","E01002719","Total",1490,690,800,1490,0,11,14.59,102.1
"2011","Islington 016C","E01002720","Total",2334,1040,1294,2334,0,16,10.12,230.6
"2011","Islington 016D","E01002790","Total",1435,678,757,1435,0,12,7.89,181.9
"2011","Islington 016E","E01002791","Total",1543,778,765,1543,0,21,14.34,107.6
"2011","Islington 016F","E01002793","Total",1905,935,970,1898,7,15,10.66,178.7
"2011","Islington 017A","E01002698","Total",2063,1035,1028,2063,0,17,11.01,187.4
"2011","Islington 017B","E01002699","Total",1507,764,743,1507,0,16,9.15,164.7
"2011","Islington 017C","E01002700","Total",1478,771,707,1459,19,35,17.98,82.2
"2011","Islington 017D","E01002714","Total",1698,836,862,1698,0,25,11.45,148.3
"2011","Islington 017E","E01002792","Total",1869,897,972,1868,1,27,10.53,177.5
"2011","Islington 018A","E01002722","Total",1305,648,657,1305,0,9,8.48,153.9
"2011","Islington 018B","E01002797","Total",1873,919,954,1873,0,15,10.91,171.7
"2011","Islington 018C","E01002798","Total",1965,1013,952,1932,33,15,13.80,142.4
"2011","Islington 018D","E01002799","Total",1839,860,979,1839,0,15,8.46,217.4
"2011","Islington 018E","E01002800","Total",1049,508,541,1049,0,11,8.14,128.9
"2011","Islington 019A","E01002694","Total",1532,685,847,1532,0,15,7.03,217.9
"2011","Islington 019B","E01002697","Total",2098,991,1107,1635,463,35,11.13,188.5
"2011","Islington 019C","E01002709","Total",1754,887,867,1754,0,8,8.01,219.0
"2011","Islington 019D","E01002710","Total",1676,786,890,1676,0,16,13.91,120.5
"2011","Islington 019E","E01002715","Total",1511,722,789,1511,0,11,5.78,261.4
"2011","Islington 020A","E01002696","Total",1813,889,924,1813,0,17,14.80,122.5
"2011","Islington 020B","E01002794","Total",1765,887,878,1765,0,26,18.06,97.7
"2011","Islington 020C","E01002801","Total",1553,798,755,1553,0,28,10.70,145.1
"2011","Islington 020D","E01002802","Total",1480,730,750,1480,0,9,10.99,134.7
"2011","Islington 020E","E01002803","Total",2063,1064,999,1896,167,22,17.96,114.9
"2011","Islington 021A","E01002695","Total",1710,816,894,1639,71,3,11.83,144.5
"2011","Islington 021B","E01002711","Total",1939,1018,921,1934,5,5,15.14,128.1
"2011","Islington 021C","E01002727","Total",1624,820,804,1624,0,11,11.58,140.2
"2011","Islington 021D","E01002728","Total",1635,777,858,1015,620,19,9.10,179.7
"2011","Islington 021E","E01002729","Total",1593,767,826,1496,97,18,13.16,121.0
"2011","Islington 022B","E01002707","Total",1726,914,812,1717,9,23,11.89,145.2
"2011","Islington 022C","E01002723","Total",1529,784,745,1529,0,19,10.25,149.2
"2011","Islington 022D","E01002724","Total",1973,1094,879,1748,225,13,26.41,74.7
"2011","Islington 022E","E01002725","Total",1444,761,683,1235,209,9,6.10,236.7
"2011","Islington 022F","E01002726","Total",1692,887,805,1669,23,16,16.86,100.4
"2011","Islington 022G","E01033489","Total",1832,951,881,1288,544,23,9.44,194.1
"2011","Islington 022H","E01033490","Total",1693,835,858,1232,461,18,12.01,141.0
"2011","Islington 023A","E01002701","Total",1582,788,794,1471,111,18,8.29,190.8
"2011","Islington 023B","E01002702","Total",1957,985,972,1822,135,27,11.57,169.1
"2011","Islington 023C","E01002703","Total",1635,847,788,1635,0,10,8.61,189.9
"2011","Islington 023D","E01002704","Total",2198,1207,991,1898,300,17,33.51,65.6
"2011","Islington 023E","E01002706","Total",2016,984,1032,1961,55,7,13.62,148.0
"2011","Kensington and Chelsea 001A","E01002852","Total",1908,912,996,1908,0,16,51.34,37.2
"2011","Kensington and Chelsea 001B","E01002853","Total",1093,541,552,1093,0,18,6.34,172.4
"2011","Kensington and Chelsea 001C","E01002854","Total",1121,532,589,1121,0,9,12.85,87.2
"2011","Kensington and Chelsea 001D","E01002855","Total",1728,872,856,1724,4,15,10.59,163.2
"2011","Kensington and Chelsea 001E","E01002857","Total",1349,666,683,1349,0,16,6.00,224.8
"2011","Kensington and Chelsea 002A","E01002904","Total",1173,583,590,1173,0,11,9.94,118.0
"2011","Kensington and Chelsea 002B","E01002905","Total",1568,708,860,1545,23,11,16.85,93.1
"2011","Kensington and Chelsea 002C","E01002906","Total",1681,817,864,1612,69,11,19.37,86.8
"2011","Kensington and Chelsea 002D","E01002907","Total",1376,644,732,1376,0,11,5.20,264.6
"2011","Kensington and Chelsea 003A","E01002876","Total",1732,849,883,1721,11,31,12.48,138.8
"2011","Kensington and Chelsea 003B","E01002877","Total",1710,790,920,1703,7,21,16.79,101.8
"2011","Kensington and Chelsea 003C","E01002878","Total",1629,776,853,1615,14,22,12.21,133.4
"2011","Kensington and Chelsea 003D","E01002908","Total",1391,648,743,1379,12,21,9.64,144.3
"2011","Kensington and Chelsea 003E","E01002909","Total",2154,1028,1126,2152,2,28,9.93,216.9
"2011","Kensington and Chelsea 004A","E01002829","Total",1466,748,718,1455,11,29,5.80,252.8
"2011","Kensington and Chelsea 004B","E01002830","Total",1773,906,867,1773,0,10,7.44,238.3
"2011","Kensington and Chelsea 004C","E01002831","Total",1977,937,1040,1958,19,22,11.03,179.2
"2011","Kensington and Chelsea 004D","E01002832","Total",1701,793,908,1701,0,15,7.56,225.0
"2011","Kensington and Chelsea 004E","E01002856","Total",1738,862,876,1732,6,10,7.79,223.1
"2011","Kensington and Chelsea 005A","E01002870","Total",1386,667,719,1386,0,9,12.64,109.7
"2011","Kensington and Chelsea 005B","E01002872","Total",1446,672,774,1440,6,14,9.68,149.4
"2011","Kensington and Chelsea 005C","E01002879","Total",1528,691,837,1528,0,7,8.50,179.8
"2011","Kensington and Chelsea 005D","E01002880","Total",1540,702,838,1540,0,17,6.46,238.4
"2011","Kensington and Chelsea 005E","E01002881","Total",1398,683,715,1398,0,29,5.86,238.6
"2011","Kensington and Chelsea 006A","E01002882","Total",1334,584,750,1334,0,35,11.83,112.8
"2011","Kensington and Chelsea 006B","E01002883","Total",1836,881,955,1696,140,39,11.57,158.7
"2011","Kensington and Chelsea 006C","E01002884","Total",1403,749,654,1203,200,16,7.69,182.4
"2011","Kensington and Chelsea 006D","E01002885","Total",1538,788,750,1538,0,15,5.40,284.8
"2011","Kensington and Chelsea 006E","E01002886","Total",1548,756,792,1546,2,41,12.30,125.9
"2011","Kensington and Chelsea 007A","E01002833","Total",1460,696,764,1460,0,17,7.24,201.7
"2011","Kensington and Chelsea 007B","E01002871","Total",1685,819,866,1680,5,68,13.07,128.9
"2011","Kensington and Chelsea 007C","E01002873","Total",1331,634,697,1331,0,29,13.00,102.4
"2011","Kensington and Chelsea 007D","E01002874","Total",1439,701,738,1431,8,45,8.29,173.6
"2011","Kensington and Chelsea 007E","E01002875","Total",1388,635,753,1388,0,88,15.97,86.9
"2011","Kensington and Chelsea 008A","E01002824","Total",1519,732,787,1515,4,43,15.12,100.5
"2011","Kensington and Chelsea 008B","E01002825","Total",1941,873,1068,1817,124,41,19.17,101.3
"2011","Kensington and Chelsea 008C","E01002826","Total",1551,774,777,1474,77,16,22.00,70.5
"2011","Kensington and Chelsea 008D","E01002827","Total",1835,908,927,1814,21,58,25.26,72.6
"2011","Kensington and Chelsea 008E","E01002828","Total",1332,685,647,1332,0,29,9.61,138.6
"2011","Kensington and Chelsea 009A","E01002864","Total",1500,676,824,1496,4,46,29.71,50.5
"2011","Kensington and Chelsea 009B","E01002866","Total",1744,843,901,1744,0,40,15.74,110.8
"2011","Kensington and Chelsea 009C","E01002867","Total",1981,968,1013,1981,0,34,10.59,187.1
"2011","Kensington and Chelsea 009D","E01002868","Total",1652,838,814,1633,19,38,24.60,67.2
"2011","Kensington and Chelsea 009E","E01002869","Total",1507,769,738,1507,0,18,10.14,148.6
"2011","Kensington and Chelsea 010A","E01002887","Total",1401,728,673,1400,1,21,7.69,182.2
"2011","Kensington and Chelsea 010B","E01002889","Total",1279,622,657,1118,161,37,11.96,106.9
"2011","Kensington and Chelsea 010C","E01002890","Total",1812,851,961,1812,0,70,15.67,115.6
"2011","Kensington and Chelsea 010D","E01002891","Total",1446,735,711,1436,10,38,9.88,146.4
"2011","Kensington and Chelsea 010E","E01002892","Total",1831,976,855,1800,31,34,7.33,249.8
"2011","Kensington and Chelsea 011A","E01002813","Total",1767,924,843,1767,0,55,11.07,159.6
"2011","Kensington and Chelsea 011B","E01002815","Total",1424,711,713,1423,1,20,6.40,222.5
"2011","Kensington and Chelsea 011C","E01002816","Total",1355,673,682,1322,33,37,5.94,228.1
"2011","Kensington and Chelsea 011D","E01002817","Total",1594,762,832,1593,1,54,15.73,101.3
"2011","Kensington and Chelsea 011E","E01002865","Total",1383,673,710,1383,0,76,13.10,105.6
"2011","Kensington and Chelsea 012A","E01002818","Total",2002,1071,931,2002,0,22,18.91,105.9
"2011","Kensington and Chelsea 012B","E01002819","Total",1586,827,759,1585,1,29,21.44,74.0
"2011","Kensington and Chelsea 012C","E01002859","Total",1628,845,783,1628,0,48,12.82,127.0
"2011","Kensington and Chelsea 012D","E01002860","Total",1502,743,759,1502,0,59,11.12,135.1
"2011","Kensington and Chelsea 012E","E01002863","Total",1441,739,702,1441,0,33,12.42,116.0
"2011","Kensington and Chelsea 013A","E01002812","Total",1917,1002,915,1763,154,23,9.13,210.0
"2011","Kensington and Chelsea 013B","E01002834","Total",1430,736,694,1410,20,16,6.22,229.9
"2011","Kensington and Chelsea 013C","E01002839","Total",1568,861,707,1566,2,17,6.31,248.5
"2011","Kensington and Chelsea 013D","E01002850","Total",1451,781,670,1377,74,21,7.46,194.5
"2011","Kensington and Chelsea 013E","E01002888","Total",2078,1140,938,2022,56,26,7.96,261.1
"2011","Kensington and Chelsea 014A","E01002821","Total",1425,695,730,1420,5,45,19.11,74.6
"2011","Kensington and Chelsea 014B","E01002823","Total",1369,647,722,1369,0,35,8.04,170.3
"2011","Kensington and Chelsea 014C","E01002858","Total",1254,553,701,1254,0,28,5.88,213.3
"2011","Kensington and Chelsea 014D","E01002861","Total",1424,711,713,1424,0,36,8.63,165.0
"2011","Kensington and Chelsea 014E","E01002862","Total",1543,724,819,1543,0,25,4.39,351.5
"2011","Kensington and Chelsea 015A","E01002814","Total",1956,957,999,1953,3,16,14.63,133.7
"2011","Kensington and Chelsea 015B","E01002847","Total",1599,837,762,1552,47,23,7.21,221.8
"2011","Kensington and Chelsea 015C","E01002848","Total",1572,825,747,1567,5,13,8.21,191.5
"2011","Kensington and Chelsea 015D","E01002851","Total",1642,858,784,1576,66,25,6.03,272.3
"2011","Kensington and Chelsea 016A","E01002820","Total",1251,611,640,1250,1,24,16.88,74.1
"2011","Kensington and Chelsea 016B","E01002822","Total",1206,577,629,1205,1,29,11.11,108.6
"2011","Kensington and Chelsea 016C","E01002835","Total",1555,771,784,1550,5,34,15.07,103.2
"2011","Kensington and Chelsea 016D","E01002836","Total",1390,724,666,1390,0,16,7.22,192.5
"2011","Kensington and Chelsea 016E","E01002837","Total",1359,686,673,1329,30,33,6.43,211.4
"2011","Kensington and Chelsea 017A","E01002846","Total",1315,674,641,1313,2,10,10.56,124.5
"2011","Kensington and Chelsea 017B","E01002849","Total",1525,797,728,1523,2,23,6.49,235.0
"2011","Kensington and Chelsea 017C","E01002893","Total",1775,918,857,1767,8,20,9.80,181.1
"2011","Kensington and Chelsea 017D","E01002894","Total",1400,734,666,1389,11,15,10.15,137.9
"2011","Kensington and Chelsea 017E","E01002898","Total",1609,785,824,1609,0,33,12.83,125.4
"2011","Kensington and Chelsea 018A","E01002899","Total",1355,664,691,1355,0,45,7.45,181.9
"2011","Kensington and Chelsea 018B","E01002900","Total",1430,676,754,1430,0,58,12.75,112.2
"2011","Kensington and Chelsea 018C","E01002901","Total",1250,699,551,956,294,24,32.28,38.7
"2011","Kensington and Chelsea 018D","E01002902","Total",1704,844,860,1704,0,30,13.82,123.3
"2011","Kensington and Chelsea 018E","E01002903","Total",1513,742,771,1513,0,88,11.06,136.8
"2011","Kensington and Chelsea 019A","E01002844","Total",1370,671,699,1369,1,31,12.36,110.8
"2011","Kensington and Chelsea 019B","E01002845","Total",1358,681,677,1326,32,25,7.03,193.2
"2011","Kensington and Chelsea 019C","E01002910","Total",1388,628,760,1329,59,41,14.23,97.5
"2011","Kensington and Chelsea 019D","E01002911","Total",1651,770,881,1651,0,65,12.08,136.7
"2011","Kensington and Chelsea 019E","E01002914","Total",1564,722,842,1432,132,25,17.81,87.8
"2011","Kensington and Chelsea 020A","E01002838","Total",1631,909,722,1057,574,33,6.95,234.7
"2011","Kensington and Chelsea 020B","E01002895","Total",1395,678,717,1395,0,40,10.90,128.0
"2011","Kensington and Chelsea 020C","E01002896","Total",1752,894,858,1752,0,56,11.37,154.1
"2011","Kensington and Chelsea 020D","E01002897","Total",1314,648,666,1314,0,15,14.32,91.8
"2011","Kensington and Chelsea 020E","E01002912","Total",1690,771,919,1601,89,23,11.21,150.8
"2011","Kensington and Chelsea 021A","E01002840","Total",1383,629,754,1383,0,20,8.90,155.4
"2011","Kensington and Chelsea 021B","E01002841","Total",1368,694,674,1363,5,25,11.14,122.8
"2011","Kensington and Chelsea 021C","E01002842","Total",1253,568,685,1248,5,7,1.83,684.7
"2011","Kensington and Chelsea 021D","E01002843","Total",1232,554,678,1232,0,19,6.73,183.1
"2011","Kensington and Chelsea 021E","E01002913","Total",1894,932,962,1894,0,45,10.91,173.6
"2011","Lambeth 002A","E01003015","Total",1594,739,855,1594,0,6,9.55,166.9
"2011","Lambeth 002B","E01003108","Total",1555,811,744,1536,19,25,8.01,194.1
"2011","Lambeth 002C","E01003110","Total",1873,965,908,1825,48,8,15.07,124.3
"2011","Lambeth 002D","E01003111","Total",1530,771,759,1530,0,21,7.35,208.2
"2011","Lambeth 002E","E01003112","Total",1502,783,719,1502,0,15,14.86,101.1
"2011","Lambeth 003A","E01003101","Total",1568,812,756,1568,0,14,11.59,135.3
"2011","Lambeth 003B","E01003105","Total",1673,835,838,1673,0,18,9.58,174.6
"2011","Lambeth 003C","E01003106","Total",1962,1001,961,1942,20,22,11.90,164.9
"2011","Lambeth 003D","E01003107","Total",1912,1049,863,1912,0,13,12.95,147.6
"2011","Lambeth 003E","E01003109","Total",2255,1198,1057,2255,0,23,26.62,84.7
"2011","Lambeth 004A","E01003102","Total",1738,953,785,1655,83,13,16.59,104.8
"2011","Lambeth 004C","E01003104","Total",1608,883,725,1608,0,5,8.18,196.6
"2011","Lambeth 004D","E01003122","Total",1813,976,837,1811,2,6,10.32,175.7
"2011","Lambeth 004E","E01003129","Total",1839,964,875,1839,0,20,8.64,212.8
"2011","Lambeth 004F","E01033207","Total",1708,928,780,1635,73,19,24.15,70.7
"2011","Lambeth 004G","E01033208","Total",1723,945,778,1723,0,14,5.00,344.6
"2011","Lambeth 005A","E01003098","Total",1558,828,730,1544,14,23,8.03,194.0
"2011","Lambeth 005B","E01003099","Total",1590,857,733,1590,0,22,30.42,52.3
"2011","Lambeth 005C","E01003100","Total",1942,1090,852,1928,14,4,10.16,191.1
"2011","Lambeth 005D","E01003180","Total",1506,749,757,1471,35,17,14.06,107.1
"2011","Lambeth 005E","E01003183","Total",1498,753,745,1498,0,17,15.18,98.7
"2011","Lambeth 006A","E01003097","Total",1671,854,817,1671,0,8,9.81,170.3
"2011","Lambeth 006B","E01003121","Total",1624,795,829,1624,0,31,6.18,262.8
"2011","Lambeth 006C","E01003123","Total",1489,791,698,1484,5,28,14.46,103.0
"2011","Lambeth 006D","E01003124","Total",1444,778,666,1438,6,11,8.13,177.6
"2011","Lambeth 006E","E01003125","Total",1762,831,931,1762,0,24,7.29,241.7
"2011","Lambeth 007A","E01003181","Total",1472,737,735,1449,23,10,8.13,181.1
"2011","Lambeth 007B","E01003184","Total",1414,668,746,1414,0,19,5.57,253.9
"2011","Lambeth 007C","E01003185","Total",1655,860,795,1645,10,6,8.80,188.1
"2011","Lambeth 007D","E01003186","Total",1948,1047,901,1939,9,32,20.86,93.4
"2011","Lambeth 007E","E01003187","Total",1487,713,774,1486,1,13,14.18,104.9
"2011","Lambeth 008A","E01003089","Total",1874,956,918,1874,0,24,13.26,141.3
"2011","Lambeth 008B","E01003091","Total",1667,855,812,1667,0,21,8.04,207.3
"2011","Lambeth 008C","E01003092","Total",1787,873,914,1738,49,13,15.77,113.3
"2011","Lambeth 008D","E01003126","Total",1532,781,751,1532,0,16,9.79,156.5
"2011","Lambeth 008E","E01003128","Total",1501,774,727,1499,2,18,8.67,173.1
"2011","Lambeth 009A","E01003046","Total",1741,839,902,1738,3,19,9.48,183.6
"2011","Lambeth 009B","E01003048","Total",1764,848,916,1764,0,26,12.14,145.3
"2011","Lambeth 009C","E01003075","Total",1633,795,838,1614,19,7,7.81,209.1
"2011","Lambeth 009D","E01003182","Total",1822,939,883,1804,18,22,18.05,100.9
"2011","Lambeth 009E","E01003188","Total",1341,646,695,1336,5,20,8.10,165.6
"2011","Lambeth 010A","E01003088","Total",1817,876,941,1817,0,12,9.44,192.5
"2011","Lambeth 010B","E01003093","Total",2371,1116,1255,2305,66,24,7.35,322.6
"2011","Lambeth 010C","E01003094","Total",1539,739,800,1539,0,8,8.13,189.3
"2011","Lambeth 010D","E01003096","Total",2071,1143,928,2062,9,12,14.28,145.0
"2011","Lambeth 010E","E01003127","Total",1773,963,810,1773,0,31,13.43,132.0
"2011","Lambeth 011A","E01003045","Total",1971,976,995,1971,0,15,11.42,172.6
"2011","Lambeth 011B","E01003047","Total",1627,824,803,1627,0,16,18.06,90.1
"2011","Lambeth 011C","E01003049","Total",1695,816,879,1686,9,10,11.90,142.4
"2011","Lambeth 011D","E01003059","Total",1634,826,808,1592,42,16,7.74,211.1
"2011","Lambeth 011E","E01003060","Total",1558,774,784,1558,0,29,8.52,182.9
"2011","Lambeth 011F","E01003061","Total",1246,658,588,1242,4,7,7.94,156.9
"2011","Lambeth 012A","E01003034","Total",1751,898,853,1731,20,16,11.47,152.7
"2011","Lambeth 012B","E01003035","Total",1557,759,798,1557,0,7,11.76,132.4
"2011","Lambeth 012C","E01003036","Total",1608,808,800,1603,5,16,11.31,142.2
"2011","Lambeth 012D","E01003090","Total",2279,1197,1082,2279,0,9,14.12,161.4
"2011","Lambeth 012E","E01003095","Total",1838,908,930,1834,4,34,15.49,118.7
"2011","Lambeth 013A","E01003037","Total",1387,628,759,1387,0,10,11.43,121.3
"2011","Lambeth 013B","E01003038","Total",1506,757,749,1506,0,26,13.29,113.3
"2011","Lambeth 013C","E01003039","Total",2042,1092,950,2042,0,23,18.48,110.5
"2011","Lambeth 013D","E01003040","Total",1288,618,670,1288,0,23,15.09,85.4
"2011","Lambeth 013E","E01003042","Total",1043,514,529,1042,1,6,9.57,109.0
"2011","Lambeth 014A","E01003072","Total",1848,895,953,1846,2,31,20.76,89.0
"2011","Lambeth 014B","E01003073","Total",1697,805,892,1697,0,17,16.89,100.5
"2011","Lambeth 014C","E01003076","Total",1915,946,969,1887,28,25,37.61,50.9
"2011","Lambeth 014D","E01003077","Total",1792,871,921,1792,0,8,10.34,173.3
"2011","Lambeth 014E","E01003078","Total",1580,773,807,1576,4,33,20.87,75.7
"2011","Lambeth 015A","E01003019","Total",2090,1063,1027,2084,6,11,15.04,139.0
"2011","Lambeth 015B","E01003053","Total",1728,895,833,1724,4,9,11.59,149.1
"2011","Lambeth 015C","E01003054","Total",1832,905,927,1825,7,12,8.77,208.9
"2011","Lambeth 015D","E01003056","Total",1935,954,981,1929,6,2,8.31,232.9
"2011","Lambeth 015E","E01003058","Total",1931,1012,919,1922,9,7,9.11,212.0
"2011","Lambeth 016A","E01003020","Total",1775,848,927,1772,3,23,14.35,123.7
"2011","Lambeth 016B","E01003050","Total",1650,832,818,1618,32,8,9.81,168.2
"2011","Lambeth 016C","E01003052","Total",1821,933,888,1821,0,19,12.59,144.6
"2011","Lambeth 016D","E01003055","Total",1490,783,707,1464,26,18,13.68,108.9
"2011","Lambeth 016E","E01003176","Total",1906,890,1016,1906,0,21,12.71,150.0
"2011","Lambeth 017A","E01003029","Total",1808,916,892,1781,27,15,14.87,121.6
"2011","Lambeth 017B","E01003032","Total",1747,867,880,1747,0,31,17.99,97.1
"2011","Lambeth 017C","E01003041","Total",1613,784,829,1536,77,10,9.60,168.0
"2011","Lambeth 017D","E01003057","Total",1678,825,853,1676,2,18,9.63,174.2
"2011","Lambeth 018A","E01003043","Total",1634,793,841,1634,0,13,10.34,158.0
"2011","Lambeth 018B","E01003044","Total",1238,637,601,1238,0,12,6.72,184.2
"2011","Lambeth 018C","E01003051","Total",1643,776,867,1641,2,15,18.34,89.6
"2011","Lambeth 018D","E01003071","Total",2278,1155,1123,2278,0,28,17.76,128.3
"2011","Lambeth 018E","E01003074","Total",2364,1207,1157,2347,17,20,71.11,33.2
"2011","Lambeth 019A","E01003026","Total",1484,760,724,1471,13,16,34.76,42.7
"2011","Lambeth 019B","E01003027","Total",1373,667,706,1373,0,38,12.40,110.7
"2011","Lambeth 019C","E01003028","Total",1469,751,718,1469,0,26,13.66,107.5
"2011","Lambeth 019D","E01003030","Total",1795,895,900,1782,13,20,16.71,107.4
"2011","Lambeth 019E","E01003033","Total",1518,756,762,1518,0,41,14.86,102.2
"2011","Lambeth 020A","E01003018","Total",2079,1063,1016,2063,16,7,15.00,138.6
"2011","Lambeth 020B","E01003171","Total",1745,873,872,1740,5,25,10.43,167.3
"2011","Lambeth 020C","E01003173","Total",1610,818,792,1610,0,12,12.53,128.5
"2011","Lambeth 020D","E01003177","Total",1648,849,799,1648,0,11,9.72,169.5
"2011","Lambeth 020E","E01003178","Total",1605,824,781,1576,29,4,10.75,149.3
"2011","Lambeth 021A","E01003021","Total",1903,1065,838,1514,389,17,16.08,118.3
"2011","Lambeth 021B","E01003022","Total",1746,839,907,1746,0,13,11.60,150.5
"2011","Lambeth 021C","E01003023","Total",2380,1154,1226,2380,0,15,12.76,186.5
"2011","Lambeth 021D","E01003024","Total",1798,854,944,1798,0,15,12.40,145.0
"2011","Lambeth 021E","E01003025","Total",2071,1047,1024,2071,0,12,15.67,132.2
"2011","Lambeth 022A","E01003136","Total",1583,753,830,1583,0,18,11.65,135.9
"2011","Lambeth 022B","E01003137","Total",1475,727,748,1446,29,11,11.27,130.9
"2011","Lambeth 022C","E01003159","Total",1473,732,741,1473,0,16,14.48,101.7
"2011","Lambeth 022D","E01003160","Total",1462,705,757,1462,0,15,10.10,144.8
"2011","Lambeth 022E","E01003162","Total",2126,1008,1118,2126,0,22,10.93,194.5
"2011","Lambeth 023A","E01003031","Total",1658,818,840,1658,0,12,9.05,183.2
"2011","Lambeth 023B","E01003156","Total",1555,733,822,1555,0,16,11.68,133.1
"2011","Lambeth 023C","E01003157","Total",1549,739,810,1549,0,14,16.77,92.4
"2011","Lambeth 023D","E01003158","Total",1596,728,868,1596,0,16,12.41,128.6
"2011","Lambeth 023E","E01003161","Total",1250,592,658,1237,13,10,11.89,105.1
"2011","Lambeth 023F","E01003163","Total",1515,726,789,1515,0,19,20.02,75.7
"2011","Lambeth 024A","E01003132","Total",1522,709,813,1413,109,17,14.23,107.0
"2011","Lambeth 024B","E01003172","Total",1949,990,959,1922,27,12,12.19,159.9
"2011","Lambeth 024C","E01003174","Total",2045,919,1126,2045,0,21,15.16,134.9
"2011","Lambeth 024D","E01003175","Total",1610,758,852,1610,0,13,12.13,132.7
"2011","Lambeth 024E","E01003179","Total",1653,762,891,1648,5,25,7.30,226.4
"2011","Lambeth 025A","E01003164","Total",2120,1050,1070,2118,2,6,18.15,116.8
"2011","Lambeth 025B","E01003165","Total",1610,757,853,1610,0,28,18.32,87.9
"2011","Lambeth 025C","E01003168","Total",1584,752,832,1584,0,22,20.75,76.3
"2011","Lambeth 025D","E01003169","Total",2455,1228,1227,2446,9,20,19.01,129.1
"2011","Lambeth 025E","E01003170","Total",1859,905,954,1859,0,41,32.18,57.8
"2011","Lambeth 026A","E01003130","Total",1740,902,838,1735,5,20,14.77,117.8
"2011","Lambeth 026B","E01003131","Total",1447,704,743,1447,0,35,18.30,79.1
"2011","Lambeth 026C","E01003135","Total",1684,803,881,1684,0,17,10.32,163.2
"2011","Lambeth 026D","E01003138","Total",1537,759,778,1531,6,19,13.24,116.1
"2011","Lambeth 026E","E01003151","Total",1961,846,1115,1950,11,15,13.45,145.8
"2011","Lambeth 027A","E01003079","Total",1797,846,951,1709,88,16,22.17,81.1
"2011","Lambeth 027B","E01003080","Total",1603,801,802,1599,4,30,12.76,125.6
"2011","Lambeth 027C","E01003133","Total",1719,882,837,1719,0,25,17.38,98.9
"2011","Lambeth 027D","E01003134","Total",1556,747,809,1552,4,14,16.12,96.5
"2011","Lambeth 027E","E01003152","Total",1945,937,1008,1945,0,30,22.02,88.3
"2011","Lambeth 028A","E01003064","Total",1536,756,780,1536,0,23,15.25,100.7
"2011","Lambeth 028B","E01003066","Total",1688,810,878,1688,0,19,34.48,49.0
"2011","Lambeth 028C","E01003081","Total",1783,903,880,1766,17,22,20.55,86.8
"2011","Lambeth 028D","E01003166","Total",2290,1117,1173,2279,11,44,23.14,99.0
"2011","Lambeth 028E","E01003167","Total",1723,838,885,1723,0,40,19.90,86.6
"2011","Lambeth 029A","E01003116","Total",1598,768,830,1583,15,38,28.16,56.7
"2011","Lambeth 029B","E01003117","Total",1926,941,985,1914,12,7,16.76,114.9
"2011","Lambeth 029C","E01003118","Total",1735,873,862,1677,58,31,21.15,82.0
"2011","Lambeth 029D","E01003153","Total",2066,1027,1039,2066,0,11,12.22,169.1
"2011","Lambeth 029E","E01003155","Total",1796,902,894,1743,53,12,16.50,108.8
"2011","Lambeth 030A","E01003083","Total",1508,732,776,1459,49,16,14.83,101.7
"2011","Lambeth 030B","E01003084","Total",1611,802,809,1603,8,20,14.11,114.2
"2011","Lambeth 030C","E01003085","Total",1734,840,894,1734,0,28,22.48,77.1
"2011","Lambeth 030D","E01003149","Total",1791,883,908,1693,98,19,26.57,67.4
"2011","Lambeth 030E","E01003154","Total",1839,922,917,1836,3,24,18.72,98.2
"2011","Lambeth 031A","E01003065","Total",1472,659,813,1472,0,12,12.25,120.2
"2011","Lambeth 031B","E01003068","Total",1592,744,848,1592,0,22,17.81,89.4
"2011","Lambeth 031C","E01003082","Total",1452,700,752,1446,6,11,12.55,115.7
"2011","Lambeth 031D","E01003086","Total",1611,712,899,1611,0,19,14.56,110.6
"2011","Lambeth 031E","E01003087","Total",1664,764,900,1562,102,3,13.25,125.6
"2011","Lambeth 032A","E01003113","Total",1988,979,1009,1922,66,20,16.45,120.9
"2011","Lambeth 032B","E01003114","Total",1817,902,915,1812,5,10,19.84,91.6
"2011","Lambeth 032C","E01003119","Total",1885,930,955,1833,52,9,17.07,110.4
"2011","Lambeth 032D","E01003120","Total",1983,1026,957,1939,44,17,14.56,136.2
"2011","Lambeth 032E","E01003148","Total",1792,897,895,1777,15,14,19.43,92.2
"2011","Lambeth 032F","E01003150","Total",1716,833,883,1690,26,8,16.22,105.8
"2011","Lambeth 033A","E01003062","Total",1668,784,884,1668,0,12,13.56,123.0
"2011","Lambeth 033B","E01003063","Total",1432,658,774,1432,0,17,12.31,116.3
"2011","Lambeth 033C","E01003067","Total",1471,707,764,1471,0,18,15.01,98.0
"2011","Lambeth 033D","E01003069","Total",1361,619,742,1361,0,16,23.50,57.9
"2011","Lambeth 033E","E01003070","Total",1492,704,788,1492,0,17,12.81,116.5
"2011","Lambeth 034A","E01003115","Total",1618,764,854,1601,17,12,10.88,148.7
"2011","Lambeth 034B","E01003141","Total",1715,849,866,1707,8,18,16.31,105.2
"2011","Lambeth 034C","E01003144","Total",1569,799,770,1499,70,34,50.51,31.1
"2011","Lambeth 034D","E01003145","Total",1699,831,868,1675,24,14,16.58,102.5
"2011","Lambeth 034E","E01003147","Total",1990,1017,973,1974,16,19,17.70,112.4
"2011","Lambeth 035A","E01003139","Total",1564,760,804,1564,0,12,12.76,122.6
"2011","Lambeth 035B","E01003140","Total",1489,740,749,1489,0,15,13.84,107.6
"2011","Lambeth 035C","E01003142","Total",1359,687,672,1359,0,21,13.74,98.9
"2011","Lambeth 035D","E01003143","Total",1434,679,755,1395,39,16,16.14,88.8
"2011","Lambeth 035E","E01003146","Total",1517,767,750,1517,0,23,12.25,123.8
"2011","Lambeth 036A","E01003013","Total",1639,873,766,1562,77,25,34.38,47.7
"2011","Lambeth 036B","E01003014","Total",1534,787,747,1415,119,24,18.67,82.2
"2011","Lambeth 036C","E01003016","Total",1352,661,691,1026,326,28,16.33,82.8
"2011","Lambeth 036D","E01003017","Total",1663,895,768,1661,2,21,13.00,127.9
"2011","Lambeth 036E","E01032582","Total",1893,1022,871,1893,0,9,31.78,59.6
"2011","Lewisham 001A","E01003244","Total",1629,805,824,1629,0,23,6.70,243.1
"2011","Lewisham 001B","E01003245","Total",1559,723,836,1559,0,11,11.01,141.6
"2011","Lewisham 001C","E01003247","Total",1673,875,798,1673,0,22,19.78,84.6
"2011","Lewisham 001D","E01003249","Total",1928,992,936,1909,19,26,11.15,172.9
"2011","Lewisham 001E","E01003250","Total",1755,913,842,1755,0,17,18.99,92.4
"2011","Lewisham 002A","E01003246","Total",1439,709,730,1438,1,20,24.13,59.6
"2011","Lewisham 002B","E01003248","Total",1622,768,854,1619,3,13,25.50,63.6
"2011","Lewisham 002C","E01003251","Total",2003,936,1067,2003,0,30,22.95,87.3
"2011","Lewisham 002D","E01003252","Total",1557,742,815,1557,0,23,7.16,217.5
"2011","Lewisham 002E","E01003253","Total",1438,701,737,1438,0,16,14.83,97.0
"2011","Lewisham 003A","E01003297","Total",1538,769,769,1538,0,5,37.27,41.3
"2011","Lewisham 003B","E01003299","Total",1623,784,839,1623,0,18,15.12,107.3
"2011","Lewisham 003C","E01003301","Total",2166,1125,1041,1936,230,26,21.51,100.7
"2011","Lewisham 003D","E01003302","Total",1509,740,769,1509,0,26,12.59,119.9
"2011","Lewisham 003E","E01003305","Total",1372,651,721,1281,91,12,11.35,120.9
"2011","Lewisham 005A","E01003207","Total",1399,705,694,1399,0,9,12.09,115.7
"2011","Lewisham 005B","E01003209","Total",2007,978,1029,1868,139,12,12.67,158.4
"2011","Lewisham 005C","E01003210","Total",1746,942,804,1727,19,7,18.85,92.6
"2011","Lewisham 005D","E01003212","Total",1976,994,982,1976,0,15,22.51,87.8
"2011","Lewisham 005E","E01003215","Total",1950,921,1029,1596,354,21,21.26,91.7
"2011","Lewisham 006A","E01003338","Total",1784,881,903,1772,12,26,14.06,126.9
"2011","Lewisham 006B","E01003339","Total",1760,940,820,1753,7,24,14.95,117.7
"2011","Lewisham 006C","E01003340","Total",1906,1040,866,1906,0,16,17.50,108.9
"2011","Lewisham 006D","E01003341","Total",1508,764,744,1508,0,32,18.22,82.8
"2011","Lewisham 006E","E01003343","Total",1356,685,671,1356,0,18,12.67,107.0
"2011","Lewisham 007A","E01003199","Total",1728,813,915,1715,13,12,31.67,54.6
"2011","Lewisham 007B","E01003201","Total",1664,745,919,1626,38,26,15.66,106.3
"2011","Lewisham 007C","E01003204","Total",1391,682,709,1370,21,18,25.70,54.1
"2011","Lewisham 007D","E01003205","Total",1332,655,677,1332,0,11,9.00,148.0
"2011","Lewisham 007E","E01003206","Total",1582,779,803,1568,14,31,20.55,77.0
"2011","Lewisham 008B","E01003211","Total",1566,783,783,1554,12,9,20.13,77.8
"2011","Lewisham 008C","E01003213","Total",1938,942,996,1834,104,17,21.43,90.4
"2011","Lewisham 008D","E01003214","Total",1772,841,931,1755,17,15,15.66,113.2
"2011","Lewisham 008E","E01033324","Total",1597,745,852,1597,0,14,17.94,89.0
"2011","Lewisham 008F","E01033325","Total",1205,707,498,1205,0,6,6.08,198.2
"2011","Lewisham 009A","E01003198","Total",1461,654,807,1406,55,22,16.93,86.3
"2011","Lewisham 009B","E01003200","Total",1553,820,733,1553,0,11,73.84,21.0
"2011","Lewisham 009C","E01003202","Total",1559,740,819,1559,0,18,23.08,67.5
"2011","Lewisham 009D","E01003203","Total",1769,902,867,1757,12,11,14.82,119.4
"2011","Lewisham 010A","E01003336","Total",1378,653,725,1378,0,7,12.60,109.4
"2011","Lewisham 010B","E01003337","Total",1636,755,881,1636,0,23,13.23,123.7
"2011","Lewisham 010C","E01003342","Total",1641,842,799,1634,7,16,16.35,100.4
"2011","Lewisham 010D","E01003344","Total",1731,748,983,1731,0,29,18.78,92.2
"2011","Lewisham 010E","E01003345","Total",1714,861,853,1714,0,15,16.03,106.9
"2011","Lewisham 011A","E01003273","Total",2000,1192,808,2000,0,32,18.51,108.0
"2011","Lewisham 011B","E01003277","Total",1714,874,840,1706,8,20,14.30,119.9
"2011","Lewisham 011C","E01003278","Total",1887,943,944,1887,0,14,15.04,125.5
"2011","Lewisham 011D","E01003279","Total",1593,752,841,1593,0,25,17.78,89.6
"2011","Lewisham 012A","E01003288","Total",1810,909,901,1767,43,13,17.05,106.2
"2011","Lewisham 012C","E01003290","Total",1730,917,813,1701,29,18,14.41,120.1
"2011","Lewisham 012D","E01003291","Total",1512,755,757,1478,34,17,28.25,53.5
"2011","Lewisham 012E","E01003296","Total",2046,1046,1000,2046,0,10,36.33,56.3
"2011","Lewisham 012F","E01033327","Total",1527,787,740,1507,20,4,32.57,46.9
"2011","Lewisham 012G","E01033341","Total",1303,648,655,1298,5,11,12.75,102.2
"2011","Lewisham 013A","E01003282","Total",2418,1230,1188,2418,0,10,21.61,111.9
"2011","Lewisham 013B","E01003283","Total",2108,1064,1044,2108,0,25,23.37,90.2
"2011","Lewisham 013C","E01003284","Total",1757,880,877,1748,9,17,16.03,109.6
"2011","Lewisham 013D","E01003286","Total",1633,776,857,1633,0,12,19.02,85.9
"2011","Lewisham 014A","E01003272","Total",1966,906,1060,1959,7,14,14.86,132.3
"2011","Lewisham 014B","E01003274","Total",1724,831,893,1717,7,24,14.65,117.7
"2011","Lewisham 014C","E01003275","Total",1727,822,905,1640,87,18,19.44,88.8
"2011","Lewisham 014D","E01003276","Total",1904,864,1040,1898,6,16,46.24,41.2
"2011","Lewisham 015A","E01003225","Total",1507,706,801,1507,0,17,21.29,70.8
"2011","Lewisham 015B","E01003231","Total",1606,791,815,1603,3,19,17.29,92.9
"2011","Lewisham 015C","E01003232","Total",1719,778,941,1714,5,18,20.34,84.5
"2011","Lewisham 015D","E01003233","Total",1702,826,876,1702,0,19,13.81,123.2
"2011","Lewisham 016A","E01003280","Total",1606,801,805,1596,10,17,19.89,80.7
"2011","Lewisham 016B","E01003281","Total",1534,767,767,1534,0,20,34.69,44.2
"2011","Lewisham 016C","E01003285","Total",1608,794,814,1608,0,24,21.98,73.2
"2011","Lewisham 016D","E01003287","Total",1909,947,962,1909,0,35,24.30,78.6
"2011","Lewisham 017A","E01003292","Total",1565,792,773,1565,0,11,13.31,117.6
"2011","Lewisham 017B","E01003293","Total",1518,742,776,1515,3,12,11.11,136.6
"2011","Lewisham 017D","E01003295","Total",1672,855,817,1622,50,12,18.15,92.1
"2011","Lewisham 017E","E01033320","Total",1496,731,765,1463,33,12,14.66,102.0
"2011","Lewisham 017F","E01033322","Total",1267,651,616,1238,29,3,7.00,181.0
"2011","Lewisham 018A","E01003319","Total",1831,880,951,1831,0,10,13.11,139.7
"2011","Lewisham 018B","E01003320","Total",1494,712,782,1494,0,15,18.68,80.0
"2011","Lewisham 018C","E01003323","Total",1485,740,745,1478,7,13,16.96,87.6
"2011","Lewisham 018D","E01003325","Total",1729,811,918,1719,10,11,13.40,129.0
"2011","Lewisham 019A","E01003226","Total",1742,874,868,1742,0,23,18.10,96.2
"2011","Lewisham 019B","E01003227","Total",1658,839,819,1658,0,21,24.67,67.2
"2011","Lewisham 019C","E01003228","Total",1512,731,781,1487,25,9,14.22,106.3
"2011","Lewisham 019D","E01003229","Total",1558,744,814,1555,3,13,21.36,72.9
"2011","Lewisham 019E","E01003230","Total",1933,910,1023,1933,0,23,21.08,91.7
"2011","Lewisham 020A","E01003317","Total",1882,987,895,1882,0,22,39.82,47.3
"2011","Lewisham 020B","E01003318","Total",1638,848,790,1513,125,7,35.31,46.4
"2011","Lewisham 020C","E01003321","Total",1961,992,969,1915,46,18,16.65,117.8
"2011","Lewisham 020D","E01003322","Total",1429,741,688,1429,0,8,14.80,96.6
"2011","Lewisham 020E","E01003324","Total",1467,745,722,1467,0,15,9.33,157.2
"2011","Lewisham 021A","E01003254","Total",1437,727,710,1418,19,24,32.26,44.5
"2011","Lewisham 021B","E01003255","Total",1886,988,898,1886,0,14,18.08,104.3
"2011","Lewisham 021C","E01003260","Total",1824,946,878,1824,0,26,21.51,84.8
"2011","Lewisham 021D","E01003261","Total",1495,752,743,1495,0,22,18.07,82.7
"2011","Lewisham 021E","E01003262","Total",1365,647,718,1365,0,10,16.10,84.8
"2011","Lewisham 022A","E01003217","Total",1670,775,895,1667,3,27,16.07,103.9
"2011","Lewisham 022B","E01003218","Total",1498,708,790,1498,0,28,14.22,105.3
"2011","Lewisham 022C","E01003220","Total",1554,711,843,1499,55,22,17.96,86.5
"2011","Lewisham 022D","E01003222","Total",1632,779,853,1632,0,27,18.29,89.2
"2011","Lewisham 022E","E01003224","Total",1661,800,861,1648,13,19,15.21,109.2
"2011","Lewisham 023A","E01003263","Total",1675,780,895,1642,33,13,35.28,47.5
"2011","Lewisham 023B","E01003268","Total",1670,834,836,1664,6,15,29.34,56.9
"2011","Lewisham 023C","E01003269","Total",1554,726,828,1554,0,17,21.14,73.5
"2011","Lewisham 023D","E01003270","Total",1638,788,850,1638,0,18,28.18,58.1
"2011","Lewisham 023E","E01003271","Total",1667,825,842,1667,0,31,29.40,56.7
"2011","Lewisham 024A","E01003307","Total",1521,742,779,1521,0,25,14.47,105.1
"2011","Lewisham 024B","E01003308","Total",1824,873,951,1808,16,19,15.76,115.7
"2011","Lewisham 024C","E01003314","Total",1599,786,813,1596,3,10,15.51,103.1
"2011","Lewisham 024D","E01003315","Total",1287,651,636,1287,0,7,14.38,89.5
"2011","Lewisham 024E","E01003316","Total",1482,722,760,1482,0,20,14.46,102.5
"2011","Lewisham 025A","E01003216","Total",1875,947,928,1824,51,33,21.16,88.6
"2011","Lewisham 025B","E01003219","Total",1647,776,871,1647,0,17,20.95,78.6
"2011","Lewisham 025C","E01003221","Total",1962,981,981,1917,45,32,33.37,58.8
"2011","Lewisham 025D","E01003223","Total",1715,857,858,1715,0,34,29.54,58.1
"2011","Lewisham 026A","E01003346","Total",1537,718,819,1537,0,16,34.61,44.4
"2011","Lewisham 026B","E01003349","Total",1412,646,766,1412,0,4,13.74,102.8
"2011","Lewisham 026C","E01003351","Total",1463,654,809,1463,0,11,18.36,79.7
"2011","Lewisham 026D","E01003354","Total",1675,822,853,1675,0,18,36.62,45.7
"2011","Lewisham 027A","E01003309","Total",1510,754,756,1483,27,19,15.86,95.2
"2011","Lewisham 027B","E01003310","Total",1559,814,745,1551,8,14,16.01,97.4
"2011","Lewisham 027C","E01003311","Total",1546,755,791,1543,3,33,18.72,82.6
"2011","Lewisham 027D","E01003312","Total",1760,825,935,1760,0,23,19.84,88.7
"2011","Lewisham 027E","E01003313","Total",1530,783,747,1530,0,14,23.45,65.2
"2011","Lewisham 028A","E01003256","Total",2055,1073,982,2055,0,16,22.25,92.4
"2011","Lewisham 028B","E01003257","Total",1678,806,872,1607,71,25,21.79,77.0
"2011","Lewisham 028C","E01003258","Total",1499,732,767,1477,22,28,12.02,124.7
"2011","Lewisham 028D","E01003259","Total",1615,769,846,1611,4,12,20.69,78.1
"2011","Lewisham 029A","E01003193","Total",1568,754,814,1568,0,15,34.84,45.0
"2011","Lewisham 029B","E01003194","Total",1678,799,879,1678,0,22,32.98,50.9
"2011","Lewisham 029C","E01003195","Total",1547,746,801,1547,0,9,19.60,78.9
"2011","Lewisham 029D","E01003196","Total",1673,796,877,1673,0,15,26.72,62.6
"2011","Lewisham 029E","E01003197","Total",1628,758,870,1628,0,15,21.24,76.6
"2011","Lewisham 030A","E01003347","Total",1735,756,979,1735,0,22,14.28,121.5
"2011","Lewisham 030B","E01003348","Total",1459,700,759,1459,0,18,32.33,45.1
"2011","Lewisham 030C","E01003350","Total",1412,641,771,1412,0,10,24.21,58.3
"2011","Lewisham 030D","E01003352","Total",1816,905,911,1801,15,17,22.33,81.3
"2011","Lewisham 030E","E01003353","Total",1740,854,886,1740,0,19,25.87,67.3
"2011","Lewisham 031A","E01003264","Total",1610,765,845,1610,0,17,22.72,70.9
"2011","Lewisham 031B","E01003265","Total",1531,721,810,1531,0,14,23.07,66.4
"2011","Lewisham 031C","E01003266","Total",1735,796,939,1734,1,21,17.10,101.5
"2011","Lewisham 031D","E01003267","Total",1568,741,827,1568,0,8,33.02,47.5
"2011","Lewisham 033A","E01003329","Total",1590,762,828,1590,0,17,17.62,90.2
"2011","Lewisham 033B","E01003330","Total",1550,675,875,1550,0,17,25.94,59.8
"2011","Lewisham 033C","E01003331","Total",1412,653,759,1373,39,19,15.76,89.6
"2011","Lewisham 033D","E01003332","Total",1467,721,746,1467,0,16,20.42,71.8
"2011","Lewisham 033E","E01003334","Total",1660,816,844,1604,56,16,16.98,97.8
"2011","Lewisham 034A","E01003189","Total",1670,775,895,1662,8,14,19.10,87.4
"2011","Lewisham 034B","E01003190","Total",1878,870,1008,1877,1,12,32.60,57.6
"2011","Lewisham 034C","E01003191","Total",1494,694,800,1494,0,15,19.77,75.6
"2011","Lewisham 034D","E01003192","Total",1639,793,846,1639,0,15,101.62,16.1
"2011","Lewisham 035A","E01003326","Total",1475,688,787,1397,78,13,13.74,107.4
"2011","Lewisham 035B","E01003327","Total",1796,1004,792,1796,0,19,20.58,87.3
"2011","Lewisham 035C","E01003328","Total",1718,830,888,1700,18,16,19.10,89.9
"2011","Lewisham 035D","E01003333","Total",1542,790,752,1542,0,15,12.57,122.7
"2011","Lewisham 035E","E01003335","Total",1395,654,741,1393,2,26,11.72,119.0
"2011","Lewisham 037A","E01003236","Total",1590,765,825,1590,0,6,17.69,89.9
"2011","Lewisham 037B","E01003237","Total",1471,669,802,1471,0,6,25.93,56.7
"2011","Lewisham 037C","E01003238","Total",1407,621,786,1407,0,7,12.97,108.5
"2011","Lewisham 037D","E01003239","Total",1428,676,752,1428,0,10,21.97,65.0
"2011","Lewisham 037E","E01032564","Total",1312,602,710,1312,0,14,15.25,86.0
"2011","Lewisham 038A","E01003235","Total",1279,605,674,1279,0,23,48.86,26.2
"2011","Lewisham 038B","E01003240","Total",1789,823,966,1788,1,13,20.91,85.6
"2011","Lewisham 038C","E01003241","Total",1541,735,806,1541,0,17,28.46,54.1
"2011","Lewisham 038D","E01003243","Total",1358,622,736,1358,0,11,24.43,55.6
"2011","Lewisham 038E","E01032565","Total",1392,649,743,1392,0,8,21.63,64.4
"2011","Lewisham 039A","E01003298","Total",1292,607,685,1292,0,24,13.69,94.4
"2011","Lewisham 039B","E01003300","Total",1356,666,690,1356,0,14,11.83,114.6
"2011","Lewisham 039C","E01003303","Total",1550,813,737,1377,173,16,22.10,70.1
"2011","Lewisham 039D","E01003304","Total",1890,953,937,1890,0,11,17.02,111.0
"2011","Lewisham 039E","E01032579","Total",1460,741,719,1460,0,16,17.48,83.5
"2011","Newham 001A","E01003543","Total",2475,1268,1207,2475,0,28,16.56,149.5
"2011","Newham 001B","E01003544","Total",1938,1027,911,1938,0,20,15.17,127.8
"2011","Newham 001C","E01003546","Total",1940,935,1005,1940,0,10,11.63,166.8
"2011","Newham 001D","E01003550","Total",1780,934,846,1778,2,21,11.58,153.7
"2011","Newham 002A","E01003576","Total",1954,1001,953,1940,14,10,14.16,138.0
"2011","Newham 002B","E01003581","Total",1848,988,860,1845,3,31,10.16,181.9
"2011","Newham 002C","E01003582","Total",1613,821,792,1613,0,11,8.57,188.2
"2011","Newham 002D","E01003583","Total",1966,1019,947,1913,53,15,9.81,200.4
"2011","Newham 003A","E01003578","Total",1944,1069,875,1943,1,9,82.80,23.5
"2011","Newham 003B","E01003584","Total",2073,1090,983,2057,16,28,33.02,62.8
"2011","Newham 003C","E01003586","Total",1751,986,765,1751,0,8,14.91,117.4
"2011","Newham 003D","E01003590","Total",1586,767,819,1488,98,13,25.77,61.5
"2011","Newham 004A","E01003579","Total",1850,987,863,1850,0,7,9.83,188.2
"2011","Newham 004B","E01003585","Total",1649,849,800,1649,0,14,7.29,226.2
"2011","Newham 004C","E01003587","Total",2436,1303,1133,2436,0,18,16.29,149.5
"2011","Newham 004D","E01003591","Total",2166,1166,1000,2166,0,12,16.46,131.6
"2011","Newham 005A","E01003528","Total",1386,682,704,1386,0,14,7.95,174.3
"2011","Newham 005B","E01003575","Total",1702,899,803,1698,4,13,14.73,115.5
"2011","Newham 005C","E01003577","Total",1920,915,1005,1920,0,8,17.48,109.8
"2011","Newham 005D","E01003580","Total",1836,933,903,1836,0,17,22.34,82.2
"2011","Newham 006A","E01003545","Total",1727,847,880,1727,0,7,16.96,101.8
"2011","Newham 006B","E01003548","Total",2353,1214,1139,2351,2,22,23.01,102.3
"2011","Newham 006C","E01003549","Total",2105,1075,1030,2105,0,14,11.84,177.8
"2011","Newham 006D","E01003557","Total",2031,1107,924,1958,73,16,17.63,115.2
"2011","Newham 007A","E01003547","Total",1939,987,952,1925,14,28,17.83,108.7
"2011","Newham 007B","E01003555","Total",1842,1037,805,1842,0,20,16.86,109.3
"2011","Newham 007C","E01003561","Total",1880,1060,820,1880,0,20,7.96,236.2
"2011","Newham 007D","E01003567","Total",1822,1020,802,1822,0,22,9.82,185.5
"2011","Newham 008A","E01003556","Total",1913,1009,904,1741,172,12,13.79,138.7
"2011","Newham 008B","E01003558","Total",1631,903,728,1572,59,10,15.04,108.4
"2011","Newham 008C","E01003570","Total",2065,1132,933,2050,15,7,10.26,201.3
"2011","Newham 008D","E01003571","Total",2277,1239,1038,2270,7,26,10.50,216.9
"2011","Newham 008E","E01003572","Total",1779,960,819,1765,14,21,9.38,189.7
"2011","Newham 009A","E01003551","Total",1833,950,883,1713,120,23,9.54,192.1
"2011","Newham 009B","E01003553","Total",1927,993,934,1926,1,6,10.41,185.1
"2011","Newham 009C","E01003554","Total",1861,949,912,1861,0,11,9.78,190.3
"2011","Newham 009D","E01003559","Total",2605,1363,1242,2585,20,12,15.50,168.1
"2011","Newham 010A","E01003529","Total",2379,1329,1050,2376,3,12,11.79,201.8
"2011","Newham 010B","E01003530","Total",1827,1023,804,1827,0,28,12.07,151.4
"2011","Newham 010C","E01003531","Total",1997,1107,890,1991,6,13,22.24,89.8
"2011","Newham 010D","E01003532","Total",2002,1038,964,2002,0,19,11.19,178.9
"2011","Newham 010E","E01003534","Total",2395,1282,1113,2395,0,18,13.72,174.6
"2011","Newham 011A","E01003533","Total",1880,1031,849,1845,35,16,11.44,164.3
"2011","Newham 011B","E01003560","Total",1842,993,849,1818,24,7,7.95,231.7
"2011","Newham 011C","E01003563","Total",2036,1145,891,2030,6,10,9.10,223.7
"2011","Newham 011D","E01003588","Total",1786,1009,777,1785,1,15,7.46,239.4
"2011","Newham 011E","E01003589","Total",1871,1025,846,1871,0,9,13.75,136.1
"2011","Newham 012A","E01003616","Total",1650,899,751,1650,0,12,14.55,113.4
"2011","Newham 012B","E01003617","Total",2769,1390,1379,2769,0,21,23.26,119.0
"2011","Newham 012C","E01003618","Total",2193,1091,1102,2159,34,16,16.04,136.7
"2011","Newham 012D","E01003619","Total",2264,1132,1132,2195,69,15,25.46,88.9
"2011","Newham 013C","E01003615","Total",1835,924,911,1835,0,16,10.79,170.1
"2011","Newham 013E","E01033578","Total",1273,710,563,1273,0,6,56.88,22.4
"2011","Newham 013F","E01033579","Total",1293,683,610,1293,0,8,43.91,29.4
"2011","Newham 013G","E01033583","Total",3081,1687,1394,3063,18,26,157.71,19.5
"2011","Newham 013H","E01033586","Total",1410,735,675,1410,0,12,70.63,20.0
"2011","Newham 014A","E01003562","Total",2200,1242,958,2200,0,15,9.83,223.8
"2011","Newham 014B","E01003564","Total",2460,1383,1077,2460,0,10,10.89,225.9
"2011","Newham 014C","E01003565","Total",1853,1073,780,1849,4,15,9.02,205.4
"2011","Newham 014D","E01003566","Total",1792,1012,780,1792,0,15,9.73,184.2
"2011","Newham 015A","E01003625","Total",1697,910,787,1697,0,14,31.88,53.2
"2011","Newham 015B","E01003626","Total",1590,862,728,1590,0,8,10.25,155.1
"2011","Newham 015C","E01003627","Total",1603,867,736,1603,0,23,7.63,210.1
"2011","Newham 015D","E01003628","Total",1665,902,763,1665,0,10,9.29,179.2
"2011","Newham 015E","E01003629","Total",1672,899,773,1672,0,14,6.51,256.8
"2011","Newham 016A","E01003552","Total",1719,884,835,1708,11,24,10.64,161.6
"2011","Newham 016B","E01003596","Total",1777,935,842,1770,7,17,11.17,159.1
"2011","Newham 016C","E01003597","Total",1639,857,782,1639,0,12,8.98,182.5
"2011","Newham 016D","E01003635","Total",1945,1036,909,1945,0,14,39.65,49.1
"2011","Newham 017A","E01003568","Total",2302,1309,993,2302,0,9,10.98,209.7
"2011","Newham 017B","E01003569","Total",1899,1105,794,1899,0,19,10.48,181.2
"2011","Newham 017C","E01003573","Total",2154,1174,980,2142,12,15,9.96,216.3
"2011","Newham 017D","E01003574","Total",2637,1438,1199,2613,24,24,18.92,139.4
"2011","Newham 018A","E01003520","Total",2001,1142,859,2001,0,11,13.02,153.7
"2011","Newham 018B","E01003521","Total",2259,1374,885,2259,0,12,13.62,165.9
"2011","Newham 018C","E01003522","Total",1908,1047,861,1908,0,11,7.82,244.0
"2011","Newham 018D","E01003525","Total",1978,1137,841,1978,0,17,12.91,153.2
"2011","Newham 018E","E01003526","Total",1927,1018,909,1927,0,23,10.71,179.9
"2011","Newham 019A","E01003488","Total",1874,953,921,1874,0,14,13.00,144.2
"2011","Newham 019B","E01003489","Total",1807,943,864,1806,1,6,12.26,147.4
"2011","Newham 019C","E01003490","Total",1857,1029,828,1857,0,19,10.06,184.6
"2011","Newham 019D","E01003524","Total",2028,1127,901,2023,5,8,8.82,229.9
"2011","Newham 020A","E01003631","Total",1832,950,882,1832,0,14,16.56,110.6
"2011","Newham 020B","E01003632","Total",2268,1096,1172,2268,0,9,13.69,165.7
"2011","Newham 020C","E01003633","Total",1871,944,927,1871,0,9,9.62,194.5
"2011","Newham 020D","E01003634","Total",1805,913,892,1805,0,6,14.52,124.3
"2011","Newham 020E","E01003636","Total",1978,996,982,1976,2,12,19.61,100.9
"2011","Newham 021A","E01003598","Total",1897,956,941,1897,0,10,7.18,264.2
"2011","Newham 021B","E01003600","Total",1893,944,949,1893,0,21,11.01,171.9
"2011","Newham 021C","E01003630","Total",2011,1026,985,2011,0,12,10.44,192.6
"2011","Newham 021D","E01003637","Total",1841,1006,835,1839,2,15,9.41,195.6
"2011","Newham 022A","E01003491","Total",1977,1112,865,1977,0,16,10.36,190.8
"2011","Newham 022B","E01003592","Total",1842,977,865,1829,13,26,14.63,125.9
"2011","Newham 022C","E01003599","Total",1611,857,754,1611,0,2,13.40,120.2
"2011","Newham 022D","E01003606","Total",2152,1143,1009,2130,22,11,16.45,130.8
"2011","Newham 023A","E01003535","Total",1691,835,856,1654,37,8,49.94,33.9
"2011","Newham 023B","E01003536","Total",1843,894,949,1843,0,13,17.48,105.4
"2011","Newham 023C","E01003621","Total",1667,899,768,1664,3,20,6.70,248.8
"2011","Newham 023D","E01003622","Total",1613,841,772,1613,0,10,24.17,66.7
"2011","Newham 023E","E01003623","Total",1757,923,834,1757,0,12,27.21,64.6
"2011","Newham 024A","E01003523","Total",2043,1079,964,2043,0,10,20.56,99.4
"2011","Newham 024B","E01003527","Total",1773,900,873,1773,0,21,16.43,107.9
"2011","Newham 024C","E01003537","Total",2062,1027,1035,2062,0,13,19.40,106.3
"2011","Newham 024D","E01003542","Total",1974,968,1006,1974,0,31,13.42,147.1
"2011","Newham 024E","E01003624","Total",1582,789,793,1582,0,20,14.29,110.7
"2011","Newham 025A","E01003492","Total",2010,1076,934,2010,0,13,9.48,212.0
"2011","Newham 025B","E01003493","Total",2299,1240,1059,2298,1,15,14.02,164.0
"2011","Newham 025C","E01003494","Total",2048,1014,1034,2048,0,13,10.57,193.8
"2011","Newham 025D","E01003495","Total",2110,1075,1035,2110,0,15,11.87,177.8
"2011","Newham 026A","E01003594","Total",1729,897,832,1721,8,8,11.60,149.1
"2011","Newham 026B","E01003595","Total",1532,807,725,1526,6,8,9.25,165.6
"2011","Newham 026C","E01003602","Total",1985,1014,971,1985,0,13,11.92,166.5
"2011","Newham 026D","E01003607","Total",1648,811,837,1648,0,17,12.57,131.1
"2011","Newham 027A","E01003496","Total",1445,748,697,1445,0,19,18.94,76.3
"2011","Newham 027B","E01003498","Total",1741,895,846,1741,0,20,23.32,74.7
"2011","Newham 027C","E01003500","Total",2043,976,1067,2043,0,30,73.18,27.9
"2011","Newham 027D","E01003593","Total",1550,726,824,1539,11,11,10.88,142.5
"2011","Newham 028A","E01003601","Total",2130,1052,1078,2118,12,19,35.36,60.2
"2011","Newham 028B","E01003603","Total",1947,958,989,1921,26,19,20.28,96.0
"2011","Newham 028C","E01003605","Total",2112,1126,986,2112,0,20,10.61,199.1
"2011","Newham 028D","E01003608","Total",2072,1047,1025,2072,0,12,9.30,222.8
"2011","Newham 029A","E01003538","Total",2084,1043,1041,2035,49,8,17.39,119.8
"2011","Newham 029B","E01003539","Total",2217,1118,1099,2217,0,16,24.83,89.3
"2011","Newham 029C","E01003540","Total",1833,920,913,1833,0,10,20.77,88.3
"2011","Newham 029D","E01003541","Total",1871,921,950,1867,4,12,16.11,116.1
"2011","Newham 030A","E01003499","Total",2280,1152,1128,2280,0,16,17.04,133.8
"2011","Newham 030B","E01003501","Total",2040,1031,1009,2031,9,19,15.85,128.7
"2011","Newham 030C","E01003502","Total",1836,910,926,1836,0,24,15.07,121.8
"2011","Newham 030D","E01003503","Total",1710,833,877,1683,27,12,14.75,115.9
"2011","Newham 031A","E01003507","Total",2113,1078,1035,2113,0,28,14.20,148.8
"2011","Newham 031B","E01003508","Total",1605,789,816,1605,0,13,13.08,122.7
"2011","Newham 031C","E01003509","Total",1953,936,1017,1953,0,14,10.43,187.2
"2011","Newham 031D","E01003604","Total",2358,1148,1210,2354,4,11,22.13,106.6
"2011","Newham 032A","E01003483","Total",1486,698,788,1486,0,20,24.49,60.7
"2011","Newham 032B","E01003484","Total",1621,797,824,1615,6,22,10.12,160.2
"2011","Newham 032C","E01003516","Total",1859,882,977,1859,0,18,13.48,137.9
"2011","Newham 032D","E01003518","Total",1595,803,792,1595,0,18,18.06,88.3
"2011","Newham 032E","E01003519","Total",1580,781,799,1580,0,12,6.23,253.6
"2011","Newham 033A","E01003480","Total",2172,1040,1132,1768,404,28,28.45,76.3
"2011","Newham 033B","E01003482","Total",2634,1305,1329,2629,5,32,359.82,7.3
"2011","Newham 033C","E01003486","Total",1205,523,682,1195,10,10,21.85,55.1
"2011","Newham 033D","E01003487","Total",1371,644,727,1316,55,23,12.43,110.3
"2011","Newham 034A","E01003497","Total",1715,842,873,1715,0,13,68.14,25.2
"2011","Newham 034D","E01003506","Total",1480,688,792,1464,16,12,10.62,139.4
"2011","Newham 034F","E01033574","Total",1095,655,440,1095,0,1,13.40,81.7
"2011","Newham 034G","E01033575","Total",1021,614,407,1021,0,2,15.40,66.3
"2011","Newham 034H","E01033576","Total",1295,713,582,1295,0,11,37.76,34.3
"2011","Newham 034I","E01033584","Total",1595,786,809,1595,0,15,15.06,105.9
"2011","Newham 034J","E01033585","Total",2445,1256,1189,2445,0,32,29.33,83.4
"2011","Newham 035A","E01003479","Total",1505,747,758,1505,0,15,30.24,49.8
"2011","Newham 035B","E01003481","Total",1574,764,810,1288,286,11,52.00,30.3
"2011","Newham 035C","E01003485","Total",1573,755,818,1573,0,8,15.16,103.8
"2011","Newham 035D","E01003513","Total",1588,790,798,1588,0,11,35.77,44.4
"2011","Newham 036A","E01003511","Total",1394,634,760,1394,0,13,9.17,152.0
"2011","Newham 036B","E01003512","Total",1805,887,918,1805,0,13,12.90,139.9
"2011","Newham 036C","E01003514","Total",1512,749,763,1512,0,10,17.79,85.0
"2011","Newham 036D","E01003515","Total",1798,892,906,1798,0,11,74.60,24.1
"2011","Newham 036E","E01003517","Total",1674,795,879,1674,0,18,27.45,61.0
"2011","Newham 037A","E01003609","Total",2702,1355,1347,2693,9,24,93.98,28.8
"2011","Newham 037C","E01003611","Total",1803,855,948,1803,0,26,14.99,120.3
"2011","Newham 037E","E01033577","Total",1489,801,688,1489,0,12,65.78,22.6
"2011","Newham 037F","E01033580","Total",1522,875,647,1522,0,5,8.39,181.4
"2011","Newham 037G","E01033581","Total",1782,875,907,1782,0,13,131.30,13.6
"2011","Newham 037H","E01033582","Total",1381,744,637,1381,0,4,16.33,84.6
"2011","Southwark 001A","E01004029","Total",1835,937,898,1835,0,18,10.77,170.4
"2011","Southwark 001B","E01004032","Total",1695,879,816,1694,1,19,13.65,124.2
"2011","Southwark 001C","E01004053","Total",1836,970,866,1830,6,14,14.75,124.5
"2011","Southwark 001D","E01004054","Total",1656,885,771,1655,1,8,12.33,134.3
"2011","Southwark 001E","E01004055","Total",1291,607,684,1291,0,14,19.69,65.6
"2011","Southwark 002A","E01003927","Total",2377,1227,1150,1985,392,13,28.27,84.1
"2011","Southwark 002B","E01003929","Total",2111,1173,938,2111,0,10,23.45,90.0
"2011","Southwark 002C","E01003934","Total",1422,723,699,1422,0,11,23.54,60.4
"2011","Southwark 002D","E01003935","Total",1342,692,650,946,396,17,14.06,95.4
"2011","Southwark 002E","E01003939","Total",1850,897,953,1848,2,17,15.31,120.8
"2011","Southwark 003A","E01003976","Total",1955,988,967,1955,0,6,12.00,162.9
"2011","Southwark 003E","E01004027","Total",2072,1069,1003,2072,0,7,30.23,68.5
"2011","Southwark 003F","E01032637","Total",1247,689,558,1080,167,3,4.01,311.0
"2011","Southwark 003G","E01032638","Total",1159,648,511,1159,0,0,4.06,285.5
"2011","Southwark 003H","E01032640","Total",1248,751,497,1248,0,4,4.42,282.4
"2011","Southwark 003I","E01032646","Total",1569,909,660,1569,0,12,12.29,127.7
"2011","Southwark 003J","E01032803","Total",1331,747,584,1331,0,2,6.04,220.4
"2011","Southwark 003K","E01032834","Total",1130,649,481,1122,8,7,3.52,321.0
"2011","Southwark 004A","E01003975","Total",1630,753,877,1630,0,17,8.18,199.3
"2011","Southwark 004B","E01003978","Total",1840,881,959,1840,0,8,13.85,132.9
"2011","Southwark 004C","E01004022","Total",2483,1232,1251,2479,4,12,23.21,107.0
"2011","Southwark 004D","E01004023","Total",1540,764,776,1540,0,18,11.43,134.7
"2011","Southwark 004E","E01004028","Total",1651,822,829,1642,9,7,11.98,137.8
"2011","Southwark 006A","E01003938","Total",1814,902,912,1814,0,6,7.72,235.0
"2011","Southwark 006B","E01003940","Total",1483,692,791,1483,0,17,5.44,272.6
"2011","Southwark 006C","E01003941","Total",1897,996,901,1897,0,12,9.36,202.7
"2011","Southwark 006D","E01003942","Total",1637,793,844,1399,238,29,11.91,137.4
"2011","Southwark 006E","E01003979","Total",1784,865,919,1664,120,5,16.74,106.6
"2011","Southwark 006F","E01003981","Total",1675,829,846,1440,235,14,19.03,88.0
"2011","Southwark 007A","E01004030","Total",1457,728,729,1457,0,7,9.39,155.2
"2011","Southwark 007B","E01004031","Total",2060,985,1075,2036,24,22,42.62,48.3
"2011","Southwark 007C","E01004033","Total",1519,750,769,1513,6,1,14.53,104.5
"2011","Southwark 007D","E01004034","Total",1541,742,799,1541,0,18,13.20,116.7
"2011","Southwark 007E","E01004036","Total",2014,957,1057,2014,0,16,9.69,207.8
"2011","Southwark 008A","E01004056","Total",2065,1037,1028,2061,4,10,18.75,110.1
"2011","Southwark 008B","E01004057","Total",1500,724,776,1488,12,20,24.36,61.6
"2011","Southwark 008C","E01004058","Total",1699,930,769,1699,0,6,14.03,121.1
"2011","Southwark 008D","E01004059","Total",1487,777,710,1487,0,3,31.36,47.4
"2011","Southwark 008E","E01004060","Total",1901,929,972,1828,73,19,9.78,194.4
"2011","Southwark 009A","E01003936","Total",1845,878,967,1198,647,13,9.42,195.9
"2011","Southwark 009B","E01003937","Total",1553,853,700,1553,0,17,9.60,161.8
"2011","Southwark 009C","E01003943","Total",1367,681,686,1367,0,21,6.07,225.2
"2011","Southwark 009F","E01032720","Total",1732,930,802,1656,76,36,17.00,101.9
"2011","Southwark 010A","E01003977","Total",1672,814,858,1672,0,21,12.93,129.3
"2011","Southwark 010B","E01004037","Total",1953,996,957,1953,0,13,14.83,131.7
"2011","Southwark 010C","E01004038","Total",2340,1065,1275,2340,0,12,21.46,109.0
"2011","Southwark 010D","E01004042","Total",1712,830,882,1710,2,6,14.78,115.8
"2011","Southwark 010E","E01004043","Total",1366,674,692,1355,11,6,11.95,114.3
"2011","Southwark 011A","E01003986","Total",1235,558,677,1230,5,12,18.03,68.5
"2011","Southwark 011B","E01003987","Total",1777,886,891,1777,0,21,13.73,129.4
"2011","Southwark 011C","E01004024","Total",1860,932,928,1825,35,22,12.04,154.5
"2011","Southwark 011D","E01004035","Total",1622,777,845,1593,29,24,22.43,72.3
"2011","Southwark 012A","E01003960","Total",1863,944,919,1863,0,17,12.67,147.0
"2011","Southwark 012B","E01003961","Total",2045,1003,1042,2045,0,22,11.99,170.6
"2011","Southwark 012E","E01003994","Total",1493,758,735,1468,25,12,14.12,105.7
"2011","Southwark 012F","E01032722","Total",2133,1053,1080,2131,2,11,19.65,108.5
"2011","Southwark 013A","E01003980","Total",1906,953,953,1899,7,10,19.40,98.2
"2011","Southwark 013B","E01004039","Total",1568,821,747,1568,0,8,8.56,183.2
"2011","Southwark 013C","E01004040","Total",1780,853,927,1780,0,23,11.02,161.5
"2011","Southwark 013D","E01004041","Total",1660,850,810,1660,0,14,7.68,216.1
"2011","Southwark 013E","E01004044","Total",1401,705,696,1394,7,8,7.03,199.3
"2011","Southwark 014A","E01003992","Total",1492,677,815,1492,0,20,7.37,202.4
"2011","Southwark 014B","E01003995","Total",1384,697,687,1384,0,13,6.42,215.6
"2011","Southwark 014D","E01003998","Total",1331,723,608,1331,0,4,9.36,142.2
"2011","Southwark 014E","E01003999","Total",1442,727,715,1442,0,5,8.79,164.1
"2011","Southwark 014F","E01032639","Total",1643,888,755,1509,134,18,8.91,184.4
"2011","Southwark 014G","E01032719","Total",1211,683,528,1211,0,12,4.15,291.8
"2011","Southwark 015A","E01003964","Total",1927,965,962,1909,18,13,44.33,43.5
"2011","Southwark 015B","E01003966","Total",1941,974,967,1941,0,15,10.23,189.7
"2011","Southwark 015C","E01003968","Total",1441,694,747,1441,0,36,5.33,270.4
"2011","Southwark 015D","E01003971","Total",1809,878,931,1809,0,23,6.37,284.0
"2011","Southwark 015E","E01003974","Total",1268,620,648,1268,0,18,5.58,227.2
"2011","Southwark 016A","E01003963","Total",1648,806,842,1648,0,16,5.94,277.4
"2011","Southwark 016B","E01003967","Total",1673,882,791,1658,15,21,5.81,288.0
"2011","Southwark 016C","E01003970","Total",1486,712,774,1486,0,16,20.03,74.2
"2011","Southwark 016D","E01003972","Total",1654,831,823,1654,0,11,7.28,227.2
"2011","Southwark 016E","E01003973","Total",1650,774,876,1650,0,8,8.86,186.2
"2011","Southwark 017A","E01003923","Total",1735,859,876,1735,0,16,11.87,146.2
"2011","Southwark 017B","E01003969","Total",1858,957,901,1851,7,17,28.42,65.4
"2011","Southwark 017C","E01003991","Total",1208,583,625,1208,0,11,7.89,153.1
"2011","Southwark 017D","E01003993","Total",1713,817,896,1713,0,20,8.58,199.7
"2011","Southwark 017E","E01003997","Total",1219,585,634,1219,0,10,7.64,159.6
"2011","Southwark 018A","E01003983","Total",2022,927,1095,2021,1,24,11.74,172.2
"2011","Southwark 018B","E01003988","Total",2193,1114,1079,2187,6,18,38.66,56.7
"2011","Southwark 018C","E01003989","Total",1960,945,1015,1960,0,29,24.52,79.9
"2011","Southwark 018D","E01003990","Total",2132,1031,1101,2130,2,32,14.29,149.2
"2011","Southwark 018E","E01004007","Total",1261,592,669,1261,0,23,7.99,157.8
"2011","Southwark 019A","E01003912","Total",1595,805,790,1571,24,17,8.18,195.0
"2011","Southwark 019B","E01004011","Total",2112,980,1132,2112,0,31,11.42,184.9
"2011","Southwark 019C","E01004012","Total",2502,1269,1233,2502,0,12,14.07,177.8
"2011","Southwark 019D","E01004013","Total",1656,761,895,1656,0,30,10.46,158.3
"2011","Southwark 019E","E01004014","Total",1784,887,897,1739,45,23,9.17,194.5
"2011","Southwark 020A","E01003911","Total",1985,945,1040,1985,0,26,11.22,176.9
"2011","Southwark 020B","E01003916","Total",2190,1101,1089,2080,110,15,15.09,145.1
"2011","Southwark 020C","E01003917","Total",1775,876,899,1761,14,24,11.15,159.2
"2011","Southwark 020D","E01003918","Total",1602,734,868,1602,0,31,8.68,184.6
"2011","Southwark 020E","E01003925","Total",1336,632,704,1286,50,12,8.82,151.5
"2011","Southwark 021A","E01003919","Total",1776,896,880,1692,84,16,14.97,118.6
"2011","Southwark 021B","E01003920","Total",1854,926,928,1854,0,22,8.69,213.3
"2011","Southwark 021C","E01003921","Total",1461,765,696,1371,90,9,11.93,122.5
"2011","Southwark 021D","E01003922","Total",1917,927,990,1914,3,31,13.87,138.2
"2011","Southwark 021E","E01003924","Total",1928,1009,919,1916,12,21,7.95,242.5
"2011","Southwark 021F","E01003926","Total",1423,686,737,1423,0,13,10.70,133.0
"2011","Southwark 022B","E01004008","Total",2141,1059,1082,2134,7,24,10.04,213.2
"2011","Southwark 022D","E01004010","Total",1526,768,758,1526,0,22,12.86,118.7
"2011","Southwark 022E","E01004067","Total",2165,1088,1077,2147,18,18,23.26,93.1
"2011","Southwark 022F","E01032805","Total",2551,1230,1321,2538,13,23,17.45,146.2
"2011","Southwark 023A","E01003984","Total",1997,1027,970,1993,4,28,16.48,121.2
"2011","Southwark 023B","E01004003","Total",1702,830,872,1700,2,10,12.63,134.8
"2011","Southwark 023C","E01004004","Total",2499,1317,1182,2492,7,31,19.59,127.6
"2011","Southwark 023D","E01004005","Total",2223,1113,1110,2079,144,11,15.36,144.7
"2011","Southwark 023E","E01004006","Total",1968,1016,952,1968,0,16,15.14,130.0
"2011","Southwark 024A","E01003913","Total",1847,904,943,1817,30,25,23.54,78.5
"2011","Southwark 024B","E01003914","Total",1842,871,971,1831,11,18,14.56,126.5
"2011","Southwark 024C","E01003915","Total",1940,954,986,1940,0,28,9.74,199.2
"2011","Southwark 024D","E01004050","Total",1475,745,730,1472,3,31,18.46,79.9
"2011","Southwark 024E","E01004052","Total",1766,861,905,1759,7,15,17.29,102.1
"2011","Southwark 025A","E01004061","Total",1750,847,903,1748,2,22,20.89,83.8
"2011","Southwark 025B","E01004062","Total",1985,985,1000,1932,53,13,16.63,119.4
"2011","Southwark 025C","E01004063","Total",1959,993,966,1927,32,16,17.58,111.4
"2011","Southwark 025D","E01004065","Total",1525,727,798,1515,10,14,11.23,135.8
"2011","Southwark 025E","E01004066","Total",2159,1039,1120,2159,0,21,14.26,151.4
"2011","Southwark 026A","E01004000","Total",1881,908,973,1874,7,17,16.23,115.9
"2011","Southwark 026B","E01004001","Total",1738,817,921,1738,0,14,19.54,88.9
"2011","Southwark 026C","E01004019","Total",2319,1135,1184,2292,27,25,13.68,169.5
"2011","Southwark 026D","E01004064","Total",1975,944,1031,1973,2,13,16.38,120.6
"2011","Southwark 026E","E01004068","Total",2047,955,1092,1974,73,20,18.75,109.2
"2011","Southwark 027A","E01004045","Total",1518,705,813,1518,0,27,6.23,243.7
"2011","Southwark 027B","E01004047","Total",1595,744,851,1595,0,31,10.12,157.6
"2011","Southwark 027C","E01004048","Total",1587,675,912,1587,0,16,40.42,39.3
"2011","Southwark 027D","E01004049","Total",1672,765,907,1332,340,36,10.73,155.8
"2011","Southwark 027E","E01004051","Total",1383,686,697,1302,81,15,15.11,91.5
"2011","Southwark 028A","E01003953","Total",2082,963,1119,2073,9,9,20.27,102.7
"2011","Southwark 028B","E01003955","Total",1817,890,927,1813,4,15,13.94,130.3
"2011","Southwark 028C","E01004015","Total",1558,757,801,1548,10,20,57.21,27.2
"2011","Southwark 028D","E01004021","Total",2109,1003,1106,2102,7,17,15.17,139.0
"2011","Southwark 028E","E01004046","Total",1633,767,866,1625,8,13,14.77,110.6
"2011","Southwark 029A","E01004002","Total",1609,787,822,1602,7,18,33.73,47.7
"2011","Southwark 029B","E01004016","Total",2349,1109,1240,2347,2,25,57.13,41.1
"2011","Southwark 029C","E01004017","Total",1548,737,811,1515,33,24,35.57,43.5
"2011","Southwark 029D","E01004020","Total",1730,836,894,1730,0,22,19.58,88.4
"2011","Southwark 030A","E01003952","Total",1640,809,831,1640,0,19,13.21,124.1
"2011","Southwark 030B","E01003954","Total",1598,786,812,1596,2,16,10.11,158.1
"2011","Southwark 030C","E01003956","Total",1685,798,887,1685,0,12,11.55,145.9
"2011","Southwark 030D","E01004071","Total",1579,756,823,1572,7,16,12.56,125.7
"2011","Southwark 030E","E01004072","Total",1738,836,902,1726,12,54,28.16,61.7
"2011","Southwark 031A","E01004069","Total",1437,720,717,1387,50,58,91.69,15.7
"2011","Southwark 031B","E01004070","Total",1985,945,1040,1985,0,62,32.16,61.7
"2011","Southwark 031C","E01004073","Total",1931,935,996,1931,0,26,19.97,96.7
"2011","Southwark 031D","E01004074","Total",1883,910,973,1868,15,77,35.36,53.3
"2011","Southwark 031E","E01004075","Total",1849,880,969,1849,0,72,58.89,31.4
"2011","Southwark 032A","E01003949","Total",1870,896,974,1860,10,29,22.71,82.3
"2011","Southwark 032B","E01003950","Total",1906,866,1040,1896,10,28,24.48,77.9
"2011","Southwark 032C","E01003957","Total",1788,850,938,1760,28,18,16.88,105.9
"2011","Southwark 032D","E01003958","Total",1711,798,913,1710,1,25,15.90,107.6
"2011","Southwark 032E","E01004018","Total",1905,907,998,1894,11,8,26.99,70.6
"2011","Southwark 033A","E01003945","Total",1663,821,842,1663,0,32,83.79,19.8
"2011","Southwark 033B","E01003946","Total",1768,853,915,1757,11,24,45.80,38.6
"2011","Southwark 033C","E01003947","Total",1517,687,830,1517,0,8,13.97,108.6
"2011","Southwark 033D","E01003948","Total",1566,766,800,1529,37,12,26.75,58.5
"2011","Southwark 033E","E01003951","Total",1522,800,722,1403,119,44,105.88,14.4
"2011","Southwark 034A","E01003930","Total",1496,790,706,963,533,31,10.77,138.9
"2011","Southwark 034B","E01003932","Total",1573,835,738,1434,139,13,12.23,128.6
"2011","Southwark 034C","E01003933","Total",1751,886,865,1376,375,27,22.10,79.2
"2011","Southwark 034D","E01032583","Total",1587,778,809,1343,244,15,15.20,104.4
"2011","Southwark 034E","E01032584","Total",1282,671,611,1275,7,18,8.68,147.7
"2011","Tower Hamlets 001A","E01004222","Total",2480,1225,1255,2479,1,16,13.82,179.5
"2011","Tower Hamlets 001B","E01004223","Total",2079,976,1103,2079,0,8,59.24,35.1
"2011","Tower Hamlets 001C","E01004224","Total",2000,993,1007,2000,0,8,43.86,45.6
"2011","Tower Hamlets 001D","E01004226","Total",1738,826,912,1738,0,6,9.27,187.5
"2011","Tower Hamlets 002A","E01004197","Total",2329,1150,1179,2285,44,14,16.99,137.1
"2011","Tower Hamlets 002B","E01004198","Total",1529,733,796,1522,7,10,9.50,160.9
"2011","Tower Hamlets 002C","E01004199","Total",1637,818,819,1637,0,6,6.90,237.2
"2011","Tower Hamlets 002D","E01004201","Total",1556,773,783,1533,23,1,12.98,119.9
"2011","Tower Hamlets 003A","E01004228","Total",1857,881,976,1849,8,11,12.67,146.6
"2011","Tower Hamlets 003B","E01004230","Total",2101,1064,1037,2091,10,18,15.79,133.1
"2011","Tower Hamlets 003C","E01004232","Total",1665,824,841,1631,34,11,19.33,86.1
"2011","Tower Hamlets 003D","E01004233","Total",1821,884,937,1821,0,10,8.32,218.9
"2011","Tower Hamlets 003E","E01004234","Total",2218,1125,1093,2218,0,15,57.31,38.7
"2011","Tower Hamlets 004A","E01004225","Total",2178,1140,1038,2178,0,8,12.55,173.5
"2011","Tower Hamlets 004C","E01004229","Total",1484,762,722,1484,0,11,10.42,142.4
"2011","Tower Hamlets 004D","E01004231","Total",1793,856,937,1793,0,14,10.84,165.4
"2011","Tower Hamlets 004E","E01032764","Total",1302,658,644,1302,0,10,32.53,40.0
"2011","Tower Hamlets 004F","E01032765","Total",1488,759,729,1488,0,10,8.10,183.7
"2011","Tower Hamlets 004G","E01032784","Total",1516,725,791,1516,0,14,6.48,234.0
"2011","Tower Hamlets 005A","E01004200","Total",1566,793,773,1394,172,9,5.73,273.3
"2011","Tower Hamlets 005B","E01004202","Total",1705,879,826,1705,0,7,11.22,152.0
"2011","Tower Hamlets 005C","E01004203","Total",1779,902,877,1779,0,7,10.52,169.1
"2011","Tower Hamlets 005D","E01004204","Total",1582,767,815,1538,44,13,8.45,187.2
"2011","Tower Hamlets 006A","E01004311","Total",1518,749,769,1518,0,4,8.47,179.2
"2011","Tower Hamlets 006B","E01004314","Total",1100,545,555,1100,0,5,8.33,132.1
"2011","Tower Hamlets 006C","E01004315","Total",1628,863,765,1628,0,10,9.56,170.3
"2011","Tower Hamlets 006D","E01004318","Total",1459,799,660,1433,26,5,5.87,248.6
"2011","Tower Hamlets 007A","E01004259","Total",1723,893,830,1694,29,2,13.33,129.3
"2011","Tower Hamlets 007B","E01004260","Total",1790,924,866,1790,0,14,9.81,182.5
"2011","Tower Hamlets 007C","E01004263","Total",1419,698,721,1401,18,5,8.15,174.1
"2011","Tower Hamlets 007D","E01004266","Total",1545,727,818,1545,0,3,8.21,188.2
"2011","Tower Hamlets 008A","E01004235","Total",1372,722,650,1372,0,4,3.97,345.6
"2011","Tower Hamlets 008B","E01004236","Total",1679,860,819,1679,0,11,10.22,164.3
"2011","Tower Hamlets 008C","E01004237","Total",1158,578,580,1158,0,7,6.53,177.3
"2011","Tower Hamlets 008D","E01004238","Total",2733,1382,1351,2733,0,22,35.51,77.0
"2011","Tower Hamlets 008E","E01004239","Total",1649,837,812,1649,0,11,10.67,154.5
"2011","Tower Hamlets 009A","E01004312","Total",1614,861,753,1614,0,6,6.87,234.9
"2011","Tower Hamlets 009B","E01004313","Total",2043,988,1055,2043,0,6,8.21,248.8
"2011","Tower Hamlets 009C","E01004316","Total",1138,592,546,1134,4,3,3.52,323.3
"2011","Tower Hamlets 009D","E01004317","Total",2706,1460,1246,2689,17,16,27.06,100.0
"2011","Tower Hamlets 010A","E01004261","Total",2525,1177,1348,1655,870,43,16.62,151.9
"2011","Tower Hamlets 010B","E01004262","Total",1742,864,878,1366,376,28,14.68,118.7
"2011","Tower Hamlets 010C","E01004264","Total",1537,790,747,1537,0,19,6.08,252.8
"2011","Tower Hamlets 010E","E01032785","Total",1348,709,639,1348,0,13,7.27,185.4
"2011","Tower Hamlets 010F","E01032786","Total",1561,775,786,1561,0,8,5.83,267.8
"2011","Tower Hamlets 011A","E01004207","Total",1416,704,712,1342,74,7,6.86,206.4
"2011","Tower Hamlets 011B","E01004209","Total",1366,697,669,1366,0,13,8.04,169.9
"2011","Tower Hamlets 011D","E01004212","Total",1780,933,847,1604,176,17,8.78,202.7
"2011","Tower Hamlets 011F","E01032787","Total",2567,1298,1269,2567,0,22,10.61,241.9
"2011","Tower Hamlets 012A","E01004240","Total",1815,890,925,1815,0,6,8.66,209.6
"2011","Tower Hamlets 012B","E01004241","Total",1621,773,848,1621,0,6,11.68,138.8
"2011","Tower Hamlets 012C","E01004242","Total",2453,1267,1186,2433,20,22,20.17,121.6
"2011","Tower Hamlets 012D","E01004267","Total",1767,926,841,1754,13,12,21.08,83.8
"2011","Tower Hamlets 012E","E01004268","Total",1784,925,859,1756,28,5,5.17,345.1
"2011","Tower Hamlets 013A","E01004205","Total",2106,1143,963,2106,0,10,13.51,155.9
"2011","Tower Hamlets 013B","E01004206","Total",1492,751,741,1491,1,13,7.69,194.0
"2011","Tower Hamlets 013C","E01004208","Total",1976,1066,910,1842,134,12,16.18,122.1
"2011","Tower Hamlets 013D","E01004211","Total",1463,788,675,1461,2,10,16.48,88.8
"2011","Tower Hamlets 014A","E01004269","Total",1975,1023,952,1920,55,11,15.52,127.3
"2011","Tower Hamlets 014B","E01004270","Total",2236,1181,1055,2236,0,12,29.34,76.2
"2011","Tower Hamlets 014C","E01004271","Total",1589,769,820,1589,0,8,9.59,165.7
"2011","Tower Hamlets 014D","E01004272","Total",2099,1061,1038,2099,0,8,9.48,221.4
"2011","Tower Hamlets 014E","E01004273","Total",1904,935,969,1904,0,10,16.86,112.9
"2011","Tower Hamlets 015A","E01004306","Total",1799,968,831,1799,0,12,12.18,147.7
"2011","Tower Hamlets 015B","E01004307","Total",2186,1175,1011,1857,329,38,21.46,101.9
"2011","Tower Hamlets 015C","E01004308","Total",1478,765,713,1469,9,6,8.33,177.4
"2011","Tower Hamlets 015D","E01004309","Total",2852,1470,1382,2433,419,19,12.68,224.9
"2011","Tower Hamlets 015E","E01004310","Total",1971,1114,857,1893,78,13,9.19,214.5
"2011","Tower Hamlets 016A","E01004283","Total",2317,1153,1164,2143,174,17,15.11,153.3
"2011","Tower Hamlets 016B","E01004287","Total",2171,1113,1058,2171,0,9,8.53,254.5
"2011","Tower Hamlets 016C","E01004289","Total",1844,936,908,1844,0,4,10.49,175.8
"2011","Tower Hamlets 016D","E01004290","Total",1302,637,665,1259,43,5,10.26,126.9
"2011","Tower Hamlets 017A","E01004322","Total",1292,681,611,1160,132,8,14.18,91.1
"2011","Tower Hamlets 017B","E01004323","Total",1466,757,709,1466,0,6,7.07,207.4
"2011","Tower Hamlets 017C","E01004324","Total",1574,825,749,1570,4,7,7.61,206.8
"2011","Tower Hamlets 017D","E01004326","Total",1444,759,685,1438,6,5,8.37,172.5
"2011","Tower Hamlets 018A","E01004245","Total",1539,746,793,1539,0,3,21.23,72.5
"2011","Tower Hamlets 018B","E01004246","Total",1977,1026,951,1977,0,18,20.35,97.1
"2011","Tower Hamlets 018C","E01004248","Total",1344,636,708,1344,0,11,10.69,125.7
"2011","Tower Hamlets 018D","E01004249","Total",2049,1040,1009,2049,0,20,18.22,112.5
"2011","Tower Hamlets 019A","E01004284","Total",2302,1153,1149,2302,0,9,19.08,120.6
"2011","Tower Hamlets 019B","E01004285","Total",2318,1165,1153,2318,0,12,12.47,185.9
"2011","Tower Hamlets 019C","E01004286","Total",2364,1201,1163,2353,11,11,15.60,151.5
"2011","Tower Hamlets 019D","E01004288","Total",1620,821,799,1590,30,7,10.28,157.6
"2011","Tower Hamlets 020A","E01004243","Total",1789,890,899,1789,0,13,11.66,153.4
"2011","Tower Hamlets 020B","E01004244","Total",1885,993,892,1788,97,9,13.75,137.1
"2011","Tower Hamlets 020C","E01004247","Total",1934,976,958,1934,0,23,11.90,162.5
"2011","Tower Hamlets 020D","E01004250","Total",2342,1118,1224,2342,0,14,9.99,234.4
"2011","Tower Hamlets 021A","E01004319","Total",1886,999,887,1886,0,17,8.97,210.3
"2011","Tower Hamlets 021C","E01004321","Total",1822,970,852,1769,53,5,10.43,174.7
"2011","Tower Hamlets 021D","E01004325","Total",2487,1402,1085,2475,12,22,13.65,182.2
"2011","Tower Hamlets 021E","E01032766","Total",1307,731,576,1307,0,7,8.07,162.0
"2011","Tower Hamlets 021F","E01032767","Total",1584,958,626,1584,0,8,13.43,117.9
"2011","Tower Hamlets 022A","E01004298","Total",1637,798,839,1629,8,8,9.18,178.3
"2011","Tower Hamlets 022B","E01004300","Total",1349,703,646,1349,0,9,5.22,258.4
"2011","Tower Hamlets 022C","E01004304","Total",1957,986,971,1955,2,16,10.28,190.4
"2011","Tower Hamlets 022D","E01004305","Total",1952,1015,937,1940,12,10,9.11,214.3
"2011","Tower Hamlets 023A","E01004251","Total",2082,1105,977,2082,0,5,12.73,163.6
"2011","Tower Hamlets 023B","E01004254","Total",2120,1178,942,2120,0,10,17.06,124.3
"2011","Tower Hamlets 023C","E01004255","Total",1618,847,771,1618,0,7,9.39,172.3
"2011","Tower Hamlets 023D","E01004258","Total",1506,801,705,1506,0,11,9.75,154.5
"2011","Tower Hamlets 024A","E01004252","Total",2707,1420,1287,2707,0,13,16.10,168.1
"2011","Tower Hamlets 024B","E01004253","Total",2340,1160,1180,2266,74,18,15.26,153.3
"2011","Tower Hamlets 024C","E01004256","Total",1729,874,855,1729,0,9,14.33,120.7
"2011","Tower Hamlets 024D","E01004257","Total",1884,905,979,1883,1,3,12.57,149.9
"2011","Tower Hamlets 025B","E01004301","Total",1324,685,639,1324,0,13,8.18,161.9
"2011","Tower Hamlets 025C","E01004302","Total",1987,1035,952,1987,0,5,4.98,399.0
"2011","Tower Hamlets 025D","E01004303","Total",2362,1220,1142,2362,0,7,22.17,106.5
"2011","Tower Hamlets 025E","E01032768","Total",1307,750,557,1307,0,2,7.06,185.1
"2011","Tower Hamlets 025F","E01032769","Total",1235,671,564,1230,5,3,10.31,119.8
"2011","Tower Hamlets 026A","E01004292","Total",1738,973,765,1738,0,6,15.00,115.9
"2011","Tower Hamlets 026B","E01004294","Total",1757,1004,753,1690,67,7,21.33,82.4
"2011","Tower Hamlets 026C","E01004295","Total",1516,769,747,1516,0,13,8.13,186.5
"2011","Tower Hamlets 026D","E01004296","Total",1605,861,744,1605,0,11,13.50,118.9
"2011","Tower Hamlets 027A","E01004291","Total",1844,1013,831,1844,0,11,11.59,159.1
"2011","Tower Hamlets 027B","E01004293","Total",2125,1160,965,2125,0,17,32.63,65.1
"2011","Tower Hamlets 027C","E01004297","Total",1826,979,847,1826,0,7,12.04,151.7
"2011","Tower Hamlets 028A","E01004215","Total",2756,1422,1334,2756,0,16,30.15,91.4
"2011","Tower Hamlets 028B","E01004219","Total",2294,1187,1107,2294,0,27,19.95,115.0
"2011","Tower Hamlets 028D","E01004221","Total",1881,1007,874,1881,0,2,13.31,141.3
"2011","Tower Hamlets 028E","E01032776","Total",1076,606,470,1076,0,4,8.06,133.5
"2011","Tower Hamlets 028F","E01032777","Total",1141,585,556,1141,0,13,11.59,98.4
"2011","Tower Hamlets 028G","E01032778","Total",1108,602,506,1108,0,5,31.29,35.4
"2011","Tower Hamlets 028H","E01032779","Total",1089,574,515,1089,0,3,2.98,365.4
"2011","Tower Hamlets 028I","E01032780","Total",1333,736,597,1333,0,6,35.24,37.8
"2011","Tower Hamlets 030A","E01004214","Total",1669,828,841,1669,0,9,6.72,248.4
"2011","Tower Hamlets 030B","E01004216","Total",1619,859,760,1619,0,7,9.07,178.5
"2011","Tower Hamlets 030C","E01004217","Total",1745,850,895,1745,0,10,41.34,42.2
"2011","Tower Hamlets 030D","E01004218","Total",1750,873,877,1750,0,15,14.70,119.0
"2011","Tower Hamlets 031A","E01004274","Total",1973,1014,959,1973,0,15,8.49,232.4
"2011","Tower Hamlets 031B","E01004275","Total",1879,948,931,1879,0,7,13.87,135.5
"2011","Tower Hamlets 031C","E01004276","Total",2024,1096,928,2024,0,2,8.14,248.6
"2011","Tower Hamlets 031D","E01004281","Total",1770,944,826,1770,0,8,12.56,140.9
"2011","Tower Hamlets 031F","E01032775","Total",1108,625,483,1108,0,2,3.50,316.6
"2011","Tower Hamlets 031G","E01032783","Total",1383,693,690,1383,0,7,8.24,167.8
"2011","Tower Hamlets 032A","E01004280","Total",1879,941,938,1879,0,13,13.63,137.9
"2011","Tower Hamlets 032B","E01032770","Total",1191,610,581,1191,0,8,4.38,271.9
"2011","Tower Hamlets 032C","E01032772","Total",1135,622,513,1135,0,5,8.14,139.4
"2011","Tower Hamlets 032D","E01032773","Total",1561,860,701,1561,0,6,3.38,461.8
"2011","Tower Hamlets 032E","E01032774","Total",1298,647,651,1297,1,4,20.42,63.6
"2011","Tower Hamlets 033A","E01004277","Total",1630,938,692,1630,0,12,43.08,37.8
"2011","Tower Hamlets 033B","E01032771","Total",1104,584,520,1104,0,7,35.13,31.4
"2011","Tower Hamlets 033C","E01032781","Total",1535,838,697,1535,0,7,5.45,281.7
"2011","Tower Hamlets 033D","E01032782","Total",1614,891,723,1614,0,12,7.67,210.4
"2011","Wandsworth 001A","E01004560","Total",1954,983,971,1954,0,41,69.03,28.3
"2011","Wandsworth 001B","E01004566","Total",1567,764,803,1567,0,25,9.51,164.8
"2011","Wandsworth 001C","E01004582","Total",2147,1113,1034,2147,0,54,13.44,159.7
"2011","Wandsworth 001D","E01004583","Total",1806,861,945,1669,137,16,15.07,119.8
"2011","Wandsworth 002B","E01004562","Total",1764,890,874,1764,0,23,65.74,26.8
"2011","Wandsworth 002C","E01004563","Total",1961,957,1004,1961,0,21,15.46,126.8
"2011","Wandsworth 002D","E01004564","Total",1768,831,937,1768,0,10,38.20,46.3
"2011","Wandsworth 002E","E01004567","Total",2343,1081,1262,2343,0,27,12.05,194.4
"2011","Wandsworth 002F","E01033098","Total",1012,545,467,1009,3,12,32.89,30.8
"2011","Wandsworth 002G","E01033100","Total",1243,617,626,1243,0,4,11.43,108.7
"2011","Wandsworth 002H","E01033132","Total",1040,525,515,1040,0,7,26.46,39.3
"2011","Wandsworth 003A","E01004539","Total",2098,999,1099,2098,0,17,13.58,154.5
"2011","Wandsworth 003B","E01004540","Total",2083,990,1093,2083,0,23,13.86,150.3
"2011","Wandsworth 003C","E01004577","Total",1957,901,1056,1928,29,39,11.59,168.9
"2011","Wandsworth 003D","E01004584","Total",1710,819,891,1702,8,22,5.16,331.4
"2011","Wandsworth 004B","E01004579","Total",1615,805,810,1615,0,38,11.74,137.6
"2011","Wandsworth 004C","E01004580","Total",2092,1043,1049,2032,60,8,10.86,192.6
"2011","Wandsworth 004D","E01004581","Total",1817,885,932,1817,0,13,11.40,159.4
"2011","Wandsworth 004E","E01033099","Total",1028,498,530,1028,0,10,10.36,99.2
"2011","Wandsworth 004F","E01033101","Total",1191,670,521,1191,0,14,12.64,94.2
"2011","Wandsworth 004G","E01033133","Total",1193,622,571,1193,0,7,5.96,200.2
"2011","Wandsworth 005A","E01004565","Total",1679,794,885,1679,0,12,8.74,192.1
"2011","Wandsworth 005B","E01004590","Total",1749,870,879,1749,0,5,14.30,122.3
"2011","Wandsworth 005C","E01004591","Total",1734,842,892,1734,0,15,12.39,140.0
"2011","Wandsworth 005D","E01004592","Total",1628,751,877,1628,0,8,9.58,169.9
"2011","Wandsworth 006A","E01004604","Total",1686,816,870,1686,0,87,37.52,44.9
"2011","Wandsworth 006B","E01004605","Total",1728,794,934,1726,2,52,19.45,88.8
"2011","Wandsworth 006C","E01004606","Total",1633,800,833,1625,8,12,10.58,154.3
"2011","Wandsworth 006D","E01004607","Total",1729,827,902,1729,0,31,16.81,102.9
"2011","Wandsworth 006E","E01004608","Total",1682,780,902,1682,0,27,9.62,174.8
"2011","Wandsworth 007A","E01004535","Total",1758,814,944,1758,0,22,7.68,228.9
"2011","Wandsworth 007B","E01004537","Total",1881,872,1009,1881,0,1,11.78,159.7
"2011","Wandsworth 007C","E01004538","Total",2001,964,1037,2001,0,6,11.37,176.0
"2011","Wandsworth 007D","E01004541","Total",1637,720,917,1637,0,24,9.47,172.9
"2011","Wandsworth 008A","E01004534","Total",1850,878,972,1850,0,20,25.65,72.1
"2011","Wandsworth 008B","E01004536","Total",2050,983,1067,2029,21,13,15.08,135.9
"2011","Wandsworth 008C","E01004552","Total",1982,973,1009,1982,0,7,10.67,185.8
"2011","Wandsworth 008D","E01004585","Total",1840,853,987,1835,5,16,12.94,142.2
"2011","Wandsworth 008E","E01004588","Total",1954,992,962,1953,1,8,16.72,116.9
"2011","Wandsworth 009A","E01004554","Total",1607,797,810,1607,0,22,40.76,39.4
"2011","Wandsworth 009B","E01004556","Total",1612,804,808,1612,0,18,9.96,161.8
"2011","Wandsworth 009C","E01004586","Total",1812,859,953,1812,0,20,8.72,207.8
"2011","Wandsworth 009D","E01004587","Total",1743,858,885,1743,0,23,10.79,161.5
"2011","Wandsworth 009E","E01004589","Total",1700,859,841,1700,0,25,9.34,182.0
"2011","Wandsworth 010A","E01004509","Total",2190,1133,1057,2190,0,6,38.56,56.8
"2011","Wandsworth 010B","E01004511","Total",1722,851,871,1722,0,22,16.20,106.3
"2011","Wandsworth 010C","E01004602","Total",1640,761,879,1640,0,24,13.80,118.8
"2011","Wandsworth 010E","E01004609","Total",2147,1048,1099,2147,0,26,20.58,104.3
"2011","Wandsworth 010F","E01033093","Total",1526,782,744,1526,0,26,27.47,55.6
"2011","Wandsworth 010G","E01033135","Total",1071,521,550,1071,0,13,10.09,106.1
"2011","Wandsworth 011A","E01004506","Total",1923,921,1002,1922,1,26,20.20,95.2
"2011","Wandsworth 011B","E01004638","Total",1449,706,743,1438,11,98,27.35,53.0
"2011","Wandsworth 011C","E01004639","Total",1724,821,903,1715,9,43,22.55,76.5
"2011","Wandsworth 011D","E01004640","Total",1775,879,896,1775,0,41,16.61,106.9
"2011","Wandsworth 011E","E01004641","Total",1910,898,1012,1910,0,58,20.76,92.0
"2011","Wandsworth 012A","E01004508","Total",2019,1000,1019,2019,0,12,13.75,146.8
"2011","Wandsworth 012B","E01004510","Total",1945,966,979,1934,11,15,16.59,117.2
"2011","Wandsworth 012C","E01004514","Total",1685,859,826,1672,13,16,16.38,102.9
"2011","Wandsworth 012D","E01004515","Total",1692,819,873,1651,41,17,10.48,161.5
"2011","Wandsworth 012E","E01004551","Total",1764,840,924,1764,0,10,21.32,82.7
"2011","Wandsworth 013A","E01004568","Total",1665,684,981,1064,601,30,23.08,72.1
"2011","Wandsworth 013B","E01004574","Total",1811,792,1019,1811,0,15,21.03,86.1
"2011","Wandsworth 013C","E01004575","Total",1810,818,992,1528,282,19,54.08,33.5
"2011","Wandsworth 013D","E01004576","Total",1564,784,780,1543,21,24,44.57,35.1
"2011","Wandsworth 014A","E01004500","Total",1622,773,849,1591,31,7,15.84,102.4
"2011","Wandsworth 014B","E01004501","Total",1582,743,839,1582,0,30,16.48,96.0
"2011","Wandsworth 014C","E01004503","Total",1672,786,886,1625,47,31,19.81,84.4
"2011","Wandsworth 014D","E01004505","Total",1616,776,840,1616,0,13,19.92,81.1
"2011","Wandsworth 014E","E01004507","Total",1838,874,964,1838,0,17,18.11,101.5
"2011","Wandsworth 015A","E01004553","Total",1640,826,814,1640,0,8,19.96,82.2
"2011","Wandsworth 015B","E01004557","Total",1540,744,796,1530,10,27,10.82,142.3
"2011","Wandsworth 015C","E01004558","Total",1710,841,869,1707,3,30,22.64,75.5
"2011","Wandsworth 015D","E01004559","Total",1397,679,718,1397,0,63,17.70,78.9
"2011","Wandsworth 015E","E01004619","Total",1437,701,736,1437,0,95,52.27,27.5
"2011","Wandsworth 016A","E01004572","Total",1662,802,860,1649,13,40,78.63,21.1
"2011","Wandsworth 016B","E01004642","Total",1856,827,1029,1734,122,29,21.99,84.4
"2011","Wandsworth 016C","E01004643","Total",2013,923,1090,1981,32,18,20.21,99.6
"2011","Wandsworth 016D","E01004644","Total",1937,870,1067,1924,13,38,39.30,49.3
"2011","Wandsworth 016E","E01004645","Total",2078,968,1110,1983,95,16,15.86,131.0
"2011","Wandsworth 017A","E01004477","Total",1672,829,843,1668,4,80,20.54,81.4
"2011","Wandsworth 017B","E01004478","Total",1526,733,793,1526,0,42,9.44,161.7
"2011","Wandsworth 017C","E01004479","Total",1548,773,775,1540,8,56,14.43,107.3
"2011","Wandsworth 017D","E01004550","Total",1534,688,846,1363,171,45,14.39,106.6
"2011","Wandsworth 017E","E01004555","Total",1688,867,821,1663,25,31,14.01,120.5
"2011","Wandsworth 018A","E01004494","Total",1666,799,867,1645,21,5,12.09,137.8
"2011","Wandsworth 018B","E01004513","Total",1866,887,979,1866,0,6,15.25,122.4
"2011","Wandsworth 018C","E01004600","Total",2062,1000,1062,2062,0,18,12.33,167.2
"2011","Wandsworth 018D","E01004601","Total",2241,1114,1127,2241,0,15,30.41,73.7
"2011","Wandsworth 019A","E01004493","Total",1761,846,915,1734,27,7,13.95,126.2
"2011","Wandsworth 019B","E01004512","Total",1494,731,763,1483,11,27,11.51,129.8
"2011","Wandsworth 019C","E01004620","Total",1647,855,792,1642,5,43,10.72,153.6
"2011","Wandsworth 019D","E01004621","Total",1686,828,858,1635,51,43,43.84,38.5
"2011","Wandsworth 019E","E01004623","Total",1733,834,899,1733,0,32,14.90,116.3
"2011","Wandsworth 019F","E01004627","Total",1620,766,854,1614,6,40,11.13,145.6
"2011","Wandsworth 020A","E01004499","Total",1591,731,860,1591,0,21,13.99,113.7
"2011","Wandsworth 020B","E01004502","Total",1655,821,834,1655,0,36,14.22,116.4
"2011","Wandsworth 020C","E01004504","Total",1523,768,755,1523,0,48,22.35,68.1
"2011","Wandsworth 020D","E01004594","Total",1657,789,868,1657,0,47,14.37,115.3
"2011","Wandsworth 020E","E01004596","Total",1621,796,825,1621,0,27,11.79,137.5
"2011","Wandsworth 020F","E01004629","Total",1618,802,816,1586,32,31,24.42,66.3
"2011","Wandsworth 021A","E01004472","Total",1746,838,908,1746,0,31,13.10,133.3
"2011","Wandsworth 021B","E01004474","Total",1866,926,940,1856,10,8,14.78,126.3
"2011","Wandsworth 021C","E01004476","Total",1636,854,782,1636,0,18,19.23,85.1
"2011","Wandsworth 021D","E01004542","Total",1621,818,803,1621,0,44,13.18,123.0
"2011","Wandsworth 021E","E01004544","Total",1533,756,777,1529,4,33,10.27,149.3
"2011","Wandsworth 022A","E01004628","Total",2300,1143,1157,2102,198,27,22.77,101.0
"2011","Wandsworth 022B","E01004630","Total",1751,775,976,1751,0,11,11.36,154.1
"2011","Wandsworth 022C","E01004631","Total",1537,731,806,1452,85,15,16.18,95.0
"2011","Wandsworth 022D","E01004633","Total",1618,740,878,1618,0,15,8.26,195.9
"2011","Wandsworth 023A","E01004569","Total",2439,1077,1362,1969,470,50,28.77,84.8
"2011","Wandsworth 023B","E01004570","Total",1904,868,1036,1873,31,18,11.75,162.0
"2011","Wandsworth 023C","E01004571","Total",1681,797,884,1681,0,19,12.27,137.0
"2011","Wandsworth 023D","E01004573","Total",1596,793,803,1521,75,11,168.20,9.5
"2011","Wandsworth 024A","E01004495","Total",1536,710,826,1536,0,10,11.78,130.4
"2011","Wandsworth 024B","E01004496","Total",1956,968,988,1956,0,10,17.68,110.6
"2011","Wandsworth 024C","E01004497","Total",1445,659,786,1445,0,22,16.70,86.5
"2011","Wandsworth 024D","E01004622","Total",2266,1701,565,1092,1174,15,20.24,112.0
"2011","Wandsworth 024E","E01004624","Total",1592,772,820,1592,0,21,40.19,39.6
"2011","Wandsworth 025A","E01004593","Total",1830,870,960,1830,0,12,21.48,85.2
"2011","Wandsworth 025B","E01004595","Total",1757,825,932,1757,0,15,22.47,78.2
"2011","Wandsworth 025C","E01004597","Total",1813,846,967,1813,0,18,13.98,129.7
"2011","Wandsworth 025D","E01004598","Total",1760,862,898,1760,0,3,14.26,123.4
"2011","Wandsworth 025E","E01004599","Total",1515,727,788,1515,0,31,11.08,136.7
"2011","Wandsworth 026A","E01004473","Total",1698,817,881,1688,10,11,10.88,156.1
"2011","Wandsworth 026B","E01004475","Total",1406,705,701,1400,6,9,10.49,134.0
"2011","Wandsworth 026C","E01004480","Total",1653,773,880,1653,0,10,7.89,209.5
"2011","Wandsworth 026D","E01004483","Total",2119,1070,1049,2099,20,9,45.42,46.7
"2011","Wandsworth 026E","E01004484","Total",1523,723,800,1513,10,20,31.09,49.0
"2011","Wandsworth 026F","E01004486","Total",1478,702,776,1465,13,29,26.96,54.8
"2011","Wandsworth 027A","E01004543","Total",1791,862,929,1781,10,66,20.96,85.4
"2011","Wandsworth 027B","E01004545","Total",1578,760,818,1578,0,11,14.68,107.5
"2011","Wandsworth 027C","E01004546","Total",1506,710,796,1502,4,36,9.15,164.6
"2011","Wandsworth 027D","E01004549","Total",1664,842,822,1593,71,38,12.37,134.5
"2011","Wandsworth 027E","E01004625","Total",1397,670,727,1397,0,66,24.88,56.1
"2011","Wandsworth 027F","E01004626","Total",1869,934,935,1674,195,42,57.81,32.3
"2011","Wandsworth 028A","E01004632","Total",1527,702,825,1527,0,25,27.71,55.1
"2011","Wandsworth 028B","E01004634","Total",1473,728,745,1465,8,20,12.33,119.5
"2011","Wandsworth 028C","E01004635","Total",1645,809,836,1616,29,10,16.37,100.5
"2011","Wandsworth 028D","E01004636","Total",1462,715,747,1462,0,18,15.33,95.4
"2011","Wandsworth 028E","E01004637","Total",1471,702,769,1471,0,18,14.16,103.9
"2011","Wandsworth 029A","E01004481","Total",1687,791,896,1671,16,9,10.27,164.3
"2011","Wandsworth 029B","E01004488","Total",1511,746,765,1486,25,44,10.75,140.6
"2011","Wandsworth 029C","E01004547","Total",1400,642,758,1331,69,18,11.54,121.3
"2011","Wandsworth 029D","E01004548","Total",2052,1020,1032,2034,18,17,16.60,123.6
"2011","Wandsworth 030A","E01004482","Total",1588,745,843,1588,0,17,11.85,134.0
"2011","Wandsworth 030B","E01004485","Total",1668,839,829,1668,0,20,15.33,108.8
"2011","Wandsworth 030C","E01004487","Total",1560,777,783,1519,41,46,10.56,147.7
"2011","Wandsworth 030D","E01004489","Total",1441,700,741,1430,11,42,18.12,79.5
"2011","Wandsworth 031A","E01004490","Total",1510,711,799,1510,0,19,12.69,119.0
"2011","Wandsworth 031B","E01004491","Total",2150,964,1186,1824,326,20,17.22,124.9
"2011","Wandsworth 031C","E01004492","Total",1719,812,907,1719,0,10,27.64,62.2
"2011","Wandsworth 031D","E01004498","Total",1705,767,938,1705,0,7,11.31,150.8
"2011","Wandsworth 032A","E01004532","Total",1487,697,790,1487,0,14,9.01,165.0
"2011","Wandsworth 032B","E01004611","Total",1602,776,826,1602,0,13,12.27,130.6
"2011","Wandsworth 032C","E01004612","Total",1788,888,900,1785,3,17,12.04,148.5
"2011","Wandsworth 032D","E01004618","Total",1552,756,796,1552,0,9,11.71,132.5
"2011","Wandsworth 033A","E01004531","Total",1724,785,939,1724,0,8,8.65,199.3
"2011","Wandsworth 033B","E01004533","Total",1398,623,775,1398,0,16,8.75,159.8
"2011","Wandsworth 033C","E01004610","Total",1978,1039,939,1976,2,21,28.64,69.1
"2011","Wandsworth 033D","E01004613","Total",1614,785,829,1614,0,3,10.06,160.4
"2011","Wandsworth 034A","E01004614","Total",2065,925,1140,2065,0,13,14.22,145.2
"2011","Wandsworth 034B","E01004615","Total",1798,835,963,1795,3,20,17.77,101.2
"2011","Wandsworth 034C","E01004616","Total",2162,1064,1098,2159,3,8,10.58,204.3
"2011","Wandsworth 034D","E01004617","Total",1680,815,865,1645,35,25,43.14,38.9
"2011","Wandsworth 035A","E01004525","Total",1850,952,898,1848,2,11,13.94,132.7
"2011","Wandsworth 035B","E01004526","Total",1599,804,795,1558,41,17,10.37,154.2
"2011","Wandsworth 035C","E01004527","Total",1648,778,870,1643,5,13,10.04,164.1
"2011","Wandsworth 035D","E01004528","Total",1520,692,828,1488,32,8,14.16,107.3
"2011","Wandsworth 035E","E01004529","Total",2086,991,1095,2079,7,16,12.24,170.4
"2011","Wandsworth 035F","E01004530","Total",1886,947,939,1880,6,16,13.61,138.6
"2011","Wandsworth 036A","E01004516","Total",1810,891,919,1608,202,41,21.39,84.6
"2011","Wandsworth 036B","E01004518","Total",1746,829,917,1743,3,43,12.64,138.1
"2011","Wandsworth 036C","E01004519","Total",1767,862,905,1767,0,18,13.59,130.0
"2011","Wandsworth 036D","E01004520","Total",1366,640,726,1366,0,15,11.38,120.0
"2011","Wandsworth 036E","E01004523","Total",1582,752,830,1581,1,26,30.10,52.6
"2011","Wandsworth 037A","E01004517","Total",1964,990,974,1943,21,29,15.16,129.6
"2011","Wandsworth 037B","E01004521","Total",1952,962,990,1946,6,20,12.15,160.7
"2011","Wandsworth 037C","E01004522","Total",1646,787,859,1629,17,11,11.69,140.8
"2011","Wandsworth 037D","E01004524","Total",1671,815,856,1633,38,13,13.23,126.3
"2011","Westminster 001A","E01004647","Total",1480,677,803,1480,0,30,19.51,75.9
"2011","Westminster 001B","E01004649","Total",1708,804,904,1593,115,45,19.54,87.4
"2011","Westminster 001C","E01004724","Total",1761,848,913,1761,0,16,8.07,218.2
"2011","Westminster 001D","E01004730","Total",1671,784,887,1665,6,36,45.02,37.1
"2011","Westminster 002A","E01004646","Total",1653,792,861,1653,0,50,21.48,77.0
"2011","Westminster 002B","E01004648","Total",2398,1144,1254,2398,0,41,21.39,112.1
"2011","Westminster 002C","E01004650","Total",1996,963,1033,1992,4,42,17.59,113.5
"2011","Westminster 002D","E01004710","Total",1648,771,877,1603,45,30,12.85,128.2
"2011","Westminster 002E","E01004711","Total",1747,814,933,1734,13,13,7.94,220.0
"2011","Westminster 003A","E01004651","Total",2015,975,1040,2015,0,17,9.98,201.9
"2011","Westminster 003B","E01004725","Total",1615,786,829,1611,4,24,27.29,59.2
"2011","Westminster 003C","E01004726","Total",1798,880,918,1792,6,47,18.57,96.8
"2011","Westminster 003D","E01004728","Total",1558,770,788,1558,0,16,7.49,208.0
"2011","Westminster 003E","E01004729","Total",1638,790,848,1638,0,16,6.05,270.7
"2011","Westminster 004A","E01004718","Total",1962,901,1061,1962,0,12,7.39,265.5
"2011","Westminster 004B","E01004719","Total",1909,878,1031,1896,13,9,9.68,197.2
"2011","Westminster 004C","E01004720","Total",2000,950,1050,1991,9,16,11.83,169.1
"2011","Westminster 004D","E01004721","Total",1998,936,1062,1998,0,12,11.75,170.0
"2011","Westminster 004E","E01004722","Total",2494,1202,1292,2456,38,20,8.03,310.6
"2011","Westminster 005A","E01004674","Total",2107,1000,1107,2093,14,12,8.78,240.0
"2011","Westminster 005B","E01004675","Total",2284,1134,1150,2279,5,23,9.01,253.5
"2011","Westminster 005C","E01004677","Total",1815,883,932,1795,20,7,7.11,255.3
"2011","Westminster 005D","E01004678","Total",2000,966,1034,1997,3,15,8.68,230.4
"2011","Westminster 005E","E01004679","Total",2143,1024,1119,2118,25,14,7.65,280.1
"2011","Westminster 005F","E01004723","Total",2200,1056,1144,2176,24,22,9.64,228.2
"2011","Westminster 006A","E01004676","Total",1685,863,822,1685,0,13,8.23,204.7
"2011","Westminster 006B","E01004706","Total",1600,775,825,1600,0,6,13.95,114.7
"2011","Westminster 006C","E01004707","Total",1954,959,995,1954,0,30,12.89,151.6
"2011","Westminster 006D","E01004708","Total",1588,804,784,1569,19,14,8.12,195.6
"2011","Westminster 006E","E01004756","Total",1800,882,918,1796,4,6,5.94,303.0
"2011","Westminster 007A","E01004701","Total",1618,793,825,1618,0,24,7.92,204.3
"2011","Westminster 007B","E01004703","Total",2308,1152,1156,2308,0,67,20.78,111.1
"2011","Westminster 007D","E01004705","Total",1469,739,730,1469,0,29,6.83,215.1
"2011","Westminster 007E","E01004709","Total",1673,783,890,1673,0,32,8.88,188.4
"2011","Westminster 007F","E01033600","Total",1224,629,595,1224,0,25,6.36,192.5
"2011","Westminster 007G","E01033608","Total",1416,743,673,1369,47,38,5.25,269.7
"2011","Westminster 008A","E01004659","Total",1802,937,865,1769,33,18,11.41,157.9
"2011","Westminster 008B","E01004660","Total",1781,904,877,1781,0,33,6.81,261.5
"2011","Westminster 008C","E01004712","Total",1680,892,788,1545,135,27,10.04,167.3
"2011","Westminster 008D","E01004727","Total",2026,1026,1000,1998,28,83,113.14,17.9
"2011","Westminster 009A","E01004670","Total",2709,1289,1420,2709,0,15,8.31,326.0
"2011","Westminster 009E","E01004702","Total",2598,1268,1330,2597,1,27,16.43,158.1
"2011","Westminster 009F","E01033598","Total",1242,599,643,1242,0,9,5.31,233.9
"2011","Westminster 009G","E01033601","Total",1569,745,824,1569,0,7,5.45,287.9
"2011","Westminster 009H","E01033602","Total",1625,777,848,1625,0,18,5.80,280.2
"2011","Westminster 009I","E01033603","Total",1333,616,717,1217,116,13,4.98,267.7
"2011","Westminster 009J","E01033604","Total",1236,681,555,1236,0,20,7.21,171.4
"2011","Westminster 009K","E01033605","Total",2046,1018,1028,2004,42,19,7.37,277.6
"2011","Westminster 010A","E01004754","Total",1629,779,850,1528,101,12,8.30,196.3
"2011","Westminster 010B","E01004755","Total",2207,1090,1117,2147,60,24,11.50,191.9
"2011","Westminster 010C","E01004757","Total",1598,762,836,1594,4,17,12.36,129.3
"2011","Westminster 010F","E01032512","Total",2540,1250,1290,2480,60,25,16.81,151.1
"2011","Westminster 010G","E01032513","Total",1355,659,696,1311,44,12,5.33,254.2
"2011","Westminster 011A","E01004713","Total",1829,954,875,1779,50,23,17.39,105.2
"2011","Westminster 011B","E01004714","Total",2150,1154,996,2141,9,28,33.98,63.3
"2011","Westminster 011C","E01004716","Total",1423,737,686,1419,4,19,17.86,79.7
"2011","Westminster 011D","E01004717","Total",1511,801,710,1511,0,22,9.86,153.2
"2011","Westminster 011E","E01004762","Total",2070,1118,952,2066,4,39,29.32,70.6
"2011","Westminster 012A","E01004657","Total",1480,834,646,1471,9,6,12.42,119.2
"2011","Westminster 012B","E01004658","Total",1557,817,740,1391,166,56,10.17,153.1
"2011","Westminster 012C","E01004661","Total",1847,998,849,1817,30,13,13.27,139.2
"2011","Westminster 012D","E01004662","Total",1876,1037,839,1876,0,27,8.95,209.6
"2011","Westminster 012E","E01004663","Total",1648,837,811,1636,12,34,9.27,177.8
"2011","Westminster 013A","E01004715","Total",1773,890,883,1514,259,45,10.99,161.3
"2011","Westminster 013B","E01004763","Total",2127,1276,851,1731,396,10,29.37,72.4
"2011","Westminster 013D","E01004765","Total",2023,1098,925,1967,56,22,26.81,75.5
"2011","Westminster 013E","E01033595","Total",1175,708,467,1174,1,12,51.33,22.9
"2011","Westminster 013F","E01033596","Total",1235,736,499,1231,4,10,10.77,114.7
"2011","Westminster 014A","E01004653","Total",1812,890,922,1812,0,46,9.08,199.6
"2011","Westminster 014B","E01004654","Total",2274,1161,1113,2225,49,31,11.82,192.4
"2011","Westminster 014D","E01004656","Total",2107,1107,1000,2107,0,22,15.13,139.3
"2011","Westminster 014E","E01004760","Total",1630,768,862,1630,0,18,7.18,227.0
"2011","Westminster 014F","E01033606","Total",1068,560,508,1064,4,4,2.71,394.1
"2011","Westminster 014G","E01033607","Total",1199,588,611,1193,6,17,8.33,143.9
"2011","Westminster 015A","E01004680","Total",1488,758,730,1451,37,41,11.39,130.6
"2011","Westminster 015B","E01004683","Total",1662,851,811,1657,5,43,12.99,127.9
"2011","Westminster 015C","E01004684","Total",1617,928,689,1401,216,22,8.01,201.9
"2011","Westminster 015E","E01004686","Total",1529,899,630,1529,0,26,6.29,243.1
"2011","Westminster 015F","E01033593","Total",1130,663,467,1130,0,28,9.23,122.4
"2011","Westminster 015G","E01033594","Total",1368,772,596,1280,88,28,21.01,65.1
"2011","Westminster 016A","E01004681","Total",2126,1133,993,2126,0,17,17.58,120.9
"2011","Westminster 016B","E01004682","Total",1542,852,690,1336,206,10,9.34,165.1
"2011","Westminster 016C","E01004694","Total",1813,960,853,1717,96,25,10.23,177.2
"2011","Westminster 016D","E01004697","Total",1513,783,730,1504,9,6,5.54,273.1
"2011","Westminster 016E","E01004700","Total",1763,903,860,1708,55,24,5.74,307.1
"2011","Westminster 017A","E01004652","Total",1840,926,914,1840,0,20,4.70,391.5
"2011","Westminster 017B","E01004693","Total",1398,723,675,1398,0,30,8.17,171.1
"2011","Westminster 017C","E01004695","Total",1297,699,598,1274,23,24,5.62,230.8
"2011","Westminster 017D","E01004696","Total",1586,770,816,1585,1,18,6.67,237.8
"2011","Westminster 017E","E01004698","Total",1558,836,722,1428,130,41,9.35,166.6
"2011","Westminster 017F","E01004699","Total",2267,1202,1065,2241,26,8,11.66,194.4
"2011","Westminster 018A","E01004734","Total",1972,1120,852,1931,41,9,32.51,60.7
"2011","Westminster 018B","E01004735","Total",1829,999,830,1601,228,6,47.90,38.2
"2011","Westminster 018C","E01004736","Total",1744,1058,686,1265,479,27,119.04,14.7
"2011","Westminster 018D","E01004761","Total",1945,1120,825,1922,23,17,52.01,37.4
"2011","Westminster 019A","E01004687","Total",1669,824,845,1665,4,77,18.52,90.1
"2011","Westminster 019B","E01004688","Total",1950,1135,815,878,1072,27,74.79,26.1
"2011","Westminster 019C","E01004689","Total",1173,699,474,1015,158,42,192.39,6.1
"2011","Westminster 019D","E01004690","Total",1400,701,699,1400,0,58,23.64,59.2
"2011","Westminster 019E","E01004691","Total",1508,790,718,1508,0,39,34.88,43.2
"2011","Westminster 019F","E01004692","Total",1570,800,770,1396,174,21,15.11,103.9
"2011","Westminster 020A","E01004731","Total",1781,966,815,1658,123,32,67.50,26.4
"2011","Westminster 020B","E01004732","Total",1456,765,691,1314,142,16,6.98,208.6
"2011","Westminster 020C","E01004733","Total",2046,1177,869,1796,250,54,45.16,45.3
"2011","Westminster 020D","E01004744","Total",1347,664,683,1311,36,34,10.82,124.5
"2011","Westminster 020E","E01004748","Total",1451,792,659,1238,213,27,8.73,166.2
"2011","Westminster 021A","E01004740","Total",1494,736,758,1494,0,14,4.88,306.1
"2011","Westminster 021B","E01004743","Total",1396,731,665,1396,0,16,4.90,284.9
"2011","Westminster 021C","E01004745","Total",2114,1070,1044,2114,0,24,20.17,104.8
"2011","Westminster 021D","E01004746","Total",1440,714,726,1440,0,9,4.04,356.4
"2011","Westminster 021E","E01004747","Total",2240,1117,1123,2182,58,37,10.84,206.6
"2011","Westminster 022A","E01004742","Total",1391,715,676,1381,10,18,4.67,297.9
"2011","Westminster 022B","E01004749","Total",2445,1215,1230,2337,108,38,13.77,177.6
"2011","Westminster 022C","E01004751","Total",1773,924,849,1768,5,38,8.42,210.6
"2011","Westminster 022D","E01004752","Total",1569,790,779,1567,2,16,3.59,437.0
"2011","Westminster 022E","E01004753","Total",1813,902,911,1813,0,25,5.92,306.2
"2011","Westminster 023B","E01004666","Total",1103,540,563,1103,0,98,8.57,128.7
"2011","Westminster 023C","E01004667","Total",1348,654,694,1348,0,10,13.11,102.8
"2011","Westminster 023D","E01004668","Total",1443,678,765,1443,0,42,5.51,261.9
"2011","Westminster 023E","E01004750","Total",1769,904,865,1741,28,16,25.65,69.0
"2011","Westminster 023F","E01033597","Total",990,529,461,990,0,4,5.86,168.9
"2011","Westminster 023G","E01033599","Total",1573,706,867,1573,0,16,6.58,239.1
"2011","Westminster 024A","E01004665","Total",1478,701,777,1478,0,9,4.78,309.2
"2011","Westminster 024B","E01004669","Total",1683,826,857,1683,0,29,7.17,234.7
"2011","Westminster 024C","E01004737","Total",1301,635,666,1301,0,20,8.07,161.2
"2011","Westminster 024D","E01004738","Total",1351,676,675,1306,45,19,9.20,146.8
"2011","Westminster 024E","E01004739","Total",1348,675,673,1348,0,11,2.91,463.2
"2011","Westminster 024F","E01004741","Total",1273,631,642,1273,0,13,5.63,226.1
"2011","Barking and Dagenham 001A","E01000027","Total",1709,774,935,1688,21,23,147.45,11.6
"2011","Barking and Dagenham 001B","E01000028","Total",1549,715,834,1519,30,4,14.38,107.7
"2011","Barking and Dagenham 001C","E01000029","Total",1602,765,837,1602,0,13,25.69,62.4
"2011","Barking and Dagenham 001D","E01000030","Total",1915,902,1013,1915,0,9,28.63,66.9
"2011","Barking and Dagenham 002A","E01000031","Total",1617,784,833,1617,0,23,84.35,19.2
"2011","Barking and Dagenham 002B","E01000032","Total",1629,816,813,1629,0,15,37.55,43.4
"2011","Barking and Dagenham 002C","E01000110","Total",1416,696,720,1404,12,16,19.45,72.8
"2011","Barking and Dagenham 002D","E01000111","Total",1833,832,1001,1833,0,17,29.66,61.8
"2011","Barking and Dagenham 002E","E01000112","Total",1871,917,954,1871,0,15,27.75,67.4
"2011","Barking and Dagenham 002F","E01000113","Total",1679,799,880,1679,0,18,15.39,109.1
"2011","Barking and Dagenham 003A","E01000034","Total",1444,653,791,1348,96,17,51.36,28.1
"2011","Barking and Dagenham 003B","E01000037","Total",1688,852,836,1547,141,14,23.34,72.3
"2011","Barking and Dagenham 003C","E01000038","Total",1447,687,760,1447,0,10,21.40,67.6
"2011","Barking and Dagenham 003D","E01000039","Total",1603,758,845,1595,8,12,153.18,10.5
"2011","Barking and Dagenham 004A","E01000063","Total",1620,805,815,1620,0,8,18.12,89.4
"2011","Barking and Dagenham 004B","E01000100","Total",1653,779,874,1653,0,3,21.15,78.2
"2011","Barking and Dagenham 004C","E01000101","Total",1513,704,809,1513,0,20,16.39,92.3
"2011","Barking and Dagenham 004D","E01000109","Total",1686,823,863,1686,0,20,37.53,44.9
"2011","Barking and Dagenham 004E","E01000114","Total",2090,1023,1067,2090,0,20,25.62,81.6
"2011","Barking and Dagenham 006A","E01000033","Total",1361,652,709,1361,0,8,14.53,93.7
"2011","Barking and Dagenham 006B","E01000060","Total",1809,848,961,1809,0,18,54.99,32.9
"2011","Barking and Dagenham 006C","E01000061","Total",1776,822,954,1719,57,19,61.05,29.1
"2011","Barking and Dagenham 006D","E01000062","Total",1952,905,1047,1952,0,9,22.13,88.2
"2011","Barking and Dagenham 006E","E01000064","Total",1893,872,1021,1831,62,14,20.88,90.7
"2011","Barking and Dagenham 007A","E01000065","Total",1736,815,921,1736,0,11,23.36,74.3
"2011","Barking and Dagenham 007B","E01000078","Total",1666,767,899,1666,0,16,17.58,94.8
"2011","Barking and Dagenham 007C","E01000080","Total",1556,720,836,1556,0,16,23.13,67.3
"2011","Barking and Dagenham 007D","E01000081","Total",1688,844,844,1688,0,17,18.58,90.9
"2011","Barking and Dagenham 007E","E01000082","Total",1683,799,884,1678,5,25,16.07,104.7
"2011","Barking and Dagenham 007F","E01000083","Total",1700,790,910,1700,0,16,17.99,94.5
"2011","Barking and Dagenham 007G","E01000102","Total",1540,715,825,1540,0,17,25.28,60.9
"2011","Barking and Dagenham 008A","E01000021","Total",1579,803,776,1579,0,17,16.93,93.3
"2011","Barking and Dagenham 008B","E01000022","Total",1314,618,696,1314,0,14,12.83,102.4
"2011","Barking and Dagenham 008C","E01000023","Total",1112,583,529,1112,0,6,20.72,53.7
"2011","Barking and Dagenham 008D","E01000024","Total",1336,616,720,1325,11,12,12.86,103.9
"2011","Barking and Dagenham 008E","E01000025","Total",1609,773,836,1609,0,20,15.34,104.9
"2011","Barking and Dagenham 008F","E01000077","Total",1445,687,758,1437,8,6,17.38,83.1
"2011","Barking and Dagenham 009A","E01000015","Total",2241,1049,1192,2241,0,12,28.06,79.9
"2011","Barking and Dagenham 009B","E01000016","Total",1637,804,833,1637,0,11,19.88,82.3
"2011","Barking and Dagenham 009C","E01000017","Total",1594,773,821,1594,0,14,15.84,100.6
"2011","Barking and Dagenham 009D","E01000018","Total",1597,751,846,1597,0,16,17.38,91.9
"2011","Barking and Dagenham 009E","E01000079","Total",1546,708,838,1546,0,10,30.96,49.9
"2011","Barking and Dagenham 010A","E01000035","Total",1610,782,828,1543,67,11,39.71,40.5
"2011","Barking and Dagenham 010B","E01000036","Total",1353,683,670,1353,0,24,41.87,32.3
"2011","Barking and Dagenham 010C","E01000107","Total",1666,810,856,1632,34,22,53.60,31.1
"2011","Barking and Dagenham 010D","E01000108","Total",1558,771,787,1558,0,17,24.21,64.4
"2011","Barking and Dagenham 011A","E01000066","Total",1928,924,1004,1928,0,13,24.49,78.7
"2011","Barking and Dagenham 011B","E01000067","Total",1969,985,984,1969,0,19,19.25,102.3
"2011","Barking and Dagenham 011C","E01000069","Total",1763,875,888,1756,7,31,20.05,87.9
"2011","Barking and Dagenham 011D","E01000070","Total",1975,912,1063,1975,0,22,39.18,50.4
"2011","Barking and Dagenham 011E","E01000071","Total",2253,1101,1152,2251,2,23,27.06,83.3
"2011","Barking and Dagenham 012A","E01000057","Total",1496,698,798,1496,0,20,14.77,101.3
"2011","Barking and Dagenham 012B","E01000073","Total",1619,746,873,1619,0,11,28.46,56.9
"2011","Barking and Dagenham 012C","E01000074","Total",1567,717,850,1567,0,15,16.42,95.4
"2011","Barking and Dagenham 012D","E01000075","Total",1732,859,873,1732,0,18,51.74,33.5
"2011","Barking and Dagenham 012E","E01000076","Total",1988,1013,975,1982,6,6,19.07,104.2
"2011","Barking and Dagenham 013A","E01000013","Total",1660,797,863,1660,0,11,20.78,79.9
"2011","Barking and Dagenham 013B","E01000014","Total",1656,777,879,1622,34,8,34.12,48.5
"2011","Barking and Dagenham 013C","E01000059","Total",1582,720,862,1540,42,8,20.83,75.9
"2011","Barking and Dagenham 013D","E01000084","Total",1355,634,721,1355,0,8,15.00,90.3
"2011","Barking and Dagenham 013E","E01000085","Total",1718,798,920,1711,7,6,14.53,118.2
"2011","Barking and Dagenham 013F","E01000086","Total",1431,687,744,1431,0,13,14.01,102.1
"2011","Barking and Dagenham 014A","E01000103","Total",1685,777,908,1685,0,23,70.13,24.0
"2011","Barking and Dagenham 014B","E01000104","Total",1781,875,906,1781,0,18,22.02,80.9
"2011","Barking and Dagenham 014C","E01000105","Total",2129,1011,1118,2115,14,15,22.09,96.4
"2011","Barking and Dagenham 014D","E01000106","Total",1968,972,996,1968,0,24,21.94,89.7
"2011","Barking and Dagenham 015A","E01000007","Total",1391,707,684,1391,0,0,20.00,69.5
"2011","Barking and Dagenham 015B","E01000008","Total",1544,817,727,1544,0,21,19.51,79.1
"2011","Barking and Dagenham 015C","E01000010","Total",2840,1525,1315,2840,0,30,35.21,80.7
"2011","Barking and Dagenham 015D","E01000012","Total",1901,983,918,1895,6,12,13.90,136.8
"2011","Barking and Dagenham 016A","E01000006","Total",1703,866,837,1699,4,16,14.66,116.2
"2011","Barking and Dagenham 016B","E01000009","Total",1773,999,774,1773,0,23,12.79,138.6
"2011","Barking and Dagenham 016C","E01000011","Total",1634,925,709,1628,6,13,9.17,178.2
"2011","Barking and Dagenham 016D","E01000044","Total",1798,915,883,1793,5,18,17.06,105.4
"2011","Barking and Dagenham 016E","E01000068","Total",1590,819,771,1575,15,19,33.97,46.8
"2011","Barking and Dagenham 017A","E01000041","Total",1682,818,864,1682,0,17,15.26,110.2
"2011","Barking and Dagenham 017B","E01000042","Total",1788,862,926,1786,2,11,23.12,77.3
"2011","Barking and Dagenham 017C","E01000045","Total",1650,802,848,1646,4,10,29.83,55.3
"2011","Barking and Dagenham 017D","E01000046","Total",1779,861,918,1779,0,13,15.55,114.4
"2011","Barking and Dagenham 017E","E01000072","Total",1991,965,1026,1991,0,12,52.02,38.3
"2011","Barking and Dagenham 018A","E01000054","Total",1718,829,889,1718,0,24,17.12,100.4
"2011","Barking and Dagenham 018B","E01000055","Total",1553,758,795,1553,0,13,14.60,106.4
"2011","Barking and Dagenham 018C","E01000056","Total",1584,748,836,1542,42,14,24.36,65.0
"2011","Barking and Dagenham 018D","E01000058","Total",1849,905,944,1849,0,17,18.22,101.5
"2011","Barking and Dagenham 018E","E01000095","Total",1572,757,815,1572,0,10,229.47,6.9
"2011","Barking and Dagenham 019A","E01000040","Total",1569,761,808,1569,0,15,17.07,91.9
"2011","Barking and Dagenham 019B","E01000043","Total",1358,680,678,1356,2,17,26.64,51.0
"2011","Barking and Dagenham 019C","E01000050","Total",1661,865,796,1661,0,14,13.77,120.6
"2011","Barking and Dagenham 019D","E01000052","Total",2014,990,1024,2014,0,15,19.97,100.9
"2011","Barking and Dagenham 019E","E01000092","Total",2674,1339,1335,2674,0,32,264.48,10.1
"2011","Barking and Dagenham 020A","E01000053","Total",1485,688,797,1484,1,15,18.09,82.1
"2011","Barking and Dagenham 020B","E01000087","Total",1341,624,717,1341,0,9,37.25,36.0
"2011","Barking and Dagenham 020C","E01000088","Total",1828,878,950,1723,105,23,22.64,80.7
"2011","Barking and Dagenham 020D","E01000089","Total",1666,838,828,1666,0,12,14.55,114.5
"2011","Barking and Dagenham 020E","E01000090","Total",1584,769,815,1584,0,17,195.51,8.1
"2011","Barking and Dagenham 021B","E01000048","Total",1783,880,903,1783,0,26,6.47,275.6
"2011","Barking and Dagenham 021C","E01000049","Total",1820,946,874,1820,0,14,21.22,85.8
"2011","Barking and Dagenham 021D","E01000051","Total",1927,983,944,1927,0,19,6.67,288.9
"2011","Barking and Dagenham 021E","E01033587","Total",1630,821,809,1573,57,3,26.58,61.3
"2011","Barking and Dagenham 021F","E01033588","Total",1617,779,838,1581,36,12,13.95,115.9
"2011","Barking and Dagenham 022A","E01000091","Total",1714,810,904,1714,0,6,24.62,69.6
"2011","Barking and Dagenham 022B","E01000093","Total",1547,781,766,1547,0,17,29.38,52.7
"2011","Barking and Dagenham 022C","E01000094","Total",1326,663,663,1326,0,8,60.28,22.0
"2011","Barking and Dagenham 022D","E01000096","Total",1895,906,989,1895,0,18,60.24,31.5
"2011","Barking and Dagenham 023A","E01000019","Total",1407,654,753,1407,0,15,18.40,76.5
"2011","Barking and Dagenham 023B","E01000020","Total",1834,914,920,1773,61,23,18.72,98.0
"2011","Barking and Dagenham 023C","E01000097","Total",1683,787,896,1683,0,5,17.92,93.9
"2011","Barking and Dagenham 023D","E01000098","Total",1746,831,915,1746,0,17,17.54,99.5
"2011","Barking and Dagenham 023E","E01000099","Total",1732,812,920,1732,0,10,31.00,55.9
"2011","Barking and Dagenham 023F","E01032580","Total",1354,655,699,1354,0,12,12.79,105.9
"2011","Barnet 001A","E01000248","Total",1661,826,835,1613,48,29,27.08,61.3
"2011","Barnet 001B","E01000249","Total",1525,730,795,1510,15,41,81.29,18.8
"2011","Barnet 001C","E01000250","Total",2232,1071,1161,2219,13,30,58.15,38.4
"2011","Barnet 001D","E01000254","Total",1549,717,832,1497,52,40,152.68,10.1
"2011","Barnet 001E","E01000292","Total",1467,690,777,1460,7,22,28.79,51.0
"2011","Barnet 001F","E01000293","Total",1722,820,902,1670,52,52,27.36,62.9
"2011","Barnet 002A","E01000167","Total",1307,643,664,1307,0,31,60.19,21.7
"2011","Barnet 002B","E01000246","Total",1503,714,789,1498,5,38,107.64,14.0
"2011","Barnet 002C","E01000247","Total",1691,803,888,1691,0,22,26.56,63.7
"2011","Barnet 002D","E01000251","Total",1846,905,941,1824,22,27,22.31,82.7
"2011","Barnet 002E","E01000252","Total",1609,758,851,1609,0,22,23.49,68.5
"2011","Barnet 003A","E01000166","Total",1582,750,832,1582,0,21,36.97,42.8
"2011","Barnet 003B","E01000168","Total",1564,788,776,1559,5,49,31.39,49.8
"2011","Barnet 003C","E01000169","Total",1490,738,752,1485,5,27,23.85,62.5
"2011","Barnet 003D","E01000172","Total",1677,826,851,1650,27,17,54.38,30.8
"2011","Barnet 004A","E01000285","Total",1449,670,779,1443,6,19,20.21,71.7
"2011","Barnet 004B","E01000287","Total",1589,735,854,1580,9,14,27.34,58.1
"2011","Barnet 004C","E01000288","Total",1569,804,765,1565,4,24,33.70,46.6
"2011","Barnet 004D","E01000289","Total",1817,837,980,1817,0,21,28.12,64.6
"2011","Barnet 004E","E01000291","Total",1575,760,815,1574,1,13,24.97,63.1
"2011","Barnet 004F","E01000294","Total",1599,742,857,1520,79,28,33.11,48.3
"2011","Barnet 005A","E01000267","Total",1520,753,767,1520,0,37,27.95,54.4
"2011","Barnet 005B","E01000268","Total",1739,845,894,1680,59,21,25.25,68.9
"2011","Barnet 005C","E01000269","Total",1425,689,736,1425,0,37,27.16,52.5
"2011","Barnet 005D","E01000270","Total",1482,747,735,1482,0,20,25.20,58.8
"2011","Barnet 006A","E01000170","Total",1636,774,862,1626,10,20,29.65,55.2
"2011","Barnet 006B","E01000171","Total",1849,929,920,1849,0,8,33.30,55.5
"2011","Barnet 006C","E01000173","Total",1719,841,878,1719,0,35,36.57,47.0
"2011","Barnet 006D","E01000174","Total",1728,824,904,1728,0,17,18.85,91.7
"2011","Barnet 006E","E01000175","Total",1585,769,816,1585,0,41,50.08,31.6
"2011","Barnet 007A","E01000228","Total",1481,729,752,1481,0,39,288.64,5.1
"2011","Barnet 007B","E01000253","Total",1691,798,893,1610,81,62,331.69,5.1
"2011","Barnet 007C","E01000279","Total",1449,714,735,1446,3,64,504.30,2.9
"2011","Barnet 007D","E01000280","Total",1381,646,735,1381,0,56,101.61,13.6
"2011","Barnet 007E","E01000286","Total",1571,711,860,1538,33,19,26.92,58.4
"2011","Barnet 007F","E01000290","Total",1557,734,823,1557,0,39,204.71,7.6
"2011","Barnet 008A","E01000271","Total",1469,720,749,1461,8,31,34.22,42.9
"2011","Barnet 008B","E01000272","Total",1340,646,694,1266,74,42,46.97,28.5
"2011","Barnet 008C","E01000273","Total",1520,699,821,1497,23,35,32.93,46.2
"2011","Barnet 008D","E01000281","Total",1260,602,658,1221,39,14,26.90,46.8
"2011","Barnet 008E","E01000282","Total",1705,836,869,1705,0,45,52.87,32.2
"2011","Barnet 009A","E01000115","Total",1484,708,776,1460,24,37,27.40,54.2
"2011","Barnet 009B","E01000116","Total",1718,833,885,1718,0,19,24.52,70.1
"2011","Barnet 009C","E01000119","Total",1680,812,868,1680,0,31,39.74,42.3
"2011","Barnet 009D","E01000120","Total",1504,742,762,1504,0,28,24.51,61.4
"2011","Barnet 009E","E01000122","Total",1471,718,753,1463,8,22,23.61,62.3
"2011","Barnet 010A","E01000117","Total",1819,889,930,1819,0,24,33.12,54.9
"2011","Barnet 010B","E01000118","Total",1936,955,981,1936,0,44,28.55,67.8
"2011","Barnet 010C","E01000121","Total",1497,678,819,1398,99,22,37.61,39.8
"2011","Barnet 010D","E01000123","Total",1664,841,823,1664,0,17,52.73,31.6
"2011","Barnet 010E","E01000124","Total",1621,777,844,1621,0,14,25.58,63.4
"2011","Barnet 011A","E01000265","Total",1927,901,1026,1927,0,18,21.08,91.4
"2011","Barnet 011B","E01000266","Total",1527,748,779,1511,16,38,64.23,23.8
"2011","Barnet 011C","E01000274","Total",1862,908,954,1862,0,27,26.72,69.7
"2011","Barnet 011D","E01000320","Total",1475,717,758,1475,0,37,23.33,63.2
"2011","Barnet 011E","E01000322","Total",1717,785,932,1675,42,27,20.46,83.9
"2011","Barnet 012A","E01000275","Total",1637,748,889,1544,93,31,33.11,49.4
"2011","Barnet 012B","E01000277","Total",1591,740,851,1561,30,8,18.50,86.0
"2011","Barnet 012C","E01000283","Total",1430,690,740,1430,0,47,33.04,43.3
"2011","Barnet 012D","E01000284","Total",1672,806,866,1671,1,13,27.60,60.6
"2011","Barnet 012E","E01000321","Total",1635,811,824,1577,58,17,17.51,93.4
"2011","Barnet 013A","E01000195","Total",1788,860,928,1788,0,24,31.52,56.7
"2011","Barnet 013B","E01000229","Total",1667,814,853,1667,0,25,28.00,59.5
"2011","Barnet 013C","E01000230","Total",1785,846,939,1757,28,40,27.14,65.8
"2011","Barnet 013D","E01000231","Total",1849,892,957,1849,0,28,36.50,50.7
"2011","Barnet 013E","E01000232","Total",1837,910,927,1811,26,41,29.84,61.6
"2011","Barnet 013F","E01000233","Total",1817,893,924,1817,0,25,26.47,68.6
"2011","Barnet 014A","E01000186","Total",1612,770,842,1612,0,44,25.49,63.2
"2011","Barnet 014B","E01000187","Total",1657,820,837,1657,0,25,21.57,76.8
"2011","Barnet 014C","E01000188","Total",1554,782,772,1554,0,54,318.92,4.9
"2011","Barnet 014D","E01000189","Total",1814,818,996,1814,0,15,16.21,111.9
"2011","Barnet 014E","E01000190","Total",1579,753,826,1579,0,31,24.82,63.6
"2011","Barnet 014F","E01000191","Total",1525,746,779,1525,0,32,25.43,60.0
"2011","Barnet 015A","E01000158","Total",1470,699,771,1455,15,14,27.04,54.4
"2011","Barnet 015B","E01000159","Total",1777,852,925,1777,0,36,49.34,36.0
"2011","Barnet 015C","E01000160","Total",2061,1057,1004,2037,24,17,30.25,68.1
"2011","Barnet 015D","E01000161","Total",1821,945,876,1752,69,23,24.25,75.1
"2011","Barnet 015E","E01000162","Total",1599,785,814,1502,97,35,18.23,87.7
"2011","Barnet 015F","E01000324","Total",1786,882,904,1762,24,33,27.14,65.8
"2011","Barnet 016A","E01000256","Total",1788,857,931,1788,0,41,56.19,31.8
"2011","Barnet 016B","E01000258","Total",1658,806,852,1658,0,40,79.81,20.8
"2011","Barnet 016C","E01000263","Total",1581,749,832,1581,0,58,39.42,40.1
"2011","Barnet 016D","E01000264","Total",1648,846,802,1648,0,39,37.78,43.6
"2011","Barnet 017A","E01000255","Total",1481,714,767,1481,0,30,106.83,13.9
"2011","Barnet 017B","E01000257","Total",1855,827,1028,1855,0,21,68.00,27.3
"2011","Barnet 017C","E01000261","Total",1601,772,829,1513,88,54,119.72,13.4
"2011","Barnet 017D","E01000262","Total",2260,1097,1163,2245,15,45,220.96,10.2
"2011","Barnet 018A","E01000192","Total",1850,913,937,1850,0,44,28.40,65.1
"2011","Barnet 018B","E01000193","Total",1709,844,865,1709,0,32,30.40,56.2
"2011","Barnet 018C","E01000194","Total",1640,827,813,1640,0,21,33.24,49.3
"2011","Barnet 018D","E01000226","Total",1758,873,885,1758,0,19,17.30,101.6
"2011","Barnet 018E","E01000227","Total",1854,889,965,1805,49,37,25.58,72.5
"2011","Barnet 019A","E01000299","Total",1809,871,938,1782,27,14,16.51,109.6
"2011","Barnet 019B","E01000300","Total",1632,806,826,1632,0,24,17.35,94.1
"2011","Barnet 019C","E01000302","Total",1763,844,919,1728,35,8,21.69,81.3
"2011","Barnet 019D","E01000317","Total",1613,803,810,1580,33,29,17.06,94.5
"2011","Barnet 019E","E01000318","Total",1840,904,936,1820,20,36,27.23,67.6
"2011","Barnet 019F","E01000323","Total",1982,1013,969,1916,66,16,21.41,92.6
"2011","Barnet 020A","E01000276","Total",1520,728,792,1520,0,38,51.28,29.6
"2011","Barnet 020B","E01000278","Total",1514,753,761,1514,0,23,27.53,55.0
"2011","Barnet 020C","E01000301","Total",1539,733,806,1508,31,27,28.72,53.6
"2011","Barnet 020D","E01000303","Total",1567,745,822,1542,25,26,21.65,72.4
"2011","Barnet 020E","E01000304","Total",1556,769,787,1532,24,25,17.76,87.6
"2011","Barnet 021A","E01000130","Total",1603,736,867,1603,0,24,17.12,93.6
"2011","Barnet 021B","E01000132","Total",1478,692,786,1478,0,30,15.35,96.3
"2011","Barnet 021C","E01000133","Total",1601,744,857,1601,0,18,15.56,102.9
"2011","Barnet 021D","E01000234","Total",1701,792,909,1701,0,31,27.63,61.6
"2011","Barnet 021E","E01000235","Total",1688,808,880,1688,0,20,35.08,48.1
"2011","Barnet 022A","E01000156","Total",1875,903,972,1875,0,28,18.00,104.2
"2011","Barnet 022B","E01000157","Total",1541,742,799,1541,0,17,12.59,122.4
"2011","Barnet 022C","E01000163","Total",1558,763,795,1547,11,14,19.14,81.4
"2011","Barnet 022D","E01000164","Total",1686,822,864,1686,0,19,54.70,30.8
"2011","Barnet 022E","E01000165","Total",1862,949,913,1862,0,18,18.52,100.5
"2011","Barnet 022F","E01000315","Total",1715,823,892,1715,0,23,50.55,33.9
"2011","Barnet 023A","E01000197","Total",1830,908,922,1827,3,19,27.70,66.1
"2011","Barnet 023B","E01000295","Total",1714,819,895,1703,11,22,20.42,83.9
"2011","Barnet 023C","E01000296","Total",1707,837,870,1707,0,29,22.21,76.9
"2011","Barnet 023D","E01000298","Total",1812,881,931,1763,49,16,26.60,68.1
"2011","Barnet 024A","E01000125","Total",2779,1335,1444,2690,89,23,30.77,90.3
"2011","Barnet 024B","E01000127","Total",1505,697,808,1505,0,8,20.06,75.0
"2011","Barnet 024C","E01000128","Total",1869,903,966,1869,0,36,24.68,75.7
"2011","Barnet 024D","E01000129","Total",1782,839,943,1715,67,7,17.18,103.7
"2011","Barnet 024E","E01000131","Total",1806,888,918,1796,10,13,33.61,53.7
"2011","Barnet 024F","E01000134","Total",1632,774,858,1632,0,15,15.94,102.4
"2011","Barnet 025A","E01000198","Total",1893,941,952,1893,0,36,32.93,57.5
"2011","Barnet 025B","E01000199","Total",1617,754,863,1617,0,29,33.81,47.8
"2011","Barnet 025C","E01000204","Total",1728,837,891,1728,0,47,31.65,54.6
"2011","Barnet 025D","E01000259","Total",2597,1238,1359,2597,0,46,128.40,20.2
"2011","Barnet 025E","E01000260","Total",1982,943,1039,1982,0,29,81.63,24.3
"2011","Barnet 026A","E01000126","Total",2162,1002,1160,2162,0,28,16.14,134.0
"2011","Barnet 026B","E01000151","Total",1711,840,871,1711,0,12,14.22,120.3
"2011","Barnet 026C","E01000152","Total",1729,793,936,1729,0,31,18.49,93.5
"2011","Barnet 026D","E01000153","Total",1541,703,838,1541,0,19,16.50,93.4
"2011","Barnet 026E","E01000154","Total",1360,664,696,1360,0,17,13.49,100.8
"2011","Barnet 027A","E01000176","Total",1613,747,866,1605,8,11,21.97,73.4
"2011","Barnet 027B","E01000178","Total",1791,861,930,1791,0,27,41.75,42.9
"2011","Barnet 027C","E01000184","Total",1414,693,721,1414,0,13,68.60,20.6
"2011","Barnet 027D","E01000297","Total",1434,711,723,1430,4,17,23.19,61.8
"2011","Barnet 027E","E01000316","Total",2312,1117,1195,2312,0,34,40.64,56.9
"2011","Barnet 027F","E01000319","Total",1500,734,766,1500,0,22,15.90,94.3
"2011","Barnet 028A","E01000196","Total",1802,866,936,1802,0,10,24.58,73.3
"2011","Barnet 028B","E01000200","Total",1845,883,962,1839,6,38,27.80,66.4
"2011","Barnet 028C","E01000201","Total",1531,740,791,1531,0,68,39.36,38.9
"2011","Barnet 028D","E01000202","Total",1751,848,903,1751,0,47,22.60,77.5
"2011","Barnet 028E","E01000203","Total",1718,831,887,1646,72,40,30.53,56.3
"2011","Barnet 029A","E01000177","Total",1628,790,838,1628,0,21,16.87,96.5
"2011","Barnet 029B","E01000179","Total",1614,788,826,1614,0,10,14.38,112.2
"2011","Barnet 029C","E01000180","Total",1607,726,881,1607,0,23,17.07,94.1
"2011","Barnet 029D","E01000181","Total",1711,845,866,1711,0,24,14.31,119.6
"2011","Barnet 029E","E01000182","Total",1691,850,841,1691,0,29,21.93,77.1
"2011","Barnet 029F","E01000185","Total",1447,696,751,1447,0,22,12.36,117.1
"2011","Barnet 030A","E01000147","Total",1734,874,860,1732,2,25,20.23,85.7
"2011","Barnet 030B","E01000148","Total",1873,965,908,1858,15,22,23.41,80.0
"2011","Barnet 030D","E01000155","Total",1880,966,914,1880,0,10,29.05,64.7
"2011","Barnet 030E","E01033572","Total",1588,842,746,1588,0,38,68.32,23.2
"2011","Barnet 030F","E01033573","Total",1622,773,849,1192,430,39,14.01,115.8
"2011","Barnet 031A","E01000239","Total",1970,963,1007,1970,0,23,42.95,45.9
"2011","Barnet 031B","E01000240","Total",1670,830,840,1670,0,29,44.08,37.9
"2011","Barnet 031C","E01000241","Total",1744,857,887,1744,0,34,33.97,51.3
"2011","Barnet 031D","E01000309","Total",1822,902,920,1791,31,26,29.02,62.8
"2011","Barnet 032A","E01000237","Total",2038,1029,1009,2038,0,41,32.45,62.8
"2011","Barnet 032B","E01000242","Total",1656,793,863,1592,64,35,27.64,59.9
"2011","Barnet 032C","E01000243","Total",1884,967,917,1884,0,18,18.36,102.6
"2011","Barnet 032D","E01000244","Total",1705,845,860,1532,173,18,22.37,76.2
"2011","Barnet 032E","E01000245","Total",1982,980,1002,1982,0,19,18.11,109.4
"2011","Barnet 032F","E01000314","Total",1865,900,965,1865,0,32,25.09,74.3
"2011","Barnet 033A","E01000183","Total",1473,687,786,1392,81,13,23.12,63.7
"2011","Barnet 033B","E01000206","Total",1576,724,852,1490,86,52,132.12,11.9
"2011","Barnet 033C","E01000207","Total",1583,761,822,1583,0,40,34.68,45.6
"2011","Barnet 033D","E01000208","Total",1594,773,821,1591,3,43,40.69,39.2
"2011","Barnet 033E","E01000210","Total",1548,713,835,1548,0,43,49.63,31.2
"2011","Barnet 033F","E01000213","Total",1438,661,777,1438,0,54,42.47,33.9
"2011","Barnet 034A","E01000236","Total",1860,895,965,1860,0,44,22.94,81.1
"2011","Barnet 034B","E01000238","Total",1963,977,986,1961,2,42,21.13,92.9
"2011","Barnet 034C","E01000310","Total",2029,1014,1015,1984,45,29,30.48,66.6
"2011","Barnet 034D","E01000311","Total",1632,811,821,1632,0,29,34.90,46.8
"2011","Barnet 035A","E01000205","Total",1522,719,803,1522,0,27,38.04,40.0
"2011","Barnet 035B","E01000209","Total",1563,701,862,1550,13,31,40.13,38.9
"2011","Barnet 035C","E01000211","Total",2014,940,1074,2014,0,6,27.42,73.5
"2011","Barnet 035D","E01000212","Total",1428,653,775,1428,0,33,34.78,41.1
"2011","Barnet 035E","E01000216","Total",1968,917,1051,1947,21,58,19.50,100.9
"2011","Barnet 035F","E01000217","Total",1725,875,850,1716,9,79,21.46,80.4
"2011","Barnet 036A","E01000150","Total",2060,1006,1054,2056,4,43,46.47,44.3
"2011","Barnet 036B","E01000305","Total",1657,829,828,1651,6,8,68.86,24.1
"2011","Barnet 036C","E01000306","Total",1696,872,824,1696,0,13,14.66,115.7
"2011","Barnet 036D","E01000308","Total",1516,718,798,1516,0,17,52.89,28.7
"2011","Barnet 036E","E01000312","Total",1672,811,861,1672,0,9,14.66,114.1
"2011","Barnet 036F","E01000313","Total",1858,953,905,1851,7,9,21.82,85.2
"2011","Barnet 037A","E01000145","Total",1517,751,766,1473,44,57,20.71,73.2
"2011","Barnet 037B","E01000215","Total",2033,988,1045,2033,0,52,21.88,92.9
"2011","Barnet 037C","E01000218","Total",1818,903,915,1798,20,64,15.17,119.8
"2011","Barnet 037D","E01000219","Total",1905,945,960,1897,8,60,19.12,99.6
"2011","Barnet 037E","E01000220","Total",1871,917,954,1731,140,36,15.33,122.0
"2011","Barnet 037F","E01000225","Total",1776,860,916,1761,15,63,31.06,57.2
"2011","Barnet 038A","E01000135","Total",1564,741,823,1493,71,43,33.07,47.3
"2011","Barnet 038B","E01000136","Total",1532,739,793,1466,66,47,52.05,29.4
"2011","Barnet 038C","E01000144","Total",1538,774,764,1538,0,33,19.81,77.6
"2011","Barnet 038D","E01000146","Total",1716,842,874,1715,1,26,20.66,83.1
"2011","Barnet 038E","E01000214","Total",1663,822,841,1663,0,30,33.13,50.2
"2011","Barnet 039A","E01000141","Total",2104,1033,1071,2081,23,14,37.05,56.8
"2011","Barnet 039B","E01000221","Total",1294,617,677,1279,15,11,42.17,30.7
"2011","Barnet 039C","E01000223","Total",1287,614,673,1287,0,21,54.45,23.6
"2011","Barnet 039D","E01000307","Total",1655,827,828,1655,0,14,50.18,33.0
"2011","Barnet 040A","E01000138","Total",1449,690,759,1449,0,17,26.15,55.4
"2011","Barnet 040B","E01000142","Total",2381,1166,1215,2296,85,28,19.94,119.4
"2011","Barnet 040C","E01000222","Total",1582,788,794,1582,0,13,41.60,38.0
"2011","Barnet 040D","E01000224","Total",1559,806,753,1559,0,28,16.05,97.1
"2011","Barnet 041A","E01000137","Total",1729,816,913,1644,85,20,12.28,140.8
"2011","Barnet 041B","E01000139","Total",1429,701,728,1427,2,46,35.10,40.7
"2011","Barnet 041C","E01000140","Total",1631,774,857,1606,25,19,14.61,111.6
"2011","Barnet 041D","E01000143","Total",1459,723,736,1339,120,15,17.45,83.6
"2011","Bexley 001A","E01000466","Total",1655,823,832,1641,14,24,236.02,7.0
"2011","Bexley 001B","E01000467","Total",1634,765,869,1634,0,21,17.18,95.1
"2011","Bexley 001C","E01000468","Total",2723,1299,1424,2723,0,44,29.33,92.8
"2011","Bexley 001D","E01000469","Total",1654,821,833,1654,0,32,37.96,43.6
"2011","Bexley 002A","E01000416","Total",1547,741,806,1505,42,18,17.85,86.7
"2011","Bexley 002B","E01000418","Total",1937,914,1023,1937,0,21,51.55,37.6
"2011","Bexley 002C","E01000422","Total",1729,825,904,1729,0,26,10.42,165.9
"2011","Bexley 002D","E01000464","Total",1443,677,766,1443,0,23,14.54,99.2
"2011","Bexley 002E","E01000465","Total",1542,776,766,1542,0,14,26.84,57.5
"2011","Bexley 002F","E01000470","Total",1443,660,783,1443,0,21,36.09,40.0
"2011","Bexley 003A","E01000333","Total",1666,769,897,1653,13,16,29.07,57.3
"2011","Bexley 003B","E01000335","Total",1794,847,947,1794,0,13,139.44,12.9
"2011","Bexley 003C","E01000336","Total",1886,911,975,1886,0,17,18.08,104.3
"2011","Bexley 003D","E01000337","Total",1653,793,860,1653,0,16,27.47,60.2
"2011","Bexley 003E","E01000338","Total",1751,886,865,1751,0,15,17.32,101.1
"2011","Bexley 004A","E01000403","Total",2108,965,1143,2108,0,23,62.63,33.7
"2011","Bexley 004B","E01000404","Total",2234,1119,1115,2234,0,14,17.01,131.3
"2011","Bexley 004C","E01000405","Total",1410,706,704,1410,0,22,38.75,36.4
"2011","Bexley 004D","E01000408","Total",1636,808,828,1636,0,7,108.78,15.0
"2011","Bexley 005A","E01000332","Total",1529,708,821,1529,0,16,27.82,55.0
"2011","Bexley 005B","E01000402","Total",1536,743,793,1525,11,21,31.19,49.2
"2011","Bexley 005C","E01000406","Total",1649,826,823,1649,0,13,42.87,38.5
"2011","Bexley 005D","E01000407","Total",1480,714,766,1441,39,13,43.25,34.2
"2011","Bexley 006A","E01000334","Total",1611,749,862,1611,0,13,26.50,60.8
"2011","Bexley 006B","E01000417","Total",1639,809,830,1639,0,24,74.53,22.0
"2011","Bexley 006C","E01000419","Total",1461,702,759,1461,0,15,26.37,55.4
"2011","Bexley 006D","E01000420","Total",1551,758,793,1551,0,13,27.45,56.5
"2011","Bexley 006E","E01000442","Total",1613,770,843,1613,0,28,30.74,52.5
"2011","Bexley 007A","E01000437","Total",1322,618,704,1322,0,13,26.62,49.7
"2011","Bexley 007B","E01000438","Total",1599,802,797,1599,0,17,18.31,87.3
"2011","Bexley 007C","E01000439","Total",1368,681,687,1368,0,4,25.22,54.2
"2011","Bexley 007D","E01000440","Total",1413,684,729,1413,0,24,24.17,58.5
"2011","Bexley 007E","E01000441","Total",1598,746,852,1598,0,17,23.55,67.9
"2011","Bexley 008A","E01000373","Total",1574,752,822,1574,0,20,8.90,176.9
"2011","Bexley 008B","E01000429","Total",1639,825,814,1639,0,15,31.01,52.9
"2011","Bexley 008C","E01000430","Total",1782,879,903,1782,0,26,151.01,11.8
"2011","Bexley 008D","E01000431","Total",1672,808,864,1664,8,12,14.65,114.1
"2011","Bexley 008E","E01000432","Total",1673,789,884,1673,0,9,46.10,36.3
"2011","Bexley 008F","E01000433","Total",1810,857,953,1810,0,14,31.10,58.2
"2011","Bexley 008G","E01000434","Total",1584,710,874,1584,0,18,154.76,10.2
"2011","Bexley 009A","E01000356","Total",1546,763,783,1546,0,17,30.94,50.0
"2011","Bexley 009B","E01000357","Total",1457,706,751,1457,0,29,20.15,72.3
"2011","Bexley 009C","E01000359","Total",1280,629,651,1280,0,16,20.38,62.8
"2011","Bexley 009D","E01000421","Total",1482,703,779,1482,0,24,28.85,51.4
"2011","Bexley 009E","E01000450","Total",1832,879,953,1832,0,22,22.92,79.9
"2011","Bexley 009F","E01000451","Total",1699,819,880,1699,0,14,20.83,81.6
"2011","Bexley 009G","E01000452","Total",1428,704,724,1428,0,13,15.93,89.6
"2011","Bexley 010A","E01000367","Total",1575,739,836,1528,47,8,26.19,60.1
"2011","Bexley 010B","E01000368","Total",1539,701,838,1539,0,15,23.77,64.7
"2011","Bexley 010C","E01000372","Total",1680,790,890,1645,35,9,22.93,73.3
"2011","Bexley 010D","E01000380","Total",1455,677,778,1455,0,6,22.48,64.7
"2011","Bexley 010E","E01000435","Total",1406,669,737,1406,0,12,17.53,80.2
"2011","Bexley 011A","E01000353","Total",1686,840,846,1686,0,33,33.78,49.9
"2011","Bexley 011B","E01000354","Total",1505,698,807,1505,0,14,20.53,73.3
"2011","Bexley 011C","E01000355","Total",1464,713,751,1436,28,20,42.05,34.8
"2011","Bexley 011D","E01000358","Total",1608,776,832,1608,0,23,29.45,54.6
"2011","Bexley 011E","E01000436","Total",1685,838,847,1685,0,18,27.71,60.8
"2011","Bexley 013A","E01000401","Total",1647,767,880,1584,63,18,26.98,61.0
"2011","Bexley 013B","E01000453","Total",1472,725,747,1472,0,20,21.03,70.0
"2011","Bexley 013C","E01000454","Total",1572,740,832,1572,0,16,20.53,76.6
"2011","Bexley 013D","E01000455","Total",1705,814,891,1705,0,10,26.30,64.8
"2011","Bexley 013E","E01000456","Total",1427,702,725,1427,0,24,16.88,84.5
"2011","Bexley 014A","E01000325","Total",1610,784,826,1610,0,21,39.13,41.1
"2011","Bexley 014B","E01000326","Total",1295,612,683,1295,0,7,27.33,47.4
"2011","Bexley 014C","E01000369","Total",1618,797,821,1618,0,20,26.61,60.8
"2011","Bexley 014D","E01000370","Total",1597,789,808,1597,0,21,32.57,49.0
"2011","Bexley 014E","E01000371","Total",1545,736,809,1545,0,7,23.14,66.8
"2011","Bexley 015A","E01000360","Total",1662,821,841,1580,82,14,43.97,37.8
"2011","Bexley 015B","E01000362","Total",1482,696,786,1482,0,22,39.44,37.6
"2011","Bexley 015C","E01000365","Total",1678,761,917,1612,66,21,34.10,49.2
"2011","Bexley 015D","E01000366","Total",1585,756,829,1581,4,21,23.58,67.2
"2011","Bexley 015E","E01000394","Total",1458,694,764,1458,0,13,23.70,61.5
"2011","Bexley 016A","E01000388","Total",1531,742,789,1531,0,25,53.00,28.9
"2011","Bexley 016B","E01000392","Total",1646,763,883,1646,0,16,22.09,74.5
"2011","Bexley 016C","E01000409","Total",1649,800,849,1649,0,10,22.66,72.8
"2011","Bexley 016D","E01000411","Total",1398,654,744,1398,0,21,19.11,73.2
"2011","Bexley 016E","E01000414","Total",1708,842,866,1708,0,16,29.45,58.0
"2011","Bexley 016F","E01000415","Total",1498,745,753,1498,0,29,22.85,65.6
"2011","Bexley 017A","E01000327","Total",1543,752,791,1543,0,21,39.19,39.4
"2011","Bexley 017B","E01000328","Total",1480,739,741,1470,10,22,54.33,27.2
"2011","Bexley 017C","E01000329","Total",1316,625,691,1299,17,12,48.11,27.4
"2011","Bexley 017D","E01000330","Total",1544,714,830,1544,0,20,25.51,60.5
"2011","Bexley 017E","E01000331","Total",1630,823,807,1630,0,9,53.42,30.5
"2011","Bexley 018A","E01000340","Total",1502,736,766,1502,0,12,23.25,64.6
"2011","Bexley 018B","E01000395","Total",1428,708,720,1428,0,17,32.12,44.5
"2011","Bexley 018C","E01000396","Total",1399,689,710,1399,0,14,21.91,63.9
"2011","Bexley 018D","E01000410","Total",1568,750,818,1568,0,22,27.26,57.5
"2011","Bexley 018E","E01000412","Total",1678,817,861,1678,0,12,24.53,68.4
"2011","Bexley 018F","E01000413","Total",1301,638,663,1301,0,11,20.69,62.9
"2011","Bexley 019A","E01000374","Total",1533,747,786,1533,0,7,74.36,20.6
"2011","Bexley 019B","E01000375","Total",1476,726,750,1476,0,12,42.92,34.4
"2011","Bexley 019C","E01000376","Total",1541,731,810,1541,0,18,54.99,28.0
"2011","Bexley 019D","E01000377","Total",1420,701,719,1420,0,15,43.05,33.0
"2011","Bexley 019E","E01000378","Total",2121,1058,1063,2100,21,22,126.18,16.8
"2011","Bexley 019F","E01000379","Total",1680,820,860,1680,0,13,32.42,51.8
"2011","Bexley 020A","E01000348","Total",1481,755,726,1481,0,25,29.34,50.5
"2011","Bexley 020B","E01000349","Total",1659,802,857,1659,0,24,33.33,49.8
"2011","Bexley 020C","E01000361","Total",1540,784,756,1540,0,29,28.53,54.0
"2011","Bexley 020D","E01000363","Total",1441,705,736,1441,0,26,41.86,34.4
"2011","Bexley 020E","E01000389","Total",1649,805,844,1649,0,19,44.22,37.3
"2011","Bexley 020F","E01000390","Total",1290,627,663,1284,6,13,54.46,23.7
"2011","Bexley 020G","E01000393","Total",1581,779,802,1581,0,20,27.62,57.2
"2011","Bexley 021A","E01000346","Total",1622,800,822,1622,0,15,34.80,46.6
"2011","Bexley 021B","E01000347","Total",1486,692,794,1486,0,8,19.65,75.6
"2011","Bexley 021C","E01000350","Total",1501,743,758,1501,0,11,26.94,55.7
"2011","Bexley 021D","E01000352","Total",1575,731,844,1575,0,15,34.43,45.7
"2011","Bexley 021E","E01000391","Total",1709,799,910,1709,0,21,46.53,36.7
"2011","Bexley 022A","E01000341","Total",1490,735,755,1485,5,14,24.30,61.3
"2011","Bexley 022B","E01000342","Total",1595,763,832,1595,0,10,21.88,72.9
"2011","Bexley 022C","E01000343","Total",1535,752,783,1535,0,7,30.29,50.7
"2011","Bexley 022D","E01000345","Total",1355,654,701,1355,0,22,20.77,65.2
"2011","Bexley 022E","E01000460","Total",1353,680,673,1353,0,30,51.61,26.2
"2011","Bexley 023A","E01000364","Total",1577,782,795,1577,0,20,43.27,36.4
"2011","Bexley 023B","E01000444","Total",1637,802,835,1631,6,28,137.97,11.9
"2011","Bexley 023C","E01000447","Total",1535,744,791,1534,1,14,99.16,15.5
"2011","Bexley 023D","E01000448","Total",1335,668,667,1335,0,27,45.55,29.3
"2011","Bexley 023E","E01000449","Total",1495,720,775,1482,13,19,45.66,32.7
"2011","Bexley 024A","E01000351","Total",1586,766,820,1586,0,17,31.26,50.7
"2011","Bexley 024B","E01000443","Total",1276,627,649,1276,0,9,27.38,46.6
"2011","Bexley 024C","E01000445","Total",1641,825,816,1641,0,15,59.12,27.8
"2011","Bexley 024D","E01000446","Total",1572,749,823,1572,0,16,28.01,56.1
"2011","Bexley 024E","E01000461","Total",1662,823,839,1662,0,36,54.11,30.7
"2011","Bexley 025A","E01000339","Total",1530,735,795,1530,0,17,25.52,60.0
"2011","Bexley 025B","E01000344","Total",1609,774,835,1609,0,13,22.64,71.1
"2011","Bexley 025C","E01000423","Total",1638,786,852,1625,13,21,28.32,57.8
"2011","Bexley 025D","E01000425","Total",1752,834,918,1617,135,25,36.69,47.8
"2011","Bexley 025E","E01000463","Total",1254,608,646,1254,0,16,23.59,53.2
"2011","Bexley 026A","E01000424","Total",1693,820,873,1628,65,25,38.56,43.9
"2011","Bexley 026B","E01000426","Total",1675,822,853,1675,0,23,25.61,65.4
"2011","Bexley 026C","E01000427","Total",1932,852,1080,1932,0,16,40.72,47.4
"2011","Bexley 026D","E01000457","Total",1783,787,996,1703,80,13,29.77,59.9
"2011","Bexley 026E","E01000462","Total",1643,740,903,1531,112,17,46.30,35.5
"2011","Bexley 027A","E01000382","Total",1524,747,777,1524,0,27,58.49,26.1
"2011","Bexley 027B","E01000384","Total",1722,809,913,1722,0,17,29.98,57.4
"2011","Bexley 027C","E01000387","Total",1535,726,809,1535,0,13,30.74,49.9
"2011","Bexley 027D","E01000428","Total",1752,768,984,1627,125,15,89.29,19.6
"2011","Bexley 027E","E01000458","Total",1462,689,773,1459,3,27,33.84,43.2
"2011","Bexley 027F","E01000459","Total",1687,801,886,1675,12,16,31.01,54.4
"2011","Bexley 028A","E01000381","Total",1598,758,840,1579,19,14,205.66,7.8
"2011","Bexley 028B","E01000383","Total",1505,724,781,1505,0,15,278.61,5.4
"2011","Bexley 028C","E01000385","Total",1866,875,991,1866,0,11,59.74,31.2
"2011","Bexley 028D","E01000386","Total",1457,643,814,1457,0,8,55.17,26.4
"2011","Bexley 029A","E01000398","Total",1599,779,820,1599,0,8,23.37,68.4
"2011","Bexley 029B","E01000399","Total",1554,736,818,1554,0,12,29.16,53.3
"2011","Bexley 029C","E01000400","Total",1547,754,793,1547,0,25,28.19,54.9
"2011","Bexley 029D","E01032566","Total",1684,804,880,1684,0,17,55.37,30.4
"2011","Brent 001A","E01000587","Total",1708,848,860,1653,55,16,19.80,86.3
"2011","Brent 001B","E01000589","Total",1932,956,976,1884,48,20,29.08,66.4
"2011","Brent 001C","E01000590","Total",1789,863,926,1789,0,21,26.69,67.0
"2011","Brent 001D","E01000592","Total",1622,826,796,1618,4,16,19.80,81.9
"2011","Brent 001E","E01000593","Total",2134,1053,1081,2134,0,25,18.07,118.1
"2011","Brent 001F","E01000594","Total",1698,858,840,1698,0,11,24.29,69.9
"2011","Brent 002A","E01000513","Total",1693,849,844,1638,55,26,16.80,100.8
"2011","Brent 002B","E01000514","Total",1512,789,723,1512,0,7,15.69,96.4
"2011","Brent 002C","E01000516","Total",1707,881,826,1691,16,23,24.60,69.4
"2011","Brent 002D","E01000520","Total",1637,824,813,1602,35,16,24.27,67.4
"2011","Brent 002E","E01000588","Total",2197,1045,1152,2197,0,36,35.01,62.8
"2011","Brent 003A","E01000515","Total",1702,823,879,1698,4,16,38.22,44.5
"2011","Brent 003B","E01000517","Total",1609,789,820,1609,0,19,22.94,70.1
"2011","Brent 003E","E01000543","Total",1596,820,776,1596,0,15,19.61,81.4
"2011","Brent 003F","E01000591","Total",2075,1057,1018,2075,0,30,32.25,64.3
"2011","Brent 003G","E01033463","Total",2939,1456,1483,2805,134,41,41.85,70.2
"2011","Brent 004A","E01000536","Total",1573,789,784,1561,12,36,33.35,47.2
"2011","Brent 004B","E01000538","Total",1582,777,805,1554,28,48,39.86,39.7
"2011","Brent 004C","E01000539","Total",1541,755,786,1541,0,26,28.44,54.2
"2011","Brent 004D","E01000540","Total",1496,733,763,1477,19,34,37.55,39.8
"2011","Brent 004E","E01000541","Total",1406,691,715,1402,4,19,24.35,57.7
"2011","Brent 005A","E01000518","Total",1662,859,803,1662,0,30,50.03,33.2
"2011","Brent 005B","E01000519","Total",1923,975,948,1923,0,24,73.29,26.2
"2011","Brent 005C","E01000623","Total",1772,909,863,1772,0,27,19.13,92.6
"2011","Brent 005D","E01000624","Total",1690,819,871,1690,0,15,26.37,64.1
"2011","Brent 005E","E01000629","Total",1911,997,914,1911,0,22,18.31,104.4
"2011","Brent 006A","E01000480","Total",1749,897,852,1741,8,30,29.79,58.7
"2011","Brent 006B","E01000484","Total",1228,594,634,1228,0,24,31.17,39.4
"2011","Brent 006C","E01000485","Total",1375,691,684,1371,4,20,17.76,77.4
"2011","Brent 006D","E01000486","Total",1702,895,807,1702,0,23,74.44,22.9
"2011","Brent 006E","E01000487","Total",1890,963,927,1875,15,37,30.70,61.6
"2011","Brent 007A","E01000572","Total",1481,738,743,1481,0,20,21.53,68.8
"2011","Brent 007B","E01000573","Total",1596,767,829,1591,5,17,23.57,67.7
"2011","Brent 007C","E01000574","Total",1355,677,678,1355,0,17,22.04,61.5
"2011","Brent 007D","E01000575","Total",1855,943,912,1855,0,17,26.98,68.8
"2011","Brent 007E","E01000577","Total",2420,1164,1256,2369,51,24,34.61,69.9
"2011","Brent 008A","E01000562","Total",1548,755,793,1543,5,52,31.23,49.6
"2011","Brent 008B","E01000563","Total",1480,757,723,1480,0,31,37.51,39.5
"2011","Brent 008C","E01000566","Total",1535,775,760,1531,4,23,20.89,73.5
"2011","Brent 008D","E01000568","Total",2260,1031,1229,1599,661,25,80.54,28.1
"2011","Brent 008E","E01000569","Total",1565,774,791,1565,0,39,37.68,41.5
"2011","Brent 009A","E01000479","Total",1659,828,831,1620,39,30,31.41,52.8
"2011","Brent 009B","E01000481","Total",1538,776,762,1538,0,20,25.44,60.5
"2011","Brent 009C","E01000482","Total",2886,1430,1456,2790,96,31,34.20,84.4
"2011","Brent 009D","E01000483","Total",1745,873,872,1745,0,23,22.57,77.3
"2011","Brent 009E","E01000625","Total",1504,734,770,1469,35,17,26.76,56.2
"2011","Brent 010B","E01000498","Total",1680,840,840,1680,0,14,28.46,59.0
"2011","Brent 010D","E01000622","Total",1585,778,807,1585,0,4,62.61,25.3
"2011","Brent 010E","E01000626","Total",1500,703,797,1500,0,9,20.74,72.3
"2011","Brent 010F","E01033464","Total",3022,1491,1531,3018,4,37,24.12,125.3
"2011","Brent 011A","E01000497","Total",1756,855,901,1756,0,17,30.19,58.2
"2011","Brent 011B","E01000499","Total",1732,876,856,1732,0,17,52.78,32.8
"2011","Brent 011C","E01000501","Total",1874,903,971,1874,0,16,16.06,116.7
"2011","Brent 011D","E01000502","Total",1393,689,704,1375,18,22,37.64,37.0
"2011","Brent 011E","E01000503","Total",1968,988,980,1968,0,22,40.53,48.6
"2011","Brent 012A","E01000570","Total",1579,783,796,1578,1,17,13.34,118.4
"2011","Brent 012B","E01000571","Total",1707,884,823,1666,41,27,35.17,48.5
"2011","Brent 012C","E01000576","Total",1660,835,825,1660,0,30,29.25,56.8
"2011","Brent 012D","E01000578","Total",1821,929,892,1761,60,23,33.02,55.1
"2011","Brent 013A","E01000564","Total",1570,853,717,1557,13,24,20.27,77.5
"2011","Brent 013B","E01000565","Total",1473,757,716,1467,6,15,18.56,79.4
"2011","Brent 013C","E01000607","Total",2223,1160,1063,2214,9,16,19.63,113.2
"2011","Brent 013D","E01000608","Total",2263,1176,1087,2263,0,22,56.77,39.9
"2011","Brent 013E","E01000613","Total",1673,863,810,1659,14,17,21.77,76.8
"2011","Brent 014A","E01000506","Total",1671,831,840,1671,0,6,29.39,56.9
"2011","Brent 014B","E01000509","Total",1453,754,699,1453,0,4,12.97,112.0
"2011","Brent 014C","E01000510","Total",1673,871,802,1673,0,16,17.59,95.1
"2011","Brent 014D","E01000511","Total",1629,792,837,1629,0,19,16.84,96.7
"2011","Brent 014E","E01000627","Total",1900,931,969,1900,0,9,22.07,86.1
"2011","Brent 014F","E01000628","Total",1891,947,944,1882,9,22,35.25,53.6
"2011","Brent 015A","E01000553","Total",2100,1093,1007,2096,4,5,14.23,147.6
"2011","Brent 015B","E01000554","Total",1857,929,928,1857,0,11,21.67,85.7
"2011","Brent 015C","E01000555","Total",1497,766,731,1497,0,23,20.69,72.4
"2011","Brent 015D","E01000556","Total",1869,1009,860,1869,0,10,9.79,190.9
"2011","Brent 015E","E01000557","Total",1861,949,912,1841,20,6,11.72,158.8
"2011","Brent 015F","E01000558","Total",1508,763,745,1465,43,9,17.37,86.8
"2011","Brent 016A","E01000567","Total",1380,690,690,1372,8,20,20.62,66.9
"2011","Brent 016B","E01000606","Total",1710,886,824,1703,7,20,23.55,72.6
"2011","Brent 016C","E01000609","Total",2079,1058,1021,2075,4,25,24.81,83.8
"2011","Brent 016D","E01000611","Total",1415,755,660,1415,0,9,12.30,115.0
"2011","Brent 017B","E01000615","Total",1603,828,775,1603,0,6,66.47,24.1
"2011","Brent 017C","E01000617","Total",1750,930,820,1741,9,12,27.12,64.5
"2011","Brent 017D","E01000618","Total",1639,816,823,1639,0,24,18.25,89.8
"2011","Brent 017E","E01000619","Total",1652,842,810,1652,0,16,21.33,77.4
"2011","Brent 017F","E01033424","Total",1508,861,647,1358,150,15,42.91,35.1
"2011","Brent 017G","E01033457","Total",1712,908,804,1700,12,10,18.01,95.1
"2011","Brent 018A","E01000504","Total",1676,861,815,1676,0,16,14.51,115.5
"2011","Brent 018B","E01000505","Total",1660,834,826,1660,0,18,15.65,106.1
"2011","Brent 018C","E01000507","Total",1634,829,805,1634,0,21,23.12,70.7
"2011","Brent 018D","E01000512","Total",1702,866,836,1702,0,18,15.21,111.9
"2011","Brent 018E","E01000559","Total",1415,724,691,1411,4,14,11.41,124.0
"2011","Brent 019A","E01000610","Total",1935,949,986,1870,65,24,28.58,67.7
"2011","Brent 019B","E01000612","Total",1652,818,834,1652,0,10,25.59,64.6
"2011","Brent 019C","E01000631","Total",1882,980,902,1882,0,29,25.29,74.4
"2011","Brent 019D","E01000633","Total",1970,1082,888,1949,21,32,16.46,119.7
"2011","Brent 019E","E01000634","Total",2343,1230,1113,2343,0,19,16.86,139.0
"2011","Brent 020A","E01000616","Total",1747,929,818,1747,0,20,17.07,102.3
"2011","Brent 020B","E01000620","Total",1715,880,835,1637,78,17,43.90,39.1
"2011","Brent 020C","E01000621","Total",1779,950,829,1774,5,11,21.35,83.3
"2011","Brent 020D","E01000635","Total",2415,1310,1105,2392,23,23,23.25,103.9
"2011","Brent 020E","E01000636","Total",1776,948,828,1776,0,12,21.31,83.3
"2011","Brent 021A","E01000596","Total",1694,845,849,1694,0,15,18.98,89.3
"2011","Brent 021B","E01000601","Total",1505,710,795,1505,0,18,69.64,21.6
"2011","Brent 021C","E01000602","Total",1541,738,803,1541,0,5,13.41,114.9
"2011","Brent 021D","E01000603","Total",1487,701,786,1487,0,11,12.28,121.1
"2011","Brent 021E","E01000604","Total",1766,814,952,1766,0,11,16.90,104.5
"2011","Brent 021F","E01000605","Total",1662,807,855,1662,0,19,17.16,96.9
"2011","Brent 022A","E01000488","Total",1576,775,801,1573,3,23,16.26,96.9
"2011","Brent 022B","E01000637","Total",1675,834,841,1675,0,12,7.19,233.0
"2011","Brent 022C","E01000639","Total",1757,886,871,1757,0,10,9.66,181.9
"2011","Brent 022D","E01000642","Total",2054,1055,999,2044,10,8,15.91,129.1
"2011","Brent 022E","E01000644","Total",1948,969,979,1948,0,6,12.32,158.1
"2011","Brent 023A","E01000490","Total",1606,768,838,1606,0,14,13.21,121.6
"2011","Brent 023B","E01000494","Total",1738,878,860,1699,39,24,21.92,79.3
"2011","Brent 023C","E01000495","Total",1574,844,730,1574,0,9,17.19,91.6
"2011","Brent 023D","E01000560","Total",1617,828,789,1614,3,27,20.75,77.9
"2011","Brent 023E","E01000561","Total",1805,960,845,1805,0,11,11.80,153.0
"2011","Brent 024A","E01000638","Total",1939,1009,930,1939,0,14,29.38,66.0
"2011","Brent 024B","E01000640","Total",2123,1108,1015,2123,0,15,12.33,172.2
"2011","Brent 024C","E01000641","Total",1945,956,989,1945,0,10,10.79,180.3
"2011","Brent 024D","E01000643","Total",2146,1014,1132,2139,7,18,57.14,37.6
"2011","Brent 025A","E01000508","Total",1961,965,996,1961,0,24,22.88,85.7
"2011","Brent 025B","E01000521","Total",2179,1082,1097,2167,12,8,14.10,154.5
"2011","Brent 025C","E01000522","Total",1923,903,1020,1923,0,21,14.39,133.6
"2011","Brent 025D","E01000526","Total",2279,1057,1222,2226,53,29,13.86,164.4
"2011","Brent 025E","E01000527","Total",2178,1086,1092,2174,4,18,12.64,172.3
"2011","Brent 025F","E01000528","Total",1493,746,747,1493,0,14,11.12,134.3
"2011","Brent 026A","E01000471","Total",1638,855,783,1638,0,16,13.90,117.8
"2011","Brent 026B","E01000474","Total",1999,1029,970,1999,0,23,19.65,101.7
"2011","Brent 026C","E01000476","Total",1618,844,774,1618,0,23,22.72,71.2
"2011","Brent 026D","E01000477","Total",1916,1015,901,1910,6,19,38.51,49.8
"2011","Brent 026E","E01000630","Total",2254,1180,1074,2254,0,23,28.61,78.8
"2011","Brent 027A","E01000595","Total",1685,838,847,1685,0,15,19.20,87.8
"2011","Brent 027D","E01000599","Total",1308,643,665,1308,0,23,8.75,149.5
"2011","Brent 027E","E01000600","Total",2047,1046,1001,2029,18,21,202.70,10.1
"2011","Brent 027F","E01033456","Total",2208,1031,1177,2200,8,31,26.48,83.4
"2011","Brent 028A","E01000545","Total",1809,907,902,1809,0,19,11.59,156.1
"2011","Brent 028B","E01000546","Total",1645,784,861,1645,0,16,9.50,173.2
"2011","Brent 028C","E01000547","Total",1780,868,912,1780,0,7,7.58,234.8
"2011","Brent 028D","E01000548","Total",2044,1046,998,2034,10,13,10.82,188.9
"2011","Brent 028E","E01000549","Total",1936,936,1000,1936,0,6,11.12,174.1
"2011","Brent 029A","E01000472","Total",1346,711,635,1346,0,7,43.28,31.1
"2011","Brent 029B","E01000473","Total",1883,978,905,1883,0,11,17.36,108.5
"2011","Brent 029C","E01000475","Total",1976,997,979,1976,0,14,31.22,63.3
"2011","Brent 029D","E01000478","Total",1641,836,805,1640,1,12,19.21,85.4
"2011","Brent 029E","E01000632","Total",2087,1062,1025,2087,0,16,28.47,73.3
"2011","Brent 030A","E01000489","Total",1581,729,852,1581,0,30,31.94,49.5
"2011","Brent 030B","E01000491","Total",1996,1019,977,1989,7,42,37.18,53.7
"2011","Brent 030C","E01000492","Total",1315,641,674,1306,9,27,15.82,83.1
"2011","Brent 030D","E01000493","Total",1637,783,854,1637,0,28,18.72,87.4
"2011","Brent 030E","E01000581","Total",1550,729,821,1550,0,19,16.58,93.5
"2011","Brent 031A","E01000523","Total",2610,1309,1301,2610,0,17,14.00,186.4
"2011","Brent 031B","E01000524","Total",2514,1269,1245,2499,15,15,15.75,159.6
"2011","Brent 031C","E01000525","Total",1986,975,1011,1986,0,13,15.61,127.2
"2011","Brent 031E","E01000533","Total",2259,1173,1086,2259,0,27,18.67,121.0
"2011","Brent 031F","E01000535","Total",2170,1083,1087,2170,0,23,18.80,115.4
"2011","Brent 031G","E01033455","Total",1189,635,554,1151,38,7,6.21,191.5
"2011","Brent 031H","E01033485","Total",1991,1009,982,1982,9,8,14.45,137.8
"2011","Brent 032A","E01000579","Total",1665,824,841,1659,6,9,11.28,147.6
"2011","Brent 032B","E01000580","Total",1980,998,982,1944,36,35,44.55,44.4
"2011","Brent 032C","E01000582","Total",1847,898,949,1847,0,32,19.35,95.5
"2011","Brent 032D","E01000583","Total",2273,1133,1140,2262,11,13,19.53,116.4
"2011","Brent 032E","E01000586","Total",2457,1235,1222,2456,1,21,14.94,164.5
"2011","Brent 033A","E01000530","Total",1824,888,936,1823,1,25,17.58,103.8
"2011","Brent 033B","E01000531","Total",2077,1017,1060,2070,7,15,10.76,193.0
"2011","Brent 033C","E01000532","Total",1630,828,802,1630,0,17,10.27,158.7
"2011","Brent 033D","E01000534","Total",1775,834,941,1771,4,26,15.36,115.6
"2011","Brent 033E","E01000584","Total",1695,846,849,1695,0,24,12.58,134.7
"2011","Brent 033F","E01000585","Total",1814,907,907,1814,0,7,10.03,180.9
"2011","Brent 034A","E01000544","Total",1777,896,881,1777,0,10,7.21,246.5
"2011","Brent 034B","E01000550","Total",1966,966,1000,1941,25,18,14.24,138.1
"2011","Brent 034C","E01000551","Total",2215,1129,1086,2203,12,17,13.67,162.0
"2011","Brent 034D","E01000552","Total",1817,906,911,1817,0,18,8.67,209.6
"2011","Bromley 001A","E01000779","Total",1233,590,643,1185,48,18,116.07,10.6
"2011","Bromley 001B","E01000780","Total",1480,679,801,1480,0,11,21.01,70.4
"2011","Bromley 001C","E01000781","Total",1445,652,793,1445,0,8,17.20,84.0
"2011","Bromley 001D","E01000782","Total",1441,672,769,1441,0,6,28.35,50.8
"2011","Bromley 001E","E01000783","Total",1503,680,823,1503,0,15,18.88,79.6
"2011","Bromley 001F","E01000785","Total",1381,642,739,1381,0,15,21.03,65.7
"2011","Bromley 002A","E01000689","Total",1375,659,716,1339,36,10,138.62,9.9
"2011","Bromley 002B","E01000690","Total",1402,682,720,1402,0,37,33.26,42.2
"2011","Bromley 002C","E01000691","Total",1438,675,763,1420,18,16,24.17,59.5
"2011","Bromley 002D","E01000692","Total",1575,748,827,1565,10,20,35.25,44.7
"2011","Bromley 002E","E01000784","Total",1504,730,774,1504,0,16,22.39,67.2
"2011","Bromley 004A","E01000799","Total",1642,819,823,1642,0,19,21.61,76.0
"2011","Bromley 004B","E01000802","Total",1729,833,896,1729,0,19,18.51,93.4
"2011","Bromley 004C","E01000803","Total",1596,726,870,1587,9,13,26.10,61.1
"2011","Bromley 004D","E01000804","Total",1436,719,717,1426,10,22,66.33,21.6
"2011","Bromley 004E","E01000805","Total",1511,722,789,1505,6,11,16.06,94.1
"2011","Bromley 005A","E01000740","Total",1734,871,863,1734,0,12,71.46,24.3
"2011","Bromley 005B","E01000741","Total",1586,809,777,1586,0,16,13.61,116.5
"2011","Bromley 005C","E01000742","Total",2019,988,1031,1996,23,7,26.68,75.7
"2011","Bromley 005D","E01000745","Total",1757,830,927,1720,37,13,46.83,37.5
"2011","Bromley 005E","E01000746","Total",1858,915,943,1858,0,15,18.08,102.8
"2011","Bromley 006A","E01000709","Total",1317,644,673,1296,21,11,24.34,54.1
"2011","Bromley 006B","E01000710","Total",1605,754,851,1583,22,6,54.28,29.6
"2011","Bromley 006C","E01000711","Total",1719,847,872,1683,36,9,28.16,61.0
"2011","Bromley 006D","E01000714","Total",1865,939,926,1863,2,11,33.21,56.2
"2011","Bromley 006E","E01000718","Total",2061,979,1082,2061,0,20,33.79,61.0
"2011","Bromley 007A","E01000645","Total",1375,666,709,1375,0,72,78.04,17.6
"2011","Bromley 007B","E01000649","Total",1981,948,1033,1899,82,44,85.40,23.2
"2011","Bromley 007C","E01000694","Total",1627,760,867,1589,38,43,100.87,16.1
"2011","Bromley 007D","E01000695","Total",1494,706,788,1469,25,39,75.65,19.7
"2011","Bromley 007E","E01000696","Total",1514,719,795,1460,54,54,205.88,7.4
"2011","Bromley 007F","E01000697","Total",1615,801,814,1611,4,33,51.85,31.1
"2011","Bromley 008A","E01000674","Total",1564,725,839,1545,19,15,20.14,77.7
"2011","Bromley 008B","E01000676","Total",1735,831,904,1729,6,9,33.20,52.3
"2011","Bromley 008C","E01000820","Total",1405,664,741,1346,59,40,59.39,23.7
"2011","Bromley 008D","E01000822","Total",1614,763,851,1570,44,17,22.19,72.7
"2011","Bromley 008E","E01000823","Total",1676,836,840,1671,5,21,24.44,68.6
"2011","Bromley 008F","E01000824","Total",1206,595,611,1206,0,13,16.54,72.9
"2011","Bromley 008G","E01000825","Total",1573,756,817,1547,26,15,17.61,89.3
"2011","Bromley 009A","E01000743","Total",1770,847,923,1703,67,25,31.26,56.6
"2011","Bromley 009B","E01000744","Total",1531,744,787,1484,47,11,21.44,71.4
"2011","Bromley 009C","E01000796","Total",1630,769,861,1630,0,15,9.92,164.3
"2011","Bromley 009D","E01000798","Total",1464,702,762,1464,0,19,13.52,108.3
"2011","Bromley 009E","E01000800","Total",1618,788,830,1612,6,9,23.11,70.0
"2011","Bromley 009F","E01000806","Total",1721,838,883,1721,0,12,16.44,104.7
"2011","Bromley 010A","E01000693","Total",1609,777,832,1257,352,37,266.53,6.0
"2011","Bromley 010B","E01000698","Total",1182,582,600,1177,5,36,112.84,10.5
"2011","Bromley 010C","E01000736","Total",1560,766,794,1560,0,9,39.70,39.3
"2011","Bromley 010D","E01000737","Total",1377,599,778,1329,48,14,36.82,37.4
"2011","Bromley 011A","E01000672","Total",1520,715,805,1461,59,19,32.70,46.5
"2011","Bromley 011B","E01000673","Total",1571,761,810,1562,9,34,47.74,32.9
"2011","Bromley 011C","E01000716","Total",1542,742,800,1463,79,38,40.22,38.3
"2011","Bromley 011D","E01000717","Total",1609,771,838,1609,0,22,31.34,51.3
"2011","Bromley 011E","E01000828","Total",1584,736,848,1584,0,23,34.13,46.4
"2011","Bromley 012A","E01000712","Total",1641,826,815,1641,0,22,36.00,45.6
"2011","Bromley 012B","E01000713","Total",1693,838,855,1693,0,31,41.52,40.8
"2011","Bromley 012C","E01000715","Total",1657,809,848,1648,9,22,30.08,55.1
"2011","Bromley 012D","E01000770","Total",1429,661,768,1429,0,31,68.54,20.8
"2011","Bromley 012E","E01000772","Total",1516,704,812,1516,0,41,32.31,46.9
"2011","Bromley 013A","E01000700","Total",1509,725,784,1509,0,14,20.01,75.4
"2011","Bromley 013B","E01000702","Total",1321,642,679,1321,0,18,13.84,95.4
"2011","Bromley 013C","E01000703","Total",1599,755,844,1581,18,32,24.11,66.3
"2011","Bromley 013D","E01000706","Total",1293,602,691,1293,0,11,30.13,42.9
"2011","Bromley 013E","E01000797","Total",1562,744,818,1562,0,37,65.53,23.8
"2011","Bromley 014A","E01000729","Total",1783,852,931,1783,0,15,26.04,68.5
"2011","Bromley 014B","E01000730","Total",1724,775,949,1724,0,14,37.30,46.2
"2011","Bromley 014C","E01000735","Total",1484,702,782,1484,0,9,51.41,28.9
"2011","Bromley 014D","E01000738","Total",1527,725,802,1527,0,13,51.52,29.6
"2011","Bromley 014E","E01000739","Total",1523,697,826,1523,0,14,22.45,67.8
"2011","Bromley 015A","E01000699","Total",1442,704,738,1432,10,14,13.65,105.6
"2011","Bromley 015B","E01000701","Total",1327,649,678,1327,0,20,13.38,99.2
"2011","Bromley 015C","E01000704","Total",1444,686,758,1444,0,18,32.55,44.4
"2011","Bromley 015D","E01000705","Total",1310,640,670,1305,5,15,15.22,86.1
"2011","Bromley 015E","E01000801","Total",1417,669,748,1410,7,17,18.52,76.5
"2011","Bromley 016A","E01000646","Total",1641,778,863,1564,77,19,35.22,46.6
"2011","Bromley 016B","E01000647","Total",1609,773,836,1609,0,29,25.19,63.9
"2011","Bromley 016C","E01000648","Total",1744,853,891,1708,36,32,37.91,46.0
"2011","Bromley 016D","E01000653","Total",1584,722,862,1487,97,35,49.73,31.9
"2011","Bromley 016E","E01000678","Total",1707,835,872,1707,0,35,29.92,57.1
"2011","Bromley 018A","E01000670","Total",1932,972,960,1926,6,47,48.40,39.9
"2011","Bromley 018B","E01000675","Total",1624,818,806,1612,12,28,57.66,28.2
"2011","Bromley 018C","E01000677","Total",1769,836,933,1769,0,15,38.16,46.4
"2011","Bromley 018D","E01000762","Total",1623,789,834,1623,0,24,32.00,50.7
"2011","Bromley 018E","E01000829","Total",1733,823,910,1733,0,23,22.29,77.7
"2011","Bromley 019A","E01000719","Total",1896,864,1032,1896,0,6,34.89,54.3
"2011","Bromley 019B","E01000720","Total",1632,735,897,1622,10,30,750.56,2.2
"2011","Bromley 019C","E01000721","Total",1327,602,725,1327,0,12,26.64,49.8
"2011","Bromley 019D","E01000724","Total",1760,863,897,1760,0,8,41.17,42.7
"2011","Bromley 019E","E01000728","Total",1471,692,779,1471,0,9,274.79,5.4
"2011","Bromley 020A","E01000651","Total",1628,716,912,1474,154,29,29.05,56.0
"2011","Bromley 020B","E01000668","Total",1620,816,804,1620,0,17,70.17,23.1
"2011","Bromley 020C","E01000669","Total",1672,776,896,1672,0,19,17.32,96.5
"2011","Bromley 020D","E01000671","Total",1744,859,885,1744,0,16,34.29,50.9
"2011","Bromley 020E","E01000679","Total",1660,821,839,1660,0,22,29.53,56.2
"2011","Bromley 021A","E01000826","Total",1625,810,815,1625,0,58,51.82,31.4
"2011","Bromley 021B","E01000827","Total",1692,809,883,1692,0,26,37.42,45.2
"2011","Bromley 021C","E01000830","Total",1550,786,764,1550,0,62,59.34,26.1
"2011","Bromley 021D","E01000831","Total",1640,790,850,1622,18,34,40.57,40.4
"2011","Bromley 021E","E01000833","Total",1462,717,745,1462,0,57,35.89,40.7
"2011","Bromley 022A","E01000650","Total",1911,909,1002,1880,31,45,88.59,21.6
"2011","Bromley 022B","E01000652","Total",1625,774,851,1625,0,30,57.75,28.1
"2011","Bromley 022C","E01000807","Total",1532,755,777,1532,0,23,80.06,19.1
"2011","Bromley 022D","E01000809","Total",1517,723,794,1517,0,20,54.28,27.9
"2011","Bromley 023A","E01000722","Total",1636,784,852,1636,0,18,57.83,28.3
"2011","Bromley 023B","E01000725","Total",1641,767,874,1641,0,10,33.88,48.4
"2011","Bromley 023C","E01000731","Total",1363,650,713,1361,2,14,23.36,58.3
"2011","Bromley 023D","E01000732","Total",1475,702,773,1475,0,28,35.42,41.6
"2011","Bromley 023E","E01000733","Total",1593,784,809,1593,0,17,37.39,42.6
"2011","Bromley 024A","E01000769","Total",1417,716,701,1301,116,36,120.14,11.8
"2011","Bromley 024B","E01000773","Total",1521,691,830,1521,0,26,31.08,48.9
"2011","Bromley 024C","E01000775","Total",2266,1094,1172,2266,0,51,110.96,20.4
"2011","Bromley 024D","E01000777","Total",1567,758,809,1567,0,33,24.90,62.9
"2011","Bromley 024E","E01000778","Total",1580,732,848,1580,0,24,20.64,76.6
"2011","Bromley 025A","E01000808","Total",1604,770,834,1604,0,22,33.38,48.1
"2011","Bromley 025B","E01000810","Total",1503,720,783,1503,0,38,37.18,40.4
"2011","Bromley 025C","E01000811","Total",1320,631,689,1320,0,20,29.86,44.2
"2011","Bromley 025D","E01000813","Total",1610,770,840,1610,0,23,60.97,26.4
"2011","Bromley 025E","E01000815","Total",1537,737,800,1537,0,37,48.78,31.5
"2011","Bromley 026A","E01000661","Total",1594,744,850,1583,11,9,93.79,17.0
"2011","Bromley 026B","E01000662","Total",1741,845,896,1741,0,24,52.37,33.2
"2011","Bromley 026C","E01000663","Total",1627,759,868,1627,0,8,31.93,51.0
"2011","Bromley 026D","E01000664","Total",1610,780,830,1610,0,20,79.22,20.3
"2011","Bromley 027A","E01000763","Total",1452,705,747,1452,0,35,84.54,17.2
"2011","Bromley 027B","E01000764","Total",1615,753,862,1615,0,22,50.62,31.9
"2011","Bromley 027C","E01000766","Total",1714,841,873,1714,0,41,36.93,46.4
"2011","Bromley 027D","E01000767","Total",1646,812,834,1646,0,29,31.63,52.0
"2011","Bromley 027E","E01000834","Total",1328,639,689,1328,0,25,21.07,63.0
"2011","Bromley 028A","E01000727","Total",1553,738,815,1553,0,18,38.45,40.4
"2011","Bromley 028B","E01000734","Total",1360,660,700,1360,0,13,32.39,42.0
"2011","Bromley 028C","E01000790","Total",2018,994,1024,1982,36,42,52.08,38.7
"2011","Bromley 028D","E01000812","Total",1497,724,773,1491,6,32,37.98,39.4
"2011","Bromley 028E","E01000814","Total",1531,760,771,1531,0,44,47.73,32.1
"2011","Bromley 029A","E01000723","Total",1247,602,645,1247,0,13,42.42,29.4
"2011","Bromley 029B","E01000726","Total",1282,648,634,1282,0,14,28.20,45.5
"2011","Bromley 029C","E01000787","Total",1405,660,745,1405,0,10,34.12,41.2
"2011","Bromley 029D","E01000788","Total",1526,733,793,1526,0,19,36.90,41.4
"2011","Bromley 029E","E01000791","Total",1445,695,750,1445,0,19,40.09,36.0
"2011","Bromley 030A","E01000832","Total",1488,742,746,1488,0,45,86.52,17.2
"2011","Bromley 030B","E01000835","Total",1614,755,859,1588,26,32,33.25,48.5
"2011","Bromley 030C","E01000836","Total",1419,698,721,1419,0,36,21.30,66.6
"2011","Bromley 030D","E01000837","Total",1512,730,782,1512,0,23,47.89,31.6
"2011","Bromley 030E","E01000838","Total",1462,706,756,1416,46,25,54.00,27.1
"2011","Bromley 030F","E01000839","Total",1488,724,764,1488,0,40,27.50,54.1
"2011","Bromley 030G","E01000840","Total",1552,706,846,1552,0,24,79.73,19.5
"2011","Bromley 030H","E01000841","Total",1559,756,803,1559,0,27,34.15,45.7
"2011","Bromley 031A","E01000753","Total",1806,902,904,1806,0,25,87.07,20.7
"2011","Bromley 031B","E01000754","Total",1675,773,902,1675,0,19,38.76,43.2
"2011","Bromley 031C","E01000755","Total",1505,703,802,1505,0,32,34.30,43.9
"2011","Bromley 031D","E01000757","Total",1499,740,759,1499,0,40,54.27,27.6
"2011","Bromley 031E","E01000758","Total",1479,708,771,1479,0,31,30.35,48.7
"2011","Bromley 032A","E01000786","Total",1421,708,713,1421,0,17,94.88,15.0
"2011","Bromley 032B","E01000789","Total",1800,829,971,1800,0,8,14.34,125.5
"2011","Bromley 032C","E01000792","Total",1142,535,607,1142,0,13,31.58,36.2
"2011","Bromley 032D","E01000793","Total",1589,764,825,1589,0,28,46.67,34.0
"2011","Bromley 032E","E01000795","Total",1412,689,723,1412,0,16,28.58,49.4
"2011","Bromley 033A","E01000665","Total",1815,850,965,1815,0,35,83.37,21.8
"2011","Bromley 033B","E01000666","Total",1814,884,930,1814,0,39,298.23,6.1
"2011","Bromley 033C","E01000667","Total",1620,790,830,1620,0,44,105.70,15.3
"2011","Bromley 033D","E01000756","Total",1563,754,809,1563,0,47,101.32,15.4
"2011","Bromley 034A","E01000759","Total",1542,753,789,1542,0,28,460.04,3.4
"2011","Bromley 034B","E01000760","Total",1503,675,828,1417,86,25,50.51,29.8
"2011","Bromley 034C","E01000761","Total",1552,775,777,1552,0,30,57.66,26.9
"2011","Bromley 034D","E01000765","Total",1704,844,860,1697,7,31,229.42,7.4
"2011","Bromley 034E","E01000768","Total",1555,769,786,1517,38,48,48.31,32.2
"2011","Bromley 035A","E01000681","Total",1705,824,881,1705,0,29,31.41,54.3
"2011","Bromley 035B","E01000682","Total",1524,736,788,1524,0,16,27.83,54.8
"2011","Bromley 035C","E01000683","Total",1592,750,842,1567,25,14,26.04,61.1
"2011","Bromley 035D","E01000684","Total",2036,1011,1025,2036,0,36,40.21,50.6
"2011","Bromley 035E","E01000794","Total",1553,745,808,1546,7,34,46.41,33.5
"2011","Bromley 036A","E01000749","Total",1588,788,800,1588,0,27,922.59,1.7
"2011","Bromley 036B","E01000750","Total",1492,651,841,1492,0,16,31.09,48.0
"2011","Bromley 036C","E01000751","Total",2007,947,1060,1961,46,34,183.97,10.9
"2011","Bromley 036D","E01000752","Total",1606,730,876,1606,0,7,138.37,11.6
"2011","Bromley 037A","E01000680","Total",1609,813,796,1609,0,41,824.91,2.0
"2011","Bromley 037B","E01000685","Total",1565,771,794,1565,0,18,111.09,14.1
"2011","Bromley 037C","E01000686","Total",1508,732,776,1508,0,25,44.12,34.2
"2011","Bromley 037D","E01000687","Total",1603,772,831,1603,0,21,58.57,27.4
"2011","Bromley 037E","E01000688","Total",1365,661,704,1365,0,40,91.99,14.8
"2011","Bromley 039A","E01000654","Total",1273,639,634,1273,0,9,105.99,12.0
"2011","Bromley 039B","E01000655","Total",1323,640,683,1323,0,21,38.06,34.8
"2011","Bromley 039C","E01000656","Total",1400,692,708,1400,0,25,340.47,4.1
"2011","Bromley 039D","E01000657","Total",1587,748,839,1587,0,10,30.76,51.6
"2011","Bromley 039E","E01000659","Total",1462,747,715,1462,0,18,50.92,28.7
"2011","Bromley 040A","E01000816","Total",1481,718,763,1481,0,24,30.28,48.9
"2011","Bromley 040B","E01000818","Total",1467,718,749,1467,0,33,130.13,11.3
"2011","Bromley 040C","E01000819","Total",1710,813,897,1710,0,19,39.05,43.8
"2011","Bromley 040D","E01032562","Total",1507,695,812,1507,0,11,23.01,65.5
"2011","Bromley 040E","E01032563","Total",1483,686,797,1400,83,27,37.49,39.6
"2011","Bromley 041A","E01000707","Total",1455,717,738,1455,0,21,15.39,94.5
"2011","Bromley 041B","E01000708","Total",1543,750,793,1543,0,13,24.03,64.2
"2011","Bromley 041C","E01000771","Total",1635,785,850,1616,19,34,36.81,44.4
"2011","Bromley 041D","E01000774","Total",1473,697,776,1473,0,25,37.82,38.9
"2011","Bromley 041E","E01032568","Total",1488,683,805,1488,0,18,36.77,40.5
"2011","Bromley 042A","E01000658","Total",1358,673,685,1358,0,23,216.60,6.3
"2011","Bromley 042B","E01000747","Total",1920,946,974,1914,6,42,993.31,1.9
"2011","Bromley 042C","E01000748","Total",1602,783,819,1602,0,30,987.62,1.6
"2011","Bromley 042D","E01032570","Total",1548,735,813,1541,7,22,45.50,34.0
"2011","Croydon 001A","E01001137","Total",1769,890,879,1739,30,17,35.50,49.8
"2011","Croydon 001B","E01001138","Total",1582,789,793,1582,0,13,26.24,60.3
"2011","Croydon 001C","E01001156","Total",1718,836,882,1638,80,18,27.78,61.8
"2011","Croydon 001D","E01001162","Total",1724,765,959,1698,26,20,31.41,54.9
"2011","Croydon 001E","E01001164","Total",1903,969,934,1879,24,13,18.27,104.2
"2011","Croydon 002A","E01001084","Total",1828,920,908,1794,34,55,59.82,30.6
"2011","Croydon 002B","E01001157","Total",1703,836,867,1697,6,44,33.19,51.3
"2011","Croydon 002C","E01001159","Total",1801,894,907,1801,0,35,40.33,44.7
"2011","Croydon 002D","E01001160","Total",1881,911,970,1881,0,36,32.10,58.6
"2011","Croydon 002E","E01001163","Total",1939,944,995,1939,0,27,28.22,68.7
"2011","Croydon 003A","E01001083","Total",1609,808,801,1609,0,36,32.24,49.9
"2011","Croydon 003B","E01001086","Total",1750,868,882,1745,5,27,23.03,76.0
"2011","Croydon 003C","E01001087","Total",2195,1093,1102,2163,32,38,37.59,58.4
"2011","Croydon 003D","E01001161","Total",1849,859,990,1849,0,21,29.76,62.1
"2011","Croydon 004A","E01001085","Total",1606,789,817,1606,0,9,18.19,88.3
"2011","Croydon 004B","E01001088","Total",1709,815,894,1709,0,24,15.57,109.8
"2011","Croydon 004C","E01001089","Total",1907,893,1014,1891,16,31,15.71,121.4
"2011","Croydon 004D","E01001090","Total",2287,1081,1206,2287,0,22,17.86,128.1
"2011","Croydon 004E","E01001091","Total",1585,804,781,1579,6,33,31.93,49.6
"2011","Croydon 005A","E01001147","Total",1622,767,855,1621,1,20,20.09,80.7
"2011","Croydon 005B","E01001148","Total",1613,770,843,1605,8,27,14.22,113.4
"2011","Croydon 005C","E01001151","Total",1600,753,847,1569,31,21,16.70,95.8
"2011","Croydon 005D","E01001152","Total",1671,815,856,1662,9,17,17.21,97.1
"2011","Croydon 005E","E01001158","Total",1564,765,799,1564,0,11,20.99,74.5
"2011","Croydon 006A","E01001146","Total",1615,736,879,1615,0,29,13.18,122.5
"2011","Croydon 006B","E01001149","Total",1572,756,816,1572,0,21,13.70,114.7
"2011","Croydon 006C","E01001150","Total",1655,788,867,1652,3,27,27.79,59.6
"2011","Croydon 006D","E01001153","Total",1619,768,851,1617,2,17,13.99,115.7
"2011","Croydon 006E","E01001154","Total",1969,918,1051,1967,2,22,17.62,111.7
"2011","Croydon 007A","E01001136","Total",1880,951,929,1828,52,10,28.17,66.7
"2011","Croydon 007B","E01001139","Total",1602,751,851,1602,0,41,18.44,86.9
"2011","Croydon 007C","E01001140","Total",1613,800,813,1573,40,15,35.08,46.0
"2011","Croydon 007D","E01001142","Total",1526,724,802,1526,0,31,31.03,49.2
"2011","Croydon 007E","E01001144","Total",1673,819,854,1663,10,11,12.02,139.2
"2011","Croydon 008A","E01001141","Total",1246,603,643,1246,0,14,15.28,81.5
"2011","Croydon 008B","E01001143","Total",1941,902,1039,1941,0,22,22.37,86.8
"2011","Croydon 008C","E01001145","Total",1686,834,852,1686,0,16,13.97,120.7
"2011","Croydon 008D","E01001191","Total",1764,910,854,1764,0,22,15.71,112.3
"2011","Croydon 008E","E01001192","Total",1644,746,898,1644,0,10,18.58,88.5
"2011","Croydon 009A","E01000994","Total",1592,789,803,1592,0,12,17.56,90.7
"2011","Croydon 009B","E01000995","Total",1631,823,808,1631,0,17,14.34,113.7
"2011","Croydon 009C","E01000996","Total",1254,614,640,1254,0,30,10.52,119.2
"2011","Croydon 009D","E01000997","Total",1396,668,728,1351,45,29,10.64,131.2
"2011","Croydon 009E","E01000999","Total",1332,665,667,1332,0,23,9.75,136.6
"2011","Croydon 009F","E01001002","Total",1343,657,686,1343,0,19,10.70,125.5
"2011","Croydon 010A","E01000998","Total",1551,790,761,1551,0,11,13.88,111.7
"2011","Croydon 010B","E01001000","Total",1267,637,630,1251,16,12,13.87,91.3
"2011","Croydon 010C","E01001003","Total",1511,703,808,1497,14,18,15.61,96.8
"2011","Croydon 010D","E01001111","Total",1607,765,842,1604,3,8,20.44,78.6
"2011","Croydon 010E","E01001155","Total",1603,754,849,1591,12,12,13.56,118.2
"2011","Croydon 011A","E01001174","Total",1620,758,862,1620,0,22,22.89,70.8
"2011","Croydon 011B","E01001175","Total",1542,755,787,1448,94,16,15.16,101.7
"2011","Croydon 011C","E01001176","Total",1902,917,985,1899,3,17,25.22,75.4
"2011","Croydon 011D","E01001182","Total",1422,714,708,1422,0,25,13.01,109.3
"2011","Croydon 011E","E01001183","Total",1572,762,810,1572,0,16,13.51,116.4
"2011","Croydon 011F","E01001184","Total",1349,622,727,1349,0,21,18.87,71.5
"2011","Croydon 013A","E01001001","Total",1195,573,622,1184,11,17,12.14,98.4
"2011","Croydon 013B","E01001109","Total",2039,1004,1035,1935,104,12,47.14,43.3
"2011","Croydon 013C","E01001112","Total",1718,803,915,1693,25,9,35.58,48.3
"2011","Croydon 013D","E01001113","Total",1828,874,954,1828,0,13,17.63,103.7
"2011","Croydon 013E","E01001114","Total",1400,691,709,1400,0,10,17.83,78.5
"2011","Croydon 013F","E01001116","Total",1359,686,673,1359,0,12,15.79,86.1
"2011","Croydon 014A","E01000992","Total",1978,986,992,1973,5,27,49.54,39.9
"2011","Croydon 014B","E01001185","Total",1636,800,836,1636,0,14,20.11,81.4
"2011","Croydon 014C","E01001186","Total",1745,866,879,1743,2,22,18.01,96.9
"2011","Croydon 014D","E01001188","Total",1833,855,978,1818,15,11,18.80,97.5
"2011","Croydon 014E","E01001193","Total",1807,812,995,1807,0,27,17.63,102.5
"2011","Croydon 015A","E01001004","Total",2129,984,1145,2125,4,29,15.57,136.7
"2011","Croydon 015B","E01001115","Total",1706,864,842,1706,0,23,21.92,77.8
"2011","Croydon 015C","E01001117","Total",2761,1359,1402,2655,106,9,17.41,158.6
"2011","Croydon 015D","E01001178","Total",1365,685,680,1341,24,15,18.05,75.6
"2011","Croydon 015E","E01001181","Total",1829,848,981,1818,11,11,14.59,125.4
"2011","Croydon 016A","E01001006","Total",1558,738,820,1558,0,19,29.21,53.3
"2011","Croydon 016B","E01001007","Total",1968,974,994,1968,0,21,14.95,131.6
"2011","Croydon 016C","E01001177","Total",1617,795,822,1614,3,20,29.38,55.0
"2011","Croydon 016D","E01001179","Total",1534,747,787,1534,0,18,11.46,133.9
"2011","Croydon 016E","E01001180","Total",1737,850,887,1737,0,10,15.29,113.6
"2011","Croydon 017A","E01000980","Total",1407,650,757,1407,0,13,14.48,97.2
"2011","Croydon 017B","E01000981","Total",1642,769,873,1642,0,10,17.11,96.0
"2011","Croydon 017C","E01000982","Total",1604,798,806,1599,5,12,13.69,117.2
"2011","Croydon 017D","E01000983","Total",1712,849,863,1712,0,25,15.61,109.7
"2011","Croydon 017E","E01001187","Total",1945,914,1031,1940,5,26,16.62,117.0
"2011","Croydon 018A","E01000989","Total",1707,804,903,1707,0,28,26.01,65.6
"2011","Croydon 018B","E01000991","Total",1649,829,820,1649,0,26,44.63,36.9
"2011","Croydon 018C","E01001131","Total",1563,721,842,1563,0,19,16.39,95.4
"2011","Croydon 018D","E01001132","Total",1464,720,744,1464,0,23,43.16,33.9
"2011","Croydon 018E","E01001134","Total",1617,777,840,1617,0,32,37.63,43.0
"2011","Croydon 019A","E01001005","Total",1687,850,837,1687,0,14,9.16,184.2
"2011","Croydon 019B","E01001008","Total",1608,760,848,1608,0,14,18.40,87.4
"2011","Croydon 019C","E01001009","Total",1846,910,936,1846,0,23,11.47,160.9
"2011","Croydon 019D","E01001010","Total",1514,713,801,1514,0,12,72.89,20.8
"2011","Croydon 019E","E01001011","Total",1868,969,899,1867,1,24,12.23,152.7
"2011","Croydon 020A","E01001012","Total",1922,969,953,1895,27,10,14.27,134.7
"2011","Croydon 020B","E01001013","Total",2018,1008,1010,2010,8,12,19.89,101.5
"2011","Croydon 020C","E01001048","Total",1942,996,946,1936,6,24,34.95,55.6
"2011","Croydon 020D","E01001110","Total",1787,906,881,1772,15,14,15.39,116.1
"2011","Croydon 020E","E01001118","Total",1882,901,981,1882,0,13,18.59,101.2
"2011","Croydon 021A","E01000985","Total",1447,727,720,1447,0,21,38.10,38.0
"2011","Croydon 021B","E01000986","Total",1738,852,886,1721,17,31,32.52,53.4
"2011","Croydon 021C","E01000987","Total",1431,721,710,1431,0,24,16.04,89.2
"2011","Croydon 021D","E01000993","Total",1620,816,804,1620,0,25,16.43,98.6
"2011","Croydon 022A","E01000975","Total",1613,818,795,1607,6,16,18.94,85.2
"2011","Croydon 022B","E01000976","Total",1867,972,895,1867,0,14,16.36,114.1
"2011","Croydon 022C","E01000977","Total",1731,907,824,1677,54,6,17.31,100.0
"2011","Croydon 022D","E01000978","Total",1775,931,844,1775,0,10,15.71,113.0
"2011","Croydon 022E","E01000979","Total",1703,894,809,1703,0,10,13.10,130.0
"2011","Croydon 022F","E01000984","Total",1829,903,926,1785,44,9,17.24,106.1
"2011","Croydon 023A","E01001044","Total",1922,971,951,1880,42,30,44.78,42.9
"2011","Croydon 023B","E01001046","Total",1751,892,859,1751,0,11,19.60,89.3
"2011","Croydon 023C","E01001049","Total",1419,699,720,1393,26,56,138.81,10.2
"2011","Croydon 023D","E01001050","Total",1646,770,876,1598,48,13,15.49,106.3
"2011","Croydon 024A","E01001014","Total",2663,1301,1362,2663,0,14,64.22,41.5
"2011","Croydon 024B","E01001042","Total",1818,889,929,1818,0,14,20.85,87.2
"2011","Croydon 024C","E01001165","Total",1656,807,849,1656,0,15,18.06,91.7
"2011","Croydon 024D","E01001166","Total",1814,914,900,1814,0,12,17.57,103.2
"2011","Croydon 024E","E01001168","Total",1737,865,872,1737,0,16,22.41,77.5
"2011","Croydon 025A","E01001127","Total",1607,784,823,1607,0,44,32.97,48.7
"2011","Croydon 025B","E01001128","Total",1611,717,894,1611,0,26,21.94,73.4
"2011","Croydon 025C","E01001130","Total",1776,790,986,1776,0,26,13.81,128.6
"2011","Croydon 025D","E01001135","Total",1646,807,839,1646,0,30,45.08,36.5
"2011","Croydon 026A","E01001062","Total",1567,774,793,1531,36,41,124.35,12.6
"2011","Croydon 026B","E01001063","Total",1539,731,808,1539,0,33,31.85,48.3
"2011","Croydon 026C","E01001064","Total",1568,757,811,1568,0,37,345.74,4.5
"2011","Croydon 026D","E01001129","Total",1455,690,765,1455,0,38,29.04,50.1
"2011","Croydon 026E","E01001133","Total",1557,697,860,1557,0,26,39.96,39.0
"2011","Croydon 027A","E01001035","Total",1760,890,870,1647,113,15,21.83,80.6
"2011","Croydon 027B","E01001043","Total",2578,1359,1219,2559,19,17,34.20,75.4
"2011","Croydon 027C","E01001045","Total",1820,971,849,1692,128,10,49.59,36.7
"2011","Croydon 027D","E01001047","Total",1673,867,806,1665,8,14,18.20,91.9
"2011","Croydon 027E","E01001170","Total",2050,988,1062,1946,104,13,25.74,79.6
"2011","Croydon 028A","E01001167","Total",2193,1056,1137,2193,0,37,56.35,38.9
"2011","Croydon 028B","E01001169","Total",1680,769,911,1680,0,15,22.36,75.1
"2011","Croydon 028C","E01001171","Total",1638,739,899,1484,154,16,29.80,55.0
"2011","Croydon 028D","E01001172","Total",1748,833,915,1726,22,10,70.28,24.9
"2011","Croydon 028E","E01001173","Total",2561,1252,1309,2547,14,18,101.77,25.2
"2011","Croydon 029A","E01001036","Total",1521,746,775,1459,62,43,84.64,18.0
"2011","Croydon 029B","E01001037","Total",1396,652,744,1396,0,6,15.65,89.2
"2011","Croydon 029C","E01001038","Total",1792,926,866,1778,14,9,20.25,88.5
"2011","Croydon 029D","E01001039","Total",1474,731,743,1465,9,30,46.16,31.9
"2011","Croydon 029E","E01001040","Total",1708,864,844,1708,0,14,19.43,87.9
"2011","Croydon 030A","E01001051","Total",1549,697,852,1549,0,13,25.58,60.6
"2011","Croydon 030B","E01001052","Total",1447,636,811,1447,0,12,16.17,89.5
"2011","Croydon 030C","E01001054","Total",1710,788,922,1710,0,12,25.13,68.0
"2011","Croydon 030D","E01001056","Total",1851,822,1029,1851,0,11,15.49,119.5
"2011","Croydon 030E","E01001057","Total",1814,782,1032,1814,0,13,13.79,131.5
"2011","Croydon 031A","E01001033","Total",1616,798,818,1616,0,20,29.83,54.2
"2011","Croydon 031B","E01001034","Total",1516,763,753,1498,18,20,29.91,50.7
"2011","Croydon 031C","E01001041","Total",1611,801,810,1605,6,15,19.98,80.6
"2011","Croydon 031D","E01001095","Total",1468,721,747,1455,13,13,24.01,61.1
"2011","Croydon 031E","E01001100","Total",1473,730,743,1472,1,22,24.34,60.5
"2011","Croydon 032A","E01001053","Total",1513,718,795,1512,1,22,23.11,65.5
"2011","Croydon 032B","E01001055","Total",1595,755,840,1595,0,14,29.17,54.7
"2011","Croydon 032C","E01001077","Total",1396,663,733,1396,0,9,18.19,76.7
"2011","Croydon 032D","E01001078","Total",1404,658,746,1404,0,13,37.40,37.5
"2011","Croydon 032E","E01001082","Total",1627,749,878,1627,0,6,55.25,29.4
"2011","Croydon 033A","E01001120","Total",1263,638,625,1263,0,14,30.64,41.2
"2011","Croydon 033B","E01001122","Total",1539,783,756,1384,155,39,123.76,12.4
"2011","Croydon 033C","E01001123","Total",1514,738,776,1514,0,21,74.85,20.2
"2011","Croydon 033D","E01001124","Total",1573,761,812,1539,34,49,60.07,26.2
"2011","Croydon 033E","E01001125","Total",1650,820,830,1650,0,34,38.83,42.5
"2011","Croydon 034A","E01001058","Total",1326,586,740,1326,0,21,19.66,67.4
"2011","Croydon 034B","E01001059","Total",1396,669,727,1396,0,13,18.45,75.7
"2011","Croydon 034C","E01001060","Total",1581,768,813,1581,0,24,151.73,10.4
"2011","Croydon 034D","E01001061","Total",1533,731,802,1533,0,20,45.37,33.8
"2011","Croydon 034E","E01001065","Total",1334,654,680,1334,0,15,117.58,11.3
"2011","Croydon 034F","E01001066","Total",1369,595,774,1369,0,12,16.31,83.9
"2011","Croydon 034G","E01001119","Total",1470,710,760,1470,0,17,68.90,21.3
"2011","Croydon 034H","E01001126","Total",1402,667,735,1402,0,23,21.98,63.8
"2011","Croydon 035A","E01001032","Total",1396,688,708,1365,31,45,64.64,21.6
"2011","Croydon 035B","E01001101","Total",1423,686,737,1423,0,39,54.70,26.0
"2011","Croydon 035C","E01001102","Total",1463,687,776,1454,9,22,63.71,23.0
"2011","Croydon 035D","E01001107","Total",1616,812,804,1586,30,42,75.49,21.4
"2011","Croydon 035E","E01001108","Total",1711,831,880,1711,0,42,54.42,31.4
"2011","Croydon 036A","E01001076","Total",1606,749,857,1606,0,8,34.32,46.8
"2011","Croydon 036B","E01001079","Total",1681,792,889,1681,0,14,30.28,55.5
"2011","Croydon 036C","E01001080","Total",1678,774,904,1619,59,9,21.85,76.8
"2011","Croydon 036D","E01001081","Total",1409,675,734,1409,0,9,45.55,30.9
"2011","Croydon 037A","E01001073","Total",1441,714,727,1422,19,29,30.65,47.0
"2011","Croydon 037B","E01001092","Total",1777,854,923,1555,222,37,58.86,30.2
"2011","Croydon 037C","E01001093","Total",1738,854,884,1738,0,17,40.52,42.9
"2011","Croydon 037D","E01001096","Total",1534,769,765,1532,2,43,39.47,38.9
"2011","Croydon 037E","E01001097","Total",2103,1030,1073,2066,37,18,44.10,47.7
"2011","Croydon 037F","E01001098","Total",1452,708,744,1432,20,45,47.86,30.3
"2011","Croydon 038A","E01001028","Total",1630,793,837,1586,44,55,87.24,18.7
"2011","Croydon 038B","E01001029","Total",1593,784,809,1472,121,50,49.99,31.9
"2011","Croydon 038C","E01001030","Total",1411,702,709,1392,19,48,41.91,33.7
"2011","Croydon 038D","E01001031","Total",1466,735,731,1466,0,61,40.16,36.5
"2011","Croydon 038E","E01001094","Total",1585,781,804,1525,60,72,116.95,13.6
"2011","Croydon 039A","E01001103","Total",1680,807,873,1680,0,27,73.66,22.8
"2011","Croydon 039B","E01001105","Total",1729,839,890,1729,0,22,98.82,17.5
"2011","Croydon 039C","E01001106","Total",1490,727,763,1490,0,13,43.10,34.6
"2011","Croydon 039D","E01001121","Total",1308,610,698,1279,29,36,221.56,5.9
"2011","Croydon 040A","E01001069","Total",1385,676,709,1306,79,25,39.93,34.7
"2011","Croydon 040B","E01001070","Total",1726,839,887,1693,33,17,52.85,32.7
"2011","Croydon 040C","E01001075","Total",1547,739,808,1501,46,15,44.68,34.6
"2011","Croydon 040D","E01001099","Total",1477,701,776,1477,0,16,21.20,69.7
"2011","Croydon 041A","E01001015","Total",1440,681,759,1440,0,20,40.08,35.9
"2011","Croydon 041B","E01001016","Total",1705,834,871,1705,0,16,104.78,16.3
"2011","Croydon 041C","E01001023","Total",1314,638,676,1282,32,13,57.18,23.0
"2011","Croydon 041D","E01001067","Total",1631,823,808,1631,0,37,68.46,23.8
"2011","Croydon 041E","E01001074","Total",1933,921,1012,1922,11,25,40.55,47.7
"2011","Croydon 042A","E01001068","Total",1924,929,995,1924,0,34,77.02,25.0
"2011","Croydon 042B","E01001071","Total",1891,905,986,1891,0,30,74.86,25.3
"2011","Croydon 042C","E01001072","Total",1488,715,773,1420,68,48,217.01,6.9
"2011","Croydon 042D","E01001104","Total",1665,805,860,1665,0,30,170.68,9.8
"2011","Croydon 043A","E01001017","Total",1624,818,806,1611,13,23,134.50,12.1
"2011","Croydon 043B","E01001024","Total",1428,691,737,1428,0,17,27.87,51.2
"2011","Croydon 043C","E01001025","Total",1296,624,672,1296,0,27,22.82,56.8
"2011","Croydon 043D","E01001026","Total",1729,815,914,1729,0,28,27.71,62.4
"2011","Croydon 043E","E01001027","Total",1582,795,787,1567,15,26,144.57,10.9
"2011","Croydon 044A","E01001018","Total",1556,742,814,1556,0,31,95.09,16.4
"2011","Croydon 044B","E01001019","Total",1511,751,760,1511,0,21,59.83,25.3
"2011","Croydon 044C","E01001020","Total",1630,746,884,1615,15,23,36.02,45.3
"2011","Croydon 044D","E01001021","Total",1332,602,730,1332,0,9,204.26,6.5
"2011","Croydon 044E","E01001022","Total",1446,715,731,1441,5,23,99.75,14.5
"2011","Croydon 045A","E01000990","Total",1420,657,763,1420,0,13,16.80,84.5
"2011","Croydon 045B","E01001189","Total",1211,557,654,1211,0,12,11.79,102.7
"2011","Croydon 045C","E01001190","Total",1586,699,887,1586,0,26,25.22,62.9
"2011","Croydon 045D","E01001194","Total",1572,747,825,1572,0,12,54.26,29.0
"2011","Croydon 045E","E01032569","Total",1731,778,953,1731,0,17,31.29,55.3
"2011","Ealing 001A","E01001269","Total",1983,1023,960,1983,0,15,29.11,68.1
"2011","Ealing 001B","E01001271","Total",1804,939,865,1802,2,27,33.91,53.2
"2011","Ealing 001C","E01001309","Total",1830,940,890,1830,0,28,33.41,54.8
"2011","Ealing 001D","E01001310","Total",1801,921,880,1789,12,25,23.76,75.8
"2011","Ealing 001E","E01001311","Total",2082,1042,1040,1977,105,17,32.12,64.8
"2011","Ealing 002A","E01001307","Total",1833,970,863,1833,0,23,57.25,32.0
"2011","Ealing 002B","E01001308","Total",2042,1005,1037,2042,0,22,111.14,18.4
"2011","Ealing 002C","E01001312","Total",1839,919,920,1839,0,22,20.50,89.7
"2011","Ealing 002D","E01001313","Total",1701,863,838,1701,0,20,17.29,98.4
"2011","Ealing 002E","E01001314","Total",1585,806,779,1585,0,13,29.32,54.1
"2011","Ealing 003A","E01001315","Total",1461,707,754,1461,0,14,16.44,88.9
"2011","Ealing 003B","E01001316","Total",1583,760,823,1583,0,21,18.20,87.0
"2011","Ealing 003C","E01001317","Total",1862,908,954,1862,0,20,33.76,55.2
"2011","Ealing 003D","E01001318","Total",1790,879,911,1790,0,15,25.45,70.3
"2011","Ealing 003E","E01001320","Total",1548,690,858,1548,0,15,45.80,33.8
"2011","Ealing 003F","E01001321","Total",2021,1010,1011,2021,0,14,33.15,61.0
"2011","Ealing 004A","E01001270","Total",1721,880,841,1721,0,17,28.15,61.1
"2011","Ealing 004B","E01001319","Total",1498,716,782,1498,0,18,13.99,107.1
"2011","Ealing 004C","E01001322","Total",1692,841,851,1692,0,16,54.52,31.0
"2011","Ealing 004D","E01001323","Total",1728,851,877,1728,0,8,33.85,51.0
"2011","Ealing 005A","E01001341","Total",1712,908,804,1712,0,11,22.92,74.7
"2011","Ealing 005B","E01001342","Total",1867,958,909,1867,0,16,18.99,98.3
"2011","Ealing 005C","E01001343","Total",1504,769,735,1504,0,20,28.83,52.2
"2011","Ealing 005D","E01001345","Total",1680,892,788,1680,0,21,18.11,92.8
"2011","Ealing 006A","E01001265","Total",1692,844,848,1692,0,27,50.09,33.8
"2011","Ealing 006B","E01001266","Total",1832,948,884,1832,0,27,73.31,25.0
"2011","Ealing 006C","E01001267","Total",1953,941,1012,1932,21,5,38.39,50.9
"2011","Ealing 006D","E01001272","Total",1628,833,795,1607,21,14,54.77,29.7
"2011","Ealing 006E","E01001349","Total",1404,720,684,1404,0,17,68.04,20.6
"2011","Ealing 007A","E01001344","Total",2161,1083,1078,2161,0,20,48.31,44.7
"2011","Ealing 007B","E01001346","Total",1878,940,938,1878,0,29,22.98,81.7
"2011","Ealing 007C","E01001347","Total",1534,806,728,1534,0,17,67.24,22.8
"2011","Ealing 007D","E01001348","Total",1599,838,761,1599,0,22,41.14,38.9
"2011","Ealing 008A","E01001257","Total",1783,846,937,1783,0,18,16.48,108.2
"2011","Ealing 008B","E01001324","Total",1553,779,774,1541,12,15,31.64,49.1
"2011","Ealing 008C","E01001326","Total",1719,798,921,1719,0,20,74.01,23.2
"2011","Ealing 008D","E01001330","Total",1598,805,793,1598,0,12,29.69,53.8
"2011","Ealing 008E","E01001332","Total",1503,699,804,1503,0,13,13.72,109.5
"2011","Ealing 009A","E01001325","Total",1758,860,898,1758,0,12,95.15,18.5
"2011","Ealing 009B","E01001327","Total",1803,903,900,1803,0,14,27.82,64.8
"2011","Ealing 009C","E01001328","Total",1730,849,881,1730,0,20,38.34,45.1
"2011","Ealing 009D","E01001329","Total",1783,869,914,1783,0,23,30.19,59.1
"2011","Ealing 009E","E01001331","Total",1674,812,862,1674,0,15,14.24,117.6
"2011","Ealing 010B","E01001258","Total",1690,833,857,1690,0,17,21.23,79.6
"2011","Ealing 010C","E01001262","Total",1592,758,834,1522,70,27,25.95,61.3
"2011","Ealing 010D","E01001263","Total",1672,833,839,1672,0,22,32.81,51.0
"2011","Ealing 010E","E01001264","Total",1655,796,859,1655,0,18,30.36,54.5
"2011","Ealing 010F","E01032743","Total",2173,1007,1166,2173,0,16,9.58,226.8
"2011","Ealing 010G","E01032744","Total",1526,725,801,1378,148,3,19.88,76.8
"2011","Ealing 011A","E01001276","Total",1788,896,892,1788,0,18,36.05,49.6
"2011","Ealing 011B","E01001277","Total",1844,947,897,1844,0,19,54.27,34.0
"2011","Ealing 011C","E01001278","Total",1962,952,1010,1962,0,21,45.25,43.4
"2011","Ealing 011D","E01001280","Total",1740,848,892,1740,0,13,37.11,46.9
"2011","Ealing 012A","E01001218","Total",1908,922,986,1908,0,24,27.63,69.1
"2011","Ealing 012B","E01001260","Total",1899,938,961,1899,0,21,26.81,70.8
"2011","Ealing 012C","E01001261","Total",2178,1123,1055,2135,43,17,42.97,50.7
"2011","Ealing 012D","E01001268","Total",1736,859,877,1736,0,22,30.42,57.1
"2011","Ealing 013A","E01001209","Total",1712,829,883,1712,0,40,27.67,61.9
"2011","Ealing 013B","E01001211","Total",1702,809,893,1649,53,43,18.02,94.5
"2011","Ealing 013C","E01001279","Total",1473,712,761,1473,0,44,25.31,58.2
"2011","Ealing 013D","E01001281","Total",1600,743,857,1533,67,19,28.78,55.6
"2011","Ealing 014A","E01001217","Total",1539,788,751,1539,0,22,18.69,82.3
"2011","Ealing 014B","E01001259","Total",1457,725,732,1457,0,21,26.09,55.8
"2011","Ealing 014C","E01001291","Total",1642,839,803,1642,0,18,16.57,99.1
"2011","Ealing 014D","E01001292","Total",1708,850,858,1708,0,29,18.64,91.6
"2011","Ealing 014E","E01001293","Total",1598,806,792,1598,0,23,14.58,109.6
"2011","Ealing 015A","E01001196","Total",1766,857,909,1727,39,11,22.92,77.1
"2011","Ealing 015B","E01001238","Total",2868,1580,1288,2868,0,23,41.15,69.7
"2011","Ealing 015C","E01001239","Total",1542,793,749,1522,20,18,41.52,37.1
"2011","Ealing 015D","E01001246","Total",1360,669,691,1360,0,6,100.54,13.5
"2011","Ealing 015E","E01001247","Total",2170,1174,996,2170,0,18,113.51,19.1
"2011","Ealing 016A","E01001210","Total",1679,833,846,1675,4,22,22.63,74.2
"2011","Ealing 016B","E01001282","Total",1557,746,811,1557,0,19,15.01,103.7
"2011","Ealing 016C","E01001283","Total",1595,753,842,1595,0,7,26.07,61.2
"2011","Ealing 016D","E01001285","Total",1690,842,848,1627,63,15,21.32,79.3
"2011","Ealing 016E","E01001286","Total",1674,794,880,1674,0,25,21.36,78.4
"2011","Ealing 016F","E01001287","Total",1437,647,790,1437,0,17,9.22,155.9
"2011","Ealing 017A","E01001294","Total",1894,941,953,1894,0,22,29.70,63.8
"2011","Ealing 017B","E01001295","Total",1826,923,903,1826,0,26,16.00,114.1
"2011","Ealing 017C","E01001296","Total",1481,764,717,1481,0,22,15.82,93.6
"2011","Ealing 017D","E01001297","Total",1814,910,904,1814,0,24,25.04,72.4
"2011","Ealing 017E","E01001298","Total",1934,1004,930,1812,122,23,17.54,110.3
"2011","Ealing 018A","E01001204","Total",1589,776,813,1586,3,40,16.84,94.4
"2011","Ealing 018B","E01001205","Total",1559,738,821,1559,0,15,24.62,63.3
"2011","Ealing 018C","E01001206","Total",1714,802,912,1714,0,22,14.98,114.4
"2011","Ealing 018D","E01001207","Total",1570,781,789,1570,0,19,15.96,98.4
"2011","Ealing 018E","E01001208","Total",1366,655,711,1366,0,48,53.90,25.3
"2011","Ealing 018F","E01001212","Total",1667,831,836,1534,133,26,28.55,58.4
"2011","Ealing 019A","E01001222","Total",2384,1202,1182,2381,3,25,18.92,126.0
"2011","Ealing 019B","E01001224","Total",1616,790,826,1609,7,56,23.92,67.6
"2011","Ealing 019C","E01001226","Total",1535,757,778,1491,44,27,22.92,67.0
"2011","Ealing 019D","E01001227","Total",1514,756,758,1490,24,38,17.29,87.6
"2011","Ealing 019E","E01001228","Total",1812,876,936,1680,132,35,26.59,68.1
"2011","Ealing 020A","E01001221","Total",1861,900,961,1837,24,9,30.27,61.5
"2011","Ealing 020B","E01001223","Total",1517,773,744,1408,109,37,22.33,67.9
"2011","Ealing 020C","E01001225","Total",1790,851,939,1772,18,40,23.43,76.4
"2011","Ealing 020D","E01001235","Total",1597,817,780,1487,110,10,27.45,58.2
"2011","Ealing 020E","E01001236","Total",1590,810,780,1587,3,19,14.01,113.5
"2011","Ealing 020F","E01001273","Total",1623,800,823,1623,0,30,38.90,41.7
"2011","Ealing 020G","E01001274","Total",1630,797,833,1630,0,21,26.81,60.8
"2011","Ealing 020H","E01001275","Total",1901,955,946,1866,35,20,34.91,54.5
"2011","Ealing 021A","E01001195","Total",1833,962,871,1833,0,5,41.43,44.2
"2011","Ealing 021B","E01001197","Total",1753,852,901,1700,53,16,40.31,43.5
"2011","Ealing 021C","E01001198","Total",1440,739,701,1432,8,18,10.94,131.6
"2011","Ealing 021D","E01001199","Total",1704,860,844,1694,10,16,10.58,161.1
"2011","Ealing 022A","E01001284","Total",1539,762,777,1539,0,30,47.28,32.6
"2011","Ealing 022B","E01001288","Total",1498,722,776,1497,1,23,17.29,86.6
"2011","Ealing 022C","E01001289","Total",1383,660,723,1383,0,36,12.54,110.3
"2011","Ealing 022D","E01001290","Total",1856,901,955,1856,0,43,50.69,36.6
"2011","Ealing 023A","E01001213","Total",1830,966,864,1810,20,17,15.10,121.2
"2011","Ealing 023B","E01001214","Total",1749,902,847,1749,0,19,23.27,75.2
"2011","Ealing 023C","E01001215","Total",1765,868,897,1765,0,18,17.39,101.5
"2011","Ealing 023D","E01001216","Total",1564,818,746,1537,27,19,14.17,110.4
"2011","Ealing 023E","E01001361","Total",1802,946,856,1671,131,9,38.71,46.6
"2011","Ealing 024A","E01001240","Total",1615,802,813,1615,0,15,19.63,82.3
"2011","Ealing 024B","E01001241","Total",1501,786,715,1501,0,21,35.34,42.5
"2011","Ealing 024C","E01001242","Total",1455,703,752,1441,14,28,20.85,69.8
"2011","Ealing 024D","E01001243","Total",1742,850,892,1742,0,9,22.19,78.5
"2011","Ealing 024E","E01001244","Total",2539,1205,1334,2539,0,19,21.37,118.8
"2011","Ealing 024F","E01001245","Total",1914,926,988,1914,0,22,11.08,172.7
"2011","Ealing 025A","E01001200","Total",1516,768,748,1508,8,23,13.53,112.0
"2011","Ealing 025B","E01001201","Total",1561,734,827,1537,24,27,12.26,127.3
"2011","Ealing 025C","E01001202","Total",2120,1093,1027,2114,6,11,16.34,129.7
"2011","Ealing 025D","E01001203","Total",1734,880,854,1732,2,4,9.22,188.1
"2011","Ealing 025E","E01001351","Total",1994,981,1013,1864,130,18,19.39,102.8
"2011","Ealing 026A","E01001359","Total",2201,1190,1011,2201,0,21,13.27,165.9
"2011","Ealing 026B","E01001360","Total",1923,994,929,1923,0,15,14.05,136.9
"2011","Ealing 026C","E01001362","Total",1935,1061,874,1896,39,14,24.41,79.3
"2011","Ealing 026D","E01001363","Total",1685,879,806,1685,0,12,13.53,124.5
"2011","Ealing 026E","E01001364","Total",1676,844,832,1676,0,14,11.87,141.2
"2011","Ealing 026F","E01001365","Total",2217,1205,1012,2194,23,23,46.39,47.8
"2011","Ealing 027A","E01001231","Total",1866,957,909,1866,0,19,40.19,46.4
"2011","Ealing 027B","E01001234","Total",1401,701,700,1391,10,16,30.59,45.8
"2011","Ealing 027C","E01001350","Total",1486,728,758,1483,3,37,29.84,49.8
"2011","Ealing 027D","E01001352","Total",1510,750,760,1495,15,31,16.01,94.3
"2011","Ealing 027E","E01001354","Total",1840,904,936,1744,96,44,27.04,68.0
"2011","Ealing 028A","E01001249","Total",2370,1159,1211,2316,54,20,15.56,152.3
"2011","Ealing 028B","E01001250","Total",2041,1001,1040,2005,36,10,24.73,82.5
"2011","Ealing 028C","E01001255","Total",1610,760,850,1603,7,14,17.74,90.8
"2011","Ealing 028D","E01001383","Total",1791,933,858,1768,23,25,11.57,154.8
"2011","Ealing 028E","E01001388","Total",1640,840,800,1640,0,14,17.81,92.1
"2011","Ealing 028F","E01001389","Total",1667,849,818,1649,18,24,13.95,119.5
"2011","Ealing 029A","E01001219","Total",2046,985,1061,2015,31,24,16.51,123.9
"2011","Ealing 029B","E01001220","Total",1509,692,817,1509,0,20,93.09,16.2
"2011","Ealing 029C","E01001334","Total",1623,809,814,1623,0,13,15.89,102.1
"2011","Ealing 029D","E01001337","Total",1470,719,751,1388,82,11,121.77,12.1
"2011","Ealing 029E","E01001338","Total",1953,1023,930,1894,59,10,54.70,35.7
"2011","Ealing 029F","E01001339","Total",1841,887,954,1841,0,19,72.62,25.4
"2011","Ealing 029G","E01001340","Total",1889,1026,863,1368,521,14,12.17,155.2
"2011","Ealing 030A","E01001251","Total",1654,798,856,1654,0,20,18.68,88.5
"2011","Ealing 030B","E01001252","Total",1938,1003,935,1938,0,11,19.37,100.1
"2011","Ealing 030C","E01001253","Total",1649,804,845,1646,3,15,16.33,101.0
"2011","Ealing 030D","E01001254","Total",1685,798,887,1675,10,19,20.97,80.4
"2011","Ealing 031A","E01001229","Total",1522,706,816,1522,0,16,20.38,74.7
"2011","Ealing 031B","E01001230","Total",1488,740,748,1372,116,22,19.13,77.8
"2011","Ealing 031C","E01001232","Total",1538,778,760,1538,0,30,21.58,71.3
"2011","Ealing 031D","E01001233","Total",1424,709,715,1424,0,10,17.06,83.5
"2011","Ealing 031E","E01001237","Total",1593,843,750,1476,117,35,23.60,67.5
"2011","Ealing 031F","E01001386","Total",1793,890,903,1793,0,20,30.84,58.1
"2011","Ealing 032A","E01001303","Total",1639,785,854,1639,0,34,16.07,102.0
"2011","Ealing 032B","E01001382","Total",1566,772,794,1566,0,33,20.39,76.8
"2011","Ealing 032C","E01001384","Total",1645,798,847,1645,0,13,10.89,151.1
"2011","Ealing 032D","E01001385","Total",1682,807,875,1682,0,27,16.02,105.0
"2011","Ealing 032E","E01001387","Total",1546,785,761,1471,75,22,25.13,61.5
"2011","Ealing 033A","E01001353","Total",1667,802,865,1664,3,23,19.57,85.2
"2011","Ealing 033B","E01001355","Total",1664,837,827,1664,0,7,14.63,113.7
"2011","Ealing 033C","E01001356","Total",1969,924,1045,1969,0,25,8.38,235.0
"2011","Ealing 033D","E01001357","Total",1141,529,612,1141,0,17,11.13,102.5
"2011","Ealing 033E","E01001358","Total",1602,791,811,1602,0,10,25.91,61.8
"2011","Ealing 034A","E01001375","Total",1665,803,862,1665,0,29,13.85,120.2
"2011","Ealing 034B","E01001377","Total",1770,871,899,1764,6,52,19.06,92.9
"2011","Ealing 034C","E01001379","Total",1679,802,877,1679,0,26,13.32,126.1
"2011","Ealing 034D","E01001381","Total",1649,855,794,1649,0,8,28.52,57.8
"2011","Ealing 035A","E01001248","Total",1592,778,814,1547,45,26,66.64,23.9
"2011","Ealing 035B","E01001299","Total",1833,904,929,1833,0,36,22.81,80.4
"2011","Ealing 035C","E01001305","Total",1716,848,868,1716,0,33,15.07,113.9
"2011","Ealing 035D","E01001306","Total",1607,788,819,1607,0,23,15.36,104.6
"2011","Ealing 037A","E01001366","Total",1923,1016,907,1914,9,11,17.04,112.9
"2011","Ealing 037B","E01001367","Total",1764,1015,749,1764,0,13,20.33,86.8
"2011","Ealing 037C","E01001368","Total",1723,916,807,1723,0,24,12.87,133.9
"2011","Ealing 037D","E01001370","Total",1980,1038,942,1980,0,24,44.84,44.2
"2011","Ealing 037E","E01001371","Total",2081,1068,1013,2081,0,9,20.25,102.8
"2011","Ealing 037F","E01001372","Total",1763,970,793,1763,0,16,12.86,137.1
"2011","Ealing 037G","E01001373","Total",1499,823,676,1499,0,13,15.34,97.7
"2011","Ealing 038A","E01001333","Total",1903,1022,881,1806,97,10,27.82,68.4
"2011","Ealing 038B","E01001335","Total",1781,866,915,1699,82,45,49.09,36.3
"2011","Ealing 038C","E01001336","Total",1572,794,778,1572,0,20,25.34,62.0
"2011","Ealing 038D","E01001369","Total",1846,949,897,1846,0,28,15.01,123.0
"2011","Ealing 039A","E01001300","Total",1692,855,837,1688,4,17,13.76,123.0
"2011","Ealing 039B","E01001301","Total",1782,944,838,1523,259,8,25.12,70.9
"2011","Ealing 039C","E01001302","Total",1621,844,777,1621,0,27,33.69,48.1
"2011","Ealing 039D","E01001304","Total",1627,806,821,1627,0,18,11.57,140.6
"2011","Ealing 040A","E01001374","Total",1798,876,922,1798,0,11,12.98,138.5
"2011","Ealing 040B","E01001376","Total",1579,785,794,1579,0,13,15.55,101.5
"2011","Ealing 040C","E01001380","Total",1759,869,890,1759,0,13,17.56,100.2
"2011","Ealing 040D","E01032572","Total",1575,784,791,1575,0,15,22.45,70.2
"2011","Enfield 001A","E01001444","Total",1676,784,892,1676,0,26,34.72,48.3
"2011","Enfield 001B","E01001446","Total",1817,895,922,1817,0,29,18.07,100.6
"2011","Enfield 001C","E01001546","Total",1783,861,922,1783,0,13,23.86,74.7
"2011","Enfield 001D","E01001552","Total",1805,851,954,1762,43,22,28.05,64.3
"2011","Enfield 002A","E01001442","Total",1684,768,916,1661,23,22,11.51,146.3
"2011","Enfield 002B","E01001545","Total",1843,867,976,1841,2,16,34.51,53.4
"2011","Enfield 002C","E01001547","Total",1758,861,897,1758,0,19,24.87,70.7
"2011","Enfield 002D","E01001548","Total",1819,887,932,1819,0,24,29.97,60.7
"2011","Enfield 002E","E01001551","Total",1733,792,941,1692,41,16,30.62,56.6
"2011","Enfield 003B","E01001445","Total",2284,1088,1196,2281,3,26,141.43,16.1
"2011","Enfield 003C","E01001447","Total",1936,921,1015,1936,0,13,18.61,104.0
"2011","Enfield 003D","E01001448","Total",1831,888,943,1831,0,19,15.75,116.3
"2011","Enfield 003E","E01001449","Total",1635,787,848,1635,0,9,23.55,69.4
"2011","Enfield 003F","E01033148","Total",1950,906,1044,1950,0,28,45.05,43.3
"2011","Enfield 003G","E01033150","Total",1656,738,918,1656,0,6,16.43,100.8
"2011","Enfield 004A","E01001408","Total",1646,759,887,1646,0,15,14.56,113.0
"2011","Enfield 004B","E01001411","Total",1840,856,984,1840,0,19,18.59,99.0
"2011","Enfield 004C","E01001412","Total",1834,900,934,1834,0,22,1432.80,1.3
"2011","Enfield 004D","E01001413","Total",1632,782,850,1581,51,26,51.07,32.0
"2011","Enfield 004E","E01001414","Total",1563,726,837,1563,0,12,39.44,39.6
"2011","Enfield 005A","E01001407","Total",1637,781,856,1627,10,21,103.18,15.9
"2011","Enfield 005B","E01001409","Total",1889,916,973,1881,8,13,18.87,100.1
"2011","Enfield 005C","E01001410","Total",1721,812,909,1667,54,13,15.92,108.1
"2011","Enfield 005D","E01001516","Total",1834,879,955,1825,9,18,32.81,55.9
"2011","Enfield 005E","E01001537","Total",1754,812,942,1705,49,13,19.00,92.3
"2011","Enfield 006A","E01001439","Total",2075,965,1110,2074,1,12,20.99,98.9
"2011","Enfield 006B","E01001441","Total",1514,716,798,1512,2,14,33.28,45.5
"2011","Enfield 006C","E01001517","Total",1890,893,997,1890,0,20,18.15,104.1
"2011","Enfield 006D","E01001549","Total",1975,934,1041,1975,0,21,32.05,61.6
"2011","Enfield 006E","E01001550","Total",1661,737,924,1661,0,21,21.76,76.3
"2011","Enfield 007A","E01001433","Total",1827,842,985,1822,5,12,33.44,54.6
"2011","Enfield 007B","E01001434","Total",1572,783,789,1567,5,9,17.65,89.1
"2011","Enfield 007C","E01001435","Total",1480,708,772,1480,0,18,15.75,94.0
"2011","Enfield 007D","E01001436","Total",1886,911,975,1883,3,19,19.55,96.5
"2011","Enfield 007E","E01001438","Total",1659,778,881,1656,3,14,27.67,60.0
"2011","Enfield 008A","E01001469","Total",1645,818,827,1630,15,18,22.51,73.1
"2011","Enfield 008B","E01001536","Total",1717,835,882,1699,18,29,43.33,39.6
"2011","Enfield 008C","E01001540","Total",1763,849,914,1763,0,39,25.88,68.1
"2011","Enfield 008D","E01001541","Total",1504,735,769,1497,7,27,18.16,82.8
"2011","Enfield 008E","E01001542","Total",1571,743,828,1563,8,22,18.43,85.2
"2011","Enfield 009A","E01001538","Total",1660,799,861,1660,0,32,25.47,65.2
"2011","Enfield 009B","E01001539","Total",1668,783,885,1653,15,28,21.92,76.1
"2011","Enfield 009C","E01001543","Total",1672,837,835,1672,0,35,20.81,80.3
"2011","Enfield 009D","E01001544","Total",1597,785,812,1583,14,23,30.32,52.7
"2011","Enfield 010A","E01001457","Total",1633,793,840,1576,57,18,26.53,61.6
"2011","Enfield 010B","E01001468","Total",1339,712,627,1205,134,23,78.39,17.1
"2011","Enfield 010C","E01001471","Total",1737,846,891,1710,27,17,36.50,47.6
"2011","Enfield 010D","E01001472","Total",1682,782,900,1682,0,29,25.07,67.1
"2011","Enfield 010E","E01001474","Total",1767,878,889,1767,0,33,38.58,45.8
"2011","Enfield 011A","E01001415","Total",1541,735,806,1541,0,28,108.28,14.2
"2011","Enfield 011B","E01001417","Total",1974,921,1053,1673,301,53,570.13,3.5
"2011","Enfield 011C","E01001418","Total",1650,809,841,1639,11,24,62.00,26.6
"2011","Enfield 011D","E01001422","Total",1658,828,830,1641,17,73,146.34,11.3
"2011","Enfield 012A","E01001440","Total",1641,794,847,1641,0,11,31.46,52.2
"2011","Enfield 012B","E01001504","Total",1549,751,798,1540,9,19,18.15,85.3
"2011","Enfield 012C","E01001505","Total",1727,845,882,1727,0,18,19.45,88.8
"2011","Enfield 012D","E01001507","Total",1870,927,943,1870,0,16,26.79,69.8
"2011","Enfield 012E","E01001508","Total",1933,925,1008,1914,19,24,20.75,93.2
"2011","Enfield 012F","E01001513","Total",1770,848,922,1770,0,15,95.02,18.6
"2011","Enfield 013A","E01001416","Total",1733,843,890,1733,0,31,32.44,53.4
"2011","Enfield 013B","E01001470","Total",1598,745,853,1598,0,30,189.66,8.4
"2011","Enfield 013C","E01001473","Total",1534,738,796,1534,0,25,84.26,18.2
"2011","Enfield 013D","E01001475","Total",1704,819,885,1704,0,41,33.76,50.5
"2011","Enfield 014A","E01001437","Total",2373,1133,1240,2373,0,18,264.11,9.0
"2011","Enfield 014B","E01001506","Total",1635,776,859,1635,0,18,194.62,8.4
"2011","Enfield 014C","E01001509","Total",1738,838,900,1738,0,19,14.58,119.2
"2011","Enfield 014D","E01001510","Total",1496,725,771,1496,0,9,15.04,99.5
"2011","Enfield 015A","E01001405","Total",1691,839,852,1641,50,19,27.56,61.4
"2011","Enfield 015B","E01001406","Total",1629,768,861,1598,31,25,20.41,79.8
"2011","Enfield 015C","E01001450","Total",1878,949,929,1865,13,19,35.76,52.5
"2011","Enfield 015D","E01001512","Total",1780,869,911,1767,13,15,19.05,93.4
"2011","Enfield 015E","E01001515","Total",1946,949,997,1938,8,15,12.95,150.3
"2011","Enfield 016A","E01001401","Total",1323,633,690,1323,0,15,14.75,89.7
"2011","Enfield 016B","E01001478","Total",1538,765,773,1531,7,14,31.80,48.4
"2011","Enfield 016C","E01001484","Total",1371,661,710,1362,9,5,32.94,41.6
"2011","Enfield 016D","E01001511","Total",1751,815,936,1747,4,16,38.86,45.1
"2011","Enfield 016E","E01001514","Total",1768,849,919,1765,3,20,13.68,129.2
"2011","Enfield 016F","E01001518","Total",1767,854,913,1767,0,26,55.87,31.6
"2011","Enfield 017A","E01001451","Total",1641,837,804,1621,20,22,61.98,26.5
"2011","Enfield 017B","E01001452","Total",1356,685,671,1356,0,36,63.85,21.2
"2011","Enfield 017C","E01001453","Total",1677,832,845,1677,0,37,51.37,32.6
"2011","Enfield 017D","E01001454","Total",1633,792,841,1620,13,30,38.69,42.2
"2011","Enfield 018A","E01001476","Total",1666,800,866,1666,0,23,20.24,82.3
"2011","Enfield 018B","E01001477","Total",1850,884,966,1850,0,31,67.52,27.4
"2011","Enfield 018C","E01001481","Total",1647,780,867,1620,27,11,17.18,95.9
"2011","Enfield 018D","E01001502","Total",1872,900,972,1720,152,28,28.07,66.7
"2011","Enfield 018E","E01001503","Total",1844,876,968,1844,0,18,17.04,108.2
"2011","Enfield 019A","E01001520","Total",1680,804,876,1680,0,19,35.26,47.6
"2011","Enfield 019B","E01001522","Total",1805,863,942,1727,78,20,20.51,88.0
"2011","Enfield 019C","E01001523","Total",1739,854,885,1739,0,24,52.06,33.4
"2011","Enfield 019D","E01001524","Total",1531,707,824,1522,9,22,25.76,59.4
"2011","Enfield 019E","E01001526","Total",1619,780,839,1619,0,18,28.42,57.0
"2011","Enfield 020A","E01001419","Total",1946,897,1049,1938,8,28,66.58,29.2
"2011","Enfield 020B","E01001420","Total",1570,735,835,1553,17,14,35.57,44.1
"2011","Enfield 020C","E01001421","Total",1716,788,928,1672,44,19,19.36,88.6
"2011","Enfield 020D","E01001519","Total",2496,1240,1256,2496,0,13,35.25,70.8
"2011","Enfield 020E","E01001525","Total",1807,851,956,1747,60,14,23.43,77.1
"2011","Enfield 021A","E01001398","Total",1392,686,706,1368,24,40,17.47,79.7
"2011","Enfield 021B","E01001399","Total",1437,713,724,1437,0,23,24.27,59.2
"2011","Enfield 021C","E01001400","Total",1543,718,825,1528,15,30,24.37,63.3
"2011","Enfield 021D","E01001402","Total",1833,904,929,1809,24,30,35.09,52.2
"2011","Enfield 021E","E01001403","Total",1602,773,829,1602,0,19,37.02,43.3
"2011","Enfield 021F","E01001455","Total",1491,738,753,1491,0,34,23.81,62.6
"2011","Enfield 022A","E01001456","Total",1400,719,681,1400,0,31,26.63,52.6
"2011","Enfield 022B","E01001564","Total",1666,794,872,1624,42,20,23.13,72.0
"2011","Enfield 022C","E01001567","Total",1583,782,801,1583,0,24,30.99,51.1
"2011","Enfield 022D","E01001568","Total",1583,802,781,1580,3,30,89.82,17.6
"2011","Enfield 022E","E01001569","Total",1744,881,863,1722,22,21,29.44,59.2
"2011","Enfield 023A","E01001479","Total",1730,854,876,1683,47,19,24.46,70.7
"2011","Enfield 023B","E01001482","Total",1854,915,939,1854,0,26,17.65,105.0
"2011","Enfield 023C","E01001487","Total",1949,909,1040,1949,0,12,12.95,150.5
"2011","Enfield 023D","E01001489","Total",1803,880,923,1803,0,11,17.82,101.2
"2011","Enfield 023E","E01001491","Total",1976,936,1040,1973,3,28,14.82,133.3
"2011","Enfield 024A","E01001459","Total",1675,820,855,1675,0,22,21.66,77.3
"2011","Enfield 024B","E01001460","Total",1711,823,888,1689,22,10,12.26,139.6
"2011","Enfield 024C","E01001462","Total",1339,639,700,1339,0,12,10.91,122.7
"2011","Enfield 024D","E01001480","Total",1549,752,797,1516,33,10,19.72,78.5
"2011","Enfield 024E","E01001488","Total",1883,899,984,1883,0,33,13.15,143.2
"2011","Enfield 025A","E01001483","Total",1150,577,573,1150,0,3,55.93,20.6
"2011","Enfield 025B","E01001485","Total",1815,854,961,1815,0,11,12.62,143.8
"2011","Enfield 025C","E01001486","Total",2106,974,1132,2106,0,11,18.06,116.6
"2011","Enfield 025E","E01001492","Total",1930,898,1032,1930,0,22,15.35,125.7
"2011","Enfield 025F","E01033146","Total",1586,776,810,1586,0,20,13.84,114.6
"2011","Enfield 025G","E01033151","Total",1483,708,775,1483,0,16,66.50,22.3
"2011","Enfield 026A","E01001404","Total",1473,715,758,1473,0,21,51.69,28.5
"2011","Enfield 026B","E01001493","Total",1773,883,890,1767,6,11,23.29,76.1
"2011","Enfield 026C","E01001494","Total",1520,725,795,1515,5,8,16.22,93.7
"2011","Enfield 026D","E01001496","Total",1705,794,911,1701,4,31,26.17,65.2
"2011","Enfield 026E","E01001570","Total",1855,914,941,1820,35,21,40.66,45.6
"2011","Enfield 027A","E01001423","Total",1805,854,951,1800,5,19,19.16,94.2
"2011","Enfield 027B","E01001425","Total",1862,873,989,1859,3,12,40.22,46.3
"2011","Enfield 027C","E01001428","Total",1677,808,869,1677,0,20,15.75,106.5
"2011","Enfield 027D","E01001461","Total",1716,789,927,1706,10,16,28.93,59.3
"2011","Enfield 027E","E01001464","Total",1330,643,687,1330,0,21,20.17,65.9
"2011","Enfield 028A","E01001521","Total",1777,834,943,1756,21,44,48.40,36.7
"2011","Enfield 028B","E01001531","Total",1498,752,746,1462,36,42,22.80,65.7
"2011","Enfield 028C","E01001532","Total",1764,873,891,1764,0,49,28.87,61.1
"2011","Enfield 028D","E01001533","Total",1568,747,821,1533,35,33,32.75,47.9
"2011","Enfield 028E","E01001535","Total",1482,730,752,1482,0,21,39.25,37.8
"2011","Enfield 029A","E01001495","Total",1715,868,847,1715,0,29,15.41,111.3
"2011","Enfield 029B","E01001498","Total",1946,979,967,1939,7,22,19.06,102.1
"2011","Enfield 029C","E01001563","Total",1615,816,799,1585,30,23,19.46,83.0
"2011","Enfield 029D","E01001565","Total",1636,783,853,1636,0,32,22.31,73.3
"2011","Enfield 029E","E01001566","Total",1721,864,857,1598,123,51,19.86,86.7
"2011","Enfield 030A","E01001424","Total",1210,564,646,1210,0,8,7.18,168.5
"2011","Enfield 030B","E01001426","Total",1821,878,943,1821,0,14,30.82,59.1
"2011","Enfield 030C","E01001427","Total",1840,880,960,1840,0,27,134.71,13.7
"2011","Enfield 030D","E01001429","Total",2394,1111,1283,2394,0,23,24.34,98.4
"2011","Enfield 030E","E01001430","Total",1884,854,1030,1884,0,15,11.68,161.3
"2011","Enfield 031A","E01001463","Total",1573,769,804,1573,0,26,26.18,60.1
"2011","Enfield 031B","E01001465","Total",1505,733,772,1505,0,23,22.83,65.9
"2011","Enfield 031C","E01001466","Total",1795,830,965,1795,0,16,9.88,181.7
"2011","Enfield 031D","E01001467","Total",1874,936,938,1874,0,27,10.54,177.8
"2011","Enfield 031E","E01001497","Total",1476,706,770,1476,0,7,20.32,72.6
"2011","Enfield 031F","E01001499","Total",1650,800,850,1650,0,27,20.84,79.2
"2011","Enfield 032A","E01001392","Total",1824,921,903,1824,0,21,16.02,113.9
"2011","Enfield 032B","E01001528","Total",1445,673,772,1445,0,5,20.86,69.3
"2011","Enfield 032C","E01001529","Total",1546,808,738,1490,56,9,16.65,92.9
"2011","Enfield 032D","E01001530","Total",1290,658,632,1290,0,7,20.86,61.8
"2011","Enfield 032E","E01001534","Total",1631,821,810,1612,19,26,40.34,40.4
"2011","Enfield 033A","E01001431","Total",1549,764,785,1549,0,13,13.58,114.1
"2011","Enfield 033B","E01001432","Total",1907,949,958,1904,3,10,15.33,124.4
"2011","Enfield 033C","E01001555","Total",1783,889,894,1783,0,14,13.99,127.4
"2011","Enfield 033D","E01001557","Total",1586,777,809,1586,0,18,12.87,123.2
"2011","Enfield 033E","E01001558","Total",1613,780,833,1613,0,21,14.88,108.4
"2011","Enfield 033F","E01001559","Total",2051,967,1084,1977,74,20,92.20,22.2
"2011","Enfield 035A","E01001394","Total",1653,802,851,1653,0,14,17.25,95.8
"2011","Enfield 035B","E01001395","Total",1590,727,863,1590,0,8,23.98,66.3
"2011","Enfield 035C","E01001397","Total",1924,975,949,1924,0,26,29.89,64.4
"2011","Enfield 035D","E01001500","Total",1527,749,778,1516,11,13,22.46,68.0
"2011","Enfield 035E","E01001556","Total",1579,758,821,1579,0,26,21.70,72.8
"2011","Enfield 035F","E01001560","Total",1599,766,833,1599,0,13,26.42,60.5
"2011","Enfield 036A","E01001390","Total",1971,1016,955,1971,0,16,15.36,128.3
"2011","Enfield 036B","E01001391","Total",1564,801,763,1529,35,7,13.24,118.1
"2011","Enfield 036C","E01001393","Total",2112,1068,1044,2112,0,15,17.95,117.7
"2011","Enfield 036D","E01001396","Total",1413,680,733,1413,0,19,14.79,95.5
"2011","Enfield 036E","E01001501","Total",1850,897,953,1816,34,18,30.34,61.0
"2011","Enfield 036F","E01001527","Total",1563,797,766,1563,0,18,39.34,39.7
"2011","Enfield 037A","E01001458","Total",1745,836,909,1724,21,16,16.29,107.1
"2011","Enfield 037B","E01001553","Total",1597,761,836,1597,0,25,20.05,79.7
"2011","Enfield 037C","E01001554","Total",1791,817,974,1791,0,14,12.08,148.3
"2011","Enfield 037D","E01001562","Total",1716,783,933,1654,62,23,14.25,120.4
"2011","Enfield 037E","E01032574","Total",2059,950,1109,2059,0,12,36.44,56.5
"2011","Greenwich 001A","E01001690","Total",1932,960,972,1931,1,18,13.64,141.6
"2011","Greenwich 001B","E01001692","Total",1391,697,694,1391,0,13,7.43,187.2
"2011","Greenwich 001C","E01001693","Total",1558,790,768,1558,0,21,13.63,114.3
"2011","Greenwich 001D","E01001694","Total",1685,843,842,1683,2,7,38.36,43.9
"2011","Greenwich 002A","E01001687","Total",1206,587,619,1206,0,23,41.55,29.0
"2011","Greenwich 002B","E01001688","Total",2623,1231,1392,2500,123,26,35.48,73.9
"2011","Greenwich 002E","E01033739","Total",1443,712,731,1443,0,13,11.75,122.8
"2011","Greenwich 002F","E01033740","Total",1577,776,801,1577,0,16,16.54,95.3
"2011","Greenwich 002G","E01033741","Total",2457,1594,863,1681,776,14,57.02,43.1
"2011","Greenwich 002H","E01033743","Total",2038,969,1069,2038,0,30,100.11,20.4
"2011","Greenwich 002I","E01033745","Total",1820,876,944,1820,0,24,56.40,32.3
"2011","Greenwich 003A","E01001575","Total",1707,794,913,1707,0,17,21.88,78.0
"2011","Greenwich 003B","E01001576","Total",1739,830,909,1700,39,19,23.87,72.9
"2011","Greenwich 003C","E01001577","Total",1857,880,977,1857,0,18,21.11,88.0
"2011","Greenwich 003D","E01001578","Total",2131,1053,1078,2129,2,20,27.17,78.4
"2011","Greenwich 003E","E01001579","Total",1646,774,872,1646,0,16,25.26,65.2
"2011","Greenwich 004B","E01001709","Total",1170,578,592,1170,0,9,77.26,15.1
"2011","Greenwich 004C","E01001711","Total",1413,738,675,1413,0,8,17.40,81.2
"2011","Greenwich 004D","E01001712","Total",2137,1086,1051,2085,52,10,16.70,128.0
"2011","Greenwich 004E","E01033731","Total",1017,508,509,1017,0,7,20.45,49.7
"2011","Greenwich 004F","E01033734","Total",1320,660,660,1320,0,7,9.78,135.0
"2011","Greenwich 004G","E01033735","Total",1073,586,487,1073,0,4,10.41,103.1
"2011","Greenwich 004H","E01033736","Total",1125,627,498,1125,0,3,12.84,87.6
"2011","Greenwich 004I","E01033737","Total",1495,776,719,1495,0,17,23.60,63.3
"2011","Greenwich 005A","E01001705","Total",1993,1019,974,1993,0,14,17.60,113.2
"2011","Greenwich 005B","E01001706","Total",1340,663,677,1321,19,17,11.21,119.5
"2011","Greenwich 005C","E01001708","Total",1595,783,812,1595,0,17,17.72,90.0
"2011","Greenwich 005D","E01001710","Total",1694,822,872,1694,0,7,8.60,197.0
"2011","Greenwich 005E","E01001713","Total",1748,847,901,1690,58,31,10.15,172.2
"2011","Greenwich 006A","E01001672","Total",2049,1083,966,2049,0,19,36.02,56.9
"2011","Greenwich 006B","E01001673","Total",1892,988,904,1892,0,23,17.45,108.4
"2011","Greenwich 006C","E01001674","Total",1973,989,984,1973,0,22,21.43,92.1
"2011","Greenwich 006D","E01001675","Total",1980,1021,959,1980,0,17,15.52,127.6
"2011","Greenwich 006E","E01001677","Total",1948,977,971,1948,0,10,20.06,97.1
"2011","Greenwich 007B","E01001631","Total",2072,1042,1030,2072,0,17,19.70,105.2
"2011","Greenwich 007C","E01001632","Total",2319,1157,1162,2290,29,29,12.05,192.4
"2011","Greenwich 007D","E01001635","Total",1661,873,788,1661,0,15,21.08,78.8
"2011","Greenwich 007E","E01001636","Total",1722,961,761,1722,0,8,12.49,137.9
"2011","Greenwich 007F","E01033742","Total",1352,726,626,1352,0,19,12.57,107.6
"2011","Greenwich 007G","E01033744","Total",1845,909,936,1728,117,6,14.67,125.8
"2011","Greenwich 008A","E01001571","Total",1639,775,864,1639,0,15,14.81,110.7
"2011","Greenwich 008B","E01001572","Total",1711,810,901,1711,0,16,16.84,101.6
"2011","Greenwich 008C","E01001573","Total",1505,762,743,1505,0,14,13.82,108.9
"2011","Greenwich 008D","E01001574","Total",1769,860,909,1748,21,8,100.53,17.6
"2011","Greenwich 009A","E01001629","Total",2176,1061,1115,2176,0,17,20.55,105.9
"2011","Greenwich 009B","E01001633","Total",1607,827,780,1607,0,26,11.52,139.5
"2011","Greenwich 009C","E01001634","Total",1714,792,922,1661,53,11,11.61,147.6
"2011","Greenwich 009D","E01001637","Total",1703,855,848,1703,0,25,18.56,91.8
"2011","Greenwich 011A","E01001695","Total",1626,857,769,1626,0,17,10.01,162.4
"2011","Greenwich 011B","E01001696","Total",1350,670,680,1350,0,10,14.11,95.7
"2011","Greenwich 011C","E01001697","Total",2094,1072,1022,2094,0,17,15.21,137.7
"2011","Greenwich 011D","E01001700","Total",2019,1031,988,2009,10,19,14.34,140.8
"2011","Greenwich 011E","E01001703","Total",1934,970,964,1934,0,26,8.50,227.5
"2011","Greenwich 011F","E01001704","Total",1651,854,797,1618,33,18,13.98,118.1
"2011","Greenwich 012A","E01001588","Total",1692,797,895,1615,77,18,52.12,32.5
"2011","Greenwich 012B","E01001589","Total",1604,826,778,1598,6,11,21.07,76.1
"2011","Greenwich 012C","E01001591","Total",2040,973,1067,2034,6,14,20.18,101.1
"2011","Greenwich 012D","E01001595","Total",1979,927,1052,1934,45,24,36.99,53.5
"2011","Greenwich 014A","E01001590","Total",1777,883,894,1777,0,31,15.55,114.3
"2011","Greenwich 014B","E01001592","Total",1718,821,897,1718,0,20,23.94,71.8
"2011","Greenwich 014C","E01001593","Total",1638,792,846,1631,7,14,18.56,88.3
"2011","Greenwich 014D","E01001594","Total",1937,913,1024,1937,0,27,14.99,129.2
"2011","Greenwich 015A","E01001698","Total",1777,896,881,1774,3,20,12.87,138.1
"2011","Greenwich 015B","E01001699","Total",1848,1111,737,1466,382,18,68.71,26.9
"2011","Greenwich 015C","E01001701","Total",1524,766,758,1520,4,23,95.82,15.9
"2011","Greenwich 015D","E01001702","Total",1676,766,910,1676,0,21,8.48,197.6
"2011","Greenwich 016A","E01001581","Total",1693,816,877,1675,18,24,20.88,81.1
"2011","Greenwich 016B","E01001585","Total",1532,765,767,1525,7,25,17.92,85.5
"2011","Greenwich 016C","E01001586","Total",1491,694,797,1422,69,21,21.39,69.7
"2011","Greenwich 016D","E01001587","Total",1890,957,933,1890,0,32,27.41,69.0
"2011","Greenwich 017A","E01001678","Total",1667,839,828,1667,0,13,26.18,63.7
"2011","Greenwich 017B","E01001683","Total",1519,788,731,1508,11,14,13.33,114.0
"2011","Greenwich 017C","E01001684","Total",1472,703,769,1472,0,10,118.57,12.4
"2011","Greenwich 017D","E01001685","Total",1522,772,750,1522,0,10,18.13,83.9
"2011","Greenwich 019A","E01001646","Total",2829,1351,1478,2828,1,15,21.10,134.1
"2011","Greenwich 019B","E01001650","Total",1733,853,880,1733,0,12,20.85,83.1
"2011","Greenwich 019C","E01001651","Total",1714,852,862,1714,0,10,30.67,55.9
"2011","Greenwich 019D","E01001652","Total",1555,749,806,1530,25,5,26.61,58.4
"2011","Greenwich 020A","E01001679","Total",1346,653,693,1346,0,27,21.31,63.2
"2011","Greenwich 020B","E01001680","Total",1573,798,775,1572,1,22,60.85,25.9
"2011","Greenwich 020C","E01001681","Total",1224,614,610,1224,0,14,15.60,78.5
"2011","Greenwich 020D","E01001682","Total",1333,657,676,1327,6,15,87.02,15.3
"2011","Greenwich 020E","E01001686","Total",1777,882,895,1770,7,21,16.99,104.6
"2011","Greenwich 021A","E01001580","Total",1642,833,809,1642,0,19,29.76,55.2
"2011","Greenwich 021B","E01001582","Total",1475,695,780,1442,33,25,34.22,43.1
"2011","Greenwich 021C","E01001583","Total",1603,812,791,1603,0,32,29.32,54.7
"2011","Greenwich 021D","E01001584","Total",1549,747,802,1465,84,22,32.83,47.2
"2011","Greenwich 022A","E01001645","Total",1697,821,876,1697,0,30,29.01,58.5
"2011","Greenwich 022B","E01001647","Total",1491,742,749,1491,0,29,34.65,43.0
"2011","Greenwich 022C","E01001648","Total",1751,878,873,1751,0,12,41.67,42.0
"2011","Greenwich 022D","E01001649","Total",1530,738,792,1524,6,19,33.23,46.0
"2011","Greenwich 023A","E01001605","Total",1584,772,812,1584,0,25,66.13,24.0
"2011","Greenwich 023B","E01001606","Total",1637,813,824,1637,0,26,21.09,77.6
"2011","Greenwich 023C","E01001610","Total",1669,815,854,1669,0,12,22.09,75.6
"2011","Greenwich 023D","E01001611","Total",1659,829,830,1659,0,17,20.11,82.5
"2011","Greenwich 025A","E01001620","Total",1591,783,808,1591,0,9,26.07,61.0
"2011","Greenwich 025B","E01001621","Total",1491,719,772,1491,0,21,36.67,40.7
"2011","Greenwich 025C","E01001623","Total",1696,837,859,1696,0,17,27.66,61.3
"2011","Greenwich 025D","E01001624","Total",1551,724,827,1551,0,18,22.44,69.1
"2011","Greenwich 025E","E01001625","Total",1577,758,819,1577,0,13,26.98,58.5
"2011","Greenwich 027A","E01001604","Total",1440,736,704,1440,0,19,23.72,60.7
"2011","Greenwich 027B","E01001607","Total",1474,671,803,1474,0,16,21.14,69.7
"2011","Greenwich 027C","E01001608","Total",1454,721,733,1447,7,33,47.17,30.8
"2011","Greenwich 027D","E01001609","Total",1602,798,804,1602,0,20,33.62,47.7
"2011","Greenwich 028A","E01001613","Total",1586,762,824,1586,0,6,73.06,21.7
"2011","Greenwich 028B","E01001614","Total",1409,683,726,1409,0,22,88.61,15.9
"2011","Greenwich 028C","E01001615","Total",1519,783,736,1517,2,11,95.48,15.9
"2011","Greenwich 028D","E01001617","Total",1574,749,825,1574,0,15,69.39,22.7
"2011","Greenwich 029A","E01001653","Total",1547,731,816,1547,0,6,26.62,58.1
"2011","Greenwich 029B","E01001654","Total",1546,711,835,1546,0,15,30.11,51.3
"2011","Greenwich 029C","E01001655","Total",1465,723,742,1465,0,15,43.46,33.7
"2011","Greenwich 029D","E01001660","Total",1600,763,837,1600,0,18,33.48,47.8
"2011","Greenwich 029E","E01001661","Total",1525,728,797,1525,0,9,45.50,33.5
"2011","Greenwich 030C","E01001618","Total",1604,789,815,1604,0,6,34.78,46.1
"2011","Greenwich 030D","E01001619","Total",1880,925,955,1880,0,12,32.24,58.3
"2011","Greenwich 030E","E01033729","Total",2969,1306,1663,1895,1074,30,69.09,43.0
"2011","Greenwich 031A","E01001597","Total",1560,797,763,1543,17,17,32.42,48.1
"2011","Greenwich 031B","E01001598","Total",1587,817,770,1587,0,15,46.52,34.1
"2011","Greenwich 031C","E01001602","Total",1873,874,999,1873,0,18,25.69,72.9
"2011","Greenwich 031D","E01001603","Total",1655,784,871,1655,0,7,21.02,78.7
"2011","Greenwich 032A","E01001596","Total",1564,772,792,1558,6,23,29.31,53.4
"2011","Greenwich 032B","E01001599","Total",1701,830,871,1701,0,7,45.42,37.5
"2011","Greenwich 032C","E01001600","Total",1561,799,762,1557,4,8,30.30,51.5
"2011","Greenwich 032D","E01001601","Total",1561,749,812,1461,100,16,24.18,64.6
"2011","Greenwich 033A","E01001669","Total",1874,928,946,1874,0,28,50.41,37.2
"2011","Greenwich 033B","E01001671","Total",1578,767,811,1578,0,10,19.57,80.6
"2011","Greenwich 033C","E01001676","Total",1791,924,867,1791,0,19,13.14,136.3
"2011","Greenwich 033D","E01032567","Total",1651,826,825,1651,0,15,41.29,40.0
"2011","Greenwich 034A","E01001656","Total",1272,623,649,1272,0,20,27.60,46.1
"2011","Greenwich 034B","E01001657","Total",1547,755,792,1527,20,38,40.44,38.3
"2011","Greenwich 034C","E01001658","Total",1549,732,817,1549,0,13,43.46,35.6
"2011","Greenwich 034D","E01001659","Total",1454,739,715,1454,0,16,37.79,38.5
"2011","Greenwich 034E","E01033726","Total",2493,1216,1277,2439,54,34,102.82,24.2
"2011","Greenwich 035A","E01001640","Total",2334,1099,1235,2109,225,22,13.76,169.6
"2011","Greenwich 035B","E01033727","Total",2567,1250,1317,1861,706,43,15.69,163.6
"2011","Greenwich 035C","E01033728","Total",1226,647,579,1226,0,2,7.64,160.5
"2011","Greenwich 035D","E01033730","Total",1214,636,578,1214,0,3,16.90,71.8
"2011","Greenwich 036A","E01001666","Total",1470,750,720,1469,1,6,43.16,34.1
"2011","Greenwich 036B","E01001667","Total",1564,746,818,1564,0,6,136.33,11.5
"2011","Greenwich 036C","E01001668","Total",2269,1091,1178,2269,0,18,23.18,97.9
"2011","Greenwich 036D","E01033732","Total",1053,535,518,1053,0,2,10.56,99.7
"2011","Greenwich 036E","E01033733","Total",1134,576,558,1134,0,12,41.79,27.1
"2011","Greenwich 037A","E01001662","Total",1608,800,808,1608,0,10,23.60,68.1
"2011","Greenwich 037B","E01001664","Total",1870,946,924,1870,0,10,15.58,120.0
"2011","Greenwich 037C","E01001665","Total",1867,941,926,1863,4,19,18.64,100.2
"2011","Greenwich 037D","E01033738","Total",1216,628,588,1216,0,6,28.95,42.0
"2011","Greenwich 038A","E01001638","Total",1974,953,1021,1894,80,16,10.84,182.1
"2011","Greenwich 038B","E01001641","Total",1755,853,902,1663,92,13,37.19,47.2
"2011","Greenwich 038C","E01001642","Total",1781,873,908,1768,13,17,119.59,14.9
"2011","Greenwich 038D","E01001644","Total",2212,1182,1030,2212,0,23,19.06,116.1
"2011","Greenwich 038E","E01033746","Total",1464,696,768,1436,28,10,12.70,115.3
"2011","Harrow 001A","E01002112","Total",1890,895,995,1890,0,47,78.33,24.1
"2011","Harrow 001B","E01002114","Total",1993,884,1109,1990,3,24,288.54,6.9
"2011","Harrow 001C","E01002225","Total",1575,716,859,1450,125,54,203.95,7.7
"2011","Harrow 001D","E01002226","Total",2228,1035,1193,2228,0,46,60.96,36.5
"2011","Harrow 002A","E01002113","Total",1547,735,812,1547,0,56,61.55,25.1
"2011","Harrow 002B","E01002115","Total",1509,730,779,1509,0,28,34.43,43.8
"2011","Harrow 002C","E01002116","Total",1668,809,859,1668,0,55,30.49,54.7
"2011","Harrow 002D","E01002117","Total",2105,1017,1088,2105,0,59,42.54,49.5
"2011","Harrow 002E","E01002118","Total",1759,879,880,1696,63,31,27.26,64.5
"2011","Harrow 003A","E01002227","Total",1809,890,919,1733,76,36,32.71,55.3
"2011","Harrow 003B","E01002228","Total",2105,1010,1095,2103,2,51,41.92,50.2
"2011","Harrow 003C","E01002229","Total",1717,797,920,1710,7,27,63.05,27.2
"2011","Harrow 003D","E01002230","Total",1795,897,898,1776,19,32,43.00,41.7
"2011","Harrow 004A","E01002144","Total",1571,775,796,1570,1,47,295.98,5.3
"2011","Harrow 004B","E01002146","Total",1481,717,764,1481,0,45,84.18,17.6
"2011","Harrow 004C","E01002147","Total",1369,651,718,1309,60,51,62.57,21.9
"2011","Harrow 004D","E01002149","Total",1361,669,692,1361,0,62,29.47,46.2
"2011","Harrow 005A","E01002140","Total",1706,847,859,1702,4,24,25.02,68.2
"2011","Harrow 005B","E01002141","Total",1763,840,923,1753,10,42,28.66,61.5
"2011","Harrow 005C","E01002142","Total",1779,844,935,1779,0,49,36.50,48.7
"2011","Harrow 005D","E01002143","Total",1571,763,808,1568,3,26,18.08,86.9
"2011","Harrow 005E","E01002145","Total",1558,731,827,1496,62,31,31.39,49.6
"2011","Harrow 006A","E01002139","Total",1428,660,768,1426,2,14,23.23,61.5
"2011","Harrow 006B","E01002148","Total",1449,710,739,1449,0,38,33.56,43.2
"2011","Harrow 006C","E01002150","Total",1883,883,1000,1843,40,28,41.52,45.4
"2011","Harrow 006D","E01002151","Total",1526,719,807,1479,47,21,30.45,50.1
"2011","Harrow 006E","E01002152","Total",1624,761,863,1624,0,36,46.38,35.0
"2011","Harrow 007A","E01002119","Total",1708,838,870,1708,0,26,23.38,73.1
"2011","Harrow 007B","E01002120","Total",1296,622,674,1296,0,13,17.12,75.7
"2011","Harrow 007C","E01002121","Total",1761,862,899,1761,0,21,28.25,62.3
"2011","Harrow 007D","E01002122","Total",1706,877,829,1706,0,33,20.42,83.5
"2011","Harrow 007E","E01002123","Total",1735,878,857,1735,0,15,17.18,101.0
"2011","Harrow 008A","E01002106","Total",2027,1000,1027,1983,44,36,26.80,75.6
"2011","Harrow 008B","E01002108","Total",1819,883,936,1819,0,37,20.18,90.1
"2011","Harrow 008C","E01002109","Total",1789,896,893,1785,4,49,50.96,35.1
"2011","Harrow 008D","E01002110","Total",1762,873,889,1762,0,30,24.35,72.4
"2011","Harrow 008E","E01002111","Total",2172,1092,1080,2169,3,24,27.24,79.7
"2011","Harrow 009A","E01002185","Total",1543,720,823,1543,0,22,17.21,89.7
"2011","Harrow 009B","E01002186","Total",1656,785,871,1644,12,21,31.62,52.4
"2011","Harrow 009C","E01002187","Total",1843,862,981,1821,22,48,48.32,38.1
"2011","Harrow 009D","E01002190","Total",1672,826,846,1672,0,41,136.44,12.3
"2011","Harrow 010A","E01002124","Total",1769,837,932,1769,0,25,16.80,105.3
"2011","Harrow 010B","E01002125","Total",1678,882,796,1678,0,18,16.95,99.0
"2011","Harrow 010C","E01002198","Total",1820,929,891,1820,0,20,17.46,104.2
"2011","Harrow 010D","E01002200","Total",1688,865,823,1688,0,12,34.88,48.4
"2011","Harrow 010E","E01002203","Total",1751,867,884,1751,0,26,27.87,62.8
"2011","Harrow 011A","E01002232","Total",1973,978,995,1936,37,31,22.00,89.7
"2011","Harrow 011B","E01002233","Total",2031,992,1039,2029,2,25,20.20,100.5
"2011","Harrow 011C","E01002234","Total",1741,871,870,1741,0,31,16.42,106.0
"2011","Harrow 011D","E01002235","Total",1922,908,1014,1922,0,24,17.19,111.8
"2011","Harrow 011E","E01002236","Total",1803,901,902,1803,0,15,21.99,82.0
"2011","Harrow 012A","E01002107","Total",1774,865,909,1774,0,36,28.36,62.6
"2011","Harrow 012B","E01002197","Total",1394,682,712,1330,64,28,18.51,75.3
"2011","Harrow 012C","E01002199","Total",1533,761,772,1533,0,24,17.08,89.8
"2011","Harrow 012D","E01002201","Total",1742,848,894,1742,0,26,26.55,65.6
"2011","Harrow 012E","E01002202","Total",2056,1028,1028,2039,17,19,18.93,108.6
"2011","Harrow 013A","E01002179","Total",2250,1165,1085,2247,3,19,25.43,88.5
"2011","Harrow 013B","E01002180","Total",2085,1052,1033,2085,0,22,38.73,53.8
"2011","Harrow 013C","E01002183","Total",2106,1053,1053,2070,36,41,18.62,113.1
"2011","Harrow 013D","E01002184","Total",1885,945,940,1885,0,26,20.84,90.5
"2011","Harrow 013E","E01002231","Total",1924,974,950,1924,0,23,21.47,89.6
"2011","Harrow 015A","E01002154","Total",2021,999,1022,2021,0,39,131.43,15.4
"2011","Harrow 015B","E01002156","Total",1522,745,777,1516,6,56,38.16,39.9
"2011","Harrow 015C","E01002162","Total",1879,930,949,1879,0,39,18.29,102.7
"2011","Harrow 015D","E01002163","Total",1636,782,854,1636,0,52,24.51,66.7
"2011","Harrow 016A","E01002188","Total",1651,790,861,1616,35,62,48.91,33.8
"2011","Harrow 016B","E01002189","Total",1661,805,856,1661,0,29,44.45,37.4
"2011","Harrow 016C","E01002192","Total",1532,735,797,1532,0,41,45.27,33.8
"2011","Harrow 016D","E01002193","Total",1797,841,956,1797,0,42,33.40,53.8
"2011","Harrow 017A","E01002165","Total",1734,903,831,1734,0,15,20.60,84.2
"2011","Harrow 017B","E01002166","Total",1663,857,806,1663,0,19,16.80,99.0
"2011","Harrow 017C","E01002167","Total",1629,807,822,1623,6,28,16.43,99.1
"2011","Harrow 017D","E01002168","Total",1492,700,792,1492,0,18,17.46,85.5
"2011","Harrow 017E","E01002169","Total",1619,805,814,1619,0,29,20.53,78.9
"2011","Harrow 019A","E01002153","Total",1763,857,906,1757,6,26,29.13,60.5
"2011","Harrow 019B","E01002155","Total",1643,813,830,1630,13,41,74.72,22.0
"2011","Harrow 019C","E01002157","Total",1687,826,861,1687,0,23,26.34,64.0
"2011","Harrow 019D","E01002158","Total",1457,717,740,1457,0,44,29.73,49.0
"2011","Harrow 020A","E01002128","Total",2025,1005,1020,1968,57,19,18.29,110.7
"2011","Harrow 020B","E01002130","Total",2260,1170,1090,2260,0,9,33.21,68.1
"2011","Harrow 020C","E01002181","Total",1884,985,899,1853,31,23,40.90,46.1
"2011","Harrow 020D","E01002182","Total",2049,1102,947,2044,5,32,20.05,102.2
"2011","Harrow 021A","E01002159","Total",1860,930,930,1857,3,41,23.27,79.9
"2011","Harrow 021B","E01002160","Total",1967,1004,963,1967,0,18,30.26,65.0
"2011","Harrow 021C","E01002161","Total",2030,980,1050,2029,1,46,23.57,86.1
"2011","Harrow 021D","E01002164","Total",1763,868,895,1753,10,17,26.30,67.0
"2011","Harrow 022A","E01002191","Total",1964,955,1009,1964,0,52,48.93,40.1
"2011","Harrow 022B","E01002194","Total",1724,832,892,1721,3,61,42.54,40.5
"2011","Harrow 022C","E01002195","Total",1635,799,836,1635,0,35,27.87,58.7
"2011","Harrow 022D","E01002196","Total",1759,870,889,1759,0,56,37.35,47.1
"2011","Harrow 023A","E01002126","Total",2781,1406,1375,2747,34,27,37.95,73.3
"2011","Harrow 023B","E01002127","Total",1687,782,905,1653,34,29,27.74,60.8
"2011","Harrow 023C","E01002129","Total",2043,1066,977,2026,17,14,41.04,49.8
"2011","Harrow 023D","E01002131","Total",1624,814,810,1624,0,13,16.43,98.8
"2011","Harrow 024A","E01002237","Total",1626,809,817,1626,0,23,14.39,113.0
"2011","Harrow 024B","E01002238","Total",1804,904,900,1800,4,19,34.35,52.5
"2011","Harrow 024C","E01002240","Total",1739,830,909,1712,27,23,16.83,103.3
"2011","Harrow 024D","E01002242","Total",1890,940,950,1890,0,38,26.98,70.1
"2011","Harrow 025A","E01002208","Total",1357,679,678,1357,0,43,29.23,46.4
"2011","Harrow 025B","E01002209","Total",1643,838,805,1638,5,39,27.20,60.4
"2011","Harrow 025C","E01002239","Total",1678,796,882,1678,0,24,36.04,46.6
"2011","Harrow 025D","E01002241","Total",1636,833,803,1636,0,30,23.53,69.5
"2011","Harrow 027A","E01002133","Total",2031,993,1038,2031,0,22,39.48,51.4
"2011","Harrow 027B","E01002136","Total",1741,879,862,1741,0,25,37.11,46.9
"2011","Harrow 027C","E01002138","Total",1551,779,772,1544,7,22,14.70,105.5
"2011","Harrow 027D","E01002213","Total",2912,1428,1484,2911,1,28,28.67,101.6
"2011","Harrow 028A","E01002211","Total",1544,764,780,1514,30,13,17.14,90.1
"2011","Harrow 028B","E01002212","Total",1749,864,885,1749,0,29,27.49,63.6
"2011","Harrow 028C","E01002216","Total",1699,876,823,1699,0,32,26.87,63.2
"2011","Harrow 028D","E01002217","Total",1526,696,830,1526,0,15,15.11,101.0
"2011","Harrow 029A","E01002132","Total",2012,990,1022,1962,50,30,40.55,49.6
"2011","Harrow 029B","E01002134","Total",1462,759,703,1419,43,29,124.28,11.8
"2011","Harrow 029C","E01002135","Total",1765,867,898,1700,65,22,42.07,42.0
"2011","Harrow 029D","E01002137","Total",1708,1208,500,985,723,74,59.30,28.8
"2011","Harrow 030A","E01002218","Total",1647,813,834,1647,0,20,32.65,50.4
"2011","Harrow 030B","E01002219","Total",1813,912,901,1810,3,23,29.31,61.9
"2011","Harrow 030C","E01002221","Total",1564,800,764,1559,5,27,17.08,91.6
"2011","Harrow 030D","E01002222","Total",1608,795,813,1608,0,23,20.90,76.9
"2011","Harrow 031A","E01002214","Total",1863,937,926,1856,7,21,18.11,102.9
"2011","Harrow 031B","E01002215","Total",1535,713,822,1535,0,21,17.17,89.4
"2011","Harrow 031C","E01002220","Total",1628,840,788,1628,0,28,18.97,85.8
"2011","Harrow 031D","E01002223","Total",1873,926,947,1873,0,30,20.39,91.9
"2011","Harrow 031E","E01002224","Total",1530,745,785,1530,0,11,18.26,83.8
"2011","Harrow 032A","E01002204","Total",1736,873,863,1730,6,16,17.79,97.6
"2011","Harrow 032B","E01002206","Total",1387,708,679,1387,0,17,17.52,79.2
"2011","Harrow 032C","E01002207","Total",1730,873,857,1729,1,24,18.15,95.3
"2011","Harrow 032D","E01002210","Total",1604,778,826,1595,9,40,20.52,78.2
"2011","Harrow 032E","E01032576","Total",1667,808,859,1667,0,29,22.63,73.7
"2011","Harrow 033A","E01002170","Total",1324,634,690,1324,0,28,17.50,75.7
"2011","Harrow 033B","E01002171","Total",1677,826,851,1677,0,18,18.79,89.2
"2011","Harrow 033C","E01002172","Total",1579,780,799,1579,0,25,36.04,43.8
"2011","Harrow 033D","E01002173","Total",1742,865,877,1730,12,49,20.15,86.5
"2011","Harrow 033E","E01002174","Total",1582,788,794,1582,0,36,20.79,76.1
"2011","Harrow 033F","E01002175","Total",1402,717,685,1379,23,25,20.61,68.0
"2011","Harrow 033G","E01002176","Total",1746,839,907,1710,36,37,38.13,45.8
"2011","Harrow 033H","E01002177","Total",1443,731,712,1443,0,33,20.43,70.6
"2011","Harrow 033I","E01002178","Total",1679,829,850,1679,0,28,20.37,82.4
"2011","Havering 001A","E01002276","Total",1926,905,1021,1819,107,14,436.31,4.4
"2011","Havering 001B","E01002278","Total",1599,770,829,1593,6,12,22.76,70.3
"2011","Havering 001C","E01002312","Total",1400,661,739,1400,0,10,87.33,16.0
"2011","Havering 001D","E01002313","Total",1526,735,791,1526,0,6,39.31,38.8
"2011","Havering 002A","E01002277","Total",1494,746,748,1494,0,16,146.86,10.2
"2011","Havering 002B","E01002279","Total",1584,737,847,1584,0,6,35.95,44.1
"2011","Havering 002C","E01002281","Total",1614,790,824,1614,0,6,40.79,39.6
"2011","Havering 002D","E01002283","Total",1517,750,767,1517,0,4,22.68,66.9
"2011","Havering 002E","E01002299","Total",1721,815,906,1720,1,8,33.77,51.0
"2011","Havering 003A","E01002301","Total",1561,776,785,1561,0,8,27.42,56.9
"2011","Havering 003B","E01002303","Total",2043,927,1116,2043,0,18,28.63,71.4
"2011","Havering 003C","E01002304","Total",1414,669,745,1315,99,8,530.16,2.7
"2011","Havering 003D","E01002306","Total",1596,727,869,1596,0,14,17.90,89.2
"2011","Havering 003E","E01002307","Total",1673,806,867,1673,0,6,23.83,70.2
"2011","Havering 004A","E01002280","Total",1522,720,802,1493,29,12,15.73,96.8
"2011","Havering 004B","E01002282","Total",1594,776,818,1594,0,17,27.71,57.5
"2011","Havering 004C","E01002284","Total",1842,862,980,1842,0,20,27.32,67.4
"2011","Havering 004D","E01002297","Total",1484,772,712,1484,0,4,21.72,68.3
"2011","Havering 004E","E01002314","Total",1656,750,906,1656,0,20,18.82,88.0
"2011","Havering 004F","E01002316","Total",1545,720,825,1535,10,17,24.57,62.9
"2011","Havering 005A","E01002302","Total",1563,711,852,1563,0,3,28.62,54.6
"2011","Havering 005B","E01002305","Total",1519,716,803,1519,0,7,276.93,5.5
"2011","Havering 005C","E01002308","Total",1631,782,849,1631,0,5,45.32,36.0
"2011","Havering 005D","E01002326","Total",1496,715,781,1496,0,10,27.59,54.2
"2011","Havering 005E","E01002331","Total",1573,767,806,1496,77,7,30.91,50.9
"2011","Havering 006A","E01002309","Total",1539,755,784,1528,11,9,27.85,55.3
"2011","Havering 006B","E01002310","Total",1677,756,921,1577,100,7,28.14,59.6
"2011","Havering 006C","E01002311","Total",1690,802,888,1690,0,5,93.56,18.1
"2011","Havering 006D","E01002315","Total",1537,723,814,1537,0,5,21.86,70.3
"2011","Havering 007A","E01002293","Total",1591,790,801,1572,19,13,68.77,23.1
"2011","Havering 007B","E01002294","Total",1492,732,760,1478,14,19,123.28,12.1
"2011","Havering 007C","E01002296","Total",1673,825,848,1673,0,10,405.69,4.1
"2011","Havering 007D","E01002298","Total",1538,745,793,1538,0,11,45.40,33.9
"2011","Havering 007E","E01002300","Total",1593,750,843,1593,0,21,33.12,48.1
"2011","Havering 008A","E01002333","Total",1320,625,695,1312,8,29,27.45,48.1
"2011","Havering 008B","E01002334","Total",1663,804,859,1663,0,27,96.86,17.2
"2011","Havering 008C","E01002336","Total",1492,709,783,1492,0,10,25.56,58.4
"2011","Havering 008D","E01002339","Total",1610,792,818,1610,0,34,39.89,40.4
"2011","Havering 008E","E01002341","Total",1372,651,721,1372,0,14,24.31,56.4
"2011","Havering 009A","E01002327","Total",1476,687,789,1470,6,15,28.11,52.5
"2011","Havering 009B","E01002328","Total",1685,847,838,1685,0,15,28.62,58.9
"2011","Havering 009C","E01002332","Total",1631,761,870,1631,0,13,27.90,58.5
"2011","Havering 009D","E01002335","Total",1445,689,756,1416,29,7,20.81,69.4
"2011","Havering 009E","E01002338","Total",1371,673,698,1371,0,12,24.35,56.3
"2011","Havering 009F","E01002340","Total",1381,688,693,1381,0,19,23.78,58.1
"2011","Havering 010A","E01002268","Total",1350,631,719,1350,0,17,84.65,15.9
"2011","Havering 010B","E01002269","Total",1785,850,935,1785,0,23,76.88,23.2
"2011","Havering 010C","E01002295","Total",1558,739,819,1525,33,9,27.81,56.0
"2011","Havering 010D","E01002377","Total",1638,787,851,1638,0,16,43.02,38.1
"2011","Havering 010E","E01002378","Total",1678,821,857,1678,0,27,23.97,70.0
"2011","Havering 010F","E01002383","Total",1579,780,799,1579,0,23,29.23,54.0
"2011","Havering 011A","E01002244","Total",1697,824,873,1697,0,7,33.45,50.7
"2011","Havering 011B","E01002245","Total",1592,744,848,1546,46,6,25.52,62.4
"2011","Havering 011C","E01002325","Total",1709,748,961,1709,0,8,75.78,22.6
"2011","Havering 011D","E01002329","Total",1615,777,838,1615,0,15,37.55,43.0
"2011","Havering 011E","E01002330","Total",1730,868,862,1730,0,13,48.43,35.7
"2011","Havering 012A","E01002337","Total",1301,629,672,1273,28,27,112.32,11.6
"2011","Havering 012B","E01002354","Total",1372,662,710,1365,7,19,31.01,44.2
"2011","Havering 012C","E01002376","Total",1442,722,720,1426,16,26,33.98,42.4
"2011","Havering 012D","E01002379","Total",1466,706,760,1458,8,22,35.77,41.0
"2011","Havering 012E","E01002380","Total",2076,1003,1073,2058,18,12,30.07,69.0
"2011","Havering 012F","E01002381","Total",1539,692,847,1527,12,20,37.12,41.5
"2011","Havering 013A","E01002243","Total",1873,903,970,1852,21,10,23.62,79.3
"2011","Havering 013B","E01002353","Total",2010,1010,1000,2005,5,26,45.99,43.7
"2011","Havering 013C","E01002356","Total",2143,1034,1109,2135,8,17,36.49,58.7
"2011","Havering 013E","E01032741","Total",1078,562,516,1078,0,3,27.96,38.6
"2011","Havering 013F","E01032742","Total",1310,621,689,1260,50,12,22.60,58.0
"2011","Havering 014A","E01002272","Total",1319,631,688,1319,0,9,22.55,58.5
"2011","Havering 014B","E01002274","Total",1638,799,839,1638,0,20,30.71,53.3
"2011","Havering 014C","E01002317","Total",1541,737,804,1528,13,30,37.49,41.1
"2011","Havering 014D","E01002318","Total",1616,777,839,1616,0,26,29.87,54.1
"2011","Havering 014E","E01002355","Total",1470,730,740,1470,0,17,22.87,64.3
"2011","Havering 014F","E01002382","Total",1776,876,900,1776,0,8,31.46,56.5
"2011","Havering 015A","E01002270","Total",1673,808,865,1664,9,28,67.82,24.7
"2011","Havering 015B","E01002271","Total",1491,749,742,1479,12,26,54.86,27.2
"2011","Havering 015C","E01002273","Total",1362,678,684,1309,53,25,83.39,16.3
"2011","Havering 015D","E01002275","Total",1359,666,693,1359,0,23,43.05,31.6
"2011","Havering 016A","E01002319","Total",1596,733,863,1591,5,27,37.77,42.3
"2011","Havering 016B","E01002350","Total",1551,752,799,1483,68,9,28.57,54.3
"2011","Havering 016C","E01002351","Total",1580,753,827,1580,0,13,19.55,80.8
"2011","Havering 016D","E01002352","Total",1635,780,855,1596,39,13,28.92,56.5
"2011","Havering 016E","E01002358","Total",1772,853,919,1772,0,15,22.69,78.1
"2011","Havering 017A","E01002246","Total",1700,797,903,1620,80,11,54.30,31.3
"2011","Havering 017B","E01002247","Total",1800,892,908,1800,0,13,32.69,55.1
"2011","Havering 017C","E01002248","Total",1397,634,763,1395,2,13,53.57,26.1
"2011","Havering 017D","E01002249","Total",1905,975,930,1905,0,24,57.29,33.3
"2011","Havering 017E","E01002250","Total",1563,773,790,1563,0,22,107.16,14.6
"2011","Havering 017F","E01002251","Total",1430,694,736,1393,37,15,32.54,43.9
"2011","Havering 018A","E01002252","Total",1511,725,786,1511,0,11,115.47,13.1
"2011","Havering 018B","E01002256","Total",1498,699,799,1498,0,15,27.95,53.6
"2011","Havering 018C","E01002258","Total",1676,750,926,1676,0,12,30.07,55.7
"2011","Havering 018D","E01002259","Total",1486,692,794,1486,0,16,188.13,7.9
"2011","Havering 018E","E01002391","Total",1622,771,851,1501,121,20,862.97,1.9
"2011","Havering 019A","E01002253","Total",1539,752,787,1539,0,29,102.83,15.0
"2011","Havering 019B","E01002254","Total",1616,797,819,1616,0,26,56.24,28.7
"2011","Havering 019C","E01002257","Total",1719,824,895,1697,22,42,75.76,22.7
"2011","Havering 019D","E01002384","Total",1522,754,768,1522,0,10,47.77,31.9
"2011","Havering 020A","E01002359","Total",1322,644,678,1322,0,23,22.76,58.1
"2011","Havering 020B","E01002360","Total",1429,646,783,1429,0,10,38.52,37.1
"2011","Havering 020C","E01002361","Total",1700,802,898,1695,5,10,36.32,46.8
"2011","Havering 020D","E01002363","Total",1590,762,828,1566,24,20,24.80,64.1
"2011","Havering 020E","E01002367","Total",1573,752,821,1550,23,31,37.87,41.5
"2011","Havering 021A","E01002320","Total",1480,698,782,1480,0,25,20.35,72.7
"2011","Havering 021B","E01002321","Total",1642,817,825,1636,6,22,45.43,36.1
"2011","Havering 021C","E01002322","Total",1940,994,946,1940,0,22,42.69,45.4
"2011","Havering 021D","E01002323","Total",1682,845,837,1676,6,10,29.45,57.1
"2011","Havering 021E","E01002324","Total",1455,687,768,1455,0,11,47.14,30.9
"2011","Havering 022A","E01002255","Total",1483,686,797,1483,0,16,59.19,25.1
"2011","Havering 022B","E01002289","Total",1614,773,841,1614,0,15,27.16,59.4
"2011","Havering 022C","E01002292","Total",1549,715,834,1549,0,10,34.75,44.6
"2011","Havering 022D","E01002362","Total",1494,715,779,1471,23,30,33.81,44.2
"2011","Havering 022E","E01002386","Total",1846,903,943,1839,7,20,54.61,33.8
"2011","Havering 023A","E01002287","Total",1558,760,798,1558,0,20,22.53,69.2
"2011","Havering 023B","E01002291","Total",1582,785,797,1582,0,12,30.29,52.2
"2011","Havering 023C","E01002364","Total",1446,684,762,1380,66,12,23.58,61.3
"2011","Havering 023D","E01002365","Total",1316,656,660,1316,0,9,22.79,57.7
"2011","Havering 023E","E01002366","Total",1464,695,769,1464,0,13,28.25,51.8
"2011","Havering 024A","E01002385","Total",1596,788,808,1556,40,22,993.23,1.6
"2011","Havering 024B","E01002387","Total",1605,764,841,1605,0,41,136.84,11.7
"2011","Havering 024C","E01002388","Total",1658,782,876,1620,38,30,36.66,45.2
"2011","Havering 024D","E01002389","Total",1535,732,803,1518,17,34,87.32,17.6
"2011","Havering 024E","E01002390","Total",1449,705,744,1449,0,23,34.00,42.6
"2011","Havering 025A","E01002265","Total",1472,693,779,1472,0,16,51.51,28.6
"2011","Havering 025B","E01002285","Total",1245,624,621,1245,0,14,45.75,27.2
"2011","Havering 025C","E01002286","Total",1650,790,860,1650,0,13,23.69,69.6
"2011","Havering 025D","E01002288","Total",1548,766,782,1548,0,26,34.02,45.5
"2011","Havering 025E","E01002290","Total",1516,728,788,1516,0,12,27.89,54.4
"2011","Havering 026A","E01002260","Total",1535,765,770,1535,0,13,111.51,13.8
"2011","Havering 026B","E01002261","Total",1649,799,850,1649,0,21,20.69,79.7
"2011","Havering 026C","E01002262","Total",1626,772,854,1626,0,21,22.32,72.8
"2011","Havering 026D","E01002263","Total",1599,798,801,1599,0,18,85.15,18.8
"2011","Havering 026E","E01002264","Total",1475,658,817,1475,0,7,20.25,72.8
"2011","Havering 027A","E01002266","Total",1439,686,753,1439,0,7,34.42,41.8
"2011","Havering 027B","E01002267","Total",1671,766,905,1671,0,15,20.88,80.0
"2011","Havering 027C","E01002372","Total",1611,775,836,1611,0,10,21.97,73.3
"2011","Havering 027D","E01002373","Total",1581,768,813,1581,0,6,31.17,50.7
"2011","Havering 027E","E01002374","Total",1526,733,793,1526,0,26,96.71,15.8
"2011","Havering 028A","E01002368","Total",1594,839,755,1594,0,18,130.62,12.2
"2011","Havering 028B","E01002369","Total",1891,923,968,1884,7,15,48.35,39.1
"2011","Havering 028C","E01002370","Total",1973,1003,970,1973,0,16,246.68,8.0
"2011","Havering 028D","E01002371","Total",1627,823,804,1627,0,11,28.22,57.7
"2011","Havering 028E","E01002375","Total",1741,818,923,1696,45,17,26.22,66.4
"2011","Havering 029A","E01002343","Total",1705,833,872,1684,21,18,48.13,35.4
"2011","Havering 029B","E01002344","Total",1528,739,789,1524,4,15,1023.55,1.5
"2011","Havering 029C","E01002348","Total",1531,755,776,1531,0,12,275.72,5.6
"2011","Havering 029D","E01002349","Total",1508,749,759,1508,0,11,57.90,26.0
"2011","Havering 030A","E01002342","Total",1588,787,801,1588,0,13,18.31,86.7
"2011","Havering 030B","E01002345","Total",1679,771,908,1679,0,10,44.23,38.0
"2011","Havering 030C","E01002346","Total",1503,692,811,1503,0,21,20.78,72.3
"2011","Havering 030D","E01002347","Total",1440,693,747,1440,0,11,45.59,31.6
"2011","Hillingdon 001A","E01002473","Total",1547,746,801,1547,0,81,388.58,4.0
"2011","Hillingdon 001B","E01002475","Total",1497,680,817,1455,42,13,75.63,19.8
"2011","Hillingdon 001C","E01002476","Total",1576,781,795,1562,14,40,62.16,25.4
"2011","Hillingdon 001D","E01002477","Total",1252,583,669,1217,35,29,31.62,39.6
"2011","Hillingdon 001E","E01002482","Total",1607,769,838,1607,0,45,64.10,25.1
"2011","Hillingdon 002A","E01002472","Total",1571,747,824,1476,95,17,53.83,29.2
"2011","Hillingdon 002B","E01002474","Total",1507,693,814,1507,0,29,92.24,16.3
"2011","Hillingdon 002C","E01002478","Total",1519,745,774,1494,25,22,36.56,41.5
"2011","Hillingdon 002D","E01002483","Total",1739,820,919,1739,0,26,36.36,47.8
"2011","Hillingdon 002E","E01002484","Total",1424,693,731,1424,0,19,23.52,60.5
"2011","Hillingdon 002F","E01002485","Total",1713,816,897,1708,5,27,30.29,56.6
"2011","Hillingdon 003A","E01002438","Total",1325,641,684,1240,85,13,369.92,3.6
"2011","Hillingdon 003B","E01002439","Total",1571,761,810,1482,89,15,70.30,22.3
"2011","Hillingdon 003C","E01002440","Total",1441,698,743,1441,0,5,176.60,8.2
"2011","Hillingdon 003D","E01002441","Total",1550,736,814,1506,44,22,707.89,2.2
"2011","Hillingdon 003E","E01002442","Total",1512,729,783,1512,0,12,197.73,7.6
"2011","Hillingdon 004A","E01002433","Total",1826,849,977,1823,3,31,46.06,39.6
"2011","Hillingdon 004B","E01002436","Total",1608,801,807,1608,0,17,45.65,35.2
"2011","Hillingdon 004C","E01002479","Total",1702,774,928,1644,58,24,78.29,21.7
"2011","Hillingdon 004D","E01002480","Total",1760,865,895,1760,0,48,63.47,27.7
"2011","Hillingdon 004E","E01002481","Total",1633,793,840,1633,0,32,36.73,44.5
"2011","Hillingdon 005A","E01002533","Total",1462,707,755,1462,0,13,133.59,10.9
"2011","Hillingdon 005B","E01002534","Total",1465,714,751,1465,0,22,40.93,35.8
"2011","Hillingdon 005C","E01002538","Total",1569,722,847,1569,0,20,102.04,15.4
"2011","Hillingdon 005D","E01002539","Total",1524,776,748,1524,0,25,37.22,40.9
"2011","Hillingdon 006A","E01002418","Total",1789,873,916,1789,0,17,27.63,64.7
"2011","Hillingdon 006B","E01002419","Total",1531,729,802,1531,0,23,29.57,51.8
"2011","Hillingdon 006C","E01002431","Total",1415,683,732,1415,0,36,28.05,50.4
"2011","Hillingdon 006D","E01002432","Total",1561,757,804,1561,0,20,32.37,48.2
"2011","Hillingdon 006E","E01002437","Total",1469,732,737,1469,0,47,43.23,34.0
"2011","Hillingdon 007A","E01002430","Total",1469,707,762,1469,0,48,91.30,16.1
"2011","Hillingdon 007B","E01002434","Total",1358,656,702,1358,0,44,83.39,16.3
"2011","Hillingdon 007C","E01002435","Total",1436,728,708,1436,0,34,35.76,40.2
"2011","Hillingdon 007D","E01002470","Total",1684,852,832,1658,26,24,38.43,43.8
"2011","Hillingdon 007E","E01002535","Total",1767,886,881,1743,24,29,40.89,43.2
"2011","Hillingdon 008A","E01002416","Total",1741,851,890,1741,0,33,20.66,84.3
"2011","Hillingdon 008B","E01002417","Total",1596,752,844,1596,0,16,32.39,49.3
"2011","Hillingdon 008C","E01002420","Total",1595,759,836,1595,0,22,29.41,54.2
"2011","Hillingdon 008D","E01002421","Total",1696,796,900,1646,50,27,34.75,48.8
"2011","Hillingdon 008E","E01002471","Total",1619,786,833,1619,0,24,26.45,61.2
"2011","Hillingdon 009A","E01002465","Total",1576,729,847,1553,23,17,29.70,53.1
"2011","Hillingdon 009B","E01002467","Total",1517,699,818,1517,0,11,36.88,41.1
"2011","Hillingdon 009C","E01002494","Total",1696,832,864,1696,0,15,265.66,6.4
"2011","Hillingdon 009D","E01002536","Total",1420,676,744,1342,78,11,39.14,36.3
"2011","Hillingdon 009E","E01002537","Total",1404,714,690,1404,0,28,45.17,31.1
"2011","Hillingdon 010A","E01002415","Total",1710,835,875,1710,0,21,26.88,63.6
"2011","Hillingdon 010B","E01002466","Total",1680,822,858,1680,0,21,23.00,73.0
"2011","Hillingdon 010C","E01002468","Total",1696,837,859,1696,0,21,19.70,86.1
"2011","Hillingdon 010D","E01002469","Total",1670,842,828,1670,0,17,23.18,72.0
"2011","Hillingdon 010E","E01002495","Total",2230,1222,1008,1804,426,26,45.25,49.3
"2011","Hillingdon 011A","E01002458","Total",1416,689,727,1416,0,26,97.29,14.6
"2011","Hillingdon 011B","E01002459","Total",1624,771,853,1601,23,30,51.04,31.8
"2011","Hillingdon 011C","E01002460","Total",1338,661,677,1338,0,28,38.18,35.0
"2011","Hillingdon 011D","E01002462","Total",1418,710,708,1418,0,48,41.74,34.0
"2011","Hillingdon 011E","E01002464","Total",1586,770,816,1586,0,25,78.16,20.3
"2011","Hillingdon 013A","E01002461","Total",1435,683,752,1435,0,32,252.50,5.7
"2011","Hillingdon 013B","E01002463","Total",1570,776,794,1544,26,29,61.74,25.4
"2011","Hillingdon 013C","E01002512","Total",1741,872,869,1700,41,30,118.85,14.6
"2011","Hillingdon 013D","E01002513","Total",1341,650,691,1341,0,36,56.71,23.6
"2011","Hillingdon 013E","E01002516","Total",1454,711,743,1435,19,31,58.74,24.8
"2011","Hillingdon 014A","E01002450","Total",1421,696,725,1421,0,23,21.50,66.1
"2011","Hillingdon 014B","E01002451","Total",1514,754,760,1514,0,27,21.11,71.7
"2011","Hillingdon 014C","E01002452","Total",1539,802,737,1539,0,31,34.17,45.0
"2011","Hillingdon 014D","E01002453","Total",1692,832,860,1692,0,22,27.00,62.7
"2011","Hillingdon 014E","E01002454","Total",1777,858,919,1777,0,11,165.03,10.8
"2011","Hillingdon 015A","E01002414","Total",3314,1912,1402,1180,2134,71,91.85,36.1
"2011","Hillingdon 015C","E01002514","Total",1876,981,895,1876,0,30,28.51,65.8
"2011","Hillingdon 015D","E01002515","Total",1608,753,855,1608,0,25,62.38,25.8
"2011","Hillingdon 015F","E01033725","Total",2386,1236,1150,2350,36,48,91.92,26.0
"2011","Hillingdon 016B","E01002520","Total",1549,784,765,1549,0,14,50.60,30.6
"2011","Hillingdon 016C","E01002521","Total",1716,887,829,1716,0,3,54.17,31.7
"2011","Hillingdon 016D","E01002523","Total",1625,796,829,1625,0,11,16.83,96.6
"2011","Hillingdon 016F","E01033724","Total",4933,2459,2474,2761,2172,100,79.79,61.8
"2011","Hillingdon 017A","E01002410","Total",1694,853,841,1694,0,26,40.68,41.6
"2011","Hillingdon 017B","E01002412","Total",2291,1180,1111,2261,30,17,71.27,32.1
"2011","Hillingdon 017C","E01002456","Total",1675,806,869,1629,46,20,31.27,53.6
"2011","Hillingdon 017D","E01002509","Total",1452,707,745,1448,4,23,45.46,31.9
"2011","Hillingdon 017E","E01002511","Total",1522,721,801,1522,0,20,24.41,62.4
"2011","Hillingdon 018A","E01002422","Total",1436,723,713,1436,0,22,19.36,74.2
"2011","Hillingdon 018B","E01002423","Total",1645,831,814,1644,1,17,67.73,24.3
"2011","Hillingdon 018C","E01002424","Total",1574,782,792,1574,0,16,36.95,42.6
"2011","Hillingdon 018D","E01002425","Total",1795,919,876,1795,0,18,36.05,49.8
"2011","Hillingdon 018E","E01002427","Total",1506,715,791,1444,62,11,20.34,74.0
"2011","Hillingdon 018F","E01002428","Total",1470,747,723,1464,6,13,58.41,25.2
"2011","Hillingdon 019A","E01002408","Total",1527,773,754,1527,0,10,20.12,75.9
"2011","Hillingdon 019B","E01002409","Total",1773,884,889,1765,8,13,24.23,73.2
"2011","Hillingdon 019C","E01002429","Total",1413,721,692,1413,0,24,37.00,38.2
"2011","Hillingdon 019D","E01002455","Total",1728,852,876,1724,4,18,36.66,47.1
"2011","Hillingdon 019E","E01002457","Total",1560,774,786,1560,0,11,22.73,68.6
"2011","Hillingdon 020A","E01002392","Total",1675,783,892,1675,0,13,46.82,35.8
"2011","Hillingdon 020B","E01002393","Total",1988,977,1011,1982,6,18,32.61,61.0
"2011","Hillingdon 020C","E01002540","Total",1676,809,867,1676,0,17,22.64,74.0
"2011","Hillingdon 020D","E01002542","Total",1913,945,968,1906,7,2,17.71,108.0
"2011","Hillingdon 020E","E01002543","Total",1728,833,895,1728,0,7,27.35,63.2
"2011","Hillingdon 021A","E01002394","Total",1619,812,807,1619,0,14,29.36,55.1
"2011","Hillingdon 021B","E01002395","Total",1407,739,668,1407,0,15,17.30,81.3
"2011","Hillingdon 021C","E01002397","Total",1695,871,824,1689,6,30,17.74,95.5
"2011","Hillingdon 021D","E01002398","Total",1725,935,790,1702,23,14,16.36,105.4
"2011","Hillingdon 021E","E01002399","Total",1591,807,784,1591,0,11,17.68,90.0
"2011","Hillingdon 021F","E01002426","Total",1783,867,916,1783,0,4,21.50,82.9
"2011","Hillingdon 022A","E01002411","Total",1712,877,835,1703,9,11,48.58,35.2
"2011","Hillingdon 022B","E01002413","Total",1530,748,782,1530,0,12,31.02,49.3
"2011","Hillingdon 022C","E01002518","Total",1333,665,668,1321,12,17,23.04,57.9
"2011","Hillingdon 022D","E01002519","Total",1491,766,725,1485,6,5,63.62,23.4
"2011","Hillingdon 022E","E01002550","Total",1810,932,878,1806,4,8,24.48,73.9
"2011","Hillingdon 022F","E01002554","Total",2563,1283,1280,2543,20,18,124.51,20.6
"2011","Hillingdon 023A","E01002541","Total",1949,950,999,1949,0,18,38.15,51.1
"2011","Hillingdon 023B","E01002544","Total",1678,882,796,1678,0,9,61.90,27.1
"2011","Hillingdon 023C","E01002545","Total",1503,686,817,1503,0,6,28.34,53.0
"2011","Hillingdon 023D","E01002546","Total",1573,817,756,1567,6,13,19.13,82.2
"2011","Hillingdon 023E","E01002547","Total",1566,788,778,1566,0,22,17.96,87.2
"2011","Hillingdon 024A","E01002400","Total",1792,898,894,1770,22,15,60.32,29.7
"2011","Hillingdon 024B","E01002401","Total",1702,813,889,1673,29,18,33.18,51.3
"2011","Hillingdon 024C","E01002402","Total",1499,724,775,1494,5,20,19.99,75.0
"2011","Hillingdon 024D","E01002403","Total",1795,849,946,1795,0,34,20.42,87.9
"2011","Hillingdon 024E","E01002404","Total",1838,910,928,1838,0,9,20.80,88.4
"2011","Hillingdon 025A","E01002548","Total",1675,795,880,1675,0,14,115.18,14.5
"2011","Hillingdon 025B","E01002549","Total",1751,850,901,1743,8,12,60.38,29.0
"2011","Hillingdon 025C","E01002551","Total",1905,952,953,1905,0,25,31.78,59.9
"2011","Hillingdon 025D","E01002552","Total",1582,804,778,1582,0,5,26.04,60.8
"2011","Hillingdon 025E","E01002553","Total",1693,824,869,1688,5,13,18.93,89.4
"2011","Hillingdon 026A","E01002396","Total",1749,868,881,1747,2,18,34.05,51.4
"2011","Hillingdon 026B","E01002501","Total",1671,846,825,1666,5,18,22.43,74.5
"2011","Hillingdon 026C","E01002502","Total",1589,818,771,1583,6,11,19.07,83.3
"2011","Hillingdon 026D","E01002505","Total",1694,819,875,1694,0,9,70.86,23.9
"2011","Hillingdon 026E","E01002508","Total",1955,1025,930,1955,0,16,35.26,55.4
"2011","Hillingdon 027A","E01002405","Total",1919,974,945,1812,107,16,100.26,19.1
"2011","Hillingdon 027B","E01002406","Total",2135,1079,1056,2135,0,18,133.59,16.0
"2011","Hillingdon 027C","E01002503","Total",1681,851,830,1679,2,17,19.20,87.6
"2011","Hillingdon 027D","E01002504","Total",2024,986,1038,1955,69,14,44.79,45.2
"2011","Hillingdon 027E","E01002506","Total",1836,963,873,1831,5,6,28.48,64.5
"2011","Hillingdon 027F","E01002507","Total",1656,864,792,1656,0,21,109.74,15.1
"2011","Hillingdon 028A","E01002486","Total",2192,1090,1102,2192,0,33,102.25,21.4
"2011","Hillingdon 028B","E01002487","Total",1821,934,887,1821,0,20,19.45,93.6
"2011","Hillingdon 028C","E01002526","Total",1925,907,1018,1917,8,20,29.79,64.6
"2011","Hillingdon 028D","E01002528","Total",1685,807,878,1685,0,8,34.98,48.2
"2011","Hillingdon 028E","E01002532","Total",2289,1136,1153,2289,0,14,58.92,38.8
"2011","Hillingdon 029A","E01002445","Total",1703,804,899,1703,0,22,19.26,88.4
"2011","Hillingdon 029B","E01002525","Total",1613,796,817,1566,47,14,50.96,31.7
"2011","Hillingdon 029C","E01002529","Total",2086,1050,1036,2085,1,14,25.70,81.2
"2011","Hillingdon 029D","E01002530","Total",1634,761,873,1634,0,8,26.80,61.0
"2011","Hillingdon 029E","E01002531","Total",1617,824,793,1593,24,13,34.22,47.3
"2011","Hillingdon 030A","E01002407","Total",2354,1172,1182,2269,85,17,48.65,48.4
"2011","Hillingdon 030B","E01002488","Total",1729,892,837,1729,0,30,30.21,57.2
"2011","Hillingdon 030C","E01002489","Total",1824,951,873,1814,10,14,26.93,67.7
"2011","Hillingdon 030D","E01002490","Total",2082,1032,1050,2076,6,5,33.54,62.1
"2011","Hillingdon 030E","E01002492","Total",1647,819,828,1647,0,17,25.27,65.2
"2011","Hillingdon 031A","E01002444","Total",1833,1097,736,1551,282,22,1579.73,1.2
"2011","Hillingdon 031B","E01002446","Total",1612,825,787,1562,50,18,195.28,8.3
"2011","Hillingdon 031C","E01002447","Total",1697,925,772,1696,1,17,188.28,9.0
"2011","Hillingdon 031D","E01002527","Total",1521,749,772,1462,59,6,87.61,17.4
"2011","Hillingdon 032A","E01002443","Total",1625,825,800,1625,0,14,260.22,6.2
"2011","Hillingdon 032B","E01002448","Total",1957,985,972,1957,0,14,71.69,27.3
"2011","Hillingdon 032C","E01002449","Total",1772,938,834,1768,4,26,38.06,46.6
"2011","Hillingdon 032D","E01002491","Total",1604,823,781,1604,0,13,19.09,84.0
"2011","Hillingdon 032E","E01002493","Total",1868,878,990,1868,0,7,17.70,105.5
"2011","Hillingdon 033A","E01002496","Total",1802,843,959,1768,34,17,58.72,30.7
"2011","Hillingdon 033B","E01002497","Total",1832,901,931,1832,0,8,67.24,27.2
"2011","Hillingdon 033C","E01002498","Total",1416,692,724,1416,0,24,39.59,35.8
"2011","Hillingdon 033D","E01002499","Total",1705,841,864,1705,0,13,228.46,7.5
"2011","Hillingdon 033E","E01032577","Total",1683,805,878,1683,0,21,36.09,46.6
"2011","Hounslow 001A","E01002569","Total",1764,859,905,1697,67,17,20.62,85.5
"2011","Hounslow 001B","E01002570","Total",1682,805,877,1663,19,25,14.50,116.0
"2011","Hounslow 001C","E01002573","Total",1650,806,844,1650,0,44,18.35,89.9
"2011","Hounslow 001D","E01002574","Total",1537,712,825,1537,0,49,16.26,94.5
"2011","Hounslow 001E","E01002575","Total",1745,847,898,1745,0,29,22.69,76.9
"2011","Hounslow 003A","E01002562","Total",1379,690,689,1368,11,21,95.32,14.5
"2011","Hounslow 003B","E01002564","Total",1888,900,988,1888,0,18,23.99,78.7
"2011","Hounslow 003C","E01002566","Total",2123,1062,1061,2123,0,24,58.76,36.1
"2011","Hounslow 003D","E01002568","Total",2759,1306,1453,2759,0,26,19.94,138.4
"2011","Hounslow 003F","E01033081","Total",1242,628,614,1242,0,3,9.90,125.5
"2011","Hounslow 003G","E01033082","Total",1223,601,622,1223,0,7,24.38,50.2
"2011","Hounslow 004A","E01002620","Total",1851,937,914,1851,0,17,30.39,60.9
"2011","Hounslow 004B","E01002625","Total",1681,854,827,1681,0,40,19.56,85.9
"2011","Hounslow 004C","E01002626","Total",1626,822,804,1626,0,18,35.03,46.4
"2011","Hounslow 004D","E01002627","Total",1662,842,820,1662,0,15,12.46,133.4
"2011","Hounslow 004E","E01002631","Total",1628,844,784,1628,0,21,20.73,78.5
"2011","Hounslow 005A","E01002633","Total",1643,792,851,1642,1,20,98.90,16.6
"2011","Hounslow 005B","E01002634","Total",1712,820,892,1712,0,15,24.21,70.7
"2011","Hounslow 005C","E01002637","Total",1659,843,816,1659,0,12,69.36,23.9
"2011","Hounslow 005D","E01002638","Total",1823,903,920,1823,0,28,79.84,22.8
"2011","Hounslow 006A","E01002563","Total",1642,823,819,1633,9,18,50.40,32.6
"2011","Hounslow 006B","E01002565","Total",2829,1392,1437,2053,776,54,45.12,62.7
"2011","Hounslow 006C","E01002567","Total",1733,857,876,1733,0,21,21.88,79.2
"2011","Hounslow 006D","E01002684","Total",2368,1153,1215,2291,77,26,39.69,59.7
"2011","Hounslow 006E","E01002686","Total",1765,837,928,1762,3,17,98.58,17.9
"2011","Hounslow 007A","E01002571","Total",1325,690,635,1325,0,24,19.90,66.6
"2011","Hounslow 007B","E01002572","Total",1643,782,861,1643,0,22,90.97,18.1
"2011","Hounslow 007C","E01002577","Total",1635,827,808,1635,0,48,35.53,46.0
"2011","Hounslow 007D","E01002578","Total",1502,738,764,1502,0,53,50.51,29.7
"2011","Hounslow 007E","E01002689","Total",1585,764,821,1585,0,22,13.94,113.7
"2011","Hounslow 007F","E01002690","Total",1470,722,748,1459,11,44,17.99,81.7
"2011","Hounslow 008A","E01002576","Total",1746,889,857,1746,0,31,18.62,93.8
"2011","Hounslow 008B","E01002579","Total",1746,837,909,1746,0,41,40.43,43.2
"2011","Hounslow 008C","E01002580","Total",1386,704,682,1386,0,26,11.81,117.4
"2011","Hounslow 008D","E01002581","Total",1860,949,911,1860,0,24,18.40,101.1
"2011","Hounslow 008E","E01002582","Total",1668,837,831,1668,0,24,17.10,97.5
"2011","Hounslow 009A","E01002675","Total",2456,1219,1237,2456,0,40,30.08,81.6
"2011","Hounslow 009B","E01002678","Total",1855,940,915,1855,0,37,369.40,5.0
"2011","Hounslow 009C","E01002679","Total",1781,896,885,1781,0,30,46.30,38.5
"2011","Hounslow 009D","E01002680","Total",1952,1057,895,1937,15,32,40.88,47.7
"2011","Hounslow 010A","E01002619","Total",1959,1025,934,1959,0,30,23.74,82.5
"2011","Hounslow 010B","E01002622","Total",1731,886,845,1731,0,16,20.56,84.2
"2011","Hounslow 010C","E01002632","Total",1832,942,890,1828,4,41,36.70,49.9
"2011","Hounslow 010D","E01002635","Total",1753,904,849,1753,0,26,52.99,33.1
"2011","Hounslow 010E","E01002636","Total",2016,1022,994,2016,0,24,20.97,96.1
"2011","Hounslow 011A","E01002618","Total",1758,897,861,1714,44,31,23.06,76.2
"2011","Hounslow 011B","E01002621","Total",1817,931,886,1813,4,19,28.39,64.0
"2011","Hounslow 011C","E01002623","Total",1667,862,805,1635,32,19,20.08,83.0
"2011","Hounslow 011D","E01002628","Total",1940,985,955,1940,0,27,35.45,54.7
"2011","Hounslow 011E","E01002629","Total",2087,1051,1036,2087,0,36,53.67,38.9
"2011","Hounslow 012A","E01002630","Total",1695,882,813,1695,0,25,23.52,72.1
"2011","Hounslow 012B","E01002639","Total",1703,897,806,1695,8,18,19.14,89.0
"2011","Hounslow 012C","E01002640","Total",1800,975,825,1800,0,23,22.35,80.5
"2011","Hounslow 012D","E01002674","Total",1707,891,816,1707,0,16,28.52,59.9
"2011","Hounslow 012E","E01002676","Total",1715,897,818,1715,0,26,95.27,18.0
"2011","Hounslow 013A","E01002583","Total",1706,860,846,1706,0,27,40.39,42.2
"2011","Hounslow 013B","E01002584","Total",1691,902,789,1691,0,17,32.81,51.5
"2011","Hounslow 013C","E01002585","Total",1651,853,798,1651,0,23,20.94,78.8
"2011","Hounslow 013D","E01002586","Total",1650,868,782,1650,0,18,42.69,38.7
"2011","Hounslow 013E","E01002589","Total",1982,1013,969,1982,0,20,98.73,20.1
"2011","Hounslow 014A","E01002668","Total",2014,935,1079,1943,71,8,34.29,58.7
"2011","Hounslow 014B","E01002669","Total",1782,863,919,1782,0,18,30.86,57.7
"2011","Hounslow 014C","E01002681","Total",2063,993,1070,2052,11,19,31.06,66.4
"2011","Hounslow 014D","E01002682","Total",2325,1133,1192,2317,8,11,43.34,53.6
"2011","Hounslow 014E","E01002683","Total",2568,1267,1301,2568,0,34,25.07,102.4
"2011","Hounslow 015A","E01002642","Total",2005,1086,919,2005,0,9,26.39,76.0
"2011","Hounslow 015B","E01002643","Total",2289,1151,1138,2276,13,31,32.35,70.8
"2011","Hounslow 015C","E01002645","Total",2054,1078,976,2043,11,7,25.88,79.4
"2011","Hounslow 015D","E01002658","Total",1333,683,650,1333,0,20,17.49,76.2
"2011","Hounslow 015E","E01002677","Total",1565,809,756,1554,11,26,23.27,67.3
"2011","Hounslow 016A","E01002587","Total",1895,969,926,1895,0,27,22.50,84.2
"2011","Hounslow 016B","E01002588","Total",1755,829,926,1755,0,12,14.21,123.5
"2011","Hounslow 016C","E01002660","Total",1758,916,842,1758,0,18,26.82,65.5
"2011","Hounslow 016D","E01002661","Total",1849,977,872,1847,2,15,28.03,66.0
"2011","Hounslow 016E","E01002665","Total",1618,820,798,1611,7,30,13.89,116.5
"2011","Hounslow 017A","E01002624","Total",1505,779,726,1503,2,13,22.26,67.6
"2011","Hounslow 017B","E01002646","Total",2016,1012,1004,2016,0,16,14.44,139.6
"2011","Hounslow 017C","E01002662","Total",1999,1076,923,1991,8,30,24.47,81.7
"2011","Hounslow 017D","E01002663","Total",2074,1028,1046,2074,0,23,17.31,119.8
"2011","Hounslow 017E","E01002664","Total",1802,930,872,1714,88,10,26.10,69.0
"2011","Hounslow 018A","E01002641","Total",1932,979,953,1928,4,28,20.41,94.7
"2011","Hounslow 018C","E01002648","Total",2689,1412,1277,2689,0,12,23.18,116.0
"2011","Hounslow 018D","E01002649","Total",1830,942,888,1784,46,10,20.47,89.4
"2011","Hounslow 018E","E01002657","Total",1876,929,947,1876,0,25,23.29,80.5
"2011","Hounslow 018F","E01033083","Total",1664,921,743,1664,0,5,13.58,122.5
"2011","Hounslow 018G","E01033084","Total",1722,926,796,1711,11,9,13.52,127.4
"2011","Hounslow 019A","E01002653","Total",1813,937,876,1813,0,45,21.48,84.4
"2011","Hounslow 019B","E01002654","Total",1785,875,910,1785,0,24,42.60,41.9
"2011","Hounslow 019C","E01002655","Total",1885,954,931,1885,0,18,25.40,74.2
"2011","Hounslow 019D","E01002656","Total",1318,652,666,1318,0,19,20.67,63.8
"2011","Hounslow 019E","E01002659","Total",1398,675,723,1398,0,17,28.42,49.2
"2011","Hounslow 020A","E01002667","Total",1573,779,794,1529,44,14,31.33,50.2
"2011","Hounslow 020B","E01002670","Total",1737,839,898,1737,0,13,44.29,39.2
"2011","Hounslow 020C","E01002671","Total",1659,771,888,1659,0,26,23.97,69.2
"2011","Hounslow 020D","E01002672","Total",1578,770,808,1578,0,7,26.37,59.8
"2011","Hounslow 020E","E01002673","Total",1634,788,846,1634,0,18,5.54,294.9
"2011","Hounslow 021A","E01002647","Total",2213,1088,1125,2213,0,21,17.45,126.8
"2011","Hounslow 021B","E01002650","Total",2436,1203,1233,2436,0,17,170.73,14.3
"2011","Hounslow 021C","E01002651","Total",1778,921,857,1778,0,19,13.10,135.7
"2011","Hounslow 021D","E01002652","Total",1765,908,857,1765,0,15,19.28,91.5
"2011","Hounslow 021E","E01002666","Total",1558,884,674,1376,182,12,25.42,61.3
"2011","Hounslow 022A","E01002555","Total",1917,960,957,1917,0,21,71.77,26.7
"2011","Hounslow 022B","E01002556","Total",1681,843,838,1681,0,7,20.05,83.8
"2011","Hounslow 022C","E01002590","Total",1839,902,937,1839,0,9,35.24,52.2
"2011","Hounslow 022D","E01002592","Total",1999,972,1027,1999,0,8,172.31,11.6
"2011","Hounslow 022E","E01002595","Total",1924,971,953,1924,0,15,27.08,71.0
"2011","Hounslow 023A","E01002557","Total",1785,908,877,1785,0,12,33.79,52.8
"2011","Hounslow 023B","E01002558","Total",1945,953,992,1945,0,17,23.51,82.7
"2011","Hounslow 023C","E01002559","Total",2279,1116,1163,2274,5,18,237.78,9.6
"2011","Hounslow 023D","E01002560","Total",1715,841,874,1702,13,11,33.34,51.4
"2011","Hounslow 023E","E01002561","Total",1379,650,729,1379,0,7,24.43,56.4
"2011","Hounslow 024A","E01002591","Total",1729,853,876,1729,0,19,32.56,53.1
"2011","Hounslow 024B","E01002593","Total",2118,1073,1045,1966,152,31,44.50,47.6
"2011","Hounslow 024C","E01002594","Total",1954,975,979,1954,0,15,26.74,73.1
"2011","Hounslow 024D","E01002611","Total",1785,880,905,1785,0,7,86.15,20.7
"2011","Hounslow 024E","E01002612","Total",1670,809,861,1670,0,20,33.22,50.3
"2011","Hounslow 024F","E01002613","Total",1761,894,867,1761,0,6,22.36,78.8
"2011","Hounslow 025B","E01002598","Total",1840,908,932,1840,0,16,22.46,81.9
"2011","Hounslow 025C","E01002599","Total",1607,766,841,1607,0,10,18.25,88.1
"2011","Hounslow 025D","E01002600","Total",1524,761,763,1524,0,7,15.89,95.9
"2011","Hounslow 025E","E01002603","Total",1924,931,993,1924,0,13,22.26,86.4
"2011","Hounslow 025F","E01033000","Total",1785,833,952,1785,0,15,8.41,212.2
"2011","Hounslow 025G","E01033030","Total",1723,918,805,1723,0,7,7.21,239.0
"2011","Hounslow 026A","E01002604","Total",1733,865,868,1733,0,14,30.04,57.7
"2011","Hounslow 026B","E01002605","Total",1847,899,948,1847,0,9,32.81,56.3
"2011","Hounslow 026C","E01002606","Total",1641,808,833,1641,0,11,20.64,79.5
"2011","Hounslow 026D","E01002607","Total",1923,945,978,1923,0,15,34.39,55.9
"2011","Hounslow 026E","E01002615","Total",1470,729,741,1470,0,14,94.96,15.5
"2011","Hounslow 027A","E01002596","Total",1996,1084,912,1828,168,9,46.14,43.3
"2011","Hounslow 027B","E01002601","Total",1665,854,811,1665,0,7,156.60,10.6
"2011","Hounslow 027C","E01002602","Total",1477,719,758,1477,0,20,20.95,70.5
"2011","Hounslow 027D","E01002614","Total",1746,873,873,1746,0,14,59.58,29.3
"2011","Hounslow 027E","E01002616","Total",1382,692,690,1382,0,8,22.74,60.8
"2011","Hounslow 028A","E01002608","Total",1717,831,886,1717,0,10,34.60,49.6
"2011","Hounslow 028B","E01002609","Total",1730,869,861,1730,0,16,21.25,81.4
"2011","Hounslow 028C","E01002610","Total",1564,748,816,1564,0,19,151.39,10.3
"2011","Hounslow 028D","E01002617","Total",1594,782,812,1594,0,11,45.12,35.3
"2011","Hounslow 029A","E01002687","Total",1707,872,835,1707,0,27,17.68,96.5
"2011","Hounslow 029B","E01002691","Total",1596,776,820,1596,0,26,51.00,31.3
"2011","Hounslow 029C","E01002692","Total",1782,912,870,1776,6,15,32.55,54.7
"2011","Hounslow 029D","E01002693","Total",1694,792,902,1642,52,28,20.53,82.5
"2011","Hounslow 029E","E01032573","Total",1614,814,800,1614,0,17,23.12,69.8
"2011","Kingston upon Thames 001A","E01003006","Total",1500,699,801,1500,0,28,32.10,46.7
"2011","Kingston upon Thames 001B","E01003007","Total",1513,746,767,1513,0,26,20.28,74.6
"2011","Kingston upon Thames 001C","E01003008","Total",1432,660,772,1432,0,21,20.11,71.2
"2011","Kingston upon Thames 001D","E01003009","Total",1895,908,987,1895,0,43,30.30,62.5
"2011","Kingston upon Thames 001E","E01003010","Total",1497,739,758,1497,0,57,30.24,49.5
"2011","Kingston upon Thames 002A","E01002952","Total",1541,705,836,1418,123,61,142.29,10.8
"2011","Kingston upon Thames 002B","E01002953","Total",1308,660,648,1280,28,68,116.97,11.2
"2011","Kingston upon Thames 002C","E01002955","Total",1377,649,728,1377,0,34,49.39,27.9
"2011","Kingston upon Thames 002D","E01002956","Total",1611,768,843,1193,418,66,64.04,25.2
"2011","Kingston upon Thames 002E","E01002959","Total",1433,698,735,1420,13,54,42.85,33.4
"2011","Kingston upon Thames 003A","E01002935","Total",1770,901,869,1770,0,34,18.60,95.2
"2011","Kingston upon Thames 003B","E01002938","Total",1935,929,1006,1935,0,32,23.68,81.7
"2011","Kingston upon Thames 003C","E01002951","Total",1514,761,753,1514,0,46,22.33,67.8
"2011","Kingston upon Thames 003D","E01002954","Total",1289,566,723,1148,141,21,23.04,55.9
"2011","Kingston upon Thames 003E","E01002957","Total",1717,803,914,1717,0,17,22.87,75.1
"2011","Kingston upon Thames 004A","E01002933","Total",1995,955,1040,1961,34,34,16.44,121.4
"2011","Kingston upon Thames 004B","E01002934","Total",1821,923,898,1821,0,44,20.65,88.2
"2011","Kingston upon Thames 004D","E01002937","Total",1729,859,870,1729,0,14,15.04,115.0
"2011","Kingston upon Thames 004E","E01003011","Total",1741,847,894,1741,0,32,25.24,69.0
"2011","Kingston upon Thames 004F","E01033568","Total",1461,727,734,1461,0,9,13.01,112.3
"2011","Kingston upon Thames 004G","E01033569","Total",1662,845,817,1564,98,39,16.74,99.3
"2011","Kingston upon Thames 005A","E01002964","Total",2231,1067,1164,2057,174,21,31.38,71.1
"2011","Kingston upon Thames 005B","E01002969","Total",1748,871,877,1748,0,15,6.90,253.3
"2011","Kingston upon Thames 005C","E01002971","Total",1709,842,867,1709,0,12,31.80,53.7
"2011","Kingston upon Thames 005D","E01002972","Total",1809,913,896,1809,0,7,16.73,108.1
"2011","Kingston upon Thames 005E","E01002974","Total",1893,909,984,1890,3,44,20.94,90.4
"2011","Kingston upon Thames 006A","E01002932","Total",1757,841,916,1726,31,17,23.05,76.2
"2011","Kingston upon Thames 006B","E01002960","Total",1627,771,856,1608,19,52,26.42,61.6
"2011","Kingston upon Thames 006C","E01002962","Total",1528,733,795,1527,1,28,24.42,62.6
"2011","Kingston upon Thames 006D","E01002970","Total",1576,760,816,1576,0,14,28.62,55.1
"2011","Kingston upon Thames 006E","E01002973","Total",1372,645,727,1372,0,17,29.83,46.0
"2011","Kingston upon Thames 007A","E01002929","Total",1633,790,843,1633,0,58,60.03,27.2
"2011","Kingston upon Thames 007B","E01002930","Total",1709,816,893,1682,27,28,26.71,64.0
"2011","Kingston upon Thames 007C","E01002931","Total",1850,907,943,1850,0,38,30.65,60.4
"2011","Kingston upon Thames 007D","E01002963","Total",1732,835,897,1731,1,26,18.71,92.6
"2011","Kingston upon Thames 007E","E01002985","Total",1662,820,842,1662,0,15,17.21,96.6
"2011","Kingston upon Thames 008A","E01002927","Total",1556,746,810,1556,0,25,22.07,70.5
"2011","Kingston upon Thames 008B","E01002928","Total",1604,747,857,1523,81,30,25.53,62.8
"2011","Kingston upon Thames 008C","E01002958","Total",1680,818,862,1680,0,24,18.51,90.8
"2011","Kingston upon Thames 008D","E01002961","Total",1750,825,925,1750,0,49,33.82,51.7
"2011","Kingston upon Thames 008E","E01002986","Total",1273,648,625,1273,0,35,43.88,29.0
"2011","Kingston upon Thames 009A","E01002965","Total",2325,1143,1182,2322,3,28,34.87,66.7
"2011","Kingston upon Thames 009B","E01002967","Total",1858,922,936,1852,6,14,19.71,94.3
"2011","Kingston upon Thames 009C","E01002968","Total",2631,1343,1288,2375,256,41,55.58,47.3
"2011","Kingston upon Thames 009D","E01002990","Total",1680,885,795,1680,0,15,16.89,99.5
"2011","Kingston upon Thames 009E","E01002991","Total",1613,839,774,1598,15,42,22.77,70.8
"2011","Kingston upon Thames 010A","E01002922","Total",1632,810,822,1632,0,29,31.69,51.5
"2011","Kingston upon Thames 010B","E01002926","Total",1535,756,779,1535,0,17,28.89,53.1
"2011","Kingston upon Thames 010C","E01002966","Total",1910,947,963,1873,37,32,50.44,37.9
"2011","Kingston upon Thames 010D","E01002992","Total",1752,818,934,1077,675,22,33.00,53.1
"2011","Kingston upon Thames 011A","E01002921","Total",1555,803,752,1532,23,14,17.21,90.4
"2011","Kingston upon Thames 011B","E01002987","Total",1702,856,846,1508,194,10,21.25,80.1
"2011","Kingston upon Thames 011C","E01002988","Total",1906,889,1017,1234,672,24,28.52,66.8
"2011","Kingston upon Thames 011D","E01002989","Total",1830,935,895,1830,0,13,15.14,120.9
"2011","Kingston upon Thames 012A","E01002975","Total",1381,691,690,1381,0,37,29.60,46.7
"2011","Kingston upon Thames 012B","E01002977","Total",1673,793,880,1665,8,21,29.90,56.0
"2011","Kingston upon Thames 012C","E01002980","Total",1413,668,745,1396,17,24,23.08,61.2
"2011","Kingston upon Thames 012D","E01002981","Total",1544,750,794,1533,11,44,37.71,40.9
"2011","Kingston upon Thames 012E","E01002984","Total",1426,696,730,1405,21,29,27.14,52.5
"2011","Kingston upon Thames 013A","E01002923","Total",1570,782,788,1563,7,16,11.69,134.3
"2011","Kingston upon Thames 013B","E01002925","Total",1615,789,826,1553,62,10,23.13,69.8
"2011","Kingston upon Thames 013C","E01002993","Total",1519,775,744,1519,0,1,16.62,91.4
"2011","Kingston upon Thames 013D","E01002995","Total",1476,713,763,1379,97,43,40.91,36.1
"2011","Kingston upon Thames 013E","E01002999","Total",1449,730,719,1427,22,5,18.94,76.5
"2011","Kingston upon Thames 014A","E01002915","Total",1304,665,639,1304,0,42,29.29,44.5
"2011","Kingston upon Thames 014B","E01002916","Total",1478,743,735,1478,0,22,43.98,33.6
"2011","Kingston upon Thames 014C","E01002917","Total",1397,688,709,1397,0,26,27.59,50.6
"2011","Kingston upon Thames 014D","E01002920","Total",1604,790,814,1604,0,26,46.45,34.5
"2011","Kingston upon Thames 014E","E01002924","Total",1530,776,754,1530,0,38,32.60,46.9
"2011","Kingston upon Thames 015A","E01002976","Total",1654,768,886,1654,0,17,27.77,59.6
"2011","Kingston upon Thames 015B","E01002978","Total",1761,856,905,1757,4,36,36.38,48.4
"2011","Kingston upon Thames 015C","E01002979","Total",1549,779,770,1549,0,19,33.82,45.8
"2011","Kingston upon Thames 015D","E01002982","Total",1438,699,739,1350,88,19,25.81,55.7
"2011","Kingston upon Thames 015E","E01002983","Total",1626,807,819,1626,0,40,64.93,25.0
"2011","Kingston upon Thames 016A","E01002994","Total",1510,702,808,1388,122,24,31.91,47.3
"2011","Kingston upon Thames 016B","E01002996","Total",1513,741,772,1484,29,15,20.33,74.4
"2011","Kingston upon Thames 016C","E01002997","Total",1462,729,733,1440,22,34,23.35,62.6
"2011","Kingston upon Thames 016D","E01002998","Total",1530,687,843,1522,8,21,14.36,106.5
"2011","Kingston upon Thames 016E","E01003002","Total",1826,874,952,1826,0,13,30.34,60.2
"2011","Kingston upon Thames 017A","E01002918","Total",1758,862,896,1758,0,28,43.67,40.3
"2011","Kingston upon Thames 017B","E01002919","Total",1705,849,856,1705,0,25,76.75,22.2
"2011","Kingston upon Thames 017C","E01003000","Total",1553,751,802,1553,0,11,114.70,13.5
"2011","Kingston upon Thames 017D","E01003001","Total",1831,868,963,1831,0,29,36.80,49.8
"2011","Kingston upon Thames 017E","E01003003","Total",1557,787,770,1512,45,23,23.33,66.7
"2011","Kingston upon Thames 018A","E01002939","Total",1548,745,803,1548,0,21,26.20,59.1
"2011","Kingston upon Thames 018B","E01002941","Total",1487,704,783,1487,0,34,61.95,24.0
"2011","Kingston upon Thames 018C","E01002942","Total",1370,692,678,1370,0,20,21.17,64.7
"2011","Kingston upon Thames 018D","E01003004","Total",1578,763,815,1578,0,17,31.26,50.5
"2011","Kingston upon Thames 018E","E01003005","Total",1488,738,750,1488,0,6,23.06,64.5
"2011","Kingston upon Thames 019A","E01002944","Total",1360,653,707,1342,18,15,30.22,45.0
"2011","Kingston upon Thames 019B","E01002945","Total",1559,778,781,1559,0,24,24.78,62.9
"2011","Kingston upon Thames 019C","E01002946","Total",1498,711,787,1498,0,13,46.73,32.1
"2011","Kingston upon Thames 019D","E01002947","Total",1614,831,783,1614,0,24,29.47,54.8
"2011","Kingston upon Thames 020A","E01002940","Total",1580,758,822,1580,0,18,22.29,70.9
"2011","Kingston upon Thames 020B","E01002943","Total",1396,674,722,1396,0,13,31.10,44.9
"2011","Kingston upon Thames 020C","E01002948","Total",2103,987,1116,2055,48,18,526.14,4.0
"2011","Kingston upon Thames 020D","E01002949","Total",1862,942,920,1862,0,23,29.82,62.4
"2011","Kingston upon Thames 020E","E01002950","Total",1596,721,875,1596,0,19,98.24,16.2
"2011","Merton 001A","E01003472","Total",1344,664,680,1344,0,25,9.08,148.0
"2011","Merton 001B","E01003473","Total",1353,651,702,1334,19,25,20.54,65.9
"2011","Merton 001C","E01003474","Total",1411,701,710,1411,0,79,60.19,23.4
"2011","Merton 001D","E01003475","Total",2511,1212,1299,2511,0,18,71.60,35.1
"2011","Merton 001E","E01003478","Total",1639,807,832,1639,0,11,33.50,48.9
"2011","Merton 002A","E01003460","Total",1499,744,755,1459,40,65,354.96,4.2
"2011","Merton 002B","E01003462","Total",1464,712,752,1464,0,49,44.18,33.1
"2011","Merton 002C","E01003464","Total",1393,693,700,1328,65,56,78.99,17.6
"2011","Merton 002D","E01003465","Total",1300,631,669,1276,24,99,62.04,21.0
"2011","Merton 003A","E01003400","Total",1486,752,734,1484,2,27,18.21,81.6
"2011","Merton 003B","E01003454","Total",1362,650,712,1314,48,21,15.70,86.8
"2011","Merton 003C","E01003456","Total",1547,802,745,1465,82,45,23.85,64.9
"2011","Merton 003D","E01003476","Total",1404,699,705,1389,15,52,16.87,83.2
"2011","Merton 003E","E01003477","Total",1535,760,775,1516,19,18,18.21,84.3
"2011","Merton 004A","E01003401","Total",1346,628,718,1336,10,16,17.95,75.0
"2011","Merton 004B","E01003402","Total",1552,760,792,1552,0,36,22.72,68.3
"2011","Merton 004C","E01003403","Total",1546,749,797,1500,46,57,25.12,61.5
"2011","Merton 004D","E01003404","Total",1674,820,854,1647,27,14,21.38,78.3
"2011","Merton 004E","E01003461","Total",1544,763,781,1532,12,70,27.24,56.7
"2011","Merton 005A","E01003367","Total",2401,1287,1114,2186,215,17,46.79,51.3
"2011","Merton 005B","E01003369","Total",1656,809,847,1656,0,17,9.35,177.1
"2011","Merton 005C","E01003370","Total",1979,1001,978,1979,0,14,15.29,129.4
"2011","Merton 005D","E01003371","Total",1558,792,766,1542,16,11,12.10,128.8
"2011","Merton 005E","E01003455","Total",1579,821,758,1572,7,12,21.21,74.4
"2011","Merton 006A","E01003359","Total",1733,842,891,1733,0,11,16.96,102.2
"2011","Merton 006B","E01003360","Total",1687,821,866,1687,0,7,13.74,122.8
"2011","Merton 006C","E01003457","Total",1622,808,814,1622,0,14,14.08,115.2
"2011","Merton 006D","E01003458","Total",1601,786,815,1601,0,11,13.68,117.0
"2011","Merton 006E","E01003459","Total",2087,1016,1071,2071,16,8,18.93,110.2
"2011","Merton 007A","E01003394","Total",1931,1049,882,1924,7,19,16.02,120.5
"2011","Merton 007B","E01003395","Total",1471,744,727,1471,0,31,21.58,68.2
"2011","Merton 007C","E01003396","Total",1592,834,758,1592,0,12,9.52,167.2
"2011","Merton 007D","E01003397","Total",1552,828,724,1552,0,15,12.60,123.2
"2011","Merton 007E","E01003398","Total",1741,882,859,1730,11,10,20.93,83.2
"2011","Merton 008A","E01003368","Total",1586,805,781,1586,0,14,14.84,106.9
"2011","Merton 008B","E01003372","Total",1532,775,757,1532,0,19,12.75,120.2
"2011","Merton 008C","E01003393","Total",1529,805,724,1529,0,11,7.71,198.3
"2011","Merton 008D","E01003406","Total",1641,782,859,1641,0,12,18.98,86.5
"2011","Merton 008E","E01003407","Total",1784,892,892,1784,0,14,19.81,90.1
"2011","Merton 009A","E01003355","Total",1581,803,778,1556,25,6,14.19,111.4
"2011","Merton 009B","E01003356","Total",1757,872,885,1757,0,21,45.90,38.3
"2011","Merton 009C","E01003358","Total",1823,907,916,1765,58,16,15.34,118.8
"2011","Merton 009D","E01003383","Total",1535,785,750,1535,0,12,25.09,61.2
"2011","Merton 009E","E01003384","Total",1521,760,761,1521,0,15,15.32,99.3
"2011","Merton 010A","E01003442","Total",1691,793,898,1574,117,66,25.03,67.6
"2011","Merton 010B","E01003443","Total",1564,749,815,1564,0,45,22.15,70.6
"2011","Merton 010C","E01003444","Total",1557,751,806,1557,0,38,26.36,59.1
"2011","Merton 010D","E01003445","Total",1713,854,859,1713,0,39,47.64,36.0
"2011","Merton 010E","E01003463","Total",1291,617,674,1291,0,63,54.31,23.8
"2011","Merton 011A","E01003380","Total",1648,794,854,1648,0,10,22.91,71.9
"2011","Merton 011B","E01003382","Total",1539,744,795,1539,0,11,16.51,93.2
"2011","Merton 011C","E01003385","Total",1581,790,791,1581,0,32,19.84,79.7
"2011","Merton 011D","E01003399","Total",1373,686,687,1358,15,28,13.05,105.2
"2011","Merton 011E","E01003423","Total",1548,743,805,1540,8,28,20.74,74.6
"2011","Merton 012A","E01003357","Total",1742,804,938,1742,0,13,33.16,52.5
"2011","Merton 012B","E01003376","Total",1553,758,795,1553,0,8,19.61,79.2
"2011","Merton 012C","E01003377","Total",1562,752,810,1562,0,26,10.96,142.5
"2011","Merton 012D","E01003408","Total",1852,937,915,1852,0,4,15.80,117.2
"2011","Merton 012E","E01003410","Total",1581,755,826,1581,0,9,12.66,124.9
"2011","Merton 013A","E01003386","Total",2204,1084,1120,2198,6,17,15.87,138.9
"2011","Merton 013B","E01003388","Total",1439,654,785,1439,0,11,14.66,98.2
"2011","Merton 013C","E01003389","Total",1764,913,851,1764,0,16,18.43,95.7
"2011","Merton 013D","E01003392","Total",1299,675,624,1299,0,10,24.20,53.7
"2011","Merton 013E","E01003409","Total",1710,821,889,1710,0,15,22.50,76.0
"2011","Merton 014A","E01003387","Total",1604,778,826,1595,9,14,23.24,69.0
"2011","Merton 014B","E01003391","Total",1333,652,681,1333,0,12,8.68,153.6
"2011","Merton 014C","E01003411","Total",1729,837,892,1729,0,12,20.89,82.8
"2011","Merton 014D","E01003412","Total",1660,810,850,1660,0,17,20.85,79.6
"2011","Merton 014E","E01003435","Total",1312,628,684,1309,3,14,82.17,16.0
"2011","Merton 015A","E01003361","Total",1646,845,801,1646,0,24,21.04,78.2
"2011","Merton 015B","E01003424","Total",1533,760,773,1533,0,51,29.79,51.5
"2011","Merton 015C","E01003425","Total",1440,706,734,1440,0,39,27.10,53.1
"2011","Merton 015D","E01003426","Total",1749,880,869,1749,0,33,39.36,44.4
"2011","Merton 015E","E01003428","Total",1457,735,722,1457,0,25,30.20,48.2
"2011","Merton 016A","E01003366","Total",1502,767,735,1502,0,19,57.02,26.3
"2011","Merton 016B","E01003381","Total",1451,696,755,1451,0,10,15.46,93.9
"2011","Merton 016C","E01003446","Total",1668,836,832,1668,0,16,23.91,69.8
"2011","Merton 016D","E01003447","Total",1545,734,811,1501,44,7,40.23,38.4
"2011","Merton 016E","E01003471","Total",1576,766,810,1511,65,31,30.52,51.6
"2011","Merton 017A","E01003413","Total",1900,917,983,1900,0,35,30.13,63.1
"2011","Merton 017B","E01003414","Total",1591,778,813,1560,31,21,22.37,71.1
"2011","Merton 017C","E01003415","Total",1632,782,850,1622,10,34,21.77,75.0
"2011","Merton 017D","E01003416","Total",1512,748,764,1512,0,17,32.12,47.1
"2011","Merton 017E","E01003434","Total",1489,729,760,1489,0,19,17.77,83.8
"2011","Merton 018A","E01003373","Total",1465,693,772,1465,0,19,17.11,85.6
"2011","Merton 018B","E01003378","Total",1992,941,1051,1992,0,21,22.40,88.9
"2011","Merton 018C","E01003379","Total",1846,861,985,1846,0,14,13.53,136.4
"2011","Merton 018D","E01003390","Total",1597,787,810,1597,0,22,9.19,173.8
"2011","Merton 018E","E01003405","Total",1705,844,861,1705,0,14,28.21,60.4
"2011","Merton 019A","E01003429","Total",1456,714,742,1456,0,29,15.30,95.2
"2011","Merton 019B","E01003430","Total",1443,688,755,1443,0,19,12.07,119.6
"2011","Merton 019C","E01003431","Total",1506,694,812,1506,0,25,12.60,119.5
"2011","Merton 019D","E01003432","Total",1556,742,814,1556,0,24,48.58,32.0
"2011","Merton 019E","E01003433","Total",1525,759,766,1521,4,17,27.42,55.6
"2011","Merton 020A","E01003466","Total",1592,792,800,1592,0,25,23.70,67.2
"2011","Merton 020B","E01003467","Total",1618,801,817,1612,6,35,39.30,41.2
"2011","Merton 020C","E01003468","Total",1699,843,856,1699,0,27,46.58,36.5
"2011","Merton 020D","E01003469","Total",1620,799,821,1620,0,25,29.47,55.0
"2011","Merton 020E","E01003470","Total",1757,850,907,1739,18,28,25.55,68.8
"2011","Merton 021A","E01003362","Total",1323,639,684,1320,3,35,42.44,31.2
"2011","Merton 021B","E01003363","Total",1638,813,825,1638,0,20,46.31,35.4
"2011","Merton 021C","E01003364","Total",1731,847,884,1720,11,34,22.02,78.6
"2011","Merton 021D","E01003365","Total",1409,694,715,1403,6,29,33.56,42.0
"2011","Merton 021E","E01003421","Total",1600,805,795,1600,0,16,27.37,58.5
"2011","Merton 022A","E01003374","Total",1440,690,750,1284,156,12,33.37,43.2
"2011","Merton 022B","E01003375","Total",1616,769,847,1591,25,18,182.73,8.8
"2011","Merton 022C","E01003437","Total",1879,933,946,1873,6,7,39.07,48.1
"2011","Merton 022D","E01003440","Total",1536,763,773,1536,0,21,45.52,33.7
"2011","Merton 022E","E01003441","Total",1858,918,940,1778,80,20,21.90,84.8
"2011","Merton 023A","E01003427","Total",1758,907,851,1749,9,22,34.55,50.9
"2011","Merton 023B","E01003436","Total",1565,797,768,1559,6,19,21.64,72.3
"2011","Merton 023C","E01003439","Total",1439,729,710,1439,0,6,36.32,39.6
"2011","Merton 023D","E01003448","Total",1701,804,897,1701,0,14,20.00,85.0
"2011","Merton 023E","E01003453","Total",1695,836,859,1685,10,14,20.57,82.4
"2011","Merton 024A","E01003438","Total",1691,822,869,1691,0,7,19.37,87.3
"2011","Merton 024B","E01003449","Total",1759,892,867,1759,0,29,29.98,58.7
"2011","Merton 024C","E01003450","Total",1611,776,835,1605,6,12,22.57,71.4
"2011","Merton 024D","E01003451","Total",1666,806,860,1644,22,24,57.26,29.1
"2011","Merton 024E","E01003452","Total",1982,984,998,1982,0,14,33.86,58.5
"2011","Merton 025A","E01003417","Total",1559,769,790,1559,0,17,30.02,51.9
"2011","Merton 025B","E01003418","Total",1471,739,732,1471,0,16,15.08,97.5
"2011","Merton 025C","E01003419","Total",1703,847,856,1703,0,16,60.43,28.2
"2011","Merton 025D","E01003420","Total",1380,679,701,1380,0,13,19.11,72.2
"2011","Merton 025E","E01003422","Total",1377,687,690,1341,36,16,28.76,47.9
"2011","Redbridge 001A","E01003744","Total",1337,647,690,1329,8,27,66.44,20.1
"2011","Redbridge 001B","E01003745","Total",1435,709,726,1435,0,48,48.84,29.4
"2011","Redbridge 001C","E01003746","Total",1486,715,771,1462,24,30,64.07,23.2
"2011","Redbridge 001D","E01003747","Total",1343,670,673,1343,0,55,29.84,45.0
"2011","Redbridge 001E","E01003748","Total",1545,756,789,1448,97,43,40.52,38.1
"2011","Redbridge 001F","E01003749","Total",1605,762,843,1597,8,29,20.46,78.4
"2011","Redbridge 001G","E01003750","Total",1671,806,865,1651,20,30,37.31,44.8
"2011","Redbridge 002A","E01003720","Total",1777,823,954,1777,0,13,52.71,33.7
"2011","Redbridge 002B","E01003722","Total",1772,866,906,1772,0,8,27.60,64.2
"2011","Redbridge 002C","E01003723","Total",1742,804,938,1742,0,20,29.13,59.8
"2011","Redbridge 002D","E01003726","Total",1524,722,802,1524,0,11,378.98,4.0
"2011","Redbridge 003A","E01003721","Total",1659,788,871,1609,50,8,18.28,90.8
"2011","Redbridge 003B","E01003724","Total",1381,668,713,1381,0,13,20.87,66.2
"2011","Redbridge 003C","E01003725","Total",1498,690,808,1498,0,11,15.13,99.0
"2011","Redbridge 003D","E01003727","Total",1600,751,849,1600,0,4,21.48,74.5
"2011","Redbridge 004A","E01003654","Total",1563,745,818,1563,0,20,23.42,66.7
"2011","Redbridge 004B","E01003655","Total",1510,730,780,1510,0,13,22.43,67.3
"2011","Redbridge 004C","E01003658","Total",1649,804,845,1649,0,15,23.28,70.8
"2011","Redbridge 004D","E01003660","Total",1718,880,838,1718,0,37,54.16,31.7
"2011","Redbridge 005A","E01003656","Total",1489,707,782,1489,0,13,54.22,27.5
"2011","Redbridge 005B","E01003657","Total",2089,1024,1065,2082,7,28,43.28,48.3
"2011","Redbridge 005C","E01003659","Total",1640,807,833,1640,0,21,37.11,44.2
"2011","Redbridge 006A","E01003698","Total",1385,695,690,1385,0,27,18.57,74.6
"2011","Redbridge 006B","E01003699","Total",1415,681,734,1415,0,14,85.89,16.5
"2011","Redbridge 006C","E01003700","Total",2240,1085,1155,2235,5,37,65.92,34.0
"2011","Redbridge 006D","E01003701","Total",1788,890,898,1788,0,22,29.49,60.6
"2011","Redbridge 006E","E01003702","Total",1620,779,841,1620,0,14,31.00,52.3
"2011","Redbridge 006F","E01003703","Total",2501,1244,1257,2501,0,40,99.31,25.2
"2011","Redbridge 006G","E01003704","Total",1681,795,886,1681,0,18,29.18,57.6
"2011","Redbridge 007A","E01003668","Total",1622,767,855,1610,12,21,22.00,73.7
"2011","Redbridge 007B","E01003669","Total",1528,751,777,1528,0,32,17.77,86.0
"2011","Redbridge 007C","E01003670","Total",1496,763,733,1496,0,42,24.37,61.4
"2011","Redbridge 007D","E01003671","Total",1533,758,775,1533,0,31,20.21,75.9
"2011","Redbridge 007E","E01003672","Total",1430,670,760,1430,0,15,18.32,78.1
"2011","Redbridge 007F","E01003673","Total",1778,902,876,1778,0,30,19.74,90.1
"2011","Redbridge 007G","E01003674","Total",2129,1076,1053,2099,30,10,26.74,79.6
"2011","Redbridge 008A","E01003707","Total",1335,669,666,1335,0,33,25.05,53.3
"2011","Redbridge 008B","E01003708","Total",1476,684,792,1476,0,15,44.04,33.5
"2011","Redbridge 008C","E01003709","Total",1627,807,820,1627,0,26,23.65,68.8
"2011","Redbridge 008D","E01003710","Total",1515,745,770,1515,0,35,21.91,69.1
"2011","Redbridge 009A","E01003759","Total",1459,694,765,1459,0,26,22.63,64.5
"2011","Redbridge 009B","E01003760","Total",1783,901,882,1783,0,13,30.42,58.6
"2011","Redbridge 009C","E01003761","Total",1771,858,913,1771,0,26,10.45,169.5
"2011","Redbridge 009D","E01003762","Total",1620,794,826,1604,16,25,24.99,64.8
"2011","Redbridge 009E","E01003763","Total",1875,919,956,1875,0,26,69.60,26.9
"2011","Redbridge 009F","E01003764","Total",1962,961,1001,1954,8,21,53.16,36.9
"2011","Redbridge 009G","E01003765","Total",1574,767,807,1574,0,14,23.15,68.0
"2011","Redbridge 010A","E01003705","Total",2192,1059,1133,2192,0,20,31.17,70.3
"2011","Redbridge 010B","E01003706","Total",1594,740,854,1594,0,18,19.45,82.0
"2011","Redbridge 010C","E01003711","Total",1812,876,936,1770,42,19,36.44,49.7
"2011","Redbridge 010D","E01003712","Total",1359,645,714,1359,0,17,16.84,80.7
"2011","Redbridge 012A","E01003646","Total",1749,907,842,1742,7,34,20.48,85.4
"2011","Redbridge 012B","E01003648","Total",1437,723,714,1437,0,32,21.70,66.2
"2011","Redbridge 012C","E01003649","Total",1633,833,800,1627,6,40,18.49,88.3
"2011","Redbridge 012D","E01003651","Total",1471,716,755,1467,4,50,19.28,76.3
"2011","Redbridge 013A","E01003639","Total",1758,832,926,1758,0,15,103.74,16.9
"2011","Redbridge 013B","E01003640","Total",1771,867,904,1771,0,31,612.84,2.9
"2011","Redbridge 013C","E01003641","Total",1704,846,858,1692,12,32,26.49,64.3
"2011","Redbridge 013D","E01003642","Total",1695,794,901,1689,6,26,30.46,55.6
"2011","Redbridge 014A","E01003774","Total",1764,860,904,1750,14,13,25.61,68.9
"2011","Redbridge 014B","E01003775","Total",1736,823,913,1736,0,26,33.08,52.5
"2011","Redbridge 014C","E01003776","Total",1653,702,951,1632,21,7,34.57,47.8
"2011","Redbridge 014D","E01003777","Total",1772,833,939,1740,32,20,23.56,75.2
"2011","Redbridge 014E","E01003778","Total",1839,904,935,1831,8,15,35.01,52.5
"2011","Redbridge 014F","E01003779","Total",1585,713,872,1485,100,15,16.73,94.7
"2011","Redbridge 014G","E01003780","Total",1516,751,765,1516,0,44,30.01,50.5
"2011","Redbridge 015A","E01003647","Total",1786,897,889,1786,0,29,15.93,112.1
"2011","Redbridge 015B","E01003650","Total",1513,714,799,1513,0,16,19.37,78.1
"2011","Redbridge 015C","E01003652","Total",1549,790,759,1543,6,41,16.92,91.5
"2011","Redbridge 015D","E01003653","Total",1471,723,748,1471,0,20,20.49,71.8
"2011","Redbridge 017A","E01003638","Total",1611,797,814,1611,0,23,26.74,60.2
"2011","Redbridge 017B","E01003643","Total",1833,874,959,1796,37,26,20.02,91.6
"2011","Redbridge 017C","E01003644","Total",1562,765,797,1562,0,32,15.64,99.9
"2011","Redbridge 017D","E01003645","Total",2610,1309,1301,2506,104,30,25.30,103.2
"2011","Redbridge 018A","E01003789","Total",1444,711,733,1444,0,38,30.93,46.7
"2011","Redbridge 018B","E01003794","Total",1472,712,760,1472,0,23,35.58,41.4
"2011","Redbridge 018C","E01003795","Total",1178,567,611,1178,0,27,78.73,15.0
"2011","Redbridge 018D","E01003796","Total",1566,748,818,1566,0,25,24.64,63.6
"2011","Redbridge 019A","E01003661","Total",1935,941,994,1902,33,23,20.83,92.9
"2011","Redbridge 019B","E01003662","Total",1859,923,936,1859,0,13,18.28,101.7
"2011","Redbridge 019C","E01003663","Total",1822,838,984,1757,65,21,31.56,57.7
"2011","Redbridge 019D","E01003664","Total",1776,869,907,1776,0,30,16.70,106.3
"2011","Redbridge 019E","E01003665","Total",1648,796,852,1648,0,25,17.14,96.1
"2011","Redbridge 019F","E01003666","Total",2198,1009,1189,2198,0,10,22.06,99.6
"2011","Redbridge 019H","E01033590","Total",1111,547,564,1098,13,10,9.77,113.7
"2011","Redbridge 019I","E01033592","Total",1908,945,963,1908,0,26,15.09,126.4
"2011","Redbridge 020A","E01003751","Total",1954,952,1002,1954,0,31,59.71,32.7
"2011","Redbridge 020B","E01003753","Total",1976,994,982,1976,0,24,17.39,113.6
"2011","Redbridge 020C","E01003754","Total",1636,805,831,1636,0,32,16.63,98.4
"2011","Redbridge 020D","E01003757","Total",1996,1009,987,1976,20,21,22.76,87.7
"2011","Redbridge 022A","E01003769","Total",1730,923,807,1711,19,21,24.16,71.6
"2011","Redbridge 022B","E01003770","Total",2609,1327,1282,2481,128,34,69.59,37.5
"2011","Redbridge 022C","E01003771","Total",1934,944,990,1918,16,24,22.89,84.5
"2011","Redbridge 022D","E01003773","Total",1673,839,834,1673,0,24,23.67,70.7
"2011","Redbridge 023A","E01003752","Total",2492,1236,1256,2492,0,34,22.51,110.7
"2011","Redbridge 023B","E01003755","Total",2002,1014,988,2002,0,25,21.80,91.8
"2011","Redbridge 023C","E01003756","Total",2123,1053,1070,2118,5,33,25.35,83.7
"2011","Redbridge 023D","E01003758","Total",2581,1287,1294,2581,0,29,25.54,101.1
"2011","Redbridge 024A","E01003766","Total",1900,952,948,1900,0,28,15.08,126.0
"2011","Redbridge 024B","E01003767","Total",1864,1016,848,1864,0,18,20.12,92.6
"2011","Redbridge 024C","E01003768","Total",1754,911,843,1716,38,22,17.47,100.4
"2011","Redbridge 024D","E01003772","Total",1700,856,844,1700,0,26,15.24,111.5
"2011","Redbridge 026A","E01003781","Total",1662,831,831,1632,30,18,16.80,98.9
"2011","Redbridge 026B","E01003782","Total",1755,877,878,1755,0,22,16.74,104.8
"2011","Redbridge 026C","E01003786","Total",1419,680,739,1419,0,31,13.01,109.1
"2011","Redbridge 026D","E01003787","Total",1536,763,773,1532,4,31,13.49,113.9
"2011","Redbridge 027A","E01003790","Total",1417,695,722,1417,0,31,85.55,16.6
"2011","Redbridge 027B","E01003791","Total",1488,732,756,1485,3,44,129.16,11.5
"2011","Redbridge 027C","E01003792","Total",1422,685,737,1394,28,34,78.12,18.2
"2011","Redbridge 027D","E01003793","Total",1556,710,846,1556,0,18,57.07,27.3
"2011","Redbridge 029A","E01003783","Total",2235,1170,1065,2184,51,9,23.56,94.9
"2011","Redbridge 029B","E01003784","Total",1760,918,842,1760,0,9,13.82,127.4
"2011","Redbridge 029C","E01003785","Total",1904,993,911,1898,6,7,36.92,51.6
"2011","Redbridge 029D","E01003788","Total",1852,1007,845,1816,36,7,15.91,116.4
"2011","Redbridge 030A","E01003683","Total",2144,1115,1029,2144,0,27,12.03,178.2
"2011","Redbridge 030B","E01003684","Total",1780,871,909,1780,0,11,11.26,158.1
"2011","Redbridge 030C","E01003685","Total",1822,958,864,1822,0,18,11.42,159.5
"2011","Redbridge 030D","E01003686","Total",1952,1013,939,1952,0,12,16.54,118.0
"2011","Redbridge 030F","E01003688","Total",1804,910,894,1791,13,11,13.41,134.5
"2011","Redbridge 030G","E01003689","Total",1580,817,763,1580,0,16,24.83,63.6
"2011","Redbridge 030H","E01033589","Total",1676,888,788,1676,0,12,12.19,137.5
"2011","Redbridge 030I","E01033591","Total",1908,951,957,1898,10,24,25.44,75.0
"2011","Redbridge 031A","E01003737","Total",1793,871,922,1793,0,24,35.46,50.6
"2011","Redbridge 031B","E01003738","Total",2108,1056,1052,2108,0,18,23.23,90.7
"2011","Redbridge 031C","E01003739","Total",2121,1087,1034,2121,0,20,28.78,73.7
"2011","Redbridge 031D","E01003740","Total",2055,997,1058,2055,0,31,45.29,45.4
"2011","Redbridge 031E","E01003741","Total",1737,854,883,1737,0,13,23.87,72.8
"2011","Redbridge 031F","E01003742","Total",2085,1095,990,2085,0,30,14.36,145.2
"2011","Redbridge 031G","E01003743","Total",1773,884,889,1747,26,14,17.39,102.0
"2011","Redbridge 032A","E01003728","Total",2423,1298,1125,2391,32,7,27.30,88.8
"2011","Redbridge 032B","E01003729","Total",1751,917,834,1745,6,8,11.85,147.8
"2011","Redbridge 032C","E01003730","Total",1693,878,815,1693,0,21,8.81,192.2
"2011","Redbridge 032D","E01003732","Total",1655,710,945,1545,110,12,12.02,137.7
"2011","Redbridge 032E","E01003733","Total",1767,897,870,1767,0,21,9.80,180.3
"2011","Redbridge 033A","E01003731","Total",1461,767,694,1461,0,4,13.93,104.9
"2011","Redbridge 033B","E01003734","Total",1796,906,890,1737,59,15,12.53,143.3
"2011","Redbridge 033C","E01003735","Total",2339,1097,1242,2339,0,15,20.29,115.3
"2011","Redbridge 033D","E01003736","Total",1659,860,799,1659,0,18,9.90,167.6
"2011","Redbridge 034A","E01003713","Total",1744,883,861,1740,4,24,14.77,118.1
"2011","Redbridge 034B","E01003714","Total",2168,1096,1072,2159,9,27,17.81,121.7
"2011","Redbridge 034C","E01003715","Total",1988,1020,968,1970,18,25,15.59,127.5
"2011","Redbridge 034D","E01003716","Total",1712,860,852,1704,8,16,34.74,49.3
"2011","Redbridge 034E","E01003718","Total",1847,941,906,1847,0,19,14.28,129.3
"2011","Redbridge 034F","E01003719","Total",1958,1000,958,1942,16,31,38.48,50.9
"2011","Redbridge 034G","E01032581","Total",1652,836,816,1652,0,19,28.93,57.1
"2011","Redbridge 035A","E01003690","Total",1711,865,846,1596,115,30,77.69,22.0
"2011","Redbridge 035B","E01003691","Total",1434,708,726,1434,0,12,22.85,62.8
"2011","Redbridge 035C","E01003692","Total",1592,783,809,1585,7,25,15.16,105.0
"2011","Redbridge 035D","E01003693","Total",1541,776,765,1541,0,30,44.43,34.7
"2011","Redbridge 035E","E01003694","Total",1462,751,711,1451,11,31,21.33,68.5
"2011","Redbridge 035F","E01003695","Total",1533,822,711,1518,15,11,12.69,120.8
"2011","Redbridge 035G","E01003696","Total",1877,1036,841,1877,0,34,19.21,97.7
"2011","Redbridge 035H","E01003697","Total",1630,833,797,1621,9,16,27.25,59.8
"2011","Redbridge 036A","E01003675","Total",1619,785,834,1619,0,22,23.06,70.2
"2011","Redbridge 036B","E01003676","Total",1690,847,843,1690,0,34,18.97,89.1
"2011","Redbridge 036C","E01003677","Total",1547,787,760,1547,0,29,61.17,25.3
"2011","Redbridge 036D","E01003678","Total",1605,798,807,1605,0,31,26.79,59.9
"2011","Redbridge 036E","E01003679","Total",1621,800,821,1621,0,59,22.42,72.3
"2011","Redbridge 036F","E01003680","Total",1619,822,797,1619,0,31,20.54,78.8
"2011","Redbridge 036G","E01003681","Total",1844,859,985,1844,0,31,48.38,38.1
"2011","Redbridge 036H","E01003682","Total",1696,861,835,1696,0,45,27.82,61.0
"2011","Richmond upon Thames 001A","E01003797","Total",1479,680,799,1445,34,73,42.25,35.0
"2011","Richmond upon Thames 001B","E01003798","Total",1503,724,779,1503,0,53,22.23,67.6
"2011","Richmond upon Thames 001C","E01003799","Total",1621,790,831,1621,0,48,82.59,19.6
"2011","Richmond upon Thames 001D","E01003800","Total",1573,753,820,1573,0,44,25.70,61.2
"2011","Richmond upon Thames 001E","E01003801","Total",1321,653,668,1304,17,23,32.23,41.0
"2011","Richmond upon Thames 001F","E01003802","Total",1328,681,647,1328,0,40,39.28,33.8
"2011","Richmond upon Thames 001G","E01003803","Total",1474,699,775,1474,0,17,20.31,72.6
"2011","Richmond upon Thames 002A","E01003846","Total",1734,846,888,1734,0,63,23.92,72.5
"2011","Richmond upon Thames 002B","E01003847","Total",1582,755,827,1582,0,43,159.96,9.9
"2011","Richmond upon Thames 002C","E01003849","Total",1534,763,771,1480,54,32,20.03,76.6
"2011","Richmond upon Thames 002D","E01003851","Total",1688,799,889,1642,46,46,24.94,67.7
"2011","Richmond upon Thames 002E","E01003860","Total",1691,862,829,1681,10,23,151.59,11.2
"2011","Richmond upon Thames 002F","E01003864","Total",1466,699,767,1466,0,31,25.60,57.3
"2011","Richmond upon Thames 003A","E01003852","Total",1324,675,649,1324,0,39,67.17,19.7
"2011","Richmond upon Thames 003B","E01003853","Total",1535,737,798,1491,44,48,30.14,50.9
"2011","Richmond upon Thames 003C","E01003854","Total",1413,678,735,1413,0,21,14.09,100.3
"2011","Richmond upon Thames 003D","E01003855","Total",1689,817,872,1689,0,14,29.38,57.5
"2011","Richmond upon Thames 003E","E01003856","Total",1568,725,843,1568,0,15,12.26,127.9
"2011","Richmond upon Thames 003F","E01003857","Total",1752,802,950,1752,0,29,15.09,116.1
"2011","Richmond upon Thames 003G","E01003858","Total",1638,781,857,1628,10,37,16.37,100.1
"2011","Richmond upon Thames 004A","E01003848","Total",1808,878,930,1808,0,21,19.94,90.7
"2011","Richmond upon Thames 004C","E01003861","Total",1751,856,895,1751,0,15,19.22,91.1
"2011","Richmond upon Thames 004D","E01003862","Total",1388,657,731,1388,0,22,21.10,65.8
"2011","Richmond upon Thames 004E","E01003863","Total",1420,655,765,1420,0,13,21.26,66.8
"2011","Richmond upon Thames 004F","E01003865","Total",1311,627,684,1311,0,19,13.69,95.8
"2011","Richmond upon Thames 004G","E01033570","Total",1552,801,751,1552,0,17,47.25,32.8
"2011","Richmond upon Thames 004H","E01033571","Total",1538,751,787,1538,0,29,33.63,45.7
"2011","Richmond upon Thames 005A","E01003804","Total",1758,841,917,1758,0,41,18.05,97.4
"2011","Richmond upon Thames 005B","E01003807","Total",1795,888,907,1795,0,28,18.37,97.7
"2011","Richmond upon Thames 005C","E01003808","Total",1782,829,953,1782,0,24,13.56,131.4
"2011","Richmond upon Thames 005D","E01003809","Total",1735,850,885,1719,16,65,39.29,44.2
"2011","Richmond upon Thames 005E","E01003859","Total",1622,798,824,1622,0,43,19.20,84.5
"2011","Richmond upon Thames 006A","E01003873","Total",1660,827,833,1654,6,24,19.38,85.7
"2011","Richmond upon Thames 006B","E01003874","Total",1529,740,789,1508,21,21,13.64,112.1
"2011","Richmond upon Thames 006C","E01003875","Total",1613,801,812,1613,0,43,51.03,31.6
"2011","Richmond upon Thames 006D","E01003878","Total",1394,637,757,1331,63,20,99.50,14.0
"2011","Richmond upon Thames 007A","E01003866","Total",1587,816,771,1587,0,19,15.38,103.2
"2011","Richmond upon Thames 007B","E01003868","Total",1506,766,740,1506,0,28,13.28,113.4
"2011","Richmond upon Thames 007C","E01003871","Total",1649,797,852,1649,0,37,19.49,84.6
"2011","Richmond upon Thames 007D","E01003872","Total",1451,731,720,1451,0,45,31.64,45.9
"2011","Richmond upon Thames 008A","E01003821","Total",1513,791,722,1438,75,18,29.46,51.4
"2011","Richmond upon Thames 008B","E01003876","Total",1591,791,800,1591,0,39,47.64,33.4
"2011","Richmond upon Thames 008C","E01003877","Total",1482,726,756,1479,3,39,15.85,93.5
"2011","Richmond upon Thames 008D","E01003879","Total",1551,763,788,1338,213,39,18.74,82.8
"2011","Richmond upon Thames 009A","E01003892","Total",2012,997,1015,1930,82,30,41.34,48.7
"2011","Richmond upon Thames 009B","E01003893","Total",1616,800,816,1569,47,31,21.79,74.2
"2011","Richmond upon Thames 009C","E01003894","Total",1643,841,802,1635,8,26,16.61,98.9
"2011","Richmond upon Thames 009D","E01003895","Total",1718,806,912,1698,20,52,44.79,38.4
"2011","Richmond upon Thames 010A","E01003905","Total",1435,700,735,1388,47,20,36.56,39.3
"2011","Richmond upon Thames 010B","E01003906","Total",1618,792,826,1538,80,28,20.83,77.7
"2011","Richmond upon Thames 010C","E01003907","Total",1683,842,841,1683,0,19,23.86,70.5
"2011","Richmond upon Thames 010D","E01003908","Total",1817,888,929,1817,0,34,29.19,62.2
"2011","Richmond upon Thames 010E","E01003909","Total",1569,781,788,1564,5,22,22.23,70.6
"2011","Richmond upon Thames 011A","E01003867","Total",1492,754,738,1485,7,24,41.76,35.7
"2011","Richmond upon Thames 011B","E01003869","Total",1617,811,806,1605,12,29,32.35,50.0
"2011","Richmond upon Thames 011C","E01003870","Total",1870,922,948,1863,7,30,42.73,43.8
"2011","Richmond upon Thames 011D","E01003910","Total",1630,791,839,1624,6,18,29.64,55.0
"2011","Richmond upon Thames 012A","E01003805","Total",1673,824,849,1667,6,66,79.81,21.0
"2011","Richmond upon Thames 012B","E01003806","Total",1605,794,811,1481,124,66,414.45,3.9
"2011","Richmond upon Thames 012C","E01003816","Total",1707,840,867,1707,0,55,303.71,5.6
"2011","Richmond upon Thames 012D","E01003817","Total",1913,1004,909,1689,224,28,410.22,4.7
"2011","Richmond upon Thames 013A","E01003840","Total",1584,780,804,1584,0,18,19.99,79.2
"2011","Richmond upon Thames 013B","E01003841","Total",1932,975,957,1925,7,16,29.04,66.5
"2011","Richmond upon Thames 013C","E01003842","Total",1677,808,869,1677,0,17,39.36,42.6
"2011","Richmond upon Thames 013D","E01003843","Total",2044,1014,1030,2039,5,30,33.16,61.6
"2011","Richmond upon Thames 013E","E01003844","Total",1450,704,746,1444,6,27,28.61,50.7
"2011","Richmond upon Thames 013F","E01003845","Total",1626,798,828,1615,11,31,41.06,39.6
"2011","Richmond upon Thames 014A","E01003882","Total",1797,875,922,1790,7,38,21.46,83.7
"2011","Richmond upon Thames 014B","E01003883","Total",1775,905,870,1775,0,10,19.17,92.6
"2011","Richmond upon Thames 014C","E01003896","Total",1646,858,788,1646,0,25,31.01,53.1
"2011","Richmond upon Thames 014D","E01003897","Total",1761,845,916,1683,78,20,19.67,89.5
"2011","Richmond upon Thames 015A","E01003898","Total",1490,718,772,1458,32,19,18.09,82.4
"2011","Richmond upon Thames 015B","E01003899","Total",1377,660,717,1377,0,22,16.75,82.2
"2011","Richmond upon Thames 015C","E01003900","Total",1562,752,810,1562,0,19,74.37,21.0
"2011","Richmond upon Thames 015D","E01003901","Total",1640,798,842,1640,0,25,28.03,58.5
"2011","Richmond upon Thames 015E","E01003902","Total",1296,643,653,1296,0,18,16.20,80.0
"2011","Richmond upon Thames 015F","E01003903","Total",1627,806,821,1610,17,20,67.96,23.9
"2011","Richmond upon Thames 015G","E01003904","Total",1536,738,798,1536,0,15,24.17,63.5
"2011","Richmond upon Thames 016A","E01003880","Total",1468,710,758,1468,0,32,23.22,63.2
"2011","Richmond upon Thames 016B","E01003881","Total",1837,848,989,1105,732,52,33.07,55.5
"2011","Richmond upon Thames 016C","E01003884","Total",1594,801,793,1568,26,42,28.12,56.7
"2011","Richmond upon Thames 016D","E01003885","Total",1516,746,770,1516,0,38,43.93,34.5
"2011","Richmond upon Thames 017A","E01003818","Total",1560,763,797,1560,0,22,48.65,32.1
"2011","Richmond upon Thames 017B","E01003819","Total",1675,828,847,1675,0,20,104.88,16.0
"2011","Richmond upon Thames 017C","E01003820","Total",1949,918,1031,1949,0,22,29.54,66.0
"2011","Richmond upon Thames 018A","E01003811","Total",1548,755,793,1548,0,25,17.83,86.8
"2011","Richmond upon Thames 018B","E01003812","Total",1836,886,950,1836,0,25,29.02,63.3
"2011","Richmond upon Thames 018C","E01003890","Total",1509,707,802,1509,0,39,21.56,70.0
"2011","Richmond upon Thames 018D","E01003891","Total",1715,822,893,1706,9,28,30.41,56.4
"2011","Richmond upon Thames 019A","E01003810","Total",1605,800,805,1597,8,36,18.93,84.8
"2011","Richmond upon Thames 019B","E01003813","Total",1630,809,821,1618,12,57,31.71,51.4
"2011","Richmond upon Thames 019C","E01003814","Total",1714,778,936,1606,108,44,42.49,40.3
"2011","Richmond upon Thames 019D","E01003815","Total",1798,868,930,1794,4,24,51.83,34.7
"2011","Richmond upon Thames 020A","E01003828","Total",1517,729,788,1517,0,35,31.00,48.9
"2011","Richmond upon Thames 020B","E01003829","Total",1675,804,871,1675,0,24,40.02,41.9
"2011","Richmond upon Thames 020C","E01003830","Total",1760,864,896,1760,0,49,50.31,35.0
"2011","Richmond upon Thames 020D","E01003831","Total",1618,775,843,1611,7,25,31.66,51.1
"2011","Richmond upon Thames 020E","E01003832","Total",1431,681,750,1431,0,22,22.25,64.3
"2011","Richmond upon Thames 020F","E01003833","Total",1386,650,736,1352,34,18,19.72,70.3
"2011","Richmond upon Thames 021A","E01003886","Total",1699,828,871,1699,0,32,20.49,82.9
"2011","Richmond upon Thames 021B","E01003887","Total",1724,827,897,1724,0,20,22.23,77.6
"2011","Richmond upon Thames 021C","E01003888","Total",1907,892,1015,1884,23,26,79.32,24.0
"2011","Richmond upon Thames 021D","E01003889","Total",1776,892,884,1706,70,43,252.82,7.0
"2011","Richmond upon Thames 022A","E01003834","Total",1720,875,845,1512,208,26,108.30,15.9
"2011","Richmond upon Thames 022B","E01003835","Total",1527,748,779,1498,29,69,36.19,42.2
"2011","Richmond upon Thames 022C","E01003836","Total",1505,702,803,1472,33,42,24.79,60.7
"2011","Richmond upon Thames 022D","E01003837","Total",1812,878,934,1797,15,37,51.54,35.2
"2011","Richmond upon Thames 022E","E01003838","Total",1786,869,917,1786,0,34,30.36,58.8
"2011","Richmond upon Thames 022F","E01003839","Total",1871,902,969,1864,7,18,22.95,81.5
"2011","Richmond upon Thames 023A","E01003822","Total",1444,680,764,1420,24,61,37.42,38.6
"2011","Richmond upon Thames 023B","E01003823","Total",1638,795,843,1638,0,46,429.22,3.8
"2011","Richmond upon Thames 023C","E01003824","Total",1661,807,854,1641,20,44,32.57,51.0
"2011","Richmond upon Thames 023D","E01003825","Total",1762,859,903,1762,0,47,34.42,51.2
"2011","Richmond upon Thames 023E","E01003826","Total",1768,814,954,1695,73,14,108.52,16.3
"2011","Richmond upon Thames 023F","E01003827","Total",1712,839,873,1712,0,27,45.54,37.6
"2011","Sutton 001A","E01004125","Total",1583,761,822,1583,0,9,13.87,114.1
"2011","Sutton 001B","E01004183","Total",1667,784,883,1667,0,6,21.30,78.3
"2011","Sutton 001C","E01004184","Total",1590,746,844,1590,0,3,27.63,57.5
"2011","Sutton 001D","E01004185","Total",1452,705,747,1427,25,16,40.35,36.0
"2011","Sutton 001E","E01004189","Total",1879,877,1002,1879,0,11,33.60,55.9
"2011","Sutton 002A","E01004123","Total",2126,1056,1070,2126,0,11,40.70,52.2
"2011","Sutton 002B","E01004124","Total",1826,905,921,1826,0,9,18.38,99.3
"2011","Sutton 002C","E01004126","Total",1509,697,812,1509,0,13,12.87,117.2
"2011","Sutton 002D","E01004128","Total",1488,705,783,1401,87,12,17.07,87.2
"2011","Sutton 002E","E01004129","Total",1772,840,932,1762,10,6,26.47,66.9
"2011","Sutton 003A","E01004130","Total",1598,776,822,1598,0,24,67.58,23.6
"2011","Sutton 003B","E01004131","Total",1632,780,852,1632,0,24,20.53,79.5
"2011","Sutton 003C","E01004134","Total",1435,704,731,1435,0,19,21.90,65.5
"2011","Sutton 003D","E01004135","Total",1448,708,740,1448,0,28,27.68,52.3
"2011","Sutton 003E","E01004136","Total",1553,795,758,1553,0,13,24.14,64.3
"2011","Sutton 004A","E01004164","Total",1476,740,736,1476,0,13,23.47,62.9
"2011","Sutton 004B","E01004166","Total",1449,696,753,1449,0,15,24.70,58.7
"2011","Sutton 004C","E01004169","Total",1135,550,585,1135,0,3,14.49,78.3
"2011","Sutton 004D","E01004186","Total",1724,865,859,1724,0,17,29.92,57.6
"2011","Sutton 004E","E01004188","Total",1711,811,900,1711,0,8,35.25,48.5
"2011","Sutton 005A","E01004127","Total",1645,767,878,1645,0,13,20.62,79.8
"2011","Sutton 005B","E01004163","Total",1541,760,781,1541,0,17,21.65,71.2
"2011","Sutton 005C","E01004165","Total",1668,805,863,1668,0,12,25.03,66.6
"2011","Sutton 005D","E01004167","Total",1318,622,696,1318,0,7,16.38,80.5
"2011","Sutton 005E","E01004187","Total",1607,804,803,1607,0,13,17.42,92.3
"2011","Sutton 006A","E01004117","Total",1464,725,739,1464,0,21,25.49,57.4
"2011","Sutton 006B","E01004121","Total",1566,790,776,1566,0,28,25.32,61.8
"2011","Sutton 006C","E01004192","Total",1931,914,1017,1931,0,14,39.02,49.5
"2011","Sutton 006D","E01004193","Total",2328,1128,1200,2328,0,23,37.12,62.7
"2011","Sutton 006E","E01004195","Total",1578,779,799,1561,17,19,23.69,66.6
"2011","Sutton 007A","E01004144","Total",1627,826,801,1627,0,25,40.70,40.0
"2011","Sutton 007B","E01004145","Total",2131,1031,1100,2131,0,22,45.83,46.5
"2011","Sutton 007C","E01004146","Total",1710,815,895,1661,49,15,21.42,79.8
"2011","Sutton 007D","E01004147","Total",1585,751,834,1537,48,15,28.67,55.3
"2011","Sutton 008A","E01004116","Total",1608,757,851,1532,76,22,32.32,49.8
"2011","Sutton 008B","E01004122","Total",1372,690,682,1372,0,20,25.92,52.9
"2011","Sutton 008C","E01004190","Total",1367,693,674,1367,0,18,26.42,51.7
"2011","Sutton 008D","E01004191","Total",1651,820,831,1651,0,19,24.53,67.3
"2011","Sutton 008E","E01004194","Total",1356,671,685,1356,0,7,20.49,66.2
"2011","Sutton 008F","E01004196","Total",1444,700,744,1430,14,18,24.44,59.1
"2011","Sutton 009A","E01004115","Total",1750,831,919,1750,0,28,25.96,67.4
"2011","Sutton 009B","E01004118","Total",1675,826,849,1675,0,31,27.12,61.8
"2011","Sutton 009C","E01004119","Total",1418,722,696,1418,0,24,25.59,55.4
"2011","Sutton 009D","E01004132","Total",1536,754,782,1536,0,28,17.10,89.8
"2011","Sutton 009E","E01004133","Total",1510,751,759,1510,0,16,19.15,78.9
"2011","Sutton 010A","E01004171","Total",1518,739,779,1493,25,20,36.77,41.3
"2011","Sutton 010B","E01004172","Total",1549,742,807,1527,22,8,17.88,86.6
"2011","Sutton 010C","E01004173","Total",1385,668,717,1385,0,26,22.61,61.3
"2011","Sutton 010D","E01004175","Total",1614,770,844,1608,6,26,26.04,62.0
"2011","Sutton 010E","E01004176","Total",1419,670,749,1419,0,17,16.11,88.1
"2011","Sutton 011A","E01004076","Total",1487,722,765,1487,0,17,343.12,4.3
"2011","Sutton 011B","E01004077","Total",1560,772,788,1558,2,24,26.41,59.1
"2011","Sutton 011C","E01004078","Total",1617,807,810,1617,0,17,32.27,50.1
"2011","Sutton 011D","E01004079","Total",1399,713,686,1399,0,27,32.05,43.7
"2011","Sutton 011E","E01004080","Total",1332,655,677,1326,6,25,29.54,45.1
"2011","Sutton 011F","E01004081","Total",1507,738,769,1507,0,21,17.02,88.5
"2011","Sutton 011G","E01004082","Total",1407,694,713,1407,0,30,17.57,80.1
"2011","Sutton 012A","E01004137","Total",1518,770,748,1518,0,11,23.17,65.5
"2011","Sutton 012B","E01004140","Total",1509,765,744,1509,0,12,13.22,114.1
"2011","Sutton 012C","E01004141","Total",1555,733,822,1536,19,10,12.03,129.3
"2011","Sutton 012D","E01004142","Total",2038,1012,1026,2024,14,12,38.35,53.1
"2011","Sutton 012E","E01004149","Total",1710,827,883,1710,0,16,27.39,62.4
"2011","Sutton 013A","E01004101","Total",1361,680,681,1361,0,25,22.39,60.8
"2011","Sutton 013B","E01004103","Total",1577,745,832,1577,0,18,17.56,89.8
"2011","Sutton 013C","E01004138","Total",1552,768,784,1552,0,16,16.89,91.9
"2011","Sutton 013D","E01004139","Total",1368,669,699,1358,10,13,15.46,88.5
"2011","Sutton 013E","E01004168","Total",1576,769,807,1576,0,22,22.48,70.1
"2011","Sutton 014A","E01004143","Total",1453,680,773,1453,0,15,11.83,122.8
"2011","Sutton 014B","E01004148","Total",1592,750,842,1592,0,18,23.49,67.8
"2011","Sutton 014C","E01004159","Total",1528,787,741,1528,0,15,34.09,44.8
"2011","Sutton 014D","E01004160","Total",1575,794,781,1575,0,26,22.56,69.8
"2011","Sutton 014E","E01004161","Total",1444,685,759,1444,0,19,32.67,44.2
"2011","Sutton 015A","E01004097","Total",1676,831,845,1676,0,33,27.21,61.6
"2011","Sutton 015B","E01004098","Total",1256,612,644,1234,22,33,22.33,56.2
"2011","Sutton 015C","E01004099","Total",1441,698,743,1441,0,11,38.86,37.1
"2011","Sutton 015D","E01004100","Total",1354,676,678,1354,0,18,35.13,38.5
"2011","Sutton 015E","E01004102","Total",1374,667,707,1362,12,22,39.17,35.1
"2011","Sutton 016A","E01004110","Total",1828,917,911,1809,19,21,31.05,58.9
"2011","Sutton 016B","E01004111","Total",1511,743,768,1511,0,40,47.68,31.7
"2011","Sutton 016C","E01004112","Total",1636,781,855,1635,1,48,52.44,31.2
"2011","Sutton 016D","E01004120","Total",1538,745,793,1538,0,34,28.87,53.3
"2011","Sutton 016E","E01004157","Total",1274,611,663,1274,0,33,26.17,48.7
"2011","Sutton 017A","E01004087","Total",1465,722,743,1458,7,38,35.84,40.9
"2011","Sutton 017B","E01004170","Total",1721,840,881,1714,7,23,25.13,68.5
"2011","Sutton 017C","E01004174","Total",1444,703,741,1444,0,10,17.12,84.3
"2011","Sutton 017D","E01004178","Total",1979,982,997,1961,18,18,24.20,81.8
"2011","Sutton 017E","E01004179","Total",1567,774,793,1560,7,31,22.98,68.2
"2011","Sutton 018A","E01004152","Total",1562,724,838,1506,56,14,20.48,76.3
"2011","Sutton 018B","E01004155","Total",1628,789,839,1549,79,9,19.14,85.1
"2011","Sutton 018C","E01004156","Total",1687,808,879,1653,34,7,20.78,81.2
"2011","Sutton 018D","E01004158","Total",1479,734,745,1438,41,30,23.82,62.1
"2011","Sutton 018E","E01004162","Total",1549,745,804,1500,49,11,17.81,87.0
"2011","Sutton 019A","E01004083","Total",1420,662,758,1420,0,12,24.57,57.8
"2011","Sutton 019B","E01004086","Total",1617,785,832,1612,5,19,55.86,28.9
"2011","Sutton 019C","E01004088","Total",1818,835,983,1818,0,10,46.89,38.8
"2011","Sutton 019D","E01004089","Total",1290,608,682,1290,0,5,11.22,115.0
"2011","Sutton 019E","E01004182","Total",1546,713,833,1546,0,11,14.73,105.0
"2011","Sutton 020A","E01004104","Total",1528,753,775,1515,13,33,36.82,41.5
"2011","Sutton 020B","E01004107","Total",1529,711,818,1522,7,21,24.21,63.2
"2011","Sutton 020C","E01004177","Total",1754,767,987,1684,70,8,22.25,78.8
"2011","Sutton 020D","E01004180","Total",1711,815,896,1682,29,62,59.71,28.7
"2011","Sutton 020E","E01004181","Total",1643,793,850,1583,60,27,28.08,58.5
"2011","Sutton 021A","E01004090","Total",1193,587,606,1168,25,1,18.94,63.0
"2011","Sutton 021B","E01004096","Total",1426,680,746,1412,14,10,15.38,92.7
"2011","Sutton 021C","E01004150","Total",1560,749,811,1548,12,6,16.14,96.7
"2011","Sutton 021D","E01004151","Total",1711,843,868,1587,124,13,20.10,85.1
"2011","Sutton 021E","E01004153","Total",1708,878,830,1708,0,15,17.29,98.8
"2011","Sutton 022A","E01004091","Total",1282,623,659,1282,0,35,37.43,34.3
"2011","Sutton 022B","E01004092","Total",1437,691,746,1430,7,52,64.89,22.1
"2011","Sutton 022C","E01004105","Total",1819,900,919,1819,0,68,38.45,47.3
"2011","Sutton 022D","E01004106","Total",1529,744,785,1529,0,65,81.38,18.8
"2011","Sutton 022E","E01004154","Total",1430,729,701,1419,11,31,34.07,42.0
"2011","Sutton 024A","E01004084","Total",1462,724,738,1447,15,45,50.81,28.8
"2011","Sutton 024B","E01004085","Total",1595,777,818,1595,0,50,80.88,19.7
"2011","Sutton 024C","E01004108","Total",1714,835,879,1645,69,26,458.22,3.7
"2011","Sutton 024D","E01004109","Total",1596,779,817,1596,0,19,66.53,24.0
"2011","Sutton 025A","E01004093","Total",1522,729,793,1499,23,39,40.30,37.8
"2011","Sutton 025B","E01004094","Total",1677,808,869,1677,0,16,27.77,60.4
"2011","Sutton 025C","E01004095","Total",1511,754,757,1459,52,34,29.01,52.1
"2011","Sutton 025D","E01004114","Total",1735,847,888,1676,59,63,154.38,11.2
"2011","Sutton 025E","E01032623","Total",1825,865,960,1751,74,66,82.23,22.2
"2011","Waltham Forest 001A","E01004349","Total",1439,676,763,1439,0,29,63.69,22.6
"2011","Waltham Forest 001B","E01004350","Total",1753,811,942,1753,0,7,31.54,55.6
"2011","Waltham Forest 001C","E01004351","Total",1601,775,826,1584,17,13,43.56,36.8
"2011","Waltham Forest 001D","E01004356","Total",1630,801,829,1630,0,7,47.24,34.5
"2011","Waltham Forest 001E","E01004357","Total",1556,741,815,1556,0,20,33.22,46.8
"2011","Waltham Forest 002A","E01004352","Total",1920,974,946,1842,78,23,147.06,13.1
"2011","Waltham Forest 002B","E01004353","Total",1806,840,966,1789,17,24,56.38,32.0
"2011","Waltham Forest 002C","E01004354","Total",1768,856,912,1768,0,13,30.53,57.9
"2011","Waltham Forest 002D","E01004358","Total",1647,766,881,1647,0,12,24.83,66.3
"2011","Waltham Forest 002E","E01004359","Total",1673,825,848,1673,0,27,22.59,74.1
"2011","Waltham Forest 003A","E01004384","Total",1823,850,973,1737,86,21,27.25,66.9
"2011","Waltham Forest 003B","E01004385","Total",1384,635,749,1384,0,21,48.63,28.5
"2011","Waltham Forest 003C","E01004386","Total",1661,815,846,1661,0,41,37.58,44.2
"2011","Waltham Forest 003D","E01004389","Total",1613,777,836,1613,0,8,42.45,38.0
"2011","Waltham Forest 003E","E01004390","Total",1596,735,861,1596,0,15,32.37,49.3
"2011","Waltham Forest 004A","E01004355","Total",1599,770,829,1599,0,20,24.49,65.3
"2011","Waltham Forest 004B","E01004360","Total",1331,672,659,1319,12,29,22.62,58.8
"2011","Waltham Forest 004C","E01004413","Total",1564,711,853,1529,35,20,32.84,47.6
"2011","Waltham Forest 004D","E01004415","Total",1559,728,831,1535,24,20,26.04,59.9
"2011","Waltham Forest 004E","E01004416","Total",1697,869,828,1695,2,23,47.16,36.0
"2011","Waltham Forest 005A","E01004361","Total",1294,647,647,1294,0,18,20.93,61.8
"2011","Waltham Forest 005B","E01004414","Total",1607,774,833,1601,6,13,29.03,55.4
"2011","Waltham Forest 005C","E01004417","Total",1663,779,884,1615,48,18,27.62,60.2
"2011","Waltham Forest 005D","E01004451","Total",1726,823,903,1726,0,22,19.73,87.5
"2011","Waltham Forest 005E","E01004452","Total",1630,786,844,1630,0,12,23.03,70.8
"2011","Waltham Forest 006A","E01004450","Total",1655,814,841,1655,0,18,29.73,55.7
"2011","Waltham Forest 006B","E01004453","Total",1625,799,826,1625,0,13,34.16,47.6
"2011","Waltham Forest 006C","E01004454","Total",1714,828,886,1714,0,7,18.90,90.7
"2011","Waltham Forest 006D","E01004455","Total",1537,742,795,1511,26,18,47.84,32.1
"2011","Waltham Forest 006E","E01004456","Total",1557,711,846,1557,0,16,24.69,63.1
"2011","Waltham Forest 007A","E01004379","Total",1430,689,741,1430,0,18,21.15,67.6
"2011","Waltham Forest 007B","E01004380","Total",1511,694,817,1511,0,25,50.82,29.7
"2011","Waltham Forest 007C","E01004381","Total",1815,891,924,1815,0,34,23.39,77.6
"2011","Waltham Forest 007D","E01004383","Total",1634,781,853,1615,19,24,22.96,71.2
"2011","Waltham Forest 007E","E01004387","Total",1500,731,769,1500,0,25,26.48,56.6
"2011","Waltham Forest 007F","E01004388","Total",1481,713,768,1431,50,29,27.06,54.7
"2011","Waltham Forest 008A","E01004343","Total",1794,890,904,1794,0,26,27.36,65.6
"2011","Waltham Forest 008B","E01004344","Total",1840,947,893,1838,2,21,38.24,48.1
"2011","Waltham Forest 008C","E01004382","Total",1350,625,725,1350,0,14,11.83,114.1
"2011","Waltham Forest 008D","E01004418","Total",1653,803,850,1653,0,18,18.13,91.2
"2011","Waltham Forest 008E","E01004419","Total",1594,788,806,1594,0,19,26.04,61.2
"2011","Waltham Forest 009A","E01004398","Total",1966,944,1022,1966,0,12,42.99,45.7
"2011","Waltham Forest 009B","E01004399","Total",1733,797,936,1733,0,16,79.20,21.9
"2011","Waltham Forest 009C","E01004400","Total",1723,868,855,1723,0,22,17.26,99.8
"2011","Waltham Forest 009D","E01004402","Total",1804,907,897,1804,0,29,18.95,95.2
"2011","Waltham Forest 009E","E01004403","Total",1817,907,910,1817,0,15,38.24,47.5
"2011","Waltham Forest 010A","E01004345","Total",1925,939,986,1925,0,13,14.18,135.8
"2011","Waltham Forest 010B","E01004348","Total",2688,1365,1323,2688,0,16,26.94,99.8
"2011","Waltham Forest 010C","E01004377","Total",1782,862,920,1782,0,20,83.12,21.4
"2011","Waltham Forest 010D","E01004378","Total",1833,939,894,1818,15,19,21.67,84.6
"2011","Waltham Forest 011A","E01004342","Total",2143,1156,987,2143,0,21,35.95,59.6
"2011","Waltham Forest 011B","E01004346","Total",1713,832,881,1713,0,12,18.51,92.5
"2011","Waltham Forest 011C","E01004347","Total",1983,952,1031,1983,0,16,23.00,86.2
"2011","Waltham Forest 011D","E01004460","Total",1955,973,982,1885,70,13,14.03,139.3
"2011","Waltham Forest 011E","E01004462","Total",1795,893,902,1788,7,20,13.45,133.5
"2011","Waltham Forest 012A","E01004396","Total",1854,939,915,1854,0,12,11.13,166.6
"2011","Waltham Forest 012B","E01004457","Total",1894,959,935,1892,2,9,12.24,154.7
"2011","Waltham Forest 012C","E01004458","Total",1862,915,947,1862,0,15,12.98,143.5
"2011","Waltham Forest 012D","E01004459","Total",1635,749,886,1635,0,13,11.10,147.3
"2011","Waltham Forest 012E","E01004463","Total",2003,1002,1001,2003,0,9,14.36,139.5
"2011","Waltham Forest 013A","E01004407","Total",1633,811,822,1370,263,12,9.12,179.1
"2011","Waltham Forest 013B","E01004410","Total",1898,886,1012,1843,55,3,19.84,95.7
"2011","Waltham Forest 013C","E01004464","Total",1579,789,790,1579,0,21,11.43,138.1
"2011","Waltham Forest 013D","E01004469","Total",1640,804,836,1640,0,15,21.00,78.1
"2011","Waltham Forest 013E","E01004470","Total",1524,753,771,1505,19,9,14.45,105.5
"2011","Waltham Forest 013F","E01004471","Total",1724,830,894,1697,27,21,13.52,127.5
"2011","Waltham Forest 014A","E01004391","Total",1849,910,939,1849,0,13,74.16,24.9
"2011","Waltham Forest 014B","E01004393","Total",2391,1520,871,2391,0,5,14.10,169.6
"2011","Waltham Forest 014C","E01004401","Total",2102,1072,1030,2102,0,21,110.15,19.1
"2011","Waltham Forest 014D","E01004404","Total",2049,1008,1041,2049,0,7,15.45,132.6
"2011","Waltham Forest 014E","E01004461","Total",2125,1047,1078,2125,0,13,21.69,98.0
"2011","Waltham Forest 015A","E01004412","Total",1739,830,909,1738,1,12,15.21,114.3
"2011","Waltham Forest 015B","E01004465","Total",1502,711,791,1502,0,19,11.50,130.6
"2011","Waltham Forest 015C","E01004466","Total",1623,798,825,1619,4,9,14.77,109.9
"2011","Waltham Forest 015D","E01004467","Total",2155,1035,1120,2155,0,23,19.70,109.4
"2011","Waltham Forest 015E","E01004468","Total",1621,814,807,1621,0,21,78.06,20.8
"2011","Waltham Forest 016A","E01004406","Total",1859,952,907,1837,22,9,13.58,136.9
"2011","Waltham Forest 016B","E01004408","Total",1749,855,894,1743,6,13,11.76,148.7
"2011","Waltham Forest 016C","E01004409","Total",1661,843,818,1638,23,10,15.64,106.2
"2011","Waltham Forest 016D","E01004411","Total",1721,905,816,1721,0,8,12.40,138.8
"2011","Waltham Forest 016E","E01004443","Total",1833,923,910,1833,0,8,12.85,142.6
"2011","Waltham Forest 016F","E01004447","Total",1875,960,915,1875,0,13,12.84,146.0
"2011","Waltham Forest 017A","E01004392","Total",2283,1200,1083,2283,0,15,21.29,107.2
"2011","Waltham Forest 017B","E01004394","Total",1821,922,899,1820,1,7,11.96,152.3
"2011","Waltham Forest 017C","E01004397","Total",2316,1190,1126,2313,3,7,23.59,98.2
"2011","Waltham Forest 017D","E01004444","Total",2537,1244,1293,2537,0,8,19.83,127.9
"2011","Waltham Forest 017E","E01004446","Total",1915,971,944,1915,0,7,12.39,154.6
"2011","Waltham Forest 018A","E01004395","Total",1613,823,790,1613,0,15,149.89,10.8
"2011","Waltham Forest 018B","E01004421","Total",2149,1088,1061,2086,63,14,12.61,170.4
"2011","Waltham Forest 018C","E01004445","Total",1741,871,870,1737,4,11,17.01,102.4
"2011","Waltham Forest 018D","E01004448","Total",1897,918,979,1897,0,15,52.22,36.3
"2011","Waltham Forest 018E","E01004449","Total",1838,882,956,1810,28,16,18.25,100.7
"2011","Waltham Forest 019A","E01004363","Total",1565,790,775,1563,2,13,29.50,53.1
"2011","Waltham Forest 019B","E01004364","Total",1738,883,855,1738,0,16,20.11,86.4
"2011","Waltham Forest 019C","E01004366","Total",1891,978,913,1852,39,14,29.55,64.0
"2011","Waltham Forest 019D","E01004367","Total",1637,851,786,1637,0,11,12.53,130.6
"2011","Waltham Forest 019E","E01004368","Total",1875,964,911,1870,5,10,14.01,133.8
"2011","Waltham Forest 020A","E01004365","Total",2289,1174,1115,2289,0,8,11.91,192.2
"2011","Waltham Forest 020B","E01004405","Total",1652,815,837,1616,36,11,12.17,135.7
"2011","Waltham Forest 020C","E01004420","Total",2134,1113,1021,2132,2,5,16.95,125.9
"2011","Waltham Forest 020D","E01004423","Total",1903,985,918,1848,55,11,12.73,149.5
"2011","Waltham Forest 020G","E01033153","Total",2616,1249,1367,2614,2,23,16.21,161.4
"2011","Waltham Forest 021A","E01004362","Total",1614,855,759,1589,25,14,80.90,20.0
"2011","Waltham Forest 021B","E01004436","Total",1712,898,814,1608,104,13,23.19,73.8
"2011","Waltham Forest 021C","E01004437","Total",1885,987,898,1812,73,24,15.15,124.4
"2011","Waltham Forest 021D","E01004439","Total",1678,845,833,1636,42,15,14.96,112.2
"2011","Waltham Forest 021E","E01004442","Total",1754,945,809,1754,0,28,15.13,115.9
"2011","Waltham Forest 022A","E01004422","Total",1662,845,817,1662,0,6,133.78,12.4
"2011","Waltham Forest 022B","E01004424","Total",1833,928,905,1830,3,14,21.60,84.9
"2011","Waltham Forest 022C","E01004425","Total",2090,1024,1066,2090,0,9,13.32,156.9
"2011","Waltham Forest 022D","E01004426","Total",1787,893,894,1787,0,5,12.38,144.3
"2011","Waltham Forest 022E","E01004427","Total",2113,1057,1056,2113,0,5,41.17,51.3
"2011","Waltham Forest 023A","E01004369","Total",1766,917,849,1766,0,7,9.79,180.4
"2011","Waltham Forest 023B","E01004370","Total",1786,900,886,1786,0,12,13.88,128.7
"2011","Waltham Forest 023C","E01004372","Total",1831,931,900,1831,0,6,9.87,185.5
"2011","Waltham Forest 023D","E01004432","Total",1755,869,886,1755,0,8,18.73,93.7
"2011","Waltham Forest 023E","E01004435","Total",2033,971,1062,2010,23,15,15.61,130.2
"2011","Waltham Forest 024A","E01004333","Total",1769,883,886,1769,0,5,9.98,177.3
"2011","Waltham Forest 024B","E01004334","Total",1507,692,815,1507,0,22,10.72,140.6
"2011","Waltham Forest 024C","E01004438","Total",2065,1138,927,2025,40,19,25.85,79.9
"2011","Waltham Forest 024D","E01004440","Total",2164,1164,1000,2132,32,16,23.65,91.5
"2011","Waltham Forest 024E","E01004441","Total",1621,850,771,1608,13,21,13.09,123.8
"2011","Waltham Forest 025A","E01004371","Total",1703,877,826,1693,10,13,10.89,156.4
"2011","Waltham Forest 025B","E01004373","Total",1779,942,837,1779,0,6,9.87,180.2
"2011","Waltham Forest 025C","E01004374","Total",1890,953,937,1886,4,10,12.92,146.3
"2011","Waltham Forest 025D","E01004375","Total",1855,908,947,1848,7,12,11.68,158.8
"2011","Waltham Forest 025E","E01004376","Total",1994,1016,978,1994,0,3,10.88,183.3
"2011","Waltham Forest 026A","E01004336","Total",1699,868,831,1691,8,3,21.65,78.5
"2011","Waltham Forest 026B","E01004428","Total",1763,827,936,1763,0,7,16.09,109.6
"2011","Waltham Forest 026C","E01004429","Total",1772,877,895,1772,0,12,53.16,33.3
"2011","Waltham Forest 026D","E01004430","Total",2200,1188,1012,2200,0,14,51.61,42.6
"2011","Waltham Forest 026E","E01004434","Total",2045,1026,1019,2045,0,13,32.19,63.5
"2011","Waltham Forest 027A","E01004335","Total",1843,866,977,1843,0,10,11.99,153.7
"2011","Waltham Forest 027B","E01004337","Total",1966,1013,953,1966,0,4,11.42,172.2
"2011","Waltham Forest 027C","E01004338","Total",1772,921,851,1771,1,22,9.11,194.5
"2011","Waltham Forest 027D","E01004339","Total",1814,931,883,1811,3,18,10.41,174.3
"2011","Waltham Forest 027E","E01004340","Total",1849,918,931,1831,18,16,26.03,71.0
"2011","Waltham Forest 027F","E01004341","Total",1757,872,885,1757,0,22,15.04,116.8
"2011","Waltham Forest 028A","E01004327","Total",1213,622,591,1213,0,14,11.70,103.7
"2011","Waltham Forest 028B","E01004328","Total",1840,994,846,1836,4,6,10.32,178.3
"2011","Waltham Forest 028C","E01004329","Total",1931,1067,864,1923,8,20,11.61,166.3
"2011","Waltham Forest 028D","E01004330","Total",1834,974,860,1834,0,13,9.53,192.4
"2011","Waltham Forest 028E","E01004331","Total",1856,992,864,1841,15,16,10.62,174.8
"2011","Waltham Forest 028F","E01004332","Total",1849,979,870,1824,25,6,11.51,160.6
"2011","Bracknell Forest 001C","E01016252","Total",1410,701,709,1410,0,45,1455.81,1.0
"2011","Bracknell Forest 001D","E01016253","Total",1395,687,708,1395,0,22,95.48,14.6
"2011","Bracknell Forest 001E","E01032727","Total",3011,1421,1590,3000,11,90,921.71,3.3
"2011","Bracknell Forest 002A","E01016184","Total",2168,1063,1105,2135,33,44,246.95,8.8
"2011","Bracknell Forest 002B","E01016185","Total",1376,678,698,1284,92,23,103.32,13.3
"2011","Bracknell Forest 002C","E01016186","Total",1825,916,909,1825,0,66,1552.88,1.2
"2011","Bracknell Forest 002D","E01016187","Total",1636,807,829,1636,0,48,85.64,19.1
"2011","Bracknell Forest 002E","E01016188","Total",1684,830,854,1684,0,24,108.57,15.5
"2011","Bracknell Forest 003A","E01016190","Total",1534,766,768,1534,0,33,39.76,38.6
"2011","Bracknell Forest 003B","E01016238","Total",1234,602,632,1171,63,25,51.92,23.8
"2011","Bracknell Forest 003C","E01016243","Total",1498,751,747,1498,0,21,29.27,51.2
"2011","Bracknell Forest 003D","E01016245","Total",2363,1176,1187,2359,4,49,50.02,47.2
"2011","Bracknell Forest 003E","E01016246","Total",1584,741,843,1584,0,38,34.72,45.6
"2011","Bracknell Forest 003F","E01016247","Total",1654,828,826,1654,0,18,41.86,39.5
"2011","Bracknell Forest 004A","E01016239","Total",1490,720,770,1490,0,16,30.68,48.6
"2011","Bracknell Forest 004B","E01016240","Total",1535,753,782,1535,0,19,30.20,50.8
"2011","Bracknell Forest 004C","E01016241","Total",1616,804,812,1616,0,12,32.40,49.9
"2011","Bracknell Forest 004D","E01016242","Total",1728,847,881,1728,0,12,78.85,21.9
"2011","Bracknell Forest 005A","E01016180","Total",1499,736,763,1288,211,27,57.02,26.3
"2011","Bracknell Forest 005B","E01016181","Total",1455,622,833,1233,222,41,1498.52,1.0
"2011","Bracknell Forest 005C","E01016182","Total",1520,730,790,1520,0,38,115.81,13.1
"2011","Bracknell Forest 005D","E01016183","Total",1279,622,657,1279,0,21,23.41,54.6
"2011","Bracknell Forest 005E","E01016222","Total",1269,629,640,1269,0,47,32.07,39.6
"2011","Bracknell Forest 006B","E01016191","Total",1660,822,838,1660,0,15,49.24,33.7
"2011","Bracknell Forest 006C","E01016223","Total",1434,729,705,1434,0,15,22.21,64.6
"2011","Bracknell Forest 006D","E01016224","Total",1734,850,884,1734,0,17,43.16,40.2
"2011","Bracknell Forest 006E","E01016226","Total",1361,690,671,1361,0,5,33.43,40.7
"2011","Bracknell Forest 006F","E01032724","Total",1343,666,677,1343,0,5,21.70,61.9
"2011","Bracknell Forest 006G","E01032728","Total",1392,689,703,1392,0,12,56.36,24.7
"2011","Bracknell Forest 007A","E01016225","Total",2164,1070,1094,2164,0,29,69.89,31.0
"2011","Bracknell Forest 007B","E01016233","Total",2307,1130,1177,2307,0,27,49.62,46.5
"2011","Bracknell Forest 007C","E01016248","Total",1543,724,819,1485,58,17,32.41,47.6
"2011","Bracknell Forest 007D","E01016249","Total",1467,742,725,1467,0,5,96.70,15.2
"2011","Bracknell Forest 007E","E01016250","Total",1601,779,822,1601,0,9,53.24,30.1
"2011","Bracknell Forest 008A","E01016200","Total",1351,668,683,1351,0,12,22.35,60.4
"2011","Bracknell Forest 008B","E01016201","Total",1344,671,673,1344,0,20,21.67,62.0
"2011","Bracknell Forest 008C","E01016202","Total",1191,610,581,1191,0,11,21.95,54.3
"2011","Bracknell Forest 008D","E01016203","Total",1311,598,713,1311,0,5,26.34,49.8
"2011","Bracknell Forest 008E","E01016204","Total",1212,591,621,1212,0,11,17.47,69.4
"2011","Bracknell Forest 009A","E01016209","Total",1491,735,756,1491,0,16,98.11,15.2
"2011","Bracknell Forest 009B","E01016210","Total",1224,592,632,1224,0,14,20.79,58.9
"2011","Bracknell Forest 009D","E01016213","Total",1143,558,585,1143,0,18,166.80,6.9
"2011","Bracknell Forest 009E","E01016214","Total",1374,670,704,1374,0,43,56.14,24.5
"2011","Bracknell Forest 009F","E01016215","Total",1255,613,642,1255,0,12,13.69,91.7
"2011","Bracknell Forest 009G","E01032725","Total",1585,774,811,1585,0,18,145.06,10.9
"2011","Bracknell Forest 009H","E01032726","Total",1421,690,731,1421,0,11,42.68,33.3
"2011","Bracknell Forest 010A","E01016205","Total",1327,657,670,1327,0,13,27.90,47.6
"2011","Bracknell Forest 010B","E01016217","Total",1404,697,707,1404,0,19,45.98,30.5
"2011","Bracknell Forest 010C","E01016218","Total",1375,693,682,1375,0,13,31.01,44.3
"2011","Bracknell Forest 010D","E01016231","Total",1894,966,928,1894,0,26,47.16,40.2
"2011","Bracknell Forest 010E","E01016232","Total",1410,687,723,1404,6,15,34.25,41.2
"2011","Bracknell Forest 011A","E01016212","Total",1301,651,650,1301,0,14,20.08,64.8
"2011","Bracknell Forest 011B","E01016216","Total",1296,632,664,1296,0,14,22.73,57.0
"2011","Bracknell Forest 011C","E01016219","Total",1341,663,678,1341,0,17,31.44,42.7
"2011","Bracknell Forest 011D","E01016220","Total",1379,686,693,1363,16,8,20.95,65.8
"2011","Bracknell Forest 011E","E01016221","Total",1264,620,644,1264,0,14,20.68,61.1
"2011","Bracknell Forest 012A","E01016206","Total",1789,871,918,1763,26,31,55.48,32.2
"2011","Bracknell Forest 012B","E01016208","Total",1927,934,993,1874,53,45,95.98,20.1
"2011","Bracknell Forest 012C","E01016229","Total",1181,567,614,1177,4,25,62.30,19.0
"2011","Bracknell Forest 012D","E01016230","Total",1795,1006,789,1040,755,90,268.77,6.7
"2011","Bracknell Forest 013A","E01016207","Total",1537,816,721,1413,124,25,1042.69,1.5
"2011","Bracknell Forest 013B","E01016234","Total",1150,570,580,1150,0,14,309.88,3.7
"2011","Bracknell Forest 013C","E01016235","Total",1339,669,670,1339,0,27,42.67,31.4
"2011","Bracknell Forest 013D","E01016236","Total",1436,698,738,1436,0,24,23.65,60.7
"2011","Bracknell Forest 013E","E01016237","Total",1191,596,595,1191,0,10,18.21,65.4
"2011","Bracknell Forest 014A","E01016192","Total",1400,704,696,1364,36,15,48.68,28.8
"2011","Bracknell Forest 014B","E01016194","Total",1251,613,638,1251,0,27,103.10,12.1
"2011","Bracknell Forest 014C","E01016195","Total",1138,557,581,1137,1,13,57.67,19.7
"2011","Bracknell Forest 014D","E01016227","Total",1340,665,675,1287,53,35,89.47,15.0
"2011","Bracknell Forest 014E","E01016228","Total",1541,759,782,1474,67,26,95.64,16.1
"2011","Bracknell Forest 015A","E01016193","Total",1228,594,634,1228,0,13,18.60,66.0
"2011","Bracknell Forest 015B","E01016196","Total",2496,1580,916,1656,840,43,321.67,7.8
"2011","Bracknell Forest 015C","E01016197","Total",1351,663,688,1344,7,15,38.91,34.7
"2011","Bracknell Forest 015D","E01016198","Total",1211,575,636,1200,11,21,20.82,58.2
"2011","Bracknell Forest 015E","E01016199","Total",1242,627,615,1242,0,33,24.29,51.1
"2011","Brighton and Hove 001A","E01016924","Total",1518,714,804,1501,17,11,37.41,40.6
"2011","Brighton and Hove 001B","E01016926","Total",1530,741,789,1530,0,10,76.15,20.1
"2011","Brighton and Hove 001C","E01016927","Total",1548,744,804,1548,0,17,31.22,49.6
"2011","Brighton and Hove 001D","E01016929","Total",1587,775,812,1587,0,24,33.02,48.1
"2011","Brighton and Hove 001E","E01016931","Total",1543,729,814,1513,30,9,140.43,11.0
"2011","Brighton and Hove 002A","E01016898","Total",2246,1110,1136,1873,373,15,57.24,39.2
"2011","Brighton and Hove 002B","E01016899","Total",3321,1568,1753,1028,2293,76,327.64,10.1
"2011","Brighton and Hove 002C","E01016914","Total",2380,1101,1279,1483,897,34,192.80,12.3
"2011","Brighton and Hove 002D","E01016915","Total",1544,755,789,1544,0,10,24.64,62.7
"2011","Brighton and Hove 003A","E01016923","Total",1586,752,834,1557,29,21,44.40,35.7
"2011","Brighton and Hove 003B","E01016928","Total",1602,775,827,1596,6,17,373.23,4.3
"2011","Brighton and Hove 003C","E01016998","Total",1504,748,756,1504,0,18,54.87,27.4
"2011","Brighton and Hove 003D","E01016999","Total",1410,669,741,1410,0,17,512.55,2.8
"2011","Brighton and Hove 003E","E01017000","Total",1722,833,889,1711,11,17,42.98,40.1
"2011","Brighton and Hove 004A","E01016925","Total",1520,743,777,1520,0,13,25.57,59.4
"2011","Brighton and Hove 004B","E01016930","Total",1843,893,950,1843,0,38,46.77,39.4
"2011","Brighton and Hove 004C","E01017001","Total",1504,730,774,1504,0,54,69.36,21.7
"2011","Brighton and Hove 004D","E01017003","Total",1647,779,868,1636,11,33,25.99,63.4
"2011","Brighton and Hove 005A","E01016916","Total",1457,714,743,1457,0,8,451.99,3.2
"2011","Brighton and Hove 005B","E01016917","Total",1368,678,690,1368,0,8,28.73,47.6
"2011","Brighton and Hove 005C","E01016918","Total",1425,671,754,1425,0,11,25.88,55.1
"2011","Brighton and Hove 005D","E01016919","Total",1379,662,717,1379,0,19,32.73,42.1
"2011","Brighton and Hove 005E","E01016920","Total",1571,745,826,1571,0,10,26.31,59.7
"2011","Brighton and Hove 006A","E01016882","Total",1454,650,804,1454,0,21,26.82,54.2
"2011","Brighton and Hove 006B","E01016883","Total",1455,701,754,1455,0,22,67.28,21.6
"2011","Brighton and Hove 006C","E01016884","Total",1594,782,812,1594,0,22,23.55,67.7
"2011","Brighton and Hove 006D","E01016885","Total",1370,615,755,1370,0,12,427.78,3.2
"2011","Brighton and Hove 006E","E01016886","Total",1557,753,804,1557,0,22,24.60,63.3
"2011","Brighton and Hove 007A","E01016980","Total",1500,737,763,1480,20,28,78.40,19.1
"2011","Brighton and Hove 007B","E01016982","Total",1302,617,685,1302,0,17,24.00,54.2
"2011","Brighton and Hove 007C","E01016983","Total",1431,697,734,1387,44,41,55.06,26.0
"2011","Brighton and Hove 007D","E01016984","Total",1475,750,725,1475,0,44,52.31,28.2
"2011","Brighton and Hove 007E","E01016985","Total",1583,794,789,1580,3,36,29.25,54.1
"2011","Brighton and Hove 008A","E01016900","Total",1678,860,818,1544,134,11,239.79,7.0
"2011","Brighton and Hove 008B","E01016902","Total",1501,735,766,1501,0,16,35.35,42.5
"2011","Brighton and Hove 008C","E01016904","Total",1589,790,799,1589,0,9,28.68,55.4
"2011","Brighton and Hove 008D","E01016905","Total",1723,869,854,1712,11,7,23.99,71.8
"2011","Brighton and Hove 008E","E01016909","Total",1891,970,921,1891,0,14,30.81,61.4
"2011","Brighton and Hove 009A","E01016906","Total",1610,769,841,1610,0,3,108.32,14.9
"2011","Brighton and Hove 009B","E01016907","Total",1811,910,901,1811,0,8,27.16,66.7
"2011","Brighton and Hove 009C","E01016908","Total",1535,744,791,1535,0,5,25.59,60.0
"2011","Brighton and Hove 009D","E01016910","Total",1527,746,781,1527,0,17,37.38,40.9
"2011","Brighton and Hove 009E","E01016911","Total",1539,752,787,1503,36,10,108.29,14.2
"2011","Brighton and Hove 010A","E01016901","Total",1661,774,887,1661,0,22,15.10,110.0
"2011","Brighton and Hove 010B","E01016903","Total",1962,965,997,1961,1,25,13.82,142.0
"2011","Brighton and Hove 010C","E01016934","Total",1404,685,719,1404,0,27,13.80,101.7
"2011","Brighton and Hove 010D","E01016939","Total",1631,769,862,1631,0,43,13.80,118.2
"2011","Brighton and Hove 010E","E01016940","Total",1702,812,890,1659,43,34,13.16,129.3
"2011","Brighton and Hove 011A","E01016981","Total",1657,811,846,1594,63,40,77.45,21.4
"2011","Brighton and Hove 011B","E01017002","Total",1703,838,865,1677,26,31,52.23,32.6
"2011","Brighton and Hove 011C","E01017004","Total",1688,855,833,1663,25,21,22.56,74.8
"2011","Brighton and Hove 011D","E01017005","Total",1702,833,869,1695,7,25,14.28,119.2
"2011","Brighton and Hove 011E","E01017006","Total",1572,812,760,1572,0,22,16.91,93.0
"2011","Brighton and Hove 012A","E01016921","Total",1553,727,826,1553,0,10,25.14,61.8
"2011","Brighton and Hove 012B","E01016922","Total",1282,615,667,1278,4,10,19.28,66.5
"2011","Brighton and Hove 012C","E01016973","Total",1528,741,787,1528,0,13,22.52,67.9
"2011","Brighton and Hove 012D","E01016977","Total",1540,751,789,1503,37,16,26.23,58.7
"2011","Brighton and Hove 012E","E01016978","Total",1671,851,820,1589,82,11,29.02,57.6
"2011","Brighton and Hove 013A","E01016879","Total",1527,728,799,1482,45,19,36.66,41.7
"2011","Brighton and Hove 013B","E01016880","Total",1357,650,707,1357,0,9,14.83,91.5
"2011","Brighton and Hove 013C","E01016881","Total",1510,744,766,1510,0,19,42.14,35.8
"2011","Brighton and Hove 013D","E01016887","Total",1425,671,754,1425,0,10,33.23,42.9
"2011","Brighton and Hove 013E","E01016888","Total",1495,710,785,1472,23,29,26.90,55.6
"2011","Brighton and Hove 013F","E01016976","Total",1660,828,832,1654,6,18,37.04,44.8
"2011","Brighton and Hove 014A","E01016932","Total",1635,824,811,1620,15,27,16.13,101.4
"2011","Brighton and Hove 014B","E01016933","Total",1506,727,779,1421,85,31,14.07,107.0
"2011","Brighton and Hove 014C","E01016935","Total",1574,765,809,1574,0,12,47.67,33.0
"2011","Brighton and Hove 014D","E01016936","Total",1634,832,802,1634,0,14,22.77,71.8
"2011","Brighton and Hove 014E","E01016937","Total",2041,1092,949,2002,39,16,14.55,140.3
"2011","Brighton and Hove 015A","E01016890","Total",1747,900,847,1744,3,11,12.62,138.4
"2011","Brighton and Hove 015B","E01016966","Total",1796,909,887,1792,4,16,12.87,139.5
"2011","Brighton and Hove 015C","E01016970","Total",1636,777,859,1636,0,13,13.32,122.8
"2011","Brighton and Hove 015D","E01016971","Total",1955,991,964,1954,1,19,9.74,200.7
"2011","Brighton and Hove 015E","E01016972","Total",1850,874,976,1844,6,10,9.36,197.6
"2011","Brighton and Hove 016A","E01016979","Total",1654,812,842,1642,12,21,39.43,41.9
"2011","Brighton and Hove 016B","E01016990","Total",1678,833,845,1678,0,14,10.73,156.4
"2011","Brighton and Hove 016C","E01016991","Total",1765,822,943,1737,28,9,9.73,181.4
"2011","Brighton and Hove 016D","E01016996","Total",1663,779,884,1663,0,12,14.64,113.6
"2011","Brighton and Hove 017A","E01017007","Total",1623,771,852,1622,1,4,49.59,32.7
"2011","Brighton and Hove 017B","E01017008","Total",1635,795,840,1635,0,12,203.82,8.0
"2011","Brighton and Hove 017C","E01017009","Total",1536,732,804,1534,2,14,34.71,44.3
"2011","Brighton and Hove 017D","E01017010","Total",1782,852,930,1782,0,16,44.52,40.0
"2011","Brighton and Hove 017E","E01017011","Total",1408,659,749,1408,0,7,319.27,4.4
"2011","Brighton and Hove 017F","E01017012","Total",1809,901,908,1802,7,16,191.47,9.4
"2011","Brighton and Hove 018A","E01016892","Total",1722,791,931,1722,0,13,34.92,49.3
"2011","Brighton and Hove 018B","E01016893","Total",1900,943,957,1895,5,33,10.58,179.6
"2011","Brighton and Hove 018C","E01016912","Total",1890,937,953,1888,2,17,14.40,131.2
"2011","Brighton and Hove 018D","E01016913","Total",1745,861,884,1745,0,14,13.69,127.5
"2011","Brighton and Hove 018E","E01016946","Total",1484,766,718,1484,0,25,12.87,115.3
"2011","Brighton and Hove 019A","E01016860","Total",1524,770,754,1521,3,11,14.49,105.2
"2011","Brighton and Hove 019B","E01016871","Total",1785,908,877,1785,0,3,10.83,164.8
"2011","Brighton and Hove 019C","E01016872","Total",1826,963,863,1826,0,10,9.91,184.3
"2011","Brighton and Hove 019D","E01016873","Total",1698,881,817,1698,0,8,16.67,101.9
"2011","Brighton and Hove 019E","E01016878","Total",1871,917,954,1777,94,30,22.52,83.1
"2011","Brighton and Hove 020A","E01016870","Total",1597,813,784,1562,35,36,15.85,100.8
"2011","Brighton and Hove 020B","E01016874","Total",1818,892,926,1789,29,7,16.90,107.6
"2011","Brighton and Hove 020C","E01016875","Total",1643,836,807,1578,65,19,12.69,129.5
"2011","Brighton and Hove 020D","E01016876","Total",1625,764,861,1582,43,26,21.80,74.5
"2011","Brighton and Hove 020E","E01016877","Total",1826,884,942,1729,97,17,14.31,127.6
"2011","Brighton and Hove 021A","E01016974","Total",1637,785,852,1631,6,16,49.76,32.9
"2011","Brighton and Hove 021B","E01016975","Total",1516,703,813,1516,0,14,23.79,63.7
"2011","Brighton and Hove 021C","E01016992","Total",1598,762,836,1587,11,30,44.69,35.8
"2011","Brighton and Hove 021D","E01016994","Total",1653,791,862,1650,3,16,15.10,109.5
"2011","Brighton and Hove 021E","E01016997","Total",1582,738,844,1557,25,22,26.68,59.3
"2011","Brighton and Hove 022A","E01016889","Total",1867,962,905,1865,2,11,9.33,200.1
"2011","Brighton and Hove 022B","E01016891","Total",1770,935,835,1770,0,21,11.74,150.8
"2011","Brighton and Hove 022C","E01016894","Total",1894,944,950,1649,245,20,9.76,194.1
"2011","Brighton and Hove 022D","E01016896","Total",1767,901,866,1767,0,16,7.77,227.4
"2011","Brighton and Hove 022E","E01016897","Total",1781,880,901,1781,0,18,8.22,216.7
"2011","Brighton and Hove 023A","E01016987","Total",1857,898,959,1731,126,28,18.93,98.1
"2011","Brighton and Hove 023B","E01016989","Total",1610,766,844,1508,102,29,15.12,106.5
"2011","Brighton and Hove 023C","E01016993","Total",1438,690,748,1434,4,13,14.77,97.4
"2011","Brighton and Hove 023D","E01016995","Total",1714,809,905,1657,57,38,31.29,54.8
"2011","Brighton and Hove 024A","E01016938","Total",1784,974,810,1772,12,17,11.04,161.6
"2011","Brighton and Hove 024B","E01016950","Total",1712,868,844,1709,3,7,9.66,177.2
"2011","Brighton and Hove 024C","E01016951","Total",1435,754,681,1420,15,13,9.24,155.3
"2011","Brighton and Hove 024D","E01016967","Total",1921,1037,884,1921,0,7,9.14,210.2
"2011","Brighton and Hove 024E","E01016968","Total",1585,838,747,1585,0,7,6.44,246.1
"2011","Brighton and Hove 025A","E01016864","Total",1478,722,756,1446,32,6,243.56,6.1
"2011","Brighton and Hove 025B","E01016865","Total",1586,761,825,1578,8,12,13.17,120.4
"2011","Brighton and Hove 025C","E01016866","Total",1466,687,779,1466,0,12,19.46,75.3
"2011","Brighton and Hove 025D","E01016867","Total",1450,700,750,1450,0,3,36.68,39.5
"2011","Brighton and Hove 025E","E01016868","Total",1548,771,777,1548,0,4,15.05,102.9
"2011","Brighton and Hove 025F","E01016895","Total",1558,737,821,1558,0,13,36.02,43.3
"2011","Brighton and Hove 026A","E01016849","Total",1539,840,699,1539,0,9,9.70,158.7
"2011","Brighton and Hove 026B","E01016852","Total",1593,873,720,1593,0,4,4.86,327.8
"2011","Brighton and Hove 026C","E01016853","Total",1872,975,897,1872,0,4,10.69,175.1
"2011","Brighton and Hove 026D","E01016855","Total",1733,957,776,1717,16,6,12.33,140.6
"2011","Brighton and Hove 026E","E01016856","Total",1629,832,797,1608,21,9,9.22,176.7
"2011","Brighton and Hove 027A","E01016952","Total",1625,921,704,1550,75,6,41.80,38.9
"2011","Brighton and Hove 027B","E01016953","Total",1627,878,749,1618,9,24,11.46,142.0
"2011","Brighton and Hove 027C","E01016964","Total",2101,1080,1021,2069,32,14,25.78,81.5
"2011","Brighton and Hove 027E","E01016969","Total",2019,1143,876,2018,1,7,28.86,70.0
"2011","Brighton and Hove 027F","E01033328","Total",1451,768,683,1451,0,14,7.49,193.7
"2011","Brighton and Hove 027G","E01033329","Total",1995,1037,958,1706,289,20,19.66,101.5
"2011","Brighton and Hove 028A","E01016857","Total",1523,774,749,1440,83,6,16.00,95.2
"2011","Brighton and Hove 028B","E01016858","Total",1439,752,687,1410,29,3,8.56,168.1
"2011","Brighton and Hove 028C","E01016859","Total",1454,733,721,1442,12,5,15.60,93.2
"2011","Brighton and Hove 028D","E01016986","Total",1625,758,867,1514,111,6,26.99,60.2
"2011","Brighton and Hove 028E","E01016988","Total",1531,707,824,1417,114,17,14.80,103.4
"2011","Brighton and Hove 029A","E01016850","Total",1740,945,795,1739,1,8,14.94,116.5
"2011","Brighton and Hove 029B","E01016851","Total",1709,930,779,1709,0,9,7.25,235.7
"2011","Brighton and Hove 029C","E01016854","Total",1662,887,775,1620,42,11,5.46,304.4
"2011","Brighton and Hove 029D","E01016954","Total",1811,981,830,1783,28,8,6.82,265.5
"2011","Brighton and Hove 029E","E01016955","Total",1747,1022,725,1728,19,2,9.44,185.1
"2011","Brighton and Hove 030A","E01016941","Total",1917,1096,821,1905,12,11,12.35,155.2
"2011","Brighton and Hove 030B","E01016945","Total",1623,956,667,1603,20,5,6.34,256.0
"2011","Brighton and Hove 030C","E01016947","Total",1607,844,763,1607,0,17,10.14,158.5
"2011","Brighton and Hove 030D","E01016948","Total",1775,880,895,1775,0,10,14.08,126.1
"2011","Brighton and Hove 030E","E01016949","Total",1723,893,830,1678,45,10,21.92,78.6
"2011","Brighton and Hove 031A","E01016861","Total",1610,891,719,1593,17,7,18.55,86.8
"2011","Brighton and Hove 031B","E01016862","Total",1578,854,724,1508,70,9,15.24,103.5
"2011","Brighton and Hove 031C","E01016942","Total",1727,861,866,1516,211,8,13.73,125.8
"2011","Brighton and Hove 031D","E01016943","Total",1585,796,789,1585,0,13,13.06,121.4
"2011","Brighton and Hove 031E","E01016944","Total",1583,862,721,1514,69,9,17.27,91.7
"2011","Brighton and Hove 032A","E01016863","Total",1579,811,768,1579,0,8,26.71,59.1
"2011","Brighton and Hove 032B","E01016869","Total",1788,910,878,1788,0,8,17.99,99.4
"2011","Brighton and Hove 032C","E01016957","Total",1774,874,900,1504,270,28,183.18,9.7
"2011","Brighton and Hove 032D","E01016963","Total",1906,1020,886,1906,0,21,33.06,57.7
"2011","Brighton and Hove 033A","E01016956","Total",1555,745,810,1555,0,11,172.32,9.0
"2011","Brighton and Hove 033B","E01016958","Total",1733,811,922,1728,5,16,53.69,32.3
"2011","Brighton and Hove 033C","E01016959","Total",1470,705,765,1404,66,28,93.18,15.8
"2011","Brighton and Hove 033D","E01016960","Total",1753,806,947,1707,46,23,142.27,12.3
"2011","Brighton and Hove 033E","E01016961","Total",1767,882,885,1723,44,23,56.72,31.2
"2011","Brighton and Hove 033F","E01016962","Total",1693,792,901,1644,49,27,284.93,5.9
"2011","Isle of Wight 001A","E01017300","Total",2234,1066,1168,2193,41,21,73.32,30.5
"2011","Isle of Wight 001B","E01017303","Total",1218,604,614,1204,14,16,17.23,70.7
"2011","Isle of Wight 001C","E01017305","Total",1386,688,698,1346,40,11,25.72,53.9
"2011","Isle of Wight 001D","E01017306","Total",1350,635,715,1350,0,15,17.70,76.3
"2011","Isle of Wight 001E","E01017309","Total",1642,808,834,1642,0,10,24.49,67.0
"2011","Isle of Wight 002A","E01017301","Total",1066,502,564,1037,29,10,65.77,16.2
"2011","Isle of Wight 002B","E01017302","Total",1747,868,879,1720,27,24,59.13,29.5
"2011","Isle of Wight 002C","E01017304","Total",1404,675,729,1398,6,18,21.15,66.4
"2011","Isle of Wight 002D","E01017316","Total",1682,813,869,1677,5,29,408.63,4.1
"2011","Isle of Wight 002E","E01017329","Total",2311,1129,1182,2304,7,39,556.44,4.2
"2011","Isle of Wight 003A","E01017307","Total",1949,944,1005,1932,17,12,186.34,10.5
"2011","Isle of Wight 003B","E01017308","Total",1766,838,928,1700,66,23,26.92,65.6
"2011","Isle of Wight 003D","E01033229","Total",1381,661,720,1373,8,9,662.75,2.1
"2011","Isle of Wight 003E","E01033237","Total",1363,651,712,1329,34,6,231.06,5.9
"2011","Isle of Wight 004A","E01017335","Total",1520,754,766,1478,42,13,27.71,54.9
"2011","Isle of Wight 004B","E01017336","Total",1604,811,793,1499,105,10,27.69,57.9
"2011","Isle of Wight 004C","E01017337","Total",1611,800,811,1507,104,19,32.67,49.3
"2011","Isle of Wight 004D","E01017346","Total",1498,714,784,1441,57,11,47.63,31.5
"2011","Isle of Wight 005A","E01017286","Total",1537,758,779,1506,31,21,446.46,3.4
"2011","Isle of Wight 005B","E01017287","Total",1648,771,877,1648,0,19,58.27,28.3
"2011","Isle of Wight 005C","E01017367","Total",1918,909,1009,1839,79,27,396.61,4.8
"2011","Isle of Wight 005D","E01017368","Total",1559,726,833,1546,13,18,303.83,5.1
"2011","Isle of Wight 006A","E01017282","Total",1404,680,724,1404,0,20,85.22,16.5
"2011","Isle of Wight 006B","E01017283","Total",1581,772,809,1519,62,20,1280.31,1.2
"2011","Isle of Wight 006C","E01017338","Total",1390,662,728,1315,75,26,72.53,19.2
"2011","Isle of Wight 006D","E01017341","Total",1558,725,833,1532,26,14,44.01,35.4
"2011","Isle of Wight 006E","E01017342","Total",1731,827,904,1691,40,25,39.31,44.0
"2011","Isle of Wight 007A","E01017339","Total",1662,790,872,1634,28,21,45.68,36.4
"2011","Isle of Wight 007B","E01017340","Total",1784,815,969,1776,8,13,20.48,87.1
"2011","Isle of Wight 007C","E01017343","Total",1330,678,652,1307,23,7,82.28,16.2
"2011","Isle of Wight 007D","E01017344","Total",1652,813,839,1608,44,15,114.08,14.5
"2011","Isle of Wight 007E","E01017345","Total",1980,940,1040,1980,0,15,31.59,62.7
"2011","Isle of Wight 008A","E01017310","Total",1411,675,736,1231,180,16,1465.81,1.0
"2011","Isle of Wight 008B","E01017311","Total",1515,728,787,1510,5,11,53.39,28.4
"2011","Isle of Wight 008C","E01017331","Total",1473,712,761,1434,39,4,191.37,7.7
"2011","Isle of Wight 008D","E01017332","Total",1272,610,662,1272,0,10,30.52,41.7
"2011","Isle of Wight 008E","E01017334","Total",1792,1161,631,1212,580,15,513.79,3.5
"2011","Isle of Wight 009A","E01017295","Total",1265,595,670,1265,0,7,65.10,19.4
"2011","Isle of Wight 009B","E01017325","Total",1305,628,677,1305,0,6,36.42,35.8
"2011","Isle of Wight 009C","E01017326","Total",1580,785,795,1568,12,8,36.34,43.5
"2011","Isle of Wight 009D","E01017328","Total",1444,705,739,1416,28,8,14.40,100.3
"2011","Isle of Wight 009E","E01017333","Total",2900,1993,907,1803,1097,26,590.82,4.9
"2011","Isle of Wight 010A","E01017284","Total",1775,814,961,1638,137,29,417.76,4.2
"2011","Isle of Wight 010B","E01017285","Total",1913,882,1031,1834,79,30,495.02,3.9
"2011","Isle of Wight 010C","E01017288","Total",1213,563,650,1213,0,12,188.17,6.4
"2011","Isle of Wight 010D","E01017351","Total",1402,670,732,1401,1,22,442.03,3.2
"2011","Isle of Wight 010E","E01017352","Total",1147,536,611,1142,5,19,97.85,11.7
"2011","Isle of Wight 011A","E01017292","Total",1594,770,824,1591,3,24,47.32,33.7
"2011","Isle of Wight 011B","E01017293","Total",2017,981,1036,2017,0,23,70.09,28.8
"2011","Isle of Wight 011C","E01017296","Total",1281,608,673,1236,45,26,2017.27,0.6
"2011","Isle of Wight 011D","E01017321","Total",1188,555,633,1127,61,16,305.57,3.9
"2011","Isle of Wight 011E","E01017322","Total",1493,712,781,1493,0,12,27.45,54.4
"2011","Isle of Wight 011F","E01017327","Total",1653,802,851,1647,6,16,32.36,51.1
"2011","Isle of Wight 012A","E01017312","Total",1563,738,825,1539,24,14,180.30,8.7
"2011","Isle of Wight 012D","E01017315","Total",1500,710,790,1495,5,10,76.92,19.5
"2011","Isle of Wight 012E","E01017354","Total",1186,567,619,1185,1,16,767.30,1.5
"2011","Isle of Wight 012F","E01017361","Total",1436,676,760,1310,126,14,482.98,3.0
"2011","Isle of Wight 012G","E01017362","Total",1491,715,776,1445,46,11,51.81,28.8
"2011","Isle of Wight 012H","E01033239","Total",2306,1082,1224,2269,37,33,1191.24,1.9
"2011","Isle of Wight 013A","E01017290","Total",1332,656,676,1308,24,15,4908.02,0.3
"2011","Isle of Wight 013B","E01017291","Total",1157,532,625,1157,0,24,216.63,5.3
"2011","Isle of Wight 013C","E01017294","Total",1594,788,806,1573,21,42,1963.64,0.8
"2011","Isle of Wight 013D","E01017353","Total",1225,605,620,1225,0,20,1943.60,0.6
"2011","Isle of Wight 014A","E01017289","Total",2034,967,1067,2031,3,26,1426.21,1.4
"2011","Isle of Wight 014B","E01017347","Total",1636,789,847,1606,30,9,262.83,6.2
"2011","Isle of Wight 014C","E01017348","Total",1495,726,769,1296,199,14,27.45,54.5
"2011","Isle of Wight 014D","E01017349","Total",2149,1041,1108,2042,107,22,44.69,48.1
"2011","Isle of Wight 014E","E01017350","Total",1905,921,984,1896,9,14,89.48,21.3
"2011","Isle of Wight 015A","E01017317","Total",1549,751,798,1549,0,19,120.24,12.9
"2011","Isle of Wight 015B","E01017320","Total",1091,492,599,1091,0,4,60.37,18.1
"2011","Isle of Wight 015C","E01017323","Total",1158,576,582,1158,0,9,864.75,1.3
"2011","Isle of Wight 015D","E01017324","Total",1464,729,735,1451,13,22,737.58,2.0
"2011","Isle of Wight 015E","E01017355","Total",1528,741,787,1518,10,23,84.13,18.2
"2011","Isle of Wight 015F","E01017358","Total",1295,598,697,1276,19,24,129.90,10.0
"2011","Isle of Wight 016A","E01017318","Total",1186,564,622,1186,0,9,31.51,37.6
"2011","Isle of Wight 016B","E01017319","Total",1291,589,702,1273,18,11,30.89,41.8
"2011","Isle of Wight 016C","E01017356","Total",1551,749,802,1428,123,26,31.17,49.8
"2011","Isle of Wight 016D","E01017357","Total",1509,734,775,1476,33,13,40.23,37.5
"2011","Isle of Wight 016E","E01017359","Total",1483,735,748,1410,73,16,430.08,3.4
"2011","Isle of Wight 016F","E01017360","Total",1706,857,849,1575,131,16,56.68,30.1
"2011","Isle of Wight 017A","E01017297","Total",1437,693,744,1433,4,20,3359.46,0.4
"2011","Isle of Wight 017B","E01017298","Total",1502,729,773,1502,0,23,1090.94,1.4
"2011","Isle of Wight 017C","E01017299","Total",1219,609,610,1216,3,22,1091.26,1.1
"2011","Isle of Wight 017D","E01017369","Total",1459,717,742,1459,0,9,1979.30,0.7
"2011","Isle of Wight 018A","E01017363","Total",1543,761,782,1480,63,14,66.86,23.1
"2011","Isle of Wight 018B","E01017364","Total",1509,739,770,1463,46,18,164.02,9.2
"2011","Isle of Wight 018C","E01017365","Total",1455,695,760,1380,75,10,274.20,5.3
"2011","Isle of Wight 018D","E01017366","Total",1469,693,776,1469,0,12,314.71,4.7
"2011","Isle of Wight 018E","E01017370","Total",1753,848,905,1753,0,18,752.86,2.3
"2011","Medway 001A","E01016070","Total",1676,833,843,1652,24,14,930.42,1.8
"2011","Medway 001B","E01016071","Total",1648,808,840,1646,2,9,1249.86,1.3
"2011","Medway 001C","E01016072","Total",1298,638,660,1288,10,17,1820.01,0.7
"2011","Medway 001D","E01016074","Total",1688,816,872,1655,33,10,1176.50,1.4
"2011","Medway 002A","E01016142","Total",1273,666,607,1273,0,12,1249.50,1.0
"2011","Medway 002B","E01016144","Total",1502,766,736,1496,6,13,424.20,3.5
"2011","Medway 002C","E01016145","Total",1346,665,681,1346,0,15,90.28,14.9
"2011","Medway 002D","E01016149","Total",1435,712,723,1435,0,18,791.76,1.8
"2011","Medway 003A","E01016073","Total",2023,984,1039,2023,0,32,2027.58,1.0
"2011","Medway 003B","E01016075","Total",1435,689,746,1435,0,10,96.05,14.9
"2011","Medway 003C","E01016076","Total",2406,1190,1216,2406,0,23,108.09,22.3
"2011","Medway 003D","E01016077","Total",1482,700,782,1468,14,9,77.11,19.2
"2011","Medway 003E","E01016143","Total",2346,1149,1197,2346,0,19,490.75,4.8
"2011","Medway 004A","E01016146","Total",2019,983,1036,2006,13,31,242.72,8.3
"2011","Medway 004B","E01016147","Total",1916,929,987,1867,49,19,148.46,12.9
"2011","Medway 004C","E01016148","Total",1968,994,974,1941,27,32,86.94,22.6
"2011","Medway 005A","E01016133","Total",1372,678,694,1372,0,23,69.37,19.8
"2011","Medway 005B","E01016134","Total",1429,702,727,1429,0,15,30.13,47.4
"2011","Medway 005C","E01016138","Total",1514,720,794,1514,0,12,36.04,42.0
"2011","Medway 005D","E01016139","Total",1683,821,862,1683,0,24,28.78,58.5
"2011","Medway 006A","E01016135","Total",1534,732,802,1509,25,15,20.98,73.1
"2011","Medway 006B","E01016136","Total",1567,771,796,1530,37,9,45.56,34.4
"2011","Medway 006C","E01016137","Total",1553,769,784,1553,0,10,21.46,72.4
"2011","Medway 006D","E01016140","Total",1427,734,693,1350,77,11,20.69,69.0
"2011","Medway 006E","E01016141","Total",1687,851,836,1678,9,12,20.82,81.0
"2011","Medway 007A","E01016035","Total",1862,922,940,1851,11,17,32.61,57.1
"2011","Medway 007D","E01016112","Total",2847,1483,1364,2847,0,36,68.23,41.7
"2011","Medway 007E","E01032798","Total",3549,2134,1415,2690,859,39,255.36,13.9
"2011","Medway 008A","E01016151","Total",1617,775,842,1610,7,24,33.19,48.7
"2011","Medway 008B","E01016152","Total",1484,739,745,1477,7,10,29.34,50.6
"2011","Medway 008C","E01016153","Total",1433,676,757,1433,0,6,21.57,66.4
"2011","Medway 008D","E01016155","Total",1553,742,811,1549,4,10,45.64,34.0
"2011","Medway 009A","E01016033","Total",1145,561,584,1145,0,3,15.04,76.1
"2011","Medway 009B","E01016036","Total",2451,1245,1206,1841,610,35,24.86,98.6
"2011","Medway 009C","E01016037","Total",1709,840,869,1709,0,14,17.45,97.9
"2011","Medway 009D","E01016039","Total",1670,871,799,1669,1,10,19.80,84.3
"2011","Medway 010A","E01016030","Total",1859,871,988,1800,59,12,44.74,41.6
"2011","Medway 010B","E01016032","Total",1326,641,685,1326,0,3,26.26,50.5
"2011","Medway 010C","E01016034","Total",2568,1348,1220,2568,0,18,69.15,37.1
"2011","Medway 010D","E01016038","Total",1512,767,745,1512,0,16,21.46,70.5
"2011","Medway 011A","E01016150","Total",1605,779,826,1605,0,9,23.86,67.3
"2011","Medway 011B","E01016154","Total",1606,804,802,1606,0,4,72.70,22.1
"2011","Medway 011C","E01016156","Total",1677,821,856,1677,0,5,15.78,106.3
"2011","Medway 011D","E01016157","Total",1958,930,1028,1958,0,5,76.74,25.5
"2011","Medway 011E","E01016158","Total",2143,1032,1111,2143,0,9,69.46,30.9
"2011","Medway 012A","E01016031","Total",1752,900,852,1743,9,10,16.60,105.5
"2011","Medway 012B","E01016041","Total",1660,870,790,1658,2,14,18.84,88.1
"2011","Medway 012C","E01016045","Total",1666,864,802,1651,15,7,30.14,55.3
"2011","Medway 012D","E01016049","Total",1922,1000,922,1920,2,23,17.82,107.9
"2011","Medway 013A","E01016040","Total",1764,880,884,1761,3,19,20.78,84.9
"2011","Medway 013B","E01016042","Total",1510,775,735,1503,7,13,13.33,113.3
"2011","Medway 013C","E01016043","Total",1416,696,720,1407,9,7,22.14,64.0
"2011","Medway 013D","E01016177","Total",1567,755,812,1558,9,6,17.20,91.1
"2011","Medway 013E","E01016178","Total",1530,747,783,1469,61,13,21.24,72.0
"2011","Medway 014A","E01016117","Total",1764,875,889,1760,4,16,15.18,116.2
"2011","Medway 014B","E01016129","Total",1924,1015,909,1924,0,14,40.70,47.3
"2011","Medway 014C","E01016130","Total",1891,1004,887,1808,83,27,47.63,39.7
"2011","Medway 014D","E01016131","Total",1735,827,908,1727,8,31,44.05,39.4
"2011","Medway 015A","E01016016","Total",1521,760,761,1519,2,11,18.02,84.4
"2011","Medway 015B","E01016017","Total",1576,812,764,1571,5,12,30.27,52.1
"2011","Medway 015C","E01016019","Total",1866,938,928,1866,0,12,16.12,115.8
"2011","Medway 015D","E01016110","Total",2072,1014,1058,1819,253,17,112.42,18.4
"2011","Medway 015E","E01016111","Total",1244,660,584,1175,69,11,52.49,23.7
"2011","Medway 016A","E01016044","Total",1704,856,848,1673,31,11,15.31,111.3
"2011","Medway 016B","E01016046","Total",1528,757,771,1528,0,14,16.79,91.0
"2011","Medway 016C","E01016047","Total",1725,880,845,1706,19,12,13.81,124.9
"2011","Medway 016D","E01016048","Total",1699,868,831,1695,4,12,25.51,66.6
"2011","Medway 017A","E01016113","Total",1486,737,749,1486,0,18,22.55,65.9
"2011","Medway 017B","E01016114","Total",1584,768,816,1550,34,16,15.68,101.0
"2011","Medway 017C","E01016115","Total",1944,937,1007,1944,0,13,34.06,57.1
"2011","Medway 017D","E01016118","Total",1741,855,886,1741,0,14,20.97,83.0
"2011","Medway 018A","E01016160","Total",1474,703,771,1474,0,4,34.18,43.1
"2011","Medway 018B","E01016161","Total",1543,706,837,1543,0,11,29.54,52.2
"2011","Medway 018C","E01016162","Total",1646,821,825,1646,0,20,29.03,56.7
"2011","Medway 018D","E01016163","Total",1331,644,687,1331,0,10,20.11,66.2
"2011","Medway 018E","E01016164","Total",1495,707,788,1495,0,7,23.46,63.7
"2011","Medway 018F","E01016165","Total",1300,637,663,1300,0,11,26.74,48.6
"2011","Medway 019A","E01016159","Total",1381,637,744,1381,0,5,70.64,19.5
"2011","Medway 019B","E01016174","Total",1400,711,689,1348,52,38,24.14,58.0
"2011","Medway 019C","E01016175","Total",1840,916,924,1827,13,15,46.17,39.9
"2011","Medway 019D","E01016179","Total",1381,694,687,1381,0,18,39.12,35.3
"2011","Medway 020A","E01016061","Total",1695,898,797,1695,0,12,16.79,101.0
"2011","Medway 020B","E01016063","Total",1633,849,784,1633,0,4,13.69,119.3
"2011","Medway 020C","E01016064","Total",1566,811,755,1541,25,9,41.34,37.9
"2011","Medway 020D","E01016069","Total",1810,961,849,1808,2,10,14.01,129.2
"2011","Medway 021A","E01016020","Total",1244,592,652,1244,0,11,20.67,60.2
"2011","Medway 021B","E01016021","Total",1527,792,735,1494,33,13,16.15,94.6
"2011","Medway 021C","E01016022","Total",1427,684,743,1423,4,24,14.16,100.8
"2011","Medway 021D","E01016125","Total",1763,883,880,1742,21,10,20.83,84.6
"2011","Medway 022A","E01016018","Total",1986,1006,980,1985,1,11,12.76,155.6
"2011","Medway 022B","E01016023","Total",1686,812,874,1686,0,11,16.94,99.5
"2011","Medway 022C","E01016024","Total",1958,981,977,1957,1,10,19.28,101.6
"2011","Medway 022D","E01016062","Total",1505,740,765,1476,29,11,40.82,36.9
"2011","Medway 023A","E01016093","Total",1548,770,778,1548,0,15,394.95,3.9
"2011","Medway 023B","E01016096","Total",1430,677,753,1412,18,19,28.60,50.0
"2011","Medway 023C","E01016166","Total",1450,722,728,1450,0,14,34.54,42.0
"2011","Medway 023D","E01016167","Total",1428,710,718,1428,0,20,28.30,50.5
"2011","Medway 024A","E01016116","Total",1832,874,958,1829,3,13,30.23,60.6
"2011","Medway 024B","E01016127","Total",1519,748,771,1519,0,17,343.11,4.4
"2011","Medway 024C","E01016128","Total",2068,1305,763,1295,773,32,69.76,29.6
"2011","Medway 024D","E01016132","Total",1642,822,820,1642,0,31,58.17,28.2
"2011","Medway 025A","E01016094","Total",1456,703,753,1456,0,7,82.70,17.6
"2011","Medway 025B","E01016095","Total",1303,614,689,1303,0,11,59.05,22.1
"2011","Medway 025C","E01016097","Total",1448,707,741,1448,0,5,22.77,63.6
"2011","Medway 025D","E01016098","Total",1378,613,765,1378,0,9,22.04,62.5
"2011","Medway 025E","E01016102","Total",1445,687,758,1445,0,6,25.92,55.7
"2011","Medway 026A","E01016119","Total",1522,745,777,1447,75,27,40.18,37.9
"2011","Medway 026B","E01016120","Total",1374,681,693,1374,0,4,59.34,23.2
"2011","Medway 026C","E01016124","Total",1690,825,865,1652,38,24,28.75,58.8
"2011","Medway 026D","E01016126","Total",1691,820,871,1682,9,26,27.09,62.4
"2011","Medway 027A","E01016025","Total",1622,760,862,1509,113,19,48.77,33.3
"2011","Medway 027B","E01016065","Total",1410,691,719,1410,0,12,21.52,65.5
"2011","Medway 027C","E01016066","Total",1490,701,789,1490,0,8,65.11,22.9
"2011","Medway 027D","E01016067","Total",1611,777,834,1611,0,8,36.87,43.7
"2011","Medway 027E","E01016068","Total",1659,788,871,1659,0,18,24.22,68.5
"2011","Medway 028A","E01016026","Total",1258,630,628,1258,0,12,114.42,11.0
"2011","Medway 028B","E01016027","Total",1528,752,776,1526,2,25,657.27,2.3
"2011","Medway 028C","E01016028","Total",1357,652,705,1357,0,10,196.37,6.9
"2011","Medway 028D","E01016029","Total",1305,639,666,1305,0,12,545.55,2.4
"2011","Medway 029A","E01016087","Total",1681,830,851,1668,13,17,40.69,41.3
"2011","Medway 029B","E01016088","Total",1514,738,776,1514,0,26,25.75,58.8
"2011","Medway 029C","E01016089","Total",1580,768,812,1565,15,14,26.62,59.4
"2011","Medway 029D","E01016090","Total",1495,731,764,1493,2,19,24.47,61.1
"2011","Medway 030A","E01016085","Total",1615,782,833,1599,16,21,56.14,28.8
"2011","Medway 030B","E01016086","Total",1300,602,698,1300,0,29,93.30,13.9
"2011","Medway 030C","E01016091","Total",1514,746,768,1514,0,13,41.61,36.4
"2011","Medway 030D","E01016176","Total",1525,754,771,1524,1,29,101.65,15.0
"2011","Medway 031A","E01016058","Total",1473,719,754,1473,0,14,399.94,3.7
"2011","Medway 031B","E01016059","Total",1344,649,695,1344,0,2,18.88,71.2
"2011","Medway 031C","E01016079","Total",1353,678,675,1353,0,19,28.49,47.5
"2011","Medway 031D","E01016083","Total",1334,626,708,1334,0,2,22.96,58.1
"2011","Medway 031E","E01016084","Total",1518,727,791,1518,0,10,30.07,50.5
"2011","Medway 032A","E01016101","Total",1470,722,748,1470,0,8,21.35,68.9
"2011","Medway 032B","E01016103","Total",1458,725,733,1458,0,21,319.81,4.6
"2011","Medway 032C","E01016104","Total",1428,691,737,1428,0,21,20.34,70.2
"2011","Medway 032D","E01016107","Total",1547,800,747,1547,0,21,37.89,40.8
"2011","Medway 033A","E01016121","Total",1535,739,796,1519,16,11,87.00,17.6
"2011","Medway 033B","E01016122","Total",1529,738,791,1501,28,24,89.12,17.2
"2011","Medway 033C","E01016123","Total",1574,772,802,1574,0,12,28.97,54.3
"2011","Medway 033D","E01016173","Total",1590,778,812,1590,0,12,34.06,46.7
"2011","Medway 034A","E01016078","Total",1517,754,763,1517,0,11,32.73,46.3
"2011","Medway 034B","E01016080","Total",1513,743,770,1513,0,16,28.40,53.3
"2011","Medway 034C","E01016081","Total",1611,784,827,1611,0,14,35.51,45.4
"2011","Medway 034D","E01016082","Total",1587,787,800,1587,0,21,22.00,72.1
"2011","Medway 035A","E01016050","Total",1698,839,859,1698,0,32,48.04,35.3
"2011","Medway 035B","E01016051","Total",1599,801,798,1558,41,27,46.36,34.5
"2011","Medway 035C","E01016052","Total",1684,814,870,1684,0,34,109.84,15.3
"2011","Medway 035D","E01016053","Total",1548,722,826,1508,40,18,55.82,27.7
"2011","Medway 035E","E01016054","Total",1474,734,740,1474,0,29,150.77,9.8
"2011","Medway 036A","E01016092","Total",1553,763,790,1553,0,16,23.41,66.3
"2011","Medway 036B","E01016099","Total",1526,739,787,1526,0,15,21.52,70.9
"2011","Medway 036C","E01016100","Total",1533,710,823,1533,0,8,53.97,28.4
"2011","Medway 036D","E01016105","Total",1416,697,719,1384,32,15,39.92,35.5
"2011","Medway 036E","E01016106","Total",1450,713,737,1449,1,10,22.43,64.6
"2011","Medway 037A","E01016168","Total",1556,758,798,1556,0,20,33.92,45.9
"2011","Medway 037B","E01016169","Total",1709,854,855,1709,0,19,40.94,41.7
"2011","Medway 037C","E01016171","Total",1578,748,830,1578,0,4,21.60,73.1
"2011","Medway 037D","E01016172","Total",1448,723,725,1441,7,16,37.28,38.8
"2011","Medway 038A","E01016055","Total",1552,776,776,1552,0,11,29.52,52.6
"2011","Medway 038B","E01016056","Total",1391,676,715,1391,0,15,29.46,47.2
"2011","Medway 038C","E01016057","Total",1712,856,856,1712,0,13,46.88,36.5
"2011","Medway 038D","E01016060","Total",1607,789,818,1607,0,21,35.73,45.0
"2011","Medway 038E","E01016170","Total",1639,801,838,1639,0,11,25.03,65.5
"2011","Milton Keynes 001A","E01016796","Total",1526,725,801,1463,63,33,39.10,39.0
"2011","Milton Keynes 001B","E01016797","Total",1782,822,960,1746,36,26,688.11,2.6
"2011","Milton Keynes 001C","E01016798","Total",1924,962,962,1924,0,62,540.92,3.6
"2011","Milton Keynes 001D","E01016799","Total",1871,926,945,1871,0,35,1869.37,1.0
"2011","Milton Keynes 001E","E01016800","Total",1632,798,834,1632,0,37,2083.58,0.8
"2011","Milton Keynes 002A","E01016759","Total",1378,677,701,1378,0,23,896.19,1.5
"2011","Milton Keynes 002B","E01016760","Total",2386,1162,1224,2386,0,31,1585.12,1.5
"2011","Milton Keynes 002C","E01016761","Total",1368,702,666,1368,0,27,1541.93,0.9
"2011","Milton Keynes 002D","E01016801","Total",1350,654,696,1350,0,36,2346.22,0.6
"2011","Milton Keynes 002E","E01016802","Total",1433,690,743,1386,47,42,2781.57,0.5
"2011","Milton Keynes 002F","E01016803","Total",1319,649,670,1318,1,30,3660.06,0.4
"2011","Milton Keynes 003A","E01016786","Total",1432,671,761,1432,0,12,33.76,42.4
"2011","Milton Keynes 003B","E01016787","Total",1658,778,880,1565,93,16,37.43,44.3
"2011","Milton Keynes 003C","E01016788","Total",1611,794,817,1611,0,36,272.52,5.9
"2011","Milton Keynes 003D","E01016789","Total",1334,637,697,1334,0,21,22.77,58.6
"2011","Milton Keynes 003E","E01016790","Total",1357,655,702,1314,43,19,38.72,35.0
"2011","Milton Keynes 004A","E01016791","Total",1437,696,741,1437,0,26,62.28,23.1
"2011","Milton Keynes 004B","E01016792","Total",1299,631,668,1299,0,32,43.01,30.2
"2011","Milton Keynes 004C","E01016793","Total",1948,975,973,1922,26,29,151.96,12.8
"2011","Milton Keynes 004D","E01016794","Total",1483,750,733,1483,0,20,49.63,29.9
"2011","Milton Keynes 004E","E01016795","Total",1559,760,799,1553,6,16,26.82,58.1
"2011","Milton Keynes 005A","E01016762","Total",1278,619,659,1278,0,21,60.87,21.0
"2011","Milton Keynes 005B","E01016764","Total",1431,713,718,1431,0,28,70.88,20.2
"2011","Milton Keynes 005C","E01016766","Total",1352,650,702,1352,0,17,31.27,43.2
"2011","Milton Keynes 005D","E01016767","Total",1324,645,679,1324,0,39,95.08,13.9
"2011","Milton Keynes 005E","E01016771","Total",1370,639,731,1322,48,17,33.83,40.5
"2011","Milton Keynes 006A","E01016806","Total",1955,957,998,1955,0,7,49.98,39.1
"2011","Milton Keynes 006B","E01016807","Total",1733,872,861,1733,0,10,40.48,42.8
"2011","Milton Keynes 006C","E01016809","Total",1424,669,755,1424,0,9,44.84,31.8
"2011","Milton Keynes 006D","E01016835","Total",1632,780,852,1632,0,10,58.91,27.7
"2011","Milton Keynes 007A","E01016763","Total",1340,653,687,1340,0,26,118.72,11.3
"2011","Milton Keynes 007B","E01016769","Total",1400,696,704,1385,15,37,138.68,10.1
"2011","Milton Keynes 007C","E01016770","Total",1674,824,850,1674,0,25,44.35,37.7
"2011","Milton Keynes 007D","E01016773","Total",1801,867,934,1801,0,46,48.32,37.3
"2011","Milton Keynes 008A","E01016836","Total",1677,863,814,1677,0,11,19.60,85.6
"2011","Milton Keynes 008B","E01016837","Total",1858,942,916,1842,16,27,20.96,88.6
"2011","Milton Keynes 008C","E01016838","Total",1606,795,811,1606,0,15,53.84,29.8
"2011","Milton Keynes 008D","E01016841","Total",2117,1047,1070,2117,0,14,119.22,17.8
"2011","Milton Keynes 009A","E01016721","Total",1666,847,819,1666,0,30,39.34,42.3
"2011","Milton Keynes 009B","E01016765","Total",1672,779,893,1561,111,27,51.76,32.3
"2011","Milton Keynes 009C","E01016772","Total",1385,674,711,1338,47,17,31.11,44.5
"2011","Milton Keynes 009D","E01016804","Total",1648,779,869,1648,0,12,159.43,10.3
"2011","Milton Keynes 010A","E01016812","Total",1562,761,801,1562,0,22,44.93,34.8
"2011","Milton Keynes 010B","E01016817","Total",1523,737,786,1523,0,17,66.44,22.9
"2011","Milton Keynes 010C","E01016818","Total",1699,802,897,1644,55,30,72.31,23.5
"2011","Milton Keynes 010D","E01016840","Total",2598,1276,1322,2598,0,17,372.49,7.0
"2011","Milton Keynes 011A","E01016719","Total",1458,718,740,1458,0,15,45.52,32.0
"2011","Milton Keynes 011B","E01016722","Total",1634,812,822,1634,0,30,41.34,39.5
"2011","Milton Keynes 011C","E01016805","Total",1342,693,649,1342,0,22,74.02,18.1
"2011","Milton Keynes 011D","E01016808","Total",1367,665,702,1367,0,21,40.49,33.8
"2011","Milton Keynes 012A","E01016810","Total",1319,635,684,1319,0,5,71.12,18.5
"2011","Milton Keynes 012B","E01016811","Total",1507,740,767,1497,10,11,33.19,45.4
"2011","Milton Keynes 012C","E01016819","Total",1158,550,608,1158,0,8,42.14,27.5
"2011","Milton Keynes 012D","E01016839","Total",1636,766,870,1636,0,14,46.19,35.4
"2011","Milton Keynes 013A","E01016717","Total",1545,764,781,1545,0,23,28.24,54.7
"2011","Milton Keynes 013B","E01016720","Total",1554,740,814,1554,0,12,40.29,38.6
"2011","Milton Keynes 013C","E01016723","Total",1738,900,838,1738,0,53,42.87,40.5
"2011","Milton Keynes 013D","E01016724","Total",1728,938,790,1719,9,17,72.51,23.8
"2011","Milton Keynes 014A","E01016718","Total",1615,834,781,1609,6,12,25.38,63.6
"2011","Milton Keynes 014B","E01016729","Total",2213,1154,1059,2213,0,30,43.32,51.1
"2011","Milton Keynes 014D","E01016768","Total",2042,1121,921,2041,1,17,250.01,8.2
"2011","Milton Keynes 014E","E01033499","Total",1393,789,604,1390,3,14,105.77,13.2
"2011","Milton Keynes 014F","E01033500","Total",1333,793,540,1333,0,8,131.56,10.1
"2011","Milton Keynes 015A","E01016776","Total",1468,739,729,1468,0,45,37.20,39.5
"2011","Milton Keynes 015B","E01016813","Total",1398,690,708,1398,0,22,122.17,11.4
"2011","Milton Keynes 015C","E01016815","Total",1324,695,629,1324,0,22,27.47,48.2
"2011","Milton Keynes 015D","E01016816","Total",1493,719,774,1493,0,34,137.04,10.9
"2011","Milton Keynes 016A","E01016731","Total",1497,723,774,1495,2,16,69.12,21.7
"2011","Milton Keynes 016B","E01016732","Total",1432,691,741,1405,27,26,57.88,24.7
"2011","Milton Keynes 016D","E01016784","Total",1615,831,784,1614,1,14,145.86,11.1
"2011","Milton Keynes 016E","E01033501","Total",2062,1053,1009,2062,0,20,37.34,55.2
"2011","Milton Keynes 016F","E01033506","Total",2037,1059,978,2037,0,47,104.34,19.5
"2011","Milton Keynes 017A","E01016783","Total",1944,947,997,1944,0,20,126.17,15.4
"2011","Milton Keynes 017C","E01016820","Total",1648,801,847,1648,0,37,175.74,9.4
"2011","Milton Keynes 017D","E01016821","Total",1465,674,791,1316,149,22,35.45,41.3
"2011","Milton Keynes 017E","E01016823","Total",1703,839,864,1694,9,19,79.50,21.4
"2011","Milton Keynes 017F","E01033503","Total",1554,751,803,1548,6,19,247.74,6.3
"2011","Milton Keynes 017G","E01033508","Total",1716,867,849,1716,0,20,38.91,44.1
"2011","Milton Keynes 017H","E01033509","Total",1665,841,824,1665,0,13,148.34,11.2
"2011","Milton Keynes 017I","E01033511","Total",1514,803,711,1514,0,9,34.29,44.2
"2011","Milton Keynes 017J","E01033512","Total",1668,841,827,1668,0,26,112.80,14.8
"2011","Milton Keynes 018A","E01016726","Total",1709,926,783,1685,24,15,21.85,78.2
"2011","Milton Keynes 018B","E01016733","Total",1911,1008,903,1910,1,14,30.40,62.9
"2011","Milton Keynes 018C","E01016845","Total",1894,928,966,1809,85,22,59.74,31.7
"2011","Milton Keynes 018D","E01016846","Total",1635,795,840,1635,0,9,35.56,46.0
"2011","Milton Keynes 018E","E01016848","Total",1497,740,757,1343,154,6,58.83,25.4
"2011","Milton Keynes 019B","E01016780","Total",1736,847,889,1730,6,35,47.97,36.2
"2011","Milton Keynes 019C","E01016781","Total",1533,751,782,1533,0,65,67.93,22.6
"2011","Milton Keynes 019D","E01016814","Total",1642,836,806,1642,0,22,785.28,2.1
"2011","Milton Keynes 019E","E01033505","Total",1776,1091,685,1368,408,15,150.10,11.8
"2011","Milton Keynes 019F","E01033522","Total",1448,759,689,1349,99,20,226.42,6.4
"2011","Milton Keynes 019G","E01033523","Total",1491,742,749,1491,0,16,52.11,28.6
"2011","Milton Keynes 019H","E01033525","Total",1756,854,902,1747,9,20,117.15,15.0
"2011","Milton Keynes 020A","E01016774","Total",1781,876,905,1762,19,41,86.87,20.5
"2011","Milton Keynes 020B","E01016775","Total",1733,807,926,1733,0,35,171.69,10.1
"2011","Milton Keynes 020C","E01016777","Total",1618,806,812,1561,57,30,27.09,59.7
"2011","Milton Keynes 020D","E01016778","Total",1768,868,900,1767,1,23,80.18,22.1
"2011","Milton Keynes 021A","E01016725","Total",1633,835,798,1633,0,11,21.13,77.3
"2011","Milton Keynes 021B","E01016727","Total",1742,893,849,1742,0,16,28.09,62.0
"2011","Milton Keynes 021C","E01016728","Total",1996,1051,945,1996,0,22,67.78,29.4
"2011","Milton Keynes 021D","E01016847","Total",2065,998,1067,2065,0,18,62.51,33.0
"2011","Milton Keynes 022A","E01016822","Total",1561,773,788,1561,0,16,48.00,32.5
"2011","Milton Keynes 022B","E01016824","Total",1622,803,819,1622,0,19,39.66,40.9
"2011","Milton Keynes 022C","E01016825","Total",1516,757,759,1516,0,12,35.20,43.1
"2011","Milton Keynes 022D","E01016827","Total",1692,833,859,1684,8,20,94.26,18.0
"2011","Milton Keynes 022E","E01016828","Total",1795,896,899,1795,0,45,163.61,11.0
"2011","Milton Keynes 023B","E01016842","Total",1594,783,811,1594,0,1,24.45,65.2
"2011","Milton Keynes 023C","E01016843","Total",1526,773,753,1526,0,14,38.15,40.0
"2011","Milton Keynes 023D","E01016844","Total",1613,785,828,1613,0,11,135.42,11.9
"2011","Milton Keynes 023E","E01033497","Total",1074,527,547,1069,5,10,258.89,4.1
"2011","Milton Keynes 023F","E01033498","Total",1326,692,634,1298,28,9,224.63,5.9
"2011","Milton Keynes 024A","E01016734","Total",1219,607,612,1213,6,19,1292.80,0.9
"2011","Milton Keynes 024B","E01016735","Total",2071,1052,1019,2060,11,29,620.45,3.3
"2011","Milton Keynes 024C","E01016736","Total",1382,618,764,1308,74,23,38.03,36.3
"2011","Milton Keynes 024D","E01016826","Total",1557,778,779,1557,0,41,41.88,37.2
"2011","Milton Keynes 025B","E01016752","Total",1742,838,904,1742,0,31,34.79,50.1
"2011","Milton Keynes 025C","E01016753","Total",2242,1089,1153,2242,0,44,68.88,32.5
"2011","Milton Keynes 025D","E01016755","Total",1905,942,963,1898,7,33,41.05,46.4
"2011","Milton Keynes 025E","E01033514","Total",1465,742,723,1463,2,19,28.49,51.4
"2011","Milton Keynes 025F","E01033515","Total",1950,965,985,1950,0,46,57.72,33.8
"2011","Milton Keynes 025G","E01033517","Total",1598,800,798,1598,0,19,23.30,68.6
"2011","Milton Keynes 026A","E01016754","Total",1652,795,857,1652,0,13,42.58,38.8
"2011","Milton Keynes 026B","E01016756","Total",2287,1064,1223,2265,22,41,65.91,34.7
"2011","Milton Keynes 026C","E01016757","Total",1579,803,776,1579,0,21,38.59,40.9
"2011","Milton Keynes 026D","E01016758","Total",1725,840,885,1725,0,26,50.41,34.2
"2011","Milton Keynes 027A","E01016737","Total",1641,793,848,1641,0,21,33.94,48.4
"2011","Milton Keynes 027B","E01016738","Total",1815,797,1018,1778,37,13,41.50,43.7
"2011","Milton Keynes 027C","E01016739","Total",1569,790,779,1569,0,15,38.10,41.2
"2011","Milton Keynes 027D","E01016740","Total",1367,686,681,1367,0,7,32.21,42.4
"2011","Milton Keynes 027E","E01016741","Total",1670,838,832,1670,0,14,26.85,62.2
"2011","Milton Keynes 028A","E01016748","Total",1977,1005,972,1977,0,26,43.99,44.9
"2011","Milton Keynes 028C","E01016750","Total",1629,802,827,1619,10,22,41.19,39.5
"2011","Milton Keynes 028D","E01016751","Total",1614,787,827,1601,13,25,35.04,46.1
"2011","Milton Keynes 028E","E01033519","Total",1870,909,961,1870,0,26,190.99,9.8
"2011","Milton Keynes 028F","E01033520","Total",1809,890,919,1809,0,31,100.05,18.1
"2011","Milton Keynes 029A","E01016829","Total",1564,729,835,1564,0,15,27.53,56.8
"2011","Milton Keynes 029B","E01016831","Total",1555,750,805,1555,0,23,39.52,39.3
"2011","Milton Keynes 029C","E01016832","Total",1279,628,651,1279,0,13,24.36,52.5
"2011","Milton Keynes 029D","E01016833","Total",1290,632,658,1290,0,34,84.32,15.3
"2011","Milton Keynes 029E","E01016834","Total",1543,742,801,1543,0,11,31.13,49.6
"2011","Milton Keynes 030A","E01016710","Total",1738,791,947,1738,0,19,49.98,34.8
"2011","Milton Keynes 030B","E01016714","Total",1883,916,967,1883,0,7,41.48,45.4
"2011","Milton Keynes 030C","E01016716","Total",1871,954,917,1832,39,21,57.11,32.8
"2011","Milton Keynes 030D","E01016745","Total",1567,779,788,1567,0,20,34.21,45.8
"2011","Milton Keynes 031A","E01016711","Total",2370,1213,1157,2320,50,36,91.27,26.0
"2011","Milton Keynes 031B","E01016713","Total",1670,824,846,1670,0,22,52.26,32.0
"2011","Milton Keynes 031C","E01016715","Total",1649,773,876,1649,0,11,74.04,22.3
"2011","Milton Keynes 031D","E01016830","Total",1231,600,631,1172,59,14,22.03,55.9
"2011","Milton Keynes 032A","E01016742","Total",1643,784,859,1601,42,15,31.04,52.9
"2011","Milton Keynes 032B","E01016743","Total",2024,958,1066,2024,0,18,293.21,6.9
"2011","Milton Keynes 032C","E01016744","Total",1603,799,804,1603,0,6,40.23,39.8
"2011","Milton Keynes 032D","E01016746","Total",1726,805,921,1726,0,10,49.09,35.2
"2011","Portsmouth 001A","E01017112","Total",1838,912,926,1838,0,7,31.90,57.6
"2011","Portsmouth 001B","E01017115","Total",1359,674,685,1359,0,7,36.75,37.0
"2011","Portsmouth 001C","E01017117","Total",1570,753,817,1570,0,3,55.23,28.4
"2011","Portsmouth 001D","E01017119","Total",1730,848,882,1727,3,7,28.22,61.3
"2011","Portsmouth 001E","E01017120","Total",1492,723,769,1492,0,3,35.92,41.5
"2011","Portsmouth 002A","E01017051","Total",1907,928,979,1877,30,3,80.86,23.6
"2011","Portsmouth 002B","E01017052","Total",1419,694,725,1417,2,4,27.26,52.1
"2011","Portsmouth 002C","E01017053","Total",1349,642,707,1349,0,6,66.71,20.2
"2011","Portsmouth 002D","E01017118","Total",1564,738,826,1564,0,5,26.47,59.1
"2011","Portsmouth 003A","E01017050","Total",1549,757,792,1543,6,23,96.53,16.0
"2011","Portsmouth 003B","E01017061","Total",1694,864,830,1658,36,31,59.70,28.4
"2011","Portsmouth 003C","E01017063","Total",1611,786,825,1586,25,26,35.99,44.8
"2011","Portsmouth 003D","E01017064","Total",1655,759,896,1605,50,21,33.78,49.0
"2011","Portsmouth 004A","E01017054","Total",1412,686,726,1412,0,11,100.64,14.0
"2011","Portsmouth 004B","E01017113","Total",1510,722,788,1510,0,6,181.69,8.3
"2011","Portsmouth 004C","E01017114","Total",1351,705,646,1351,0,12,46.53,29.0
"2011","Portsmouth 004D","E01017116","Total",1596,774,822,1596,0,15,54.46,29.3
"2011","Portsmouth 006A","E01017055","Total",1575,759,816,1529,46,16,22.21,70.9
"2011","Portsmouth 006B","E01017056","Total",1371,665,706,1371,0,8,20.48,66.9
"2011","Portsmouth 006C","E01017057","Total",1517,770,747,1517,0,14,18.35,82.7
"2011","Portsmouth 006D","E01017058","Total",1731,848,883,1671,60,13,23.39,74.0
"2011","Portsmouth 006E","E01017060","Total",1549,741,808,1549,0,7,65.53,23.6
"2011","Portsmouth 007A","E01017086","Total",1325,639,686,1325,0,5,13.63,97.2
"2011","Portsmouth 007B","E01017089","Total",1604,745,859,1604,0,5,52.45,30.6
"2011","Portsmouth 007C","E01017090","Total",1557,766,791,1557,0,9,56.15,27.7
"2011","Portsmouth 007D","E01017091","Total",1546,714,832,1528,18,3,28.04,55.1
"2011","Portsmouth 007E","E01017092","Total",1493,720,773,1453,40,14,19.29,77.4
"2011","Portsmouth 008A","E01017014","Total",1590,803,787,1586,4,10,74.78,21.3
"2011","Portsmouth 008B","E01017046","Total",1708,868,840,1708,0,22,98.81,17.3
"2011","Portsmouth 008C","E01017047","Total",1647,782,865,1647,0,12,90.21,18.3
"2011","Portsmouth 008D","E01017048","Total",1576,777,799,1576,0,18,56.43,27.9
"2011","Portsmouth 008E","E01017085","Total",1428,684,744,1428,0,8,64.17,22.3
"2011","Portsmouth 009A","E01017084","Total",1429,717,712,1423,6,6,27.35,52.2
"2011","Portsmouth 009B","E01017087","Total",1459,737,722,1454,5,5,11.53,126.5
"2011","Portsmouth 009C","E01017088","Total",1711,860,851,1690,21,8,17.17,99.7
"2011","Portsmouth 009D","E01017105","Total",1402,699,703,1402,0,3,11.48,122.1
"2011","Portsmouth 009E","E01017107","Total",1537,768,769,1537,0,11,11.23,136.9
"2011","Portsmouth 010A","E01017104","Total",1163,577,586,1150,13,3,63.58,18.3
"2011","Portsmouth 010B","E01017106","Total",1498,710,788,1498,0,4,14.84,100.9
"2011","Portsmouth 010C","E01017108","Total",1551,760,791,1542,9,2,46.94,33.0
"2011","Portsmouth 010D","E01017109","Total",1358,656,702,1358,0,6,10.30,131.8
"2011","Portsmouth 011A","E01017041","Total",1398,703,695,1398,0,8,11.97,116.8
"2011","Portsmouth 011B","E01017043","Total",1465,712,753,1465,0,4,9.58,152.9
"2011","Portsmouth 011C","E01017044","Total",1537,799,738,1537,0,4,10.29,149.4
"2011","Portsmouth 011D","E01017049","Total",1498,763,735,1498,0,10,24.58,60.9
"2011","Portsmouth 011E","E01017110","Total",1465,716,749,1465,0,5,11.44,128.1
"2011","Portsmouth 011F","E01017111","Total",1454,708,746,1454,0,4,15.79,92.1
"2011","Portsmouth 012A","E01017013","Total",1605,775,830,1605,0,9,14.54,110.4
"2011","Portsmouth 012B","E01017042","Total",1412,691,721,1412,0,13,8.24,171.4
"2011","Portsmouth 012C","E01017045","Total",1367,676,691,1358,9,5,8.78,155.7
"2011","Portsmouth 012D","E01017075","Total",1629,802,827,1629,0,6,10.44,156.0
"2011","Portsmouth 012E","E01017082","Total",1744,903,841,1744,0,11,11.05,157.8
"2011","Portsmouth 012F","E01017083","Total",1734,827,907,1734,0,9,11.00,157.6
"2011","Portsmouth 013A","E01017036","Total",1568,755,813,1568,0,2,13.53,115.9
"2011","Portsmouth 013B","E01017037","Total",1492,703,789,1492,0,7,9.66,154.5
"2011","Portsmouth 013C","E01017038","Total",1631,791,840,1614,17,0,40.88,39.9
"2011","Portsmouth 013D","E01017102","Total",1570,802,768,1570,0,4,17.72,88.6
"2011","Portsmouth 013E","E01017103","Total",1252,599,653,1252,0,4,33.34,37.6
"2011","Portsmouth 014A","E01017015","Total",1467,727,740,1466,1,10,47.51,30.9
"2011","Portsmouth 014B","E01017016","Total",1587,783,804,1587,0,14,12.01,132.1
"2011","Portsmouth 014C","E01017017","Total",1522,739,783,1522,0,16,16.48,92.4
"2011","Portsmouth 014D","E01017018","Total",1601,786,815,1601,0,14,18.74,85.4
"2011","Portsmouth 014E","E01017019","Total",1998,1073,925,1784,214,10,21.50,92.9
"2011","Portsmouth 014F","E01017020","Total",2293,1131,1162,2290,3,18,34.80,65.9
"2011","Portsmouth 015A","E01017076","Total",1627,825,802,1615,12,14,37.89,42.9
"2011","Portsmouth 015B","E01017077","Total",1729,854,875,1720,9,2,17.82,97.0
"2011","Portsmouth 015C","E01017078","Total",1570,791,779,1568,2,4,10.37,151.4
"2011","Portsmouth 015D","E01017079","Total",1579,862,717,1579,0,11,8.45,186.9
"2011","Portsmouth 015E","E01017080","Total",2048,1052,996,2028,20,20,12.91,158.6
"2011","Portsmouth 015F","E01017081","Total",1654,812,842,1654,0,8,8.76,188.8
"2011","Portsmouth 016A","E01017031","Total",1939,973,966,1939,0,6,20.56,94.3
"2011","Portsmouth 016B","E01017032","Total",2607,1335,1272,1141,1466,63,46.06,56.6
"2011","Portsmouth 016D","E01017034","Total",1892,1161,731,1176,716,12,135.24,14.0
"2011","Portsmouth 016E","E01017039","Total",1754,849,905,1754,0,5,15.52,113.0
"2011","Portsmouth 016F","E01017040","Total",1479,750,729,1479,0,8,16.47,89.8
"2011","Portsmouth 016G","E01033381","Total",1401,786,615,1401,0,9,9.03,155.1
"2011","Portsmouth 016H","E01033383","Total",1295,626,669,1295,0,10,16.39,79.0
"2011","Portsmouth 017A","E01017021","Total",1458,685,773,1380,78,10,72.69,20.1
"2011","Portsmouth 017B","E01017093","Total",1617,856,761,1046,571,22,55.08,29.4
"2011","Portsmouth 017C","E01017096","Total",1404,673,731,1404,0,15,17.96,78.2
"2011","Portsmouth 017D","E01017099","Total",1631,799,832,1628,3,23,67.93,24.0
"2011","Portsmouth 017E","E01017100","Total",1459,718,741,1395,64,7,24.60,59.3
"2011","Portsmouth 017F","E01017101","Total",1550,758,792,1550,0,10,16.51,93.9
"2011","Portsmouth 018A","E01017035","Total",1584,721,863,1584,0,9,14.80,107.0
"2011","Portsmouth 018B","E01017128","Total",1652,923,729,1644,8,23,8.63,191.4
"2011","Portsmouth 018C","E01017129","Total",1918,1094,824,1916,2,17,11.33,169.3
"2011","Portsmouth 018D","E01017130","Total",1917,942,975,1917,0,7,12.01,159.6
"2011","Portsmouth 018E","E01017132","Total",2689,1314,1375,2406,283,17,11.06,243.1
"2011","Portsmouth 018F","E01017133","Total",1868,986,882,1867,1,10,11.09,168.4
"2011","Portsmouth 019A","E01017023","Total",1694,889,805,1694,0,15,10.54,160.7
"2011","Portsmouth 019B","E01017025","Total",2066,1110,956,2066,0,20,11.43,180.8
"2011","Portsmouth 019C","E01017026","Total",1956,930,1026,1956,0,16,13.08,149.5
"2011","Portsmouth 019D","E01017029","Total",1752,922,830,1752,0,10,10.45,167.7
"2011","Portsmouth 019E","E01017030","Total",1988,977,1011,1988,0,16,11.27,176.4
"2011","Portsmouth 020A","E01017022","Total",1423,740,683,1423,0,12,12.33,115.4
"2011","Portsmouth 020B","E01017024","Total",1810,985,825,1810,0,14,10.92,165.8
"2011","Portsmouth 020C","E01017027","Total",1794,998,796,1794,0,15,11.62,154.4
"2011","Portsmouth 020D","E01017028","Total",2177,1175,1002,2177,0,27,11.33,192.1
"2011","Portsmouth 020E","E01017124","Total",1747,889,858,1719,28,19,11.88,147.1
"2011","Portsmouth 021A","E01017094","Total",1557,795,762,1557,0,8,11.42,136.3
"2011","Portsmouth 021B","E01017095","Total",1811,888,923,1811,0,13,16.32,111.0
"2011","Portsmouth 021C","E01017097","Total",1637,835,802,1637,0,13,10.40,157.4
"2011","Portsmouth 021D","E01017098","Total",1445,683,762,1445,0,10,10.27,140.7
"2011","Portsmouth 022A","E01017122","Total",1743,953,790,1671,72,16,15.33,113.7
"2011","Portsmouth 022B","E01017125","Total",1796,896,900,1616,180,18,16.89,106.3
"2011","Portsmouth 022C","E01017127","Total",1924,1103,821,1879,45,19,11.00,174.9
"2011","Portsmouth 022D","E01017135","Total",1685,926,759,1632,53,17,13.97,120.6
"2011","Portsmouth 023A","E01017067","Total",1470,732,738,1470,0,14,33.75,43.6
"2011","Portsmouth 023B","E01017068","Total",1773,873,900,1769,4,13,21.09,84.1
"2011","Portsmouth 023C","E01017069","Total",1900,875,1025,1846,54,30,26.33,72.2
"2011","Portsmouth 023D","E01017070","Total",1520,762,758,1494,26,35,33.26,45.7
"2011","Portsmouth 023E","E01017074","Total",1862,957,905,1862,0,12,70.72,26.3
"2011","Portsmouth 024A","E01017073","Total",1737,877,860,1711,26,21,14.82,117.2
"2011","Portsmouth 024B","E01017123","Total",2002,1067,935,1950,52,25,75.33,26.6
"2011","Portsmouth 024C","E01017131","Total",1967,1032,935,1609,358,46,56.28,35.0
"2011","Portsmouth 024E","E01033380","Total",1510,890,620,1510,0,17,19.11,79.0
"2011","Portsmouth 024F","E01033384","Total",1428,754,674,1428,0,32,16.02,89.1
"2011","Portsmouth 025A","E01017071","Total",1702,932,770,1666,36,17,10.72,158.8
"2011","Portsmouth 025B","E01017072","Total",1627,830,797,1505,122,26,15.95,102.0
"2011","Portsmouth 025C","E01017121","Total",1706,909,797,1652,54,18,15.03,113.5
"2011","Portsmouth 025D","E01017126","Total",1761,953,808,1761,0,12,12.50,140.9
"2011","Portsmouth 026A","E01017059","Total",1543,740,803,1535,8,5,241.63,6.4
"2011","Portsmouth 026B","E01017062","Total",1621,801,820,1621,0,43,69.81,23.2
"2011","Portsmouth 026C","E01017066","Total",1825,892,933,1823,2,13,41.29,44.2
"2011","Portsmouth 026D","E01032604","Total",1556,792,764,1525,31,22,37.04,42.0
"2011","Reading 001A","E01016407","Total",1512,736,776,1512,0,29,63.04,24.0
"2011","Reading 001B","E01016408","Total",1503,748,755,1503,0,17,69.46,21.6
"2011","Reading 001C","E01016410","Total",1646,804,842,1646,0,17,55.35,29.7
"2011","Reading 001D","E01016411","Total",1571,752,819,1571,0,45,80.73,19.5
"2011","Reading 001E","E01016412","Total",1549,749,800,1543,6,20,24.51,63.2
"2011","Reading 002A","E01016386","Total",1456,714,742,1449,7,52,103.22,14.1
"2011","Reading 002B","E01016387","Total",1549,770,779,1549,0,38,45.36,34.1
"2011","Reading 002C","E01016425","Total",1768,880,888,1768,0,48,44.20,40.0
"2011","Reading 002D","E01016426","Total",1410,687,723,1400,10,61,38.78,36.4
"2011","Reading 002E","E01016430","Total",1418,693,725,1418,0,39,59.82,23.7
"2011","Reading 003A","E01016364","Total",1414,702,712,1414,0,25,28.91,48.9
"2011","Reading 003B","E01016409","Total",1714,796,918,1632,82,26,47.58,36.0
"2011","Reading 003C","E01016427","Total",1618,734,884,1506,112,38,55.42,29.2
"2011","Reading 003D","E01016428","Total",1866,903,963,1827,39,35,51.45,36.3
"2011","Reading 003E","E01016429","Total",1621,765,856,1590,31,30,32.65,49.6
"2011","Reading 004A","E01016362","Total",1514,758,756,1514,0,10,28.31,53.5
"2011","Reading 004B","E01016363","Total",1860,885,975,1860,0,19,33.07,56.2
"2011","Reading 004C","E01016365","Total",1585,822,763,1585,0,15,39.74,39.9
"2011","Reading 004D","E01016366","Total",1582,795,787,1582,0,30,25.34,62.4
"2011","Reading 004E","E01016367","Total",1578,778,800,1575,3,8,23.12,68.3
"2011","Reading 005A","E01016380","Total",1643,811,832,1643,0,28,43.24,38.0
"2011","Reading 005B","E01016383","Total",1484,694,790,1484,0,18,26.05,57.0
"2011","Reading 005C","E01016384","Total",1637,813,824,1620,17,65,67.11,24.4
"2011","Reading 005D","E01016431","Total",1597,772,825,1590,7,36,33.78,47.3
"2011","Reading 005E","E01016432","Total",1469,693,776,1469,0,27,29.23,50.3
"2011","Reading 006A","E01016381","Total",1458,720,738,1458,0,14,28.21,51.7
"2011","Reading 006B","E01016382","Total",1746,856,890,1746,0,15,63.71,27.4
"2011","Reading 006C","E01016385","Total",1666,810,856,1543,123,17,28.95,57.5
"2011","Reading 006D","E01016396","Total",1275,630,645,1275,0,10,22.39,56.9
"2011","Reading 006E","E01016397","Total",1391,658,733,1387,4,4,23.34,59.6
"2011","Reading 007A","E01016355","Total",1836,974,862,1836,0,14,77.65,23.6
"2011","Reading 007B","E01016358","Total",1724,923,801,1724,0,14,27.62,62.4
"2011","Reading 007C","E01016359","Total",2093,1028,1065,2093,0,11,150.80,13.9
"2011","Reading 007D","E01016360","Total",2057,1098,959,2057,0,17,16.59,124.0
"2011","Reading 007E","E01016361","Total",1743,871,872,1743,0,12,10.86,160.5
"2011","Reading 008A","E01016356","Total",1557,793,764,1550,7,8,16.39,95.0
"2011","Reading 008B","E01016357","Total",1668,902,766,1657,11,12,20.11,82.9
"2011","Reading 008C","E01016395","Total",1388,664,724,1388,0,12,36.00,38.6
"2011","Reading 008D","E01016398","Total",1700,868,832,1700,0,11,15.17,112.1
"2011","Reading 008E","E01016399","Total",1416,735,681,1416,0,16,17.88,79.2
"2011","Reading 008F","E01016400","Total",1481,750,731,1481,0,27,21.62,68.5
"2011","Reading 009A","E01016394","Total",1355,625,730,1355,0,12,26.28,51.6
"2011","Reading 009B","E01016433","Total",1379,678,701,1379,0,24,29.25,47.1
"2011","Reading 009C","E01016434","Total",1770,841,929,1770,0,22,51.43,34.4
"2011","Reading 009D","E01016435","Total",1410,670,740,1410,0,16,32.38,43.5
"2011","Reading 009E","E01016436","Total",1530,752,778,1521,9,11,33.60,45.5
"2011","Reading 010B","E01016402","Total",1911,965,946,1911,0,21,12.49,153.0
"2011","Reading 010C","E01016404","Total",2050,1050,1000,2050,0,31,13.62,150.5
"2011","Reading 010D","E01016405","Total",2079,1125,954,2079,0,18,9.72,213.9
"2011","Reading 010E","E01016406","Total",1602,855,747,1602,0,28,38.84,41.2
"2011","Reading 010F","E01033417","Total",1095,601,494,1095,0,0,8.05,136.0
"2011","Reading 010G","E01033421","Total",1780,935,845,1780,0,9,34.29,51.9
"2011","Reading 011B","E01016353","Total",1797,966,831,1797,0,11,24.25,74.1
"2011","Reading 011D","E01016378","Total",2083,1113,970,1924,159,14,28.76,72.4
"2011","Reading 011E","E01016391","Total",1835,918,917,1835,0,9,27.96,65.6
"2011","Reading 011F","E01033415","Total",1535,924,611,1382,153,3,77.07,19.9
"2011","Reading 011G","E01033418","Total",1171,654,517,1171,0,7,49.93,23.5
"2011","Reading 011H","E01033420","Total",1130,636,494,1103,27,15,21.42,52.8
"2011","Reading 011I","E01033422","Total",1117,602,515,1111,6,1,13.11,85.2
"2011","Reading 011J","E01033423","Total",1168,623,545,1168,0,4,11.76,99.3
"2011","Reading 012A","E01016401","Total",1509,763,746,1485,24,37,25.14,60.0
"2011","Reading 012B","E01016403","Total",1951,1000,951,1912,39,38,33.30,58.6
"2011","Reading 012C","E01016416","Total",1637,876,761,1637,0,14,11.81,138.6
"2011","Reading 012D","E01016417","Total",1726,879,847,1701,25,30,14.45,119.4
"2011","Reading 012E","E01016418","Total",1640,812,828,1640,0,18,14.06,116.6
"2011","Reading 013A","E01016388","Total",1435,695,740,1435,0,23,100.48,14.3
"2011","Reading 013B","E01016389","Total",1736,813,923,1732,4,17,92.15,18.8
"2011","Reading 013C","E01016390","Total",1540,799,741,1477,63,25,25.15,61.2
"2011","Reading 013D","E01016392","Total",2041,1052,989,1825,216,10,27.34,74.7
"2011","Reading 013E","E01016393","Total",1554,768,786,1490,64,16,35.71,43.5
"2011","Reading 014A","E01016374","Total",1626,843,783,1626,0,4,13.10,124.1
"2011","Reading 014B","E01016375","Total",1258,634,624,1258,0,9,9.47,132.8
"2011","Reading 014C","E01016376","Total",1535,783,752,1527,8,7,26.34,58.3
"2011","Reading 014D","E01016379","Total",1750,964,786,1750,0,14,12.21,143.3
"2011","Reading 014E","E01016413","Total",1764,862,902,1068,696,28,30.48,57.9
"2011","Reading 014F","E01016414","Total",1610,836,774,1391,219,32,51.75,31.1
"2011","Reading 015A","E01016419","Total",1675,831,844,1636,39,14,59.27,28.3
"2011","Reading 015B","E01016420","Total",1395,669,726,1378,17,9,20.55,67.9
"2011","Reading 015C","E01016421","Total",1316,612,704,1271,45,21,84.67,15.5
"2011","Reading 015D","E01016422","Total",1359,637,722,1359,0,18,32.13,42.3
"2011","Reading 015E","E01016423","Total",1480,674,806,1480,0,7,91.82,16.1
"2011","Reading 015F","E01016424","Total",1323,655,668,1323,0,35,41.30,32.0
"2011","Reading 016A","E01016370","Total",3093,1492,1601,1173,1920,72,65.66,47.1
"2011","Reading 016B","E01016371","Total",1669,817,852,1498,171,39,60.13,27.8
"2011","Reading 016C","E01016373","Total",1515,734,781,1515,0,13,38.71,39.1
"2011","Reading 016D","E01016415","Total",1611,841,770,1611,0,15,20.85,77.3
"2011","Reading 017A","E01016368","Total",1412,691,721,1412,0,4,35.87,39.4
"2011","Reading 017B","E01016372","Total",1274,620,654,1274,0,10,23.42,54.4
"2011","Reading 017C","E01016377","Total",1641,843,798,1639,2,13,62.10,26.4
"2011","Reading 017D","E01016438","Total",1294,626,668,1294,0,6,25.44,50.9
"2011","Reading 017E","E01016442","Total",2805,1434,1371,2805,0,16,307.56,9.1
"2011","Reading 017F","E01016443","Total",1505,712,793,1505,0,11,19.53,77.1
"2011","Reading 018A","E01016369","Total",1603,779,824,1603,0,15,29.17,55.0
"2011","Reading 018B","E01016437","Total",1415,707,708,1415,0,11,64.82,21.8
"2011","Reading 018C","E01016439","Total",1534,747,787,1534,0,15,95.07,16.1
"2011","Reading 018D","E01016440","Total",1458,732,726,1455,3,7,26.22,55.6
"2011","Reading 018E","E01016441","Total",1449,668,781,1449,0,8,41.66,34.8
"2011","Slough 001A","E01016450","Total",1609,774,835,1598,11,13,34.01,47.3
"2011","Slough 001B","E01016451","Total",1620,789,831,1620,0,13,15.19,106.6
"2011","Slough 001C","E01016452","Total",1660,821,839,1660,0,15,27.29,60.8
"2011","Slough 001D","E01016453","Total",1559,776,783,1558,1,8,39.39,39.6
"2011","Slough 001E","E01016454","Total",1531,758,773,1531,0,14,26.86,57.0
"2011","Slough 001F","E01016455","Total",1397,642,755,1397,0,17,29.12,48.0
"2011","Slough 002A","E01016483","Total",1798,926,872,1798,0,19,25.16,71.5
"2011","Slough 002B","E01016484","Total",1578,808,770,1578,0,20,19.20,82.2
"2011","Slough 002C","E01016485","Total",1725,900,825,1725,0,14,15.49,111.4
"2011","Slough 002D","E01016486","Total",1650,799,851,1650,0,10,130.79,12.6
"2011","Slough 002E","E01016487","Total",1777,888,889,1777,0,16,16.92,105.0
"2011","Slough 002F","E01016488","Total",1806,903,903,1806,0,19,23.63,76.4
"2011","Slough 003A","E01016493","Total",1237,596,641,1218,19,13,17.58,70.4
"2011","Slough 003B","E01016494","Total",1929,971,958,1929,0,17,77.38,24.9
"2011","Slough 003C","E01016495","Total",1467,716,751,1467,0,10,26.21,56.0
"2011","Slough 003D","E01016496","Total",1298,606,692,1298,0,10,21.63,60.0
"2011","Slough 003E","E01016497","Total",1442,702,740,1430,12,31,28.60,50.4
"2011","Slough 003F","E01016498","Total",1642,796,846,1642,0,16,21.40,76.7
"2011","Slough 003G","E01016499","Total",1342,666,676,1342,0,4,26.91,49.9
"2011","Slough 004A","E01016444","Total",1715,842,873,1715,0,11,16.08,106.7
"2011","Slough 004B","E01016445","Total",1824,860,964,1824,0,12,20.61,88.5
"2011","Slough 004C","E01016446","Total",1613,801,812,1613,0,24,21.98,73.4
"2011","Slough 004D","E01016447","Total",1818,934,884,1818,0,6,21.51,84.5
"2011","Slough 004E","E01016448","Total",2349,1211,1138,2346,3,16,50.71,46.3
"2011","Slough 004F","E01016449","Total",2131,1054,1077,2131,0,26,26.23,81.2
"2011","Slough 005A","E01016516","Total",1723,866,857,1723,0,10,15.66,110.0
"2011","Slough 005B","E01016517","Total",1522,767,755,1522,0,23,12.72,119.7
"2011","Slough 005C","E01016518","Total",1735,902,833,1735,0,21,18.55,93.5
"2011","Slough 005D","E01016519","Total",2556,1145,1411,2451,105,12,70.97,36.0
"2011","Slough 005E","E01016520","Total",1681,833,848,1681,0,5,40.78,41.2
"2011","Slough 005F","E01016521","Total",1800,893,907,1800,0,15,31.30,57.5
"2011","Slough 006A","E01016467","Total",1457,742,715,1457,0,16,17.47,83.4
"2011","Slough 006B","E01016468","Total",1712,843,869,1712,0,13,26.05,65.7
"2011","Slough 006C","E01016469","Total",1643,828,815,1643,0,12,26.72,61.5
"2011","Slough 006D","E01016470","Total",1615,825,790,1615,0,18,28.09,57.5
"2011","Slough 006E","E01016471","Total",1354,637,717,1343,11,13,25.66,52.8
"2011","Slough 006F","E01016472","Total",1666,817,849,1666,0,2,19.89,83.8
"2011","Slough 007A","E01016456","Total",2112,1121,991,2112,0,26,31.11,67.9
"2011","Slough 007B","E01016457","Total",1892,939,953,1892,0,15,20.71,91.4
"2011","Slough 007C","E01016458","Total",1746,823,923,1720,26,24,33.11,52.7
"2011","Slough 007D","E01016459","Total",2210,1126,1084,2162,48,26,36.47,60.6
"2011","Slough 007E","E01016460","Total",1869,931,938,1869,0,26,32.75,57.1
"2011","Slough 007F","E01016461","Total",2535,1321,1214,2535,0,18,54.21,46.8
"2011","Slough 008A","E01016473","Total",2136,1062,1074,2136,0,22,40.35,52.9
"2011","Slough 008B","E01016474","Total",1957,965,992,1957,0,19,33.77,58.0
"2011","Slough 008C","E01016475","Total",2083,1038,1045,2083,0,16,34.08,61.1
"2011","Slough 008D","E01016476","Total",1760,881,879,1749,11,12,28.18,62.5
"2011","Slough 008E","E01016477","Total",2343,1171,1172,2343,0,18,200.21,11.7
"2011","Slough 008F","E01016478","Total",1837,935,902,1837,0,27,31.87,57.6
"2011","Slough 009A","E01016462","Total",2395,1277,1118,2389,6,15,29.04,82.5
"2011","Slough 009B","E01016463","Total",1950,1056,894,1907,43,20,68.77,28.4
"2011","Slough 009C","E01016464","Total",1892,1020,872,1874,18,31,19.25,98.3
"2011","Slough 009D","E01016465","Total",2732,1390,1342,2700,32,18,55.14,49.5
"2011","Slough 009F","E01032729","Total",1636,850,786,1573,63,4,18.53,88.3
"2011","Slough 009G","E01032730","Total",1512,773,739,1493,19,9,21.26,71.1
"2011","Slough 010A","E01016506","Total",1765,926,839,1765,0,20,43.84,40.3
"2011","Slough 010B","E01016507","Total",1580,765,815,1580,0,25,29.01,54.5
"2011","Slough 010C","E01016508","Total",1741,853,888,1741,0,23,36.57,47.6
"2011","Slough 010D","E01016509","Total",1521,766,755,1521,0,25,45.86,33.2
"2011","Slough 010E","E01016510","Total",1472,732,740,1468,4,42,47.86,30.8
"2011","Slough 011A","E01016511","Total",1835,943,892,1786,49,28,32.92,55.7
"2011","Slough 011B","E01016512","Total",1843,962,881,1843,0,13,40.96,45.0
"2011","Slough 011C","E01016513","Total",1927,950,977,1927,0,45,112.63,17.1
"2011","Slough 011D","E01016514","Total",1741,886,855,1741,0,12,65.22,26.7
"2011","Slough 011E","E01016515","Total",2040,981,1059,2040,0,51,39.89,51.1
"2011","Slough 012A","E01016500","Total",1796,852,944,1796,0,35,40.05,44.8
"2011","Slough 012B","E01016501","Total",1597,765,832,1597,0,22,18.85,84.7
"2011","Slough 012C","E01016502","Total",1458,706,752,1458,0,17,24.25,60.1
"2011","Slough 012D","E01016503","Total",1546,776,770,1546,0,15,17.57,88.0
"2011","Slough 012E","E01016504","Total",1419,705,714,1394,25,42,28.86,49.2
"2011","Slough 012F","E01016505","Total",1688,835,853,1688,0,14,27.91,60.5
"2011","Slough 013B","E01016490","Total",1956,952,1004,1956,0,18,32.38,60.4
"2011","Slough 013C","E01016491","Total",1707,881,826,1707,0,12,23.94,71.3
"2011","Slough 013D","E01016492","Total",1673,823,850,1673,0,17,34.62,48.3
"2011","Slough 013E","E01032731","Total",1547,773,774,1547,0,15,24.22,63.9
"2011","Slough 013F","E01032732","Total",1618,803,815,1618,0,15,20.49,79.0
"2011","Slough 014A","E01016479","Total",1592,829,763,1592,0,15,33.00,48.2
"2011","Slough 014B","E01016480","Total",1377,670,707,1377,0,14,32.45,42.4
"2011","Slough 014C","E01016481","Total",1457,756,701,1455,2,8,183.97,7.9
"2011","Slough 014D","E01016482","Total",1731,914,817,1731,0,19,313.74,5.5
"2011","Southampton 001A","E01017144","Total",1218,623,595,1015,203,18,28.75,42.4
"2011","Southampton 001B","E01017145","Total",1427,721,706,1427,0,27,64.86,22.0
"2011","Southampton 001C","E01017146","Total",2223,1143,1080,1608,615,44,112.97,19.7
"2011","Southampton 001D","E01017148","Total",2185,1089,1096,1183,1002,29,47.17,46.3
"2011","Southampton 001E","E01017149","Total",1400,751,649,1400,0,17,15.21,92.0
"2011","Southampton 002A","E01017180","Total",1491,725,766,1491,0,12,37.94,39.3
"2011","Southampton 002B","E01017181","Total",1405,690,715,1405,0,3,32.95,42.6
"2011","Southampton 002C","E01017183","Total",1628,803,825,1628,0,18,31.29,52.0
"2011","Southampton 002D","E01017185","Total",1767,860,907,1767,0,9,30.94,57.1
"2011","Southampton 002E","E01017187","Total",1587,777,810,1587,0,8,39.99,39.7
"2011","Southampton 003A","E01017264","Total",2582,1322,1260,988,1594,30,26.84,96.2
"2011","Southampton 003B","E01017265","Total",1632,786,846,1632,0,6,100.11,16.3
"2011","Southampton 003C","E01017270","Total",1355,711,644,1135,220,10,21.28,63.7
"2011","Southampton 003D","E01017271","Total",1086,552,534,1086,0,15,41.17,26.4
"2011","Southampton 004A","E01017182","Total",1401,656,745,1401,0,4,23.75,59.0
"2011","Southampton 004B","E01017184","Total",1407,676,731,1407,0,1,34.37,40.9
"2011","Southampton 004C","E01017186","Total",1652,826,826,1652,0,12,24.56,67.3
"2011","Southampton 004D","E01017188","Total",1708,830,878,1708,0,4,26.08,65.5
"2011","Southampton 005A","E01017266","Total",1442,767,675,1442,0,4,18.77,76.8
"2011","Southampton 005B","E01017267","Total",1238,665,573,1238,0,15,29.92,41.4
"2011","Southampton 005E","E01017272","Total",1413,674,739,1413,0,9,20.01,70.6
"2011","Southampton 005F","E01032756","Total",2916,1620,1296,2916,0,26,40.81,71.5
"2011","Southampton 006A","E01017147","Total",1432,715,717,1415,17,17,27.35,52.4
"2011","Southampton 006B","E01017150","Total",1511,762,749,1429,82,34,64.57,23.4
"2011","Southampton 006C","E01017151","Total",1573,753,820,1573,0,14,66.70,23.6
"2011","Southampton 006D","E01017152","Total",1563,782,781,1534,29,15,25.37,61.6
"2011","Southampton 007A","E01017238","Total",1402,702,700,1402,0,6,27.67,50.7
"2011","Southampton 007B","E01017241","Total",1425,651,774,1425,0,0,48.87,29.2
"2011","Southampton 007C","E01017242","Total",1432,719,713,1432,0,8,33.31,43.0
"2011","Southampton 007D","E01017243","Total",1727,887,840,1727,0,20,22.51,76.7
"2011","Southampton 007E","E01017244","Total",1339,635,704,1339,0,9,24.92,53.7
"2011","Southampton 008A","E01017174","Total",1318,637,681,1318,0,11,55.38,23.8
"2011","Southampton 008B","E01017175","Total",1545,773,772,1545,0,14,54.48,28.4
"2011","Southampton 008C","E01017176","Total",1617,823,794,1617,0,20,25.78,62.7
"2011","Southampton 008D","E01017179","Total",1461,723,738,1461,0,7,19.99,73.1
"2011","Southampton 009A","E01017226","Total",1484,751,733,1467,17,22,25.28,58.7
"2011","Southampton 009D","E01017231","Total",1709,897,812,1709,0,21,22.74,75.2
"2011","Southampton 009E","E01017232","Total",1260,641,619,1260,0,24,22.24,56.7
"2011","Southampton 009F","E01032753","Total",2444,1271,1173,2237,207,65,93.73,26.1
"2011","Southampton 010A","E01017246","Total",1923,949,974,1923,0,22,26.98,71.3
"2011","Southampton 010B","E01017250","Total",1415,650,765,1398,17,12,23.42,60.4
"2011","Southampton 010C","E01017251","Total",1563,770,793,1563,0,5,37.39,41.8
"2011","Southampton 010D","E01017253","Total",1711,847,864,1711,0,7,30.45,56.2
"2011","Southampton 011A","E01017247","Total",1637,789,848,1602,35,24,26.21,62.5
"2011","Southampton 011B","E01017248","Total",1558,763,795,1558,0,38,25.57,60.9
"2011","Southampton 011C","E01017249","Total",1398,686,712,1392,6,44,86.20,16.2
"2011","Southampton 011D","E01017252","Total",1564,751,813,1564,0,37,86.94,18.0
"2011","Southampton 011E","E01017254","Total",1656,808,848,1636,20,15,21.77,76.1
"2011","Southampton 012A","E01017236","Total",1395,664,731,1395,0,8,45.02,31.0
"2011","Southampton 012B","E01017237","Total",1504,753,751,1504,0,4,23.89,63.0
"2011","Southampton 012C","E01017239","Total",1536,775,761,1536,0,3,98.17,15.6
"2011","Southampton 012D","E01017240","Total",1230,605,625,1230,0,7,49.65,24.8
"2011","Southampton 012E","E01017245","Total",1500,689,811,1500,0,6,29.97,50.1
"2011","Southampton 013A","E01017227","Total",1319,691,628,1258,61,9,9.53,138.4
"2011","Southampton 013B","E01017228","Total",1552,796,756,1545,7,5,21.11,73.5
"2011","Southampton 013C","E01017233","Total",1613,787,826,1613,0,5,27.84,57.9
"2011","Southampton 013D","E01017234","Total",1864,989,875,1863,1,9,23.77,78.4
"2011","Southampton 013E","E01017235","Total",1586,849,737,1538,48,10,17.29,91.7
"2011","Southampton 014A","E01017171","Total",1840,960,880,1805,35,19,28.70,64.1
"2011","Southampton 014B","E01017172","Total",1776,925,851,1769,7,9,34.48,51.5
"2011","Southampton 014C","E01017173","Total",1436,715,721,1436,0,17,29.79,48.2
"2011","Southampton 014D","E01017177","Total",1510,773,737,1492,18,14,30.72,49.2
"2011","Southampton 014E","E01017178","Total",1523,760,763,1523,0,24,20.68,73.6
"2011","Southampton 015A","E01017207","Total",1628,752,876,1582,46,3,21.12,77.1
"2011","Southampton 015B","E01017209","Total",1440,727,713,1440,0,11,17.64,81.6
"2011","Southampton 015C","E01017211","Total",1760,820,940,1727,33,13,22.16,79.4
"2011","Southampton 015D","E01017212","Total",1374,675,699,1374,0,14,28.27,48.6
"2011","Southampton 015E","E01017213","Total",1515,780,735,1515,0,7,16.48,91.9
"2011","Southampton 016A","E01017200","Total",1772,862,910,1772,0,11,36.54,48.5
"2011","Southampton 016B","E01017201","Total",1368,650,718,1368,0,5,17.94,76.3
"2011","Southampton 016C","E01017202","Total",1675,772,903,1648,27,13,21.80,76.8
"2011","Southampton 016D","E01017203","Total",1634,786,848,1634,0,14,33.50,48.8
"2011","Southampton 016E","E01017204","Total",1551,760,791,1522,29,17,26.84,57.8
"2011","Southampton 017A","E01017157","Total",1576,863,713,1520,56,4,12.51,126.0
"2011","Southampton 017B","E01017158","Total",1891,1033,858,1858,33,20,22.05,85.8
"2011","Southampton 017C","E01017159","Total",1674,862,812,1674,0,5,11.87,141.0
"2011","Southampton 017D","E01017160","Total",1481,750,731,1481,0,8,15.55,95.2
"2011","Southampton 018A","E01017198","Total",1434,675,759,1434,0,10,35.36,40.6
"2011","Southampton 018B","E01017199","Total",1624,754,870,1614,10,9,26.79,60.6
"2011","Southampton 018C","E01017205","Total",1365,663,702,1365,0,8,29.37,46.5
"2011","Southampton 018D","E01017206","Total",1612,806,806,1612,0,10,33.99,47.4
"2011","Southampton 019A","E01017208","Total",1424,694,730,1424,0,9,23.47,60.7
"2011","Southampton 019B","E01017210","Total",1532,686,846,1532,0,5,23.69,64.7
"2011","Southampton 019C","E01017214","Total",1468,729,739,1416,52,8,165.52,8.9
"2011","Southampton 019D","E01017215","Total",1777,866,911,1777,0,15,31.65,56.1
"2011","Southampton 019E","E01017216","Total",1464,747,717,1464,0,8,23.78,61.6
"2011","Southampton 020A","E01017189","Total",1522,844,678,1437,85,6,14.95,101.8
"2011","Southampton 020B","E01017190","Total",1720,926,794,1457,263,10,18.18,94.6
"2011","Southampton 020C","E01017191","Total",1732,962,770,1718,14,12,15.34,112.9
"2011","Southampton 020D","E01017196","Total",2015,1097,918,1915,100,19,26.56,75.9
"2011","Southampton 020E","E01017197","Total",1520,757,763,1507,13,26,20.20,75.2
"2011","Southampton 021A","E01017192","Total",2023,1036,987,2020,3,12,23.13,87.5
"2011","Southampton 021B","E01017193","Total",1657,845,812,1657,0,6,19.55,84.8
"2011","Southampton 021C","E01017194","Total",1798,953,845,1795,3,3,132.97,13.5
"2011","Southampton 021D","E01017195","Total",1950,1033,917,1929,21,4,26.75,72.9
"2011","Southampton 022A","E01017153","Total",1631,912,719,1623,8,14,13.96,116.8
"2011","Southampton 022B","E01017154","Total",2289,1181,1108,2289,0,8,67.35,34.0
"2011","Southampton 022C","E01017155","Total",1698,963,735,1698,0,11,29.50,57.6
"2011","Southampton 022D","E01017156","Total",1813,996,817,1813,0,13,9.44,192.1
"2011","Southampton 022F","E01032738","Total",1296,738,558,1249,47,4,22.14,58.5
"2011","Southampton 022G","E01032750","Total",1495,859,636,1137,358,16,12.82,116.6
"2011","Southampton 023A","E01017136","Total",1623,866,757,1607,16,15,19.00,85.4
"2011","Southampton 023B","E01017137","Total",1719,935,784,1719,0,36,10.15,169.4
"2011","Southampton 023C","E01017138","Total",2325,1109,1216,2004,321,28,16.44,141.4
"2011","Southampton 023D","E01017140","Total",1497,815,682,1413,84,9,112.55,13.3
"2011","Southampton 024A","E01017217","Total",1544,762,782,1522,22,8,38.00,40.6
"2011","Southampton 024B","E01017223","Total",1678,848,830,1676,2,21,30.81,54.5
"2011","Southampton 024C","E01017224","Total",1353,691,662,1353,0,17,31.83,42.5
"2011","Southampton 024D","E01017225","Total",1552,741,811,1533,19,11,32.31,48.0
"2011","Southampton 025A","E01017162","Total",1435,690,745,1435,0,10,31.87,45.0
"2011","Southampton 025B","E01017163","Total",1549,754,795,1549,0,11,20.77,74.6
"2011","Southampton 025C","E01017164","Total",1503,753,750,1503,0,9,37.89,39.7
"2011","Southampton 025D","E01017165","Total",1458,711,747,1440,18,2,22.59,64.5
"2011","Southampton 025E","E01017166","Total",1507,696,811,1507,0,3,33.92,44.4
"2011","Southampton 026A","E01017256","Total",2029,977,1052,2024,5,14,43.69,46.4
"2011","Southampton 026B","E01017257","Total",1560,789,771,1560,0,12,23.15,67.4
"2011","Southampton 026C","E01017259","Total",1451,732,719,1451,0,10,22.37,64.9
"2011","Southampton 026D","E01017260","Total",1382,668,714,1382,0,6,27.03,51.1
"2011","Southampton 026E","E01017262","Total",1335,657,678,1335,0,7,40.61,32.9
"2011","Southampton 027A","E01017167","Total",1527,733,794,1527,0,2,22.47,68.0
"2011","Southampton 027B","E01017168","Total",1695,838,857,1695,0,1,34.70,48.8
"2011","Southampton 027C","E01017169","Total",1554,702,852,1554,0,13,18.86,82.4
"2011","Southampton 027D","E01017170","Total",1572,759,813,1572,0,10,28.74,54.7
"2011","Southampton 028A","E01017218","Total",1353,677,676,1353,0,6,21.78,62.1
"2011","Southampton 028B","E01017219","Total",1729,861,868,1708,21,6,46.00,37.6
"2011","Southampton 028C","E01017220","Total",1843,911,932,1830,13,6,24.95,73.9
"2011","Southampton 028D","E01017221","Total",1624,801,823,1624,0,7,17.96,90.4
"2011","Southampton 028E","E01017222","Total",1527,763,764,1526,1,3,20.75,73.6
"2011","Southampton 029A","E01017139","Total",2406,1260,1146,1859,547,32,41.79,57.6
"2011","Southampton 029C","E01017142","Total",2367,1351,1016,1733,634,33,37.29,63.5
"2011","Southampton 029E","E01032745","Total",2298,1221,1077,1268,1030,41,15.62,147.1
"2011","Southampton 029F","E01032746","Total",1165,675,490,1165,0,7,5.66,205.8
"2011","Southampton 029G","E01032748","Total",1080,633,447,1080,0,4,89.17,12.1
"2011","Southampton 029H","E01032751","Total",1181,663,518,1159,22,10,11.46,103.1
"2011","Southampton 029I","E01032755","Total",1101,617,484,1101,0,7,10.97,100.4
"2011","Southampton 030A","E01017255","Total",1594,802,792,1594,0,9,32.03,49.8
"2011","Southampton 030B","E01017258","Total",1558,790,768,1558,0,10,20.84,74.8
"2011","Southampton 030C","E01017261","Total",1715,838,877,1691,24,16,49.11,34.9
"2011","Southampton 030D","E01017263","Total",1429,706,723,1429,0,6,36.47,39.2
"2011","Southampton 031A","E01017273","Total",1435,665,770,1341,94,5,22.37,64.1
"2011","Southampton 031B","E01017275","Total",1643,787,856,1626,17,6,52.99,31.0
"2011","Southampton 031C","E01017276","Total",1718,883,835,1713,5,11,27.31,62.9
"2011","Southampton 031D","E01017278","Total",1335,663,672,1335,0,4,35.23,37.9
"2011","Southampton 031E","E01017279","Total",1691,800,891,1622,69,8,36.99,45.7
"2011","Southampton 032A","E01017274","Total",1490,702,788,1490,0,8,33.96,43.9
"2011","Southampton 032B","E01017277","Total",1502,715,787,1485,17,8,28.38,52.9
"2011","Southampton 032C","E01017280","Total",1394,661,733,1394,0,0,21.03,66.3
"2011","Southampton 032D","E01017281","Total",1644,835,809,1644,0,6,32.17,51.1
"2011","West Berkshire 001A","E01016277","Total",1576,834,742,1345,231,54,1690.47,0.9
"2011","West Berkshire 001B","E01016286","Total",1571,816,755,1557,14,34,1502.19,1.0
"2011","West Berkshire 001C","E01016287","Total",1464,714,750,1452,12,61,5364.46,0.3
"2011","West Berkshire 001D","E01016288","Total",1651,806,845,1640,11,48,3607.25,0.5
"2011","West Berkshire 002A","E01016303","Total",1472,719,753,1468,4,36,3139.30,0.5
"2011","West Berkshire 002B","E01016304","Total",1544,770,774,1536,8,29,3453.93,0.4
"2011","West Berkshire 002C","E01016305","Total",1245,606,639,1217,28,40,2491.99,0.5
"2011","West Berkshire 002D","E01016306","Total",1314,679,635,1307,7,16,97.70,13.4
"2011","West Berkshire 003A","E01016256","Total",1747,903,844,1747,0,63,1366.61,1.3
"2011","West Berkshire 003B","E01016257","Total",1356,649,707,1328,28,64,2220.30,0.6
"2011","West Berkshire 003C","E01016313","Total",1611,759,852,1611,0,23,91.61,17.6
"2011","West Berkshire 003D","E01016314","Total",1367,696,671,1167,200,55,587.64,2.3
"2011","West Berkshire 004A","E01016315","Total",1581,784,797,1581,0,46,775.57,2.0
"2011","West Berkshire 004B","E01016316","Total",1998,975,1023,1998,0,40,351.12,5.7
"2011","West Berkshire 004C","E01016317","Total",1426,702,724,1368,58,44,53.93,26.4
"2011","West Berkshire 004D","E01016318","Total",1543,756,787,1543,0,28,30.02,51.4
"2011","West Berkshire 005A","E01016258","Total",1542,781,761,1530,12,33,108.12,14.3
"2011","West Berkshire 005B","E01016261","Total",1647,803,844,1647,0,56,82.40,20.0
"2011","West Berkshire 005C","E01016349","Total",1230,625,605,1230,0,17,34.78,35.4
"2011","West Berkshire 005D","E01016350","Total",1526,755,771,1526,0,17,27.74,55.0
"2011","West Berkshire 006A","E01016259","Total",1550,768,782,1550,0,25,95.35,16.3
"2011","West Berkshire 006B","E01016260","Total",1710,857,853,1710,0,33,42.65,40.1
"2011","West Berkshire 006C","E01016262","Total",1340,651,689,1340,0,13,25.31,52.9
"2011","West Berkshire 006D","E01016272","Total",1543,768,775,1543,0,44,122.16,12.6
"2011","West Berkshire 006E","E01016273","Total",1514,710,804,1514,0,15,33.04,45.8
"2011","West Berkshire 007A","E01016263","Total",2258,1126,1132,2251,7,49,1126.82,2.0
"2011","West Berkshire 007B","E01016278","Total",1314,722,592,1185,129,28,396.28,3.3
"2011","West Berkshire 007C","E01016283","Total",2017,756,1261,1491,526,62,584.83,3.4
"2011","West Berkshire 007D","E01016284","Total",1441,702,739,1401,40,36,189.04,7.6
"2011","West Berkshire 007E","E01016285","Total",1593,814,779,1592,1,34,3391.34,0.5
"2011","West Berkshire 008A","E01016271","Total",1401,685,716,1401,0,17,25.01,56.0
"2011","West Berkshire 008B","E01016274","Total",1386,701,685,1375,11,25,44.39,31.2
"2011","West Berkshire 008C","E01016275","Total",1470,711,759,1470,0,12,33.97,43.3
"2011","West Berkshire 008D","E01016276","Total",1471,728,743,1471,0,28,65.28,22.5
"2011","West Berkshire 009A","E01016327","Total",1196,602,594,1196,0,35,772.52,1.5
"2011","West Berkshire 009B","E01016328","Total",1757,844,913,1757,0,23,1634.27,1.1
"2011","West Berkshire 009C","E01016344","Total",1488,715,773,1488,0,18,161.70,9.2
"2011","West Berkshire 009D","E01016345","Total",1347,675,672,1336,11,10,202.12,6.7
"2011","West Berkshire 010A","E01016296","Total",1565,735,830,1565,0,17,39.66,39.5
"2011","West Berkshire 010B","E01016297","Total",1546,751,795,1533,13,28,332.38,4.7
"2011","West Berkshire 010C","E01016298","Total",1174,567,607,1106,68,17,2286.72,0.5
"2011","West Berkshire 010D","E01016299","Total",1482,743,739,1465,17,18,93.54,15.8
"2011","West Berkshire 011A","E01016254","Total",1341,655,686,1340,1,21,1518.36,0.9
"2011","West Berkshire 011B","E01016255","Total",1510,811,699,1432,78,43,1895.59,0.8
"2011","West Berkshire 011C","E01016264","Total",1618,902,716,1018,600,62,2031.16,0.8
"2011","West Berkshire 011D","E01016265","Total",1479,733,746,1456,23,55,1634.33,0.9
"2011","West Berkshire 011E","E01016266","Total",1375,693,682,1364,11,57,666.93,2.1
"2011","West Berkshire 011F","E01016339","Total",2913,1506,1407,2804,109,37,1078.69,2.7
"2011","West Berkshire 012A","E01016310","Total",1804,834,970,1797,7,23,54.29,33.2
"2011","West Berkshire 012B","E01016311","Total",1610,807,803,1610,0,43,66.09,24.4
"2011","West Berkshire 012C","E01016323","Total",1381,658,723,1345,36,29,278.69,5.0
"2011","West Berkshire 012D","E01016324","Total",1392,688,704,1390,2,20,713.56,2.0
"2011","West Berkshire 012E","E01016325","Total",1538,764,774,1538,0,15,28.87,53.3
"2011","West Berkshire 013A","E01016279","Total",2099,1056,1043,2090,9,6,38.03,55.2
"2011","West Berkshire 013B","E01016280","Total",1831,910,921,1759,72,18,53.68,34.1
"2011","West Berkshire 013C","E01016281","Total",1422,731,691,1422,0,14,33.99,41.8
"2011","West Berkshire 013D","E01016282","Total",1475,738,737,1475,0,20,38.64,38.2
"2011","West Berkshire 014A","E01016329","Total",1461,730,731,1461,0,21,28.23,51.8
"2011","West Berkshire 014B","E01016340","Total",1573,789,784,1573,0,13,62.13,25.3
"2011","West Berkshire 014C","E01016341","Total",1402,712,690,1399,3,16,57.71,24.3
"2011","West Berkshire 014D","E01016342","Total",1967,1014,953,1967,0,29,160.40,12.3
"2011","West Berkshire 014E","E01016343","Total",1448,725,723,1448,0,20,27.17,53.3
"2011","West Berkshire 015A","E01016267","Total",1424,709,715,1424,0,40,50.80,28.0
"2011","West Berkshire 015B","E01016268","Total",1594,790,804,1588,6,16,37.32,42.7
"2011","West Berkshire 015C","E01016269","Total",1407,709,698,1397,10,36,1511.25,0.9
"2011","West Berkshire 015D","E01016270","Total",1530,745,785,1474,56,27,111.57,13.7
"2011","West Berkshire 016A","E01016330","Total",1420,693,727,1420,0,12,22.47,63.2
"2011","West Berkshire 016B","E01016331","Total",1601,776,825,1601,0,21,24.69,64.8
"2011","West Berkshire 016C","E01016332","Total",1551,753,798,1533,18,7,41.50,37.4
"2011","West Berkshire 016D","E01016334","Total",1735,871,864,1675,60,29,26.02,66.7
"2011","West Berkshire 016E","E01016336","Total",1278,629,649,1272,6,11,18.36,69.6
"2011","West Berkshire 017A","E01016333","Total",1297,637,660,1297,0,33,399.18,3.2
"2011","West Berkshire 017B","E01016335","Total",1560,799,761,1560,0,25,29.67,52.6
"2011","West Berkshire 017C","E01016337","Total",2179,1101,1078,2179,0,20,158.05,13.8
"2011","West Berkshire 017D","E01016338","Total",1882,948,934,1882,0,63,43.26,43.5
"2011","West Berkshire 018A","E01016300","Total",1461,717,744,1442,19,40,181.00,8.1
"2011","West Berkshire 018B","E01016301","Total",1930,979,951,1902,28,93,8018.64,0.2
"2011","West Berkshire 018C","E01016302","Total",1643,834,809,1643,0,30,1759.77,0.9
"2011","West Berkshire 018D","E01016326","Total",1351,639,712,1299,52,52,3319.04,0.4
"2011","West Berkshire 019A","E01016293","Total",2684,1312,1372,2681,3,34,1065.51,2.5
"2011","West Berkshire 019B","E01016346","Total",1334,666,668,1282,52,12,84.46,15.8
"2011","West Berkshire 019C","E01016347","Total",1494,756,738,1493,1,13,60.56,24.7
"2011","West Berkshire 019D","E01016348","Total",2024,1022,1002,2012,12,17,47.11,43.0
"2011","West Berkshire 020A","E01016294","Total",1493,756,737,1493,0,27,38.23,39.1
"2011","West Berkshire 020B","E01016295","Total",1505,733,772,1505,0,15,42.59,35.3
"2011","West Berkshire 020C","E01016312","Total",1940,965,975,1940,0,24,33.20,58.4
"2011","West Berkshire 020D","E01016319","Total",1647,756,891,1588,59,28,37.54,43.9
"2011","West Berkshire 020E","E01016320","Total",1380,696,684,1380,0,32,30.93,44.6
"2011","West Berkshire 021A","E01016289","Total",1427,688,739,1427,0,45,120.57,11.8
"2011","West Berkshire 021B","E01016290","Total",1549,769,780,1549,0,38,50.37,30.8
"2011","West Berkshire 021C","E01016291","Total",1783,879,904,1783,0,43,56.30,31.7
"2011","West Berkshire 021D","E01016292","Total",1602,797,805,1602,0,32,38.05,42.1
"2011","West Berkshire 021E","E01016321","Total",1483,758,725,1431,52,23,32.64,45.4
"2011","West Berkshire 021F","E01016322","Total",1289,649,640,1289,0,35,58.19,22.2
"2011","West Berkshire 022A","E01016307","Total",1591,771,820,1591,0,21,79.98,19.9
"2011","West Berkshire 022B","E01016308","Total",1888,942,946,1886,2,47,1334.50,1.4
"2011","West Berkshire 022C","E01016309","Total",2253,1158,1095,2132,121,42,2211.45,1.0
"2011","Windsor and Maidenhead 001A","E01016570","Total",1595,753,842,1595,0,45,33.87,47.1
"2011","Windsor and Maidenhead 001B","E01016572","Total",1345,629,716,1345,0,28,36.99,36.4
"2011","Windsor and Maidenhead 001C","E01016582","Total",1475,749,726,1475,0,19,112.50,13.1
"2011","Windsor and Maidenhead 001D","E01016600","Total",1175,558,617,1145,30,46,225.66,5.2
"2011","Windsor and Maidenhead 002A","E01016530","Total",1494,720,774,1471,23,10,345.49,4.3
"2011","Windsor and Maidenhead 002B","E01016531","Total",1441,723,718,1409,32,51,1073.58,1.3
"2011","Windsor and Maidenhead 002C","E01016532","Total",2015,992,1023,1948,67,46,490.13,4.1
"2011","Windsor and Maidenhead 002D","E01016533","Total",1928,932,996,1928,0,67,418.48,4.6
"2011","Windsor and Maidenhead 002E","E01016578","Total",1474,734,740,1438,36,56,1578.11,0.9
"2011","Windsor and Maidenhead 002F","E01016579","Total",1697,848,849,1676,21,55,1563.23,1.1
"2011","Windsor and Maidenhead 002G","E01016581","Total",1441,711,730,1441,0,41,1593.14,0.9
"2011","Windsor and Maidenhead 003A","E01016571","Total",1554,785,769,1550,4,44,45.46,34.2
"2011","Windsor and Maidenhead 003B","E01016573","Total",1400,673,727,1391,9,15,18.17,77.1
"2011","Windsor and Maidenhead 003C","E01016574","Total",1499,717,782,1499,0,19,27.73,54.1
"2011","Windsor and Maidenhead 003D","E01016599","Total",1614,813,801,1606,8,12,24.42,66.1
"2011","Windsor and Maidenhead 004A","E01016583","Total",1589,792,797,1589,0,38,59.38,26.8
"2011","Windsor and Maidenhead 004B","E01016585","Total",1620,826,794,1575,45,28,43.46,37.3
"2011","Windsor and Maidenhead 004C","E01016586","Total",1354,657,697,1313,41,55,156.64,8.6
"2011","Windsor and Maidenhead 004D","E01016591","Total",1704,868,836,1703,1,57,98.23,17.3
"2011","Windsor and Maidenhead 004E","E01016592","Total",1849,876,973,1755,94,35,168.75,11.0
"2011","Windsor and Maidenhead 005A","E01016525","Total",1603,781,822,1601,2,46,40.79,39.3
"2011","Windsor and Maidenhead 005B","E01016528","Total",1621,807,814,1621,0,26,37.53,43.2
"2011","Windsor and Maidenhead 005C","E01016529","Total",1638,806,832,1627,11,12,27.40,59.8
"2011","Windsor and Maidenhead 005D","E01016536","Total",1855,931,924,1828,27,18,38.21,48.5
"2011","Windsor and Maidenhead 005E","E01016584","Total",1675,822,853,1672,3,19,31.29,53.5
"2011","Windsor and Maidenhead 005G","E01032733","Total",1026,495,531,1026,0,1,30.76,33.4
"2011","Windsor and Maidenhead 005H","E01032734","Total",1435,743,692,1435,0,19,49.34,29.1
"2011","Windsor and Maidenhead 006A","E01016526","Total",1852,896,956,1851,1,35,33.86,54.7
"2011","Windsor and Maidenhead 006B","E01016527","Total",1601,775,826,1543,58,27,25.63,62.5
"2011","Windsor and Maidenhead 006C","E01016534","Total",1530,741,789,1524,6,68,69.35,22.1
"2011","Windsor and Maidenhead 006D","E01016598","Total",1410,665,745,1336,74,40,39.59,35.6
"2011","Windsor and Maidenhead 006E","E01016601","Total",1620,773,847,1620,0,34,38.81,41.7
"2011","Windsor and Maidenhead 006F","E01016602","Total",1573,740,833,1573,0,49,145.32,10.8
"2011","Windsor and Maidenhead 007A","E01016535","Total",1273,617,656,1273,0,18,20.85,61.1
"2011","Windsor and Maidenhead 007B","E01016537","Total",1529,772,757,1529,0,18,24.61,62.1
"2011","Windsor and Maidenhead 007C","E01016538","Total",1611,818,793,1611,0,32,24.21,66.5
"2011","Windsor and Maidenhead 007D","E01016593","Total",1675,826,849,1675,0,11,29.79,56.2
"2011","Windsor and Maidenhead 007E","E01016594","Total",1452,714,738,1452,0,15,68.05,21.3
"2011","Windsor and Maidenhead 008A","E01016559","Total",1477,749,728,1477,0,38,30.18,48.9
"2011","Windsor and Maidenhead 008B","E01016560","Total",1518,753,765,1518,0,13,28.48,53.3
"2011","Windsor and Maidenhead 008C","E01016561","Total",1784,877,907,1784,0,30,99.48,17.9
"2011","Windsor and Maidenhead 008D","E01016562","Total",1384,673,711,1384,0,36,183.40,7.5
"2011","Windsor and Maidenhead 008E","E01016563","Total",1342,659,683,1342,0,22,158.70,8.5
"2011","Windsor and Maidenhead 008F","E01016580","Total",1517,714,803,1517,0,9,29.96,50.6
"2011","Windsor and Maidenhead 009A","E01016539","Total",1589,807,782,1557,32,38,218.34,7.3
"2011","Windsor and Maidenhead 009B","E01016540","Total",1665,802,863,1616,49,51,687.95,2.4
"2011","Windsor and Maidenhead 009C","E01016541","Total",1384,693,691,1384,0,29,32.75,42.3
"2011","Windsor and Maidenhead 009D","E01016542","Total",1202,593,609,1202,0,14,82.83,14.5
"2011","Windsor and Maidenhead 009E","E01016543","Total",1643,822,821,1582,61,36,1555.10,1.1
"2011","Windsor and Maidenhead 010A","E01016544","Total",1705,952,753,1528,177,23,48.91,34.9
"2011","Windsor and Maidenhead 010B","E01016567","Total",2748,1848,900,1712,1036,56,588.12,4.7
"2011","Windsor and Maidenhead 010C","E01016568","Total",1240,597,643,1240,0,16,25.07,49.5
"2011","Windsor and Maidenhead 010D","E01016569","Total",1020,498,522,1020,0,10,160.47,6.4
"2011","Windsor and Maidenhead 011A","E01016564","Total",1628,804,824,1628,0,25,242.93,6.7
"2011","Windsor and Maidenhead 011B","E01016565","Total",1563,766,797,1538,25,49,149.96,10.4
"2011","Windsor and Maidenhead 011C","E01016566","Total",1722,857,865,1714,8,23,191.77,9.0
"2011","Windsor and Maidenhead 011D","E01016577","Total",1683,815,868,1676,7,20,518.51,3.2
"2011","Windsor and Maidenhead 012A","E01016545","Total",1938,900,1038,1925,13,21,35.16,55.1
"2011","Windsor and Maidenhead 012B","E01016547","Total",1688,844,844,1688,0,25,46.21,36.5
"2011","Windsor and Maidenhead 012C","E01016550","Total",1526,877,649,1271,255,16,29.11,52.4
"2011","Windsor and Maidenhead 012D","E01016552","Total",1606,803,803,1606,0,25,128.90,12.5
"2011","Windsor and Maidenhead 013A","E01016551","Total",1577,766,811,1577,0,26,68.19,23.1
"2011","Windsor and Maidenhead 013B","E01016553","Total",1470,722,748,1467,3,19,67.34,21.8
"2011","Windsor and Maidenhead 013C","E01016557","Total",1871,903,968,1871,0,20,31.43,59.5
"2011","Windsor and Maidenhead 013D","E01016558","Total",1696,825,871,1696,0,16,31.42,54.0
"2011","Windsor and Maidenhead 014A","E01016548","Total",1912,937,975,1912,0,40,46.19,41.4
"2011","Windsor and Maidenhead 014B","E01016549","Total",2012,922,1090,1925,87,23,34.98,57.5
"2011","Windsor and Maidenhead 014C","E01016554","Total",1620,779,841,1547,73,18,34.91,46.4
"2011","Windsor and Maidenhead 014D","E01016555","Total",1455,732,723,1455,0,22,24.48,59.4
"2011","Windsor and Maidenhead 014E","E01016556","Total",1774,874,900,1774,0,23,33.58,52.8
"2011","Windsor and Maidenhead 015A","E01016546","Total",1621,788,833,1607,14,34,26.50,61.2
"2011","Windsor and Maidenhead 015B","E01016595","Total",1720,815,905,1716,4,24,596.51,2.9
"2011","Windsor and Maidenhead 015C","E01016596","Total",1793,881,912,1793,0,43,201.48,8.9
"2011","Windsor and Maidenhead 015D","E01016597","Total",1777,873,904,1777,0,78,84.08,21.1
"2011","Windsor and Maidenhead 016A","E01016575","Total",1666,839,827,1666,0,29,153.69,10.8
"2011","Windsor and Maidenhead 016B","E01016576","Total",1714,872,842,1714,0,34,388.20,4.4
"2011","Windsor and Maidenhead 016C","E01016587","Total",1587,766,821,1574,13,29,36.75,43.2
"2011","Windsor and Maidenhead 016D","E01016588","Total",1770,862,908,1752,18,31,1475.80,1.2
"2011","Windsor and Maidenhead 016E","E01016589","Total",1620,790,830,1564,56,48,223.50,7.2
"2011","Windsor and Maidenhead 017A","E01016522","Total",1957,962,995,1875,82,62,51.51,38.0
"2011","Windsor and Maidenhead 017B","E01016523","Total",1640,764,876,1416,224,59,395.86,4.1
"2011","Windsor and Maidenhead 017C","E01016524","Total",2105,1056,1049,1987,118,56,409.64,5.1
"2011","Windsor and Maidenhead 017D","E01016609","Total",1814,862,952,1814,0,21,79.90,22.7
"2011","Windsor and Maidenhead 018A","E01016603","Total",1801,864,937,1730,71,49,162.70,11.1
"2011","Windsor and Maidenhead 018B","E01016604","Total",2015,983,1032,1871,144,85,268.83,7.5
"2011","Windsor and Maidenhead 018C","E01016605","Total",1531,743,788,1530,1,29,230.96,6.6
"2011","Windsor and Maidenhead 018D","E01016606","Total",1639,805,834,1639,0,47,65.57,25.0
"2011","Windsor and Maidenhead 018E","E01016607","Total",1765,687,1078,1438,327,98,151.69,11.6
"2011","Windsor and Maidenhead 018F","E01016608","Total",1824,875,949,1820,4,48,114.17,16.0
"2011","Wokingham 001A","E01016675","Total",1032,502,530,1021,11,45,1463.28,0.7
"2011","Wokingham 001B","E01016676","Total",1537,742,795,1505,32,72,139.14,11.0
"2011","Wokingham 001C","E01016677","Total",1488,735,753,1437,51,39,526.51,2.8
"2011","Wokingham 001D","E01016678","Total",1364,689,675,1325,39,30,882.70,1.5
"2011","Wokingham 002A","E01016619","Total",1561,794,767,1555,6,38,284.71,5.5
"2011","Wokingham 002B","E01016620","Total",1481,728,753,1481,0,39,69.49,21.3
"2011","Wokingham 002C","E01016692","Total",1436,699,737,1436,0,11,51.79,27.7
"2011","Wokingham 002D","E01016693","Total",1352,665,687,1352,0,19,33.21,40.7
"2011","Wokingham 002E","E01016694","Total",1454,680,774,1421,33,22,132.04,11.0
"2011","Wokingham 002F","E01016695","Total",1549,768,781,1541,8,34,46.42,33.4
"2011","Wokingham 003A","E01016621","Total",1478,731,747,1478,0,28,31.87,46.4
"2011","Wokingham 003B","E01016623","Total",1489,710,779,1489,0,23,43.11,34.5
"2011","Wokingham 003C","E01016624","Total",1438,705,733,1438,0,27,32.82,43.8
"2011","Wokingham 003D","E01016684","Total",1598,812,786,1598,0,38,40.37,39.6
"2011","Wokingham 003E","E01016685","Total",1631,797,834,1533,98,44,475.51,3.4
"2011","Wokingham 004A","E01016622","Total",1249,617,632,1249,0,37,84.73,14.7
"2011","Wokingham 004B","E01016657","Total",1483,721,762,1483,0,25,326.72,4.5
"2011","Wokingham 004C","E01016658","Total",1338,687,651,1338,0,37,85.28,15.7
"2011","Wokingham 004D","E01016659","Total",1410,661,749,1410,0,19,23.32,60.5
"2011","Wokingham 004E","E01016660","Total",1627,813,814,1627,0,31,65.72,24.8
"2011","Wokingham 005A","E01016615","Total",1519,750,769,1519,0,14,58.29,26.1
"2011","Wokingham 005B","E01016616","Total",1489,749,740,1489,0,17,37.99,39.2
"2011","Wokingham 005C","E01016617","Total",1242,606,636,1210,32,23,50.13,24.8
"2011","Wokingham 005D","E01016662","Total",1724,858,866,1724,0,4,28.23,61.1
"2011","Wokingham 006A","E01016613","Total",1534,757,777,1534,0,40,132.69,11.6
"2011","Wokingham 006B","E01016614","Total",1385,711,674,1385,0,44,39.87,34.7
"2011","Wokingham 006C","E01016618","Total",1283,628,655,1283,0,25,35.27,36.4
"2011","Wokingham 006D","E01016664","Total",1274,609,665,1274,0,37,32.76,38.9
"2011","Wokingham 006E","E01016668","Total",1587,817,770,1587,0,38,42.65,37.2
"2011","Wokingham 006F","E01016669","Total",1827,919,908,1827,0,25,43.01,42.5
"2011","Wokingham 007A","E01016661","Total",1370,682,688,1370,0,19,56.26,24.4
"2011","Wokingham 007B","E01016663","Total",1537,763,774,1537,0,11,36.57,42.0
"2011","Wokingham 007C","E01016686","Total",1139,561,578,1139,0,7,33.14,34.4
"2011","Wokingham 007D","E01016687","Total",1279,619,660,1276,3,14,21.39,59.8
"2011","Wokingham 007E","E01016688","Total",1588,814,774,1177,411,37,73.22,21.7
"2011","Wokingham 007F","E01016689","Total",1418,722,696,1412,6,24,30.49,46.5
"2011","Wokingham 008B","E01016652","Total",1276,630,646,1276,0,29,21.07,60.6
"2011","Wokingham 008C","E01016653","Total",1494,772,722,1251,243,50,40.01,37.3
"2011","Wokingham 008D","E01016665","Total",1592,789,803,1592,0,22,39.90,39.9
"2011","Wokingham 008E","E01016666","Total",1383,698,685,1383,0,28,24.86,55.6
"2011","Wokingham 008G","E01032761","Total",2743,1371,1372,2570,173,79,170.19,16.1
"2011","Wokingham 009A","E01016647","Total",1921,958,963,1834,87,49,110.07,17.5
"2011","Wokingham 009B","E01016701","Total",1746,839,907,1738,8,54,97.72,17.9
"2011","Wokingham 009C","E01016702","Total",1828,898,930,1825,3,37,126.83,14.4
"2011","Wokingham 009D","E01016703","Total",1926,950,976,1827,99,25,164.60,11.7
"2011","Wokingham 009E","E01016704","Total",2017,970,1047,2013,4,21,41.27,48.9
"2011","Wokingham 010A","E01016627","Total",1845,963,882,1845,0,40,81.48,22.6
"2011","Wokingham 010B","E01016628","Total",1534,774,760,1534,0,41,78.25,19.6
"2011","Wokingham 010C","E01016656","Total",1403,694,709,1403,0,38,1682.26,0.8
"2011","Wokingham 010D","E01016700","Total",1890,943,947,1886,4,44,186.73,10.1
"2011","Wokingham 011A","E01016644","Total",1465,733,732,1465,0,28,20.78,70.5
"2011","Wokingham 011B","E01016645","Total",1539,789,750,1539,0,16,24.82,62.0
"2011","Wokingham 011C","E01016646","Total",1586,800,786,1586,0,40,61.14,25.9
"2011","Wokingham 011D","E01016648","Total",1434,723,711,1433,1,21,23.29,61.6
"2011","Wokingham 011E","E01016649","Total",1440,725,715,1440,0,29,34.63,41.6
"2011","Wokingham 012A","E01016651","Total",1406,680,726,1406,0,35,30.36,46.3
"2011","Wokingham 012B","E01016654","Total",1397,672,725,1397,0,32,38.89,35.9
"2011","Wokingham 012C","E01016655","Total",1302,646,656,1302,0,39,26.94,48.3
"2011","Wokingham 012D","E01016679","Total",2195,1090,1105,2176,19,30,90.45,24.3
"2011","Wokingham 012E","E01016680","Total",1295,647,648,1288,7,11,34.90,37.1
"2011","Wokingham 012G","E01032758","Total",1593,778,815,1581,12,13,91.86,17.3
"2011","Wokingham 012H","E01032759","Total",1450,716,734,1443,7,14,415.57,3.5
"2011","Wokingham 013A","E01016626","Total",1629,786,843,1622,7,17,51.67,31.5
"2011","Wokingham 013B","E01016671","Total",1700,757,943,1598,102,26,89.98,18.9
"2011","Wokingham 013C","E01016673","Total",1724,816,908,1724,0,22,38.56,44.7
"2011","Wokingham 013D","E01016674","Total",1410,685,725,1410,0,21,64.29,21.9
"2011","Wokingham 013E","E01016696","Total",1476,714,762,1438,38,10,39.84,37.0
"2011","Wokingham 014A","E01016670","Total",2058,1030,1028,2058,0,37,74.03,27.8
"2011","Wokingham 014B","E01016672","Total",1761,856,905,1758,3,35,68.42,25.7
"2011","Wokingham 014E","E01032763","Total",2281,1143,1138,2252,29,76,146.63,15.6
"2011","Wokingham 015A","E01016612","Total",2214,1064,1150,2214,0,75,474.06,4.7
"2011","Wokingham 015B","E01016629","Total",1372,641,731,1372,0,43,41.91,32.7
"2011","Wokingham 015C","E01016630","Total",1532,760,772,1532,0,55,58.39,26.2
"2011","Wokingham 015D","E01016635","Total",1394,709,685,1394,0,41,30.78,45.3
"2011","Wokingham 016A","E01016625","Total",1671,816,855,1613,58,41,62.73,26.6
"2011","Wokingham 016B","E01016631","Total",1359,649,710,1359,0,32,23.25,58.5
"2011","Wokingham 016C","E01016632","Total",1511,742,769,1511,0,35,88.47,17.1
"2011","Wokingham 016D","E01016634","Total",1533,743,790,1463,70,39,137.32,11.2
"2011","Wokingham 016E","E01016699","Total",1538,718,820,1462,76,33,172.55,8.9
"2011","Wokingham 017A","E01016682","Total",1859,937,922,1854,5,15,789.78,2.4
"2011","Wokingham 017B","E01016683","Total",1878,949,929,1851,27,33,337.34,5.6
"2011","Wokingham 017C","E01016690","Total",1774,882,892,1770,4,25,573.27,3.1
"2011","Wokingham 017D","E01016691","Total",1204,593,611,1167,37,40,908.30,1.3
"2011","Wokingham 018A","E01016610","Total",2860,1426,1434,2797,63,48,1116.10,2.6
"2011","Wokingham 018B","E01016611","Total",1389,798,591,1081,308,29,203.43,6.8
"2011","Wokingham 018C","E01016641","Total",1420,680,740,1365,55,37,801.20,1.8
"2011","Wokingham 018D","E01016642","Total",1155,574,581,1155,0,19,22.41,51.5
"2011","Wokingham 019A","E01016633","Total",1362,652,710,1362,0,46,80.37,16.9
"2011","Wokingham 019B","E01016636","Total",1464,741,723,1464,0,53,95.32,15.4
"2011","Wokingham 019C","E01016637","Total",1084,543,541,1084,0,50,160.22,6.8
"2011","Wokingham 019D","E01016638","Total",1320,653,667,1320,0,28,40.39,32.7
"2011","Wokingham 019E","E01016639","Total",1595,782,813,1595,0,44,59.05,27.0
"2011","Wokingham 019F","E01016640","Total",1552,775,777,1528,24,79,685.08,2.3
"2011","Wokingham 019G","E01016643","Total",1387,693,694,1387,0,40,41.95,33.1
"2011","Wokingham 020A","E01016705","Total",1567,899,668,1247,320,40,748.14,2.1
"2011","Wokingham 020B","E01016706","Total",1667,811,856,1667,0,60,54.80,30.4
"2011","Wokingham 020C","E01016707","Total",1612,801,811,1612,0,23,41.60,38.8
"2011","Wokingham 020D","E01016708","Total",1594,787,807,1577,17,63,76.48,20.8
"2011","Wokingham 020E","E01016709","Total",1584,790,794,1584,0,46,50.24,31.5
"2011","Aylesbury Vale 001A","E01017648","Total",1806,901,905,1806,0,50,324.64,5.6
"2011","Aylesbury Vale 001B","E01017649","Total",2100,1024,1076,1988,112,34,179.93,11.7
"2011","Aylesbury Vale 001C","E01017650","Total",1668,840,828,1668,0,39,274.92,6.1
"2011","Aylesbury Vale 001F","E01032960","Total",3049,1583,1466,2346,703,128,6258.55,0.5
"2011","Aylesbury Vale 002A","E01017644","Total",1501,728,773,1501,0,32,53.42,28.1
"2011","Aylesbury Vale 002B","E01017645","Total",1513,817,696,1200,313,42,33.37,45.3
"2011","Aylesbury Vale 002C","E01017646","Total",1830,875,955,1812,18,27,209.27,8.7
"2011","Aylesbury Vale 002D","E01017647","Total",1625,795,830,1625,0,32,50.64,32.1
"2011","Aylesbury Vale 003A","E01017671","Total",1591,792,799,1591,0,57,2517.67,0.6
"2011","Aylesbury Vale 003B","E01017672","Total",1483,770,713,1483,0,48,2109.81,0.7
"2011","Aylesbury Vale 003C","E01017695","Total",1194,572,622,1185,9,18,371.75,3.2
"2011","Aylesbury Vale 003D","E01017696","Total",1263,647,616,1263,0,31,1581.38,0.8
"2011","Aylesbury Vale 004A","E01017693","Total",1083,536,547,1083,0,29,1531.48,0.7
"2011","Aylesbury Vale 004B","E01017694","Total",2329,1145,1184,2306,23,51,3076.57,0.8
"2011","Aylesbury Vale 004C","E01017713","Total",1436,728,708,1436,0,12,102.14,14.1
"2011","Aylesbury Vale 004D","E01017714","Total",1333,670,663,1333,0,59,3281.20,0.4
"2011","Aylesbury Vale 004E","E01017717","Total",1698,852,846,1695,3,52,3610.71,0.5
"2011","Aylesbury Vale 004F","E01017718","Total",1577,763,814,1568,9,51,2926.33,0.5
"2011","Aylesbury Vale 005A","E01017735","Total",1318,630,688,1318,0,35,1819.46,0.7
"2011","Aylesbury Vale 005B","E01017736","Total",1526,756,770,1526,0,39,627.93,2.4
"2011","Aylesbury Vale 005C","E01017737","Total",1351,645,706,1351,0,35,40.98,33.0
"2011","Aylesbury Vale 005D","E01017738","Total",1530,731,799,1479,51,20,107.43,14.2
"2011","Aylesbury Vale 006A","E01017669","Total",1494,722,772,1477,17,40,1975.06,0.8
"2011","Aylesbury Vale 006B","E01017670","Total",1548,758,790,1548,0,39,2058.34,0.8
"2011","Aylesbury Vale 006C","E01017715","Total",1171,584,587,1120,51,38,2788.62,0.4
"2011","Aylesbury Vale 006D","E01017716","Total",1840,914,926,1826,14,56,1611.64,1.1
"2011","Aylesbury Vale 007A","E01017641","Total",1705,815,890,1672,33,32,1275.68,1.3
"2011","Aylesbury Vale 007B","E01017731","Total",1323,655,668,1323,0,19,331.21,4.0
"2011","Aylesbury Vale 007C","E01017732","Total",1422,692,730,1355,67,28,1631.53,0.9
"2011","Aylesbury Vale 007D","E01017733","Total",1197,569,628,1194,3,24,2153.23,0.6
"2011","Aylesbury Vale 007E","E01017734","Total",1394,718,676,1357,37,35,1406.49,1.0
"2011","Aylesbury Vale 008A","E01017703","Total",1292,611,681,1292,0,34,2201.25,0.6
"2011","Aylesbury Vale 008B","E01017704","Total",1259,621,638,1249,10,55,2072.86,0.6
"2011","Aylesbury Vale 008C","E01017719","Total",1199,578,621,1199,0,33,240.13,5.0
"2011","Aylesbury Vale 008D","E01017720","Total",1314,657,657,1311,3,42,4134.41,0.3
"2011","Aylesbury Vale 008F","E01032958","Total",1522,748,774,1522,0,44,1836.06,0.8
"2011","Aylesbury Vale 008G","E01032959","Total",1748,853,895,1748,0,30,403.88,4.3
"2011","Aylesbury Vale 009A","E01017651","Total",1557,757,800,1557,0,43,665.50,2.3
"2011","Aylesbury Vale 009B","E01017652","Total",1466,738,728,1462,4,30,1200.28,1.2
"2011","Aylesbury Vale 009C","E01017657","Total",1421,701,720,1421,0,38,931.17,1.5
"2011","Aylesbury Vale 009D","E01017658","Total",1426,712,714,1426,0,45,1097.91,1.3
"2011","Aylesbury Vale 009E","E01017701","Total",2207,1098,1109,2190,17,33,1583.75,1.4
"2011","Aylesbury Vale 009F","E01017702","Total",1467,730,737,1467,0,27,445.63,3.3
"2011","Aylesbury Vale 010A","E01017642","Total",1269,592,677,1269,0,33,2346.91,0.5
"2011","Aylesbury Vale 010B","E01017643","Total",1309,662,647,1287,22,28,2058.20,0.6
"2011","Aylesbury Vale 010C","E01017673","Total",1302,650,652,1300,2,41,2027.47,0.6
"2011","Aylesbury Vale 010D","E01017674","Total",1870,1192,678,1346,524,46,3240.98,0.6
"2011","Aylesbury Vale 011A","E01017659","Total",1608,782,826,1608,0,13,27.23,59.1
"2011","Aylesbury Vale 011B","E01017660","Total",1689,832,857,1642,47,12,60.66,27.8
"2011","Aylesbury Vale 011C","E01017661","Total",1565,772,793,1565,0,18,23.41,66.9
"2011","Aylesbury Vale 011D","E01017664","Total",1404,714,690,1404,0,21,80.75,17.4
"2011","Aylesbury Vale 012A","E01017705","Total",1175,587,588,1175,0,15,884.72,1.3
"2011","Aylesbury Vale 012B","E01017706","Total",1429,706,723,1364,65,17,25.72,55.6
"2011","Aylesbury Vale 012C","E01017707","Total",1310,622,688,1310,0,15,24.37,53.8
"2011","Aylesbury Vale 012D","E01017708","Total",1564,759,805,1564,0,11,55.64,28.1
"2011","Aylesbury Vale 013A","E01017665","Total",1597,786,811,1539,58,10,74.17,21.5
"2011","Aylesbury Vale 013B","E01017666","Total",1687,837,850,1618,69,11,31.17,54.1
"2011","Aylesbury Vale 013C","E01017667","Total",1369,678,691,1369,0,6,39.74,34.4
"2011","Aylesbury Vale 013D","E01017668","Total",1534,774,760,1534,0,17,28.60,53.6
"2011","Aylesbury Vale 014A","E01017697","Total",1426,711,715,1426,0,5,19.40,73.5
"2011","Aylesbury Vale 014B","E01017698","Total",1484,713,771,1468,16,22,43.12,34.4
"2011","Aylesbury Vale 014C","E01017699","Total",1439,885,554,1073,366,9,41.44,34.7
"2011","Aylesbury Vale 014D","E01017700","Total",1547,766,781,1547,0,25,45.44,34.0
"2011","Aylesbury Vale 015B","E01017634","Total",1549,798,751,1549,0,11,29.06,53.3
"2011","Aylesbury Vale 015C","E01017662","Total",1308,631,677,1296,12,13,29.95,43.7
"2011","Aylesbury Vale 015D","E01017663","Total",1594,834,760,1583,11,9,23.73,67.2
"2011","Aylesbury Vale 015E","E01032955","Total",1233,599,634,1211,22,14,30.56,40.3
"2011","Aylesbury Vale 015F","E01032961","Total",1039,528,511,1039,0,6,25.95,40.0
"2011","Aylesbury Vale 016A","E01017653","Total",1481,716,765,1481,0,18,21.98,67.4
"2011","Aylesbury Vale 016B","E01017654","Total",1432,739,693,1432,0,10,21.42,66.9
"2011","Aylesbury Vale 016C","E01017655","Total",1946,944,1002,1892,54,13,45.19,43.1
"2011","Aylesbury Vale 016E","E01032956","Total",1629,795,834,1629,0,10,29.46,55.3
"2011","Aylesbury Vale 016F","E01032957","Total",1356,690,666,1356,0,7,23.48,57.8
"2011","Aylesbury Vale 016G","E01032962","Total",1554,791,763,1554,0,7,22.50,69.1
"2011","Aylesbury Vale 017A","E01017635","Total",1439,739,700,1439,0,18,30.62,47.0
"2011","Aylesbury Vale 017B","E01017636","Total",1560,777,783,1560,0,17,34.01,45.9
"2011","Aylesbury Vale 017C","E01017637","Total",1335,646,689,1288,47,15,57.17,23.4
"2011","Aylesbury Vale 017D","E01017638","Total",1306,653,653,1306,0,30,45.44,28.7
"2011","Aylesbury Vale 017E","E01017639","Total",1594,796,798,1594,0,54,51.95,30.7
"2011","Aylesbury Vale 017F","E01017640","Total",1570,758,812,1570,0,43,36.07,43.5
"2011","Aylesbury Vale 018A","E01017709","Total",1687,798,889,1675,12,22,30.43,55.4
"2011","Aylesbury Vale 018B","E01017710","Total",1551,758,793,1551,0,14,33.52,46.3
"2011","Aylesbury Vale 018C","E01017711","Total",1573,789,784,1566,7,25,44.12,35.7
"2011","Aylesbury Vale 018D","E01017712","Total",2101,1057,1044,2101,0,7,35.71,58.8
"2011","Aylesbury Vale 019A","E01017687","Total",2030,1044,986,1996,34,25,37.89,53.6
"2011","Aylesbury Vale 019B","E01017688","Total",1232,598,634,1232,0,15,20.59,59.8
"2011","Aylesbury Vale 019C","E01017689","Total",1389,698,691,1389,0,18,27.92,49.7
"2011","Aylesbury Vale 019D","E01017690","Total",1148,558,590,1148,0,11,40.57,28.3
"2011","Aylesbury Vale 019E","E01017691","Total",1370,658,712,1342,28,33,38.73,35.4
"2011","Aylesbury Vale 019F","E01017692","Total",1557,796,761,1537,20,17,24.91,62.5
"2011","Aylesbury Vale 020A","E01017721","Total",1575,731,844,1575,0,10,32.18,48.9
"2011","Aylesbury Vale 020B","E01017722","Total",1510,758,752,1510,0,10,21.53,70.1
"2011","Aylesbury Vale 020C","E01017723","Total",1372,662,710,1372,0,16,22.89,59.9
"2011","Aylesbury Vale 020D","E01017724","Total",1425,707,718,1425,0,14,21.99,64.8
"2011","Aylesbury Vale 021A","E01017627","Total",1599,778,821,1594,5,31,629.81,2.5
"2011","Aylesbury Vale 021B","E01017628","Total",1756,823,933,1594,162,47,296.56,5.9
"2011","Aylesbury Vale 021C","E01017629","Total",1595,779,816,1595,0,42,986.01,1.6
"2011","Aylesbury Vale 021D","E01017630","Total",1544,753,791,1539,5,44,260.20,5.9
"2011","Aylesbury Vale 021E","E01017631","Total",1586,791,795,1586,0,32,503.17,3.2
"2011","Aylesbury Vale 021F","E01017632","Total",1561,752,809,1555,6,34,842.21,1.9
"2011","Aylesbury Vale 022A","E01017675","Total",1431,706,725,1431,0,34,240.75,5.9
"2011","Aylesbury Vale 022B","E01017676","Total",1428,669,759,1412,16,45,2815.91,0.5
"2011","Aylesbury Vale 022C","E01017677","Total",1342,637,705,1342,0,37,193.97,6.9
"2011","Aylesbury Vale 022D","E01017678","Total",1297,619,678,1270,27,40,1201.95,1.1
"2011","Aylesbury Vale 022E","E01017679","Total",1615,784,831,1559,56,31,517.08,3.1
"2011","Aylesbury Vale 022F","E01017680","Total",992,495,497,992,0,8,116.95,8.5
"2011","Aylesbury Vale 023A","E01017681","Total",1232,605,627,1230,2,26,1129.46,1.1
"2011","Aylesbury Vale 023B","E01017682","Total",1219,602,617,1219,0,32,221.67,5.5
"2011","Aylesbury Vale 023C","E01017683","Total",1700,844,856,1700,0,44,1686.23,1.0
"2011","Aylesbury Vale 023D","E01017684","Total",1108,508,600,1108,0,27,905.02,1.2
"2011","Aylesbury Vale 024A","E01017726","Total",1140,531,609,1069,71,27,1318.02,0.9
"2011","Aylesbury Vale 024B","E01017727","Total",1700,808,892,1638,62,32,281.55,6.0
"2011","Aylesbury Vale 024C","E01017728","Total",2237,1103,1134,2081,156,69,646.61,3.5
"2011","Aylesbury Vale 024D","E01017729","Total",1696,823,873,1691,5,35,87.43,19.4
"2011","Aylesbury Vale 024E","E01017730","Total",1561,734,827,1561,0,16,89.92,17.4
"2011","Chiltern 001A","E01017750","Total",2203,1109,1094,2201,2,83,2495.61,0.9
"2011","Chiltern 001B","E01017752","Total",2203,1108,1095,2203,0,85,1569.03,1.4
"2011","Chiltern 001C","E01017766","Total",2304,1145,1159,2304,0,87,2495.18,0.9
"2011","Chiltern 001D","E01017778","Total",1305,632,673,1261,44,38,596.48,2.2
"2011","Chiltern 002A","E01017747","Total",1409,714,695,1399,10,32,38.69,36.4
"2011","Chiltern 002B","E01017748","Total",1805,883,922,1805,0,18,35.70,50.6
"2011","Chiltern 002C","E01017749","Total",1636,817,819,1636,0,35,111.46,14.7
"2011","Chiltern 002D","E01017789","Total",1222,599,623,1222,0,18,34.31,35.6
"2011","Chiltern 002E","E01017790","Total",1382,695,687,1382,0,9,22.56,61.3
"2011","Chiltern 002F","E01017795","Total",2139,1067,1072,2132,7,32,121.03,17.7
"2011","Chiltern 003A","E01017769","Total",1584,803,781,1561,23,41,120.76,13.1
"2011","Chiltern 003B","E01017771","Total",1460,708,752,1439,21,32,121.85,12.0
"2011","Chiltern 003C","E01017780","Total",1262,620,642,1262,0,38,123.79,10.2
"2011","Chiltern 003D","E01017781","Total",1212,587,625,1212,0,5,13.59,89.2
"2011","Chiltern 004A","E01017770","Total",1497,771,726,1497,0,9,35.21,42.5
"2011","Chiltern 004B","E01017791","Total",1491,729,762,1446,45,15,66.57,22.4
"2011","Chiltern 004C","E01017792","Total",1863,878,985,1847,16,19,282.22,6.6
"2011","Chiltern 004D","E01017793","Total",1521,729,792,1521,0,14,289.80,5.2
"2011","Chiltern 005A","E01017768","Total",2312,1088,1224,2223,89,72,966.06,2.4
"2011","Chiltern 005B","E01017779","Total",1163,563,600,1163,0,54,232.55,5.0
"2011","Chiltern 005C","E01017785","Total",1677,841,836,1677,0,49,454.48,3.7
"2011","Chiltern 005D","E01017786","Total",1553,745,808,1553,0,54,110.47,14.1
"2011","Chiltern 005E","E01017787","Total",1614,798,816,1614,0,61,131.69,12.3
"2011","Chiltern 005F","E01017788","Total",1753,822,931,1753,0,20,28.65,61.2
"2011","Chiltern 006A","E01017741","Total",1623,784,839,1567,56,28,37.92,42.8
"2011","Chiltern 006B","E01017742","Total",1695,833,862,1693,2,39,50.03,33.9
"2011","Chiltern 006C","E01017743","Total",1619,747,872,1597,22,21,52.02,31.1
"2011","Chiltern 006D","E01017763","Total",1718,794,924,1704,14,48,70.98,24.2
"2011","Chiltern 006E","E01017764","Total",1753,855,898,1726,27,76,109.71,16.0
"2011","Chiltern 006F","E01017765","Total",1764,912,852,1764,0,95,327.31,5.4
"2011","Chiltern 007A","E01017739","Total",1254,626,628,1254,0,36,36.41,34.4
"2011","Chiltern 007B","E01017740","Total",1327,635,692,1321,6,22,199.35,6.7
"2011","Chiltern 007C","E01017744","Total",1447,704,743,1435,12,26,611.54,2.4
"2011","Chiltern 007D","E01017745","Total",1768,876,892,1763,5,45,810.53,2.2
"2011","Chiltern 007E","E01017746","Total",1533,759,774,1533,0,37,33.54,45.7
"2011","Chiltern 008A","E01017762","Total",1472,734,738,1472,0,67,628.52,2.3
"2011","Chiltern 008B","E01017775","Total",1564,727,837,1557,7,34,70.44,22.2
"2011","Chiltern 008C","E01017776","Total",1619,769,850,1619,0,36,110.63,14.6
"2011","Chiltern 008D","E01017777","Total",1637,789,848,1637,0,57,101.27,16.2
"2011","Chiltern 010A","E01017759","Total",1815,857,958,1815,0,51,524.92,3.5
"2011","Chiltern 010B","E01017760","Total",1699,831,868,1699,0,69,361.08,4.7
"2011","Chiltern 010C","E01017761","Total",2132,1027,1105,2132,0,54,62.27,34.2
"2011","Chiltern 010D","E01017794","Total",2311,1120,1191,2311,0,93,348.93,6.6
"2011","Chiltern 011A","E01017754","Total",1571,756,815,1463,108,44,324.82,4.8
"2011","Chiltern 011B","E01017755","Total",1514,725,789,1514,0,33,56.82,26.6
"2011","Chiltern 011C","E01017756","Total",1492,725,767,1484,8,53,79.64,18.7
"2011","Chiltern 011D","E01017757","Total",1225,573,652,1225,0,44,353.97,3.5
"2011","Chiltern 011E","E01017758","Total",1266,635,631,1172,94,42,101.76,12.4
"2011","Chiltern 012A","E01017751","Total",2203,1081,1122,2163,40,100,167.59,13.1
"2011","Chiltern 012B","E01017753","Total",1259,587,672,1259,0,18,54.95,22.9
"2011","Chiltern 012C","E01017767","Total",2236,1021,1215,2170,66,44,470.83,4.7
"2011","Chiltern 013A","E01017773","Total",1533,739,794,1533,0,27,438.07,3.5
"2011","Chiltern 013B","E01017774","Total",1296,616,680,1296,0,26,175.12,7.4
"2011","Chiltern 013C","E01017782","Total",1442,707,735,1442,0,65,153.54,9.4
"2011","Chiltern 013D","E01017783","Total",1493,727,766,1468,25,36,1691.27,0.9
"2011","Chiltern 013E","E01017784","Total",1575,745,830,1560,15,76,480.54,3.3
"2011","Chiltern 013F","E01032609","Total",1210,582,628,1210,0,20,40.75,29.7
"2011","South Bucks 001A","E01017796","Total",1799,836,963,1719,80,35,76.03,23.7
"2011","South Bucks 001B","E01017797","Total",1513,755,758,1513,0,88,91.64,16.5
"2011","South Bucks 001C","E01017798","Total",1792,850,942,1792,0,82,526.25,3.4
"2011","South Bucks 001D","E01017799","Total",2008,944,1064,1967,41,46,130.13,15.4
"2011","South Bucks 001E","E01017800","Total",1781,912,869,1607,174,34,741.05,2.4
"2011","South Bucks 001F","E01017801","Total",1624,782,842,1624,0,56,316.43,5.1
"2011","South Bucks 001G","E01017802","Total",1564,774,790,1564,0,30,83.97,18.6
"2011","South Bucks 002A","E01017818","Total",1957,966,991,1957,0,53,482.67,4.1
"2011","South Bucks 002B","E01017819","Total",1594,808,786,1586,8,92,262.45,6.1
"2011","South Bucks 002C","E01017820","Total",1601,694,907,1497,104,57,112.27,14.3
"2011","South Bucks 002D","E01017821","Total",1598,774,824,1542,56,77,411.85,3.9
"2011","South Bucks 002E","E01017822","Total",1943,939,1004,1943,0,78,91.88,21.1
"2011","South Bucks 003A","E01017810","Total",1729,793,936,1729,0,16,116.52,14.8
"2011","South Bucks 003B","E01017811","Total",1210,586,624,1132,78,24,428.19,2.8
"2011","South Bucks 003C","E01017812","Total",1667,852,815,1667,0,24,390.16,4.3
"2011","South Bucks 003D","E01017813","Total",1857,915,942,1846,11,36,394.44,4.7
"2011","South Bucks 004A","E01017815","Total",1829,866,963,1783,46,63,138.62,13.2
"2011","South Bucks 004B","E01017816","Total",1668,792,876,1668,0,52,59.67,28.0
"2011","South Bucks 004C","E01017817","Total",2002,994,1008,1865,137,61,203.96,9.8
"2011","South Bucks 004D","E01017823","Total",1358,641,717,1349,9,35,1238.50,1.1
"2011","South Bucks 005A","E01017830","Total",1822,890,932,1822,0,20,315.60,5.8
"2011","South Bucks 005B","E01017831","Total",1716,847,869,1716,0,45,317.68,5.4
"2011","South Bucks 005C","E01017832","Total",1687,818,869,1625,62,37,419.43,4.0
"2011","South Bucks 005D","E01017834","Total",1542,792,750,1467,75,27,801.93,1.9
"2011","South Bucks 005E","E01017835","Total",1709,815,894,1698,11,36,552.52,3.1
"2011","South Bucks 006A","E01017803","Total",1310,625,685,1238,72,35,1433.39,0.9
"2011","South Bucks 006B","E01017806","Total",1685,800,885,1685,0,44,124.51,13.5
"2011","South Bucks 006C","E01017814","Total",1541,737,804,1541,0,43,757.36,2.0
"2011","South Bucks 006D","E01017833","Total",1669,821,848,1641,28,36,1121.95,1.5
"2011","South Bucks 007A","E01017804","Total",1517,715,802,1508,9,24,58.39,26.0
"2011","South Bucks 007B","E01017805","Total",1853,867,986,1853,0,25,40.84,45.4
"2011","South Bucks 007C","E01017807","Total",1496,739,757,1496,0,22,27.99,53.4
"2011","South Bucks 007D","E01017808","Total",1480,717,763,1480,0,15,50.99,29.0
"2011","South Bucks 007E","E01017809","Total",1500,723,777,1500,0,21,34.32,43.7
"2011","South Bucks 008A","E01017824","Total",1690,857,833,1690,0,25,444.22,3.8
"2011","South Bucks 008B","E01017825","Total",1744,854,890,1744,0,35,130.03,13.4
"2011","South Bucks 008C","E01017826","Total",1511,724,787,1506,5,10,243.52,6.2
"2011","South Bucks 008D","E01017827","Total",1671,838,833,1671,0,22,515.72,3.2
"2011","South Bucks 008E","E01017828","Total",1633,775,858,1591,42,25,47.17,34.6
"2011","South Bucks 008F","E01017829","Total",1997,1012,985,1997,0,53,393.28,5.1
"2011","Wycombe 001A","E01017929","Total",1668,722,946,1532,136,16,40.74,40.9
"2011","Wycombe 001B","E01017930","Total",1740,854,886,1729,11,46,302.09,5.8
"2011","Wycombe 001C","E01017931","Total",1396,681,715,1396,0,33,128.58,10.9
"2011","Wycombe 001D","E01017932","Total",1573,762,811,1573,0,51,513.34,3.1
"2011","Wycombe 001E","E01017933","Total",1724,828,896,1724,0,22,79.57,21.7
"2011","Wycombe 002A","E01017885","Total",1707,860,847,1696,11,28,1726.39,1.0
"2011","Wycombe 002B","E01017886","Total",1486,732,754,1486,0,35,2066.77,0.7
"2011","Wycombe 002C","E01017887","Total",1147,569,578,1147,0,29,293.23,3.9
"2011","Wycombe 002D","E01017888","Total",1712,821,891,1712,0,80,2030.45,0.8
"2011","Wycombe 003A","E01017869","Total",1334,667,667,1334,0,55,403.87,3.3
"2011","Wycombe 003B","E01017870","Total",1242,644,598,1242,0,49,454.48,2.7
"2011","Wycombe 003C","E01017871","Total",1573,728,845,1543,30,43,218.94,7.2
"2011","Wycombe 003D","E01017872","Total",1643,808,835,1643,0,41,537.42,3.1
"2011","Wycombe 003E","E01017873","Total",1421,716,705,1421,0,37,156.53,9.1
"2011","Wycombe 003F","E01017874","Total",1149,572,577,1149,0,33,107.58,10.7
"2011","Wycombe 004A","E01017915","Total",1361,679,682,1359,2,18,1268.93,1.1
"2011","Wycombe 004B","E01017916","Total",1194,594,600,1179,15,17,895.52,1.3
"2011","Wycombe 004C","E01017917","Total",1469,747,722,1465,4,37,269.66,5.4
"2011","Wycombe 004D","E01017918","Total",1530,743,787,1530,0,23,232.80,6.6
"2011","Wycombe 006A","E01017857","Total",1408,717,691,1408,0,9,21.05,66.9
"2011","Wycombe 006B","E01017858","Total",1617,808,809,1395,222,25,36.84,43.9
"2011","Wycombe 006C","E01017859","Total",1416,746,670,1416,0,27,131.28,10.8
"2011","Wycombe 006D","E01017860","Total",1450,734,716,1450,0,8,24.34,59.6
"2011","Wycombe 006E","E01017861","Total",1663,778,885,1580,83,32,50.50,32.9
"2011","Wycombe 006F","E01017862","Total",1880,931,949,1880,0,41,289.13,6.5
"2011","Wycombe 006G","E01017863","Total",1735,855,880,1735,0,35,42.86,40.5
"2011","Wycombe 007A","E01017842","Total",3005,1554,1451,2685,320,116,3240.01,0.9
"2011","Wycombe 007B","E01017853","Total",1345,681,664,1344,1,28,529.41,2.5
"2011","Wycombe 007C","E01017854","Total",1288,633,655,1282,6,40,1252.70,1.0
"2011","Wycombe 007D","E01017878","Total",2648,1297,1351,2629,19,109,5918.14,0.4
"2011","Wycombe 008A","E01017920","Total",1256,637,619,1256,0,16,54.62,23.0
"2011","Wycombe 008B","E01017921","Total",1793,926,867,1709,84,35,69.50,25.8
"2011","Wycombe 008C","E01017922","Total",1644,797,847,1641,3,26,43.85,37.5
"2011","Wycombe 008D","E01017923","Total",1498,800,698,1475,23,17,24.52,61.1
"2011","Wycombe 008E","E01017924","Total",1644,784,860,1527,117,60,62.86,26.2
"2011","Wycombe 009A","E01017937","Total",1548,758,790,1538,10,66,152.09,10.2
"2011","Wycombe 009B","E01017938","Total",1360,688,672,1360,0,38,131.11,10.4
"2011","Wycombe 009C","E01017940","Total",1501,750,751,1501,0,17,117.71,12.8
"2011","Wycombe 009D","E01017942","Total",1510,725,785,1510,0,44,32.07,47.1
"2011","Wycombe 010A","E01017850","Total",1372,668,704,1372,0,11,20.62,66.5
"2011","Wycombe 010B","E01017851","Total",1709,900,809,1709,0,20,26.03,65.7
"2011","Wycombe 010C","E01017852","Total",2493,1261,1232,2490,3,39,27.59,90.4
"2011","Wycombe 010D","E01017919","Total",1346,718,628,1346,0,14,21.13,63.7
"2011","Wycombe 011A","E01017925","Total",2107,1046,1061,2107,0,23,31.09,67.8
"2011","Wycombe 011B","E01017926","Total",1500,719,781,1500,0,5,20.97,71.5
"2011","Wycombe 011C","E01017927","Total",1558,760,798,1558,0,21,35.36,44.1
"2011","Wycombe 011D","E01017928","Total",1397,683,714,1397,0,8,34.00,41.1
"2011","Wycombe 012A","E01017911","Total",1723,862,861,1723,0,11,39.93,43.2
"2011","Wycombe 012B","E01017912","Total",1401,715,686,1388,13,28,45.83,30.6
"2011","Wycombe 012C","E01017913","Total",1726,896,830,1722,4,8,33.85,51.0
"2011","Wycombe 012D","E01017914","Total",1364,696,668,1364,0,18,217.55,6.3
"2011","Wycombe 013A","E01017903","Total",1654,850,804,1654,0,23,17.77,93.1
"2011","Wycombe 013B","E01017904","Total",1746,929,817,1746,0,23,17.44,100.1
"2011","Wycombe 013C","E01017905","Total",2181,1170,1011,2162,19,16,32.14,67.9
"2011","Wycombe 013D","E01017906","Total",1980,984,996,1980,0,25,16.11,122.9
"2011","Wycombe 013E","E01017907","Total",1845,914,931,1845,0,20,27.68,66.7
"2011","Wycombe 014A","E01017899","Total",1656,802,854,1656,0,13,28.00,59.1
"2011","Wycombe 014B","E01017900","Total",1343,657,686,1340,3,20,90.11,14.9
"2011","Wycombe 014C","E01017901","Total",1206,583,623,1206,0,16,24.49,49.2
"2011","Wycombe 014D","E01017902","Total",1602,765,837,1602,0,6,34.87,45.9
"2011","Wycombe 015A","E01017836","Total",1657,842,815,1657,0,24,54.26,30.5
"2011","Wycombe 015B","E01017837","Total",2196,1092,1104,1798,398,38,60.51,36.3
"2011","Wycombe 015C","E01017838","Total",1559,839,720,1559,0,15,43.26,36.0
"2011","Wycombe 015D","E01017839","Total",1721,622,1099,1083,638,31,100.42,17.1
"2011","Wycombe 015E","E01017840","Total",1803,884,919,1790,13,37,86.45,20.9
"2011","Wycombe 015F","E01017841","Total",1429,708,721,1412,17,79,110.90,12.9
"2011","Wycombe 016A","E01017908","Total",2505,1263,1242,2505,0,4,79.15,31.6
"2011","Wycombe 016B","E01017909","Total",2182,1090,1092,2182,0,14,160.39,13.6
"2011","Wycombe 016C","E01017910","Total",2401,1203,1198,2390,11,41,106.52,22.5
"2011","Wycombe 016D","E01017941","Total",1398,691,707,1398,0,17,73.01,19.1
"2011","Wycombe 017A","E01017843","Total",1550,756,794,1550,0,21,154.88,10.0
"2011","Wycombe 017B","E01017844","Total",1747,819,928,1647,100,20,38.34,45.6
"2011","Wycombe 017C","E01017845","Total",1677,844,833,1578,99,19,69.18,24.2
"2011","Wycombe 017D","E01017855","Total",1435,690,745,1435,0,23,311.03,4.6
"2011","Wycombe 017E","E01017856","Total",1416,710,706,1411,5,17,151.32,9.4
"2011","Wycombe 018A","E01017864","Total",1339,653,686,1339,0,26,94.64,14.1
"2011","Wycombe 018B","E01017865","Total",1543,757,786,1543,0,41,142.57,10.8
"2011","Wycombe 018C","E01017867","Total",1545,720,825,1545,0,24,99.47,15.5
"2011","Wycombe 018D","E01017868","Total",1538,746,792,1533,5,52,97.95,15.7
"2011","Wycombe 019A","E01017934","Total",1737,833,904,1737,0,18,125.55,13.8
"2011","Wycombe 019B","E01017935","Total",1970,924,1046,1939,31,18,123.04,16.0
"2011","Wycombe 019C","E01017936","Total",1554,750,804,1554,0,38,266.79,5.8
"2011","Wycombe 019D","E01017939","Total",1366,687,679,1365,1,17,213.40,6.4
"2011","Wycombe 020A","E01017866","Total",1438,716,722,1438,0,39,1349.19,1.1
"2011","Wycombe 020B","E01017875","Total",1523,794,729,1523,0,100,1286.21,1.2
"2011","Wycombe 020C","E01017876","Total",2076,1032,1044,2076,0,53,151.68,13.7
"2011","Wycombe 020D","E01017877","Total",1673,840,833,1673,0,35,490.94,3.4
"2011","Wycombe 021A","E01017846","Total",1387,653,734,1387,0,22,60.27,23.0
"2011","Wycombe 021B","E01017847","Total",1534,717,817,1493,41,32,69.61,22.0
"2011","Wycombe 021C","E01017848","Total",1211,607,604,1190,21,32,47.32,25.6
"2011","Wycombe 021D","E01017849","Total",1399,698,701,1397,2,30,332.59,4.2
"2011","Wycombe 022A","E01017889","Total",1301,628,673,1301,0,26,33.60,38.7
"2011","Wycombe 022B","E01017890","Total",1307,658,649,1307,0,33,37.56,34.8
"2011","Wycombe 022C","E01017891","Total",1432,673,759,1432,0,26,35.31,40.6
"2011","Wycombe 022D","E01017892","Total",1584,776,808,1584,0,50,172.72,9.2
"2011","Wycombe 022E","E01017893","Total",1580,753,827,1553,27,16,40.10,39.4
"2011","Wycombe 022F","E01017894","Total",1595,750,845,1539,56,45,168.22,9.5
"2011","Wycombe 023A","E01017895","Total",1317,634,683,1317,0,21,32.49,40.5
"2011","Wycombe 023B","E01017896","Total",1409,664,745,1409,0,35,107.28,13.1
"2011","Wycombe 023C","E01017897","Total",1576,764,812,1568,8,24,32.61,48.3
"2011","Wycombe 023D","E01017898","Total",1224,582,642,1224,0,19,28.65,42.7
"2011","Wycombe 024A","E01017880","Total",1423,694,729,1423,0,30,81.06,17.6
"2011","Wycombe 024B","E01017881","Total",1877,914,963,1803,74,52,76.70,24.5
"2011","Wycombe 024C","E01017882","Total",1619,789,830,1619,0,22,110.71,14.6
"2011","Wycombe 024D","E01017883","Total",1639,806,833,1639,0,48,84.59,19.4
"2011","Wycombe 024E","E01017884","Total",1442,661,781,1442,0,17,20.18,71.5
"2011","Wycombe 024F","E01032610","Total",1623,787,836,1623,0,33,50.55,32.1
"2011","Eastbourne 001A","E01020924","Total",1418,711,707,1417,1,15,24.02,59.0
"2011","Eastbourne 001B","E01020925","Total",1523,704,819,1523,0,15,22.46,67.8
"2011","Eastbourne 001C","E01020927","Total",1503,697,806,1503,0,18,85.23,17.6
"2011","Eastbourne 001D","E01020928","Total",1568,711,857,1556,12,6,40.13,39.1
"2011","Eastbourne 001E","E01020930","Total",1480,739,741,1480,0,19,19.12,77.4
"2011","Eastbourne 002A","E01020917","Total",1501,739,762,1501,0,9,18.54,81.0
"2011","Eastbourne 002B","E01020918","Total",1619,775,844,1616,3,13,25.96,62.4
"2011","Eastbourne 002C","E01020919","Total",1546,741,805,1543,3,5,21.13,73.2
"2011","Eastbourne 002D","E01020923","Total",1452,695,757,1452,0,7,15.37,94.5
"2011","Eastbourne 002E","E01020949","Total",1577,738,839,1577,0,6,29.87,52.8
"2011","Eastbourne 003A","E01020926","Total",1613,780,833,1613,0,19,39.41,40.9
"2011","Eastbourne 003B","E01020929","Total",1601,757,844,1601,0,10,30.36,52.7
"2011","Eastbourne 003C","E01020955","Total",1498,736,762,1498,0,6,33.05,45.3
"2011","Eastbourne 003D","E01020956","Total",1575,741,834,1567,8,6,89.53,17.6
"2011","Eastbourne 003E","E01020957","Total",1492,690,802,1492,0,9,35.82,41.7
"2011","Eastbourne 004A","E01020920","Total",1471,693,778,1471,0,7,58.29,25.2
"2011","Eastbourne 004B","E01020921","Total",1506,699,807,1418,88,13,74.30,20.3
"2011","Eastbourne 004C","E01020922","Total",1496,688,808,1449,47,12,64.62,23.2
"2011","Eastbourne 004D","E01020945","Total",1842,870,972,1829,13,26,71.64,25.7
"2011","Eastbourne 004E","E01020950","Total",1623,765,858,1623,0,16,39.65,40.9
"2011","Eastbourne 006A","E01020940","Total",1509,756,753,1493,16,26,49.50,30.5
"2011","Eastbourne 006B","E01020941","Total",1693,789,904,1693,0,12,27.21,62.2
"2011","Eastbourne 006C","E01020942","Total",1564,703,861,1560,4,16,579.28,2.7
"2011","Eastbourne 006D","E01020946","Total",1721,793,928,1647,74,28,242.75,7.1
"2011","Eastbourne 006E","E01020947","Total",1497,713,784,1481,16,28,116.52,12.8
"2011","Eastbourne 007A","E01020914","Total",1934,915,1019,1934,0,11,19.90,97.2
"2011","Eastbourne 007B","E01020915","Total",1699,839,860,1698,1,10,15.14,112.2
"2011","Eastbourne 007C","E01020952","Total",1795,844,951,1765,30,7,32.28,55.6
"2011","Eastbourne 007D","E01020953","Total",1530,750,780,1522,8,9,98.77,15.5
"2011","Eastbourne 007E","E01020954","Total",1765,855,910,1765,0,19,38.78,45.5
"2011","Eastbourne 008A","E01020948","Total",1434,674,760,1432,2,22,73.76,19.4
"2011","Eastbourne 008B","E01020963","Total",1699,811,888,1562,137,37,129.68,13.1
"2011","Eastbourne 008C","E01020965","Total",1864,929,935,1745,119,11,21.89,85.2
"2011","Eastbourne 008D","E01020966","Total",1731,772,959,1464,267,14,40.00,43.3
"2011","Eastbourne 009A","E01020938","Total",1574,752,822,1568,6,24,28.34,55.5
"2011","Eastbourne 009B","E01020939","Total",1577,741,836,1577,0,34,30.02,52.5
"2011","Eastbourne 009C","E01020943","Total",1593,735,858,1593,0,14,19.26,82.7
"2011","Eastbourne 009D","E01020964","Total",1650,767,883,1614,36,16,31.62,52.2
"2011","Eastbourne 009E","E01020967","Total",1820,819,1001,1689,131,21,34.25,53.1
"2011","Eastbourne 010A","E01020910","Total",1709,815,894,1670,39,10,27.21,62.8
"2011","Eastbourne 010B","E01020911","Total",1990,1080,910,1960,30,13,21.79,91.3
"2011","Eastbourne 010C","E01020912","Total",2035,1096,939,2026,9,18,15.24,133.5
"2011","Eastbourne 010D","E01020916","Total",1686,801,885,1686,0,12,15.58,108.2
"2011","Eastbourne 011A","E01020935","Total",1843,980,863,1843,0,11,28.28,65.2
"2011","Eastbourne 011B","E01020936","Total",1721,781,940,1613,108,14,30.07,57.2
"2011","Eastbourne 011C","E01020937","Total",1634,818,816,1277,357,12,22.12,73.9
"2011","Eastbourne 011D","E01020968","Total",1700,799,901,1588,112,10,37.05,45.9
"2011","Eastbourne 012A","E01020931","Total",1849,831,1018,1407,442,23,65.71,28.1
"2011","Eastbourne 012B","E01020932","Total",1381,621,760,1319,62,9,48.90,28.2
"2011","Eastbourne 012C","E01020933","Total",1047,458,589,909,138,16,1004.48,1.0
"2011","Eastbourne 012D","E01020934","Total",1250,563,687,1215,35,18,49.20,25.4
"2011","Eastbourne 012E","E01020944","Total",1543,743,800,1483,60,40,90.18,17.1
"2011","Eastbourne 013A","E01020913","Total",2114,998,1116,2112,2,19,51.18,41.3
"2011","Eastbourne 013B","E01020951","Total",1513,748,765,1513,0,11,185.56,8.2
"2011","Eastbourne 013C","E01020959","Total",1457,708,749,1429,28,10,23.34,62.4
"2011","Eastbourne 013D","E01020961","Total",1412,645,767,1412,0,4,38.70,36.5
"2011","Eastbourne 013E","E01020962","Total",2004,974,1030,2004,0,26,46.68,42.9
"2011","Eastbourne 014A","E01020960","Total",2455,1239,1216,2455,0,16,36.13,67.9
"2011","Eastbourne 014B","E01032831","Total",1578,776,802,1578,0,19,35.57,44.4
"2011","Eastbourne 014C","E01032832","Total",1600,760,840,1600,0,13,45.02,35.5
"2011","Eastbourne 014D","E01032833","Total",1338,699,639,1338,0,10,30.45,43.9
"2011","Hastings 001A","E01020969","Total",1519,724,795,1476,43,17,38.10,39.9
"2011","Hastings 001B","E01020970","Total",2689,1330,1359,2677,12,50,236.60,11.4
"2011","Hastings 001C","E01020971","Total",2037,984,1053,2037,0,14,70.94,28.7
"2011","Hastings 001D","E01020987","Total",1797,873,924,1797,0,14,57.61,31.2
"2011","Hastings 002A","E01020974","Total",1537,748,789,1428,109,14,74.14,20.7
"2011","Hastings 002B","E01020986","Total",1473,697,776,1402,71,27,60.78,24.2
"2011","Hastings 002C","E01020988","Total",1699,793,906,1683,16,23,50.45,33.7
"2011","Hastings 002D","E01021007","Total",1442,703,739,1442,0,16,129.50,11.1
"2011","Hastings 002E","E01021008","Total",1587,730,857,1583,4,26,29.42,53.9
"2011","Hastings 002F","E01021009","Total",1944,943,1001,1935,9,29,55.44,35.1
"2011","Hastings 003A","E01020993","Total",1343,646,697,1343,0,4,22.26,60.3
"2011","Hastings 003B","E01020994","Total",1533,741,792,1533,0,8,38.21,40.1
"2011","Hastings 003C","E01020995","Total",1431,683,748,1431,0,7,62.33,23.0
"2011","Hastings 003D","E01020996","Total",1792,865,927,1784,8,17,87.32,20.5
"2011","Hastings 003E","E01021019","Total",1607,790,817,1607,0,8,27.04,59.4
"2011","Hastings 004A","E01021004","Total",1785,852,933,1729,56,9,342.59,5.2
"2011","Hastings 004B","E01021005","Total",1617,759,858,1617,0,6,41.64,38.8
"2011","Hastings 004C","E01021006","Total",1793,873,920,1787,6,17,141.49,12.7
"2011","Hastings 004D","E01021013","Total",1827,908,919,1811,16,8,25.99,70.3
"2011","Hastings 005A","E01020972","Total",1549,721,828,1549,0,6,70.26,22.0
"2011","Hastings 005B","E01020973","Total",1752,832,920,1752,0,5,41.21,42.5
"2011","Hastings 005C","E01020977","Total",1588,774,814,1588,0,7,13.81,115.0
"2011","Hastings 005D","E01021015","Total",1606,736,870,1606,0,13,22.14,72.5
"2011","Hastings 006A","E01021010","Total",1582,757,825,1582,0,6,42.13,37.6
"2011","Hastings 006B","E01021011","Total",1560,739,821,1560,0,10,19.55,79.8
"2011","Hastings 006C","E01021012","Total",1664,799,865,1624,40,12,55.74,29.9
"2011","Hastings 006D","E01021020","Total",1850,869,981,1850,0,14,43.48,42.5
"2011","Hastings 006E","E01021021","Total",1892,881,1011,1865,27,20,60.30,31.4
"2011","Hastings 007A","E01021000","Total",1486,735,751,1485,1,10,22.82,65.1
"2011","Hastings 007B","E01021001","Total",1237,597,640,1237,0,21,15.94,77.6
"2011","Hastings 007C","E01021002","Total",1468,698,770,1423,45,25,86.91,16.9
"2011","Hastings 007D","E01021003","Total",1671,829,842,1619,52,16,33.32,50.2
"2011","Hastings 007E","E01021014","Total",1884,884,1000,1884,0,16,18.34,102.7
"2011","Hastings 008A","E01020975","Total",1810,878,932,1730,80,15,42.58,42.5
"2011","Hastings 008B","E01020976","Total",1913,942,971,1892,21,21,56.98,33.6
"2011","Hastings 008C","E01020990","Total",1653,847,806,1619,34,11,13.02,127.0
"2011","Hastings 008D","E01020991","Total",1334,657,677,1274,60,23,27.34,48.8
"2011","Hastings 008E","E01020992","Total",1842,937,905,1826,16,14,39.90,46.2
"2011","Hastings 009A","E01020978","Total",1947,993,954,1941,6,10,29.53,65.9
"2011","Hastings 009B","E01020979","Total",1834,982,852,1796,38,6,35.24,52.0
"2011","Hastings 009C","E01020980","Total",1583,780,803,1577,6,12,16.45,96.2
"2011","Hastings 009D","E01020981","Total",1623,822,801,1602,21,15,17.44,93.1
"2011","Hastings 010A","E01020997","Total",1638,737,901,1557,81,9,41.63,39.3
"2011","Hastings 010B","E01020998","Total",1850,912,938,1676,174,6,34.26,54.0
"2011","Hastings 010C","E01020999","Total",1928,859,1069,1646,282,26,54.70,35.2
"2011","Hastings 010D","E01021016","Total",1645,770,875,1581,64,13,61.14,26.9
"2011","Hastings 010E","E01021017","Total",1604,780,824,1604,0,10,98.35,16.3
"2011","Hastings 010F","E01021018","Total",1915,938,977,1915,0,24,180.40,10.6
"2011","Hastings 011A","E01020982","Total",1742,927,815,1656,86,3,12.34,141.2
"2011","Hastings 011B","E01020983","Total",1657,859,798,1598,59,4,8.41,197.0
"2011","Hastings 011C","E01020984","Total",1951,1023,928,1941,10,10,27.97,69.8
"2011","Hastings 011D","E01020985","Total",1782,949,833,1779,3,11,18.92,94.2
"2011","Hastings 011E","E01020989","Total",1762,929,833,1626,136,7,18.00,97.9
"2011","Lewes 001A","E01021022","Total",2105,1009,1096,2097,8,54,2924.16,0.7
"2011","Lewes 001B","E01021024","Total",1210,575,635,1204,6,24,213.54,5.7
"2011","Lewes 001C","E01021025","Total",1878,983,895,1808,70,80,2277.80,0.8
"2011","Lewes 001D","E01021052","Total",1267,595,672,1245,22,30,181.91,7.0
"2011","Lewes 001E","E01021053","Total",1190,601,589,1186,4,39,597.99,2.0
"2011","Lewes 002A","E01021023","Total",1980,981,999,1968,12,38,1078.77,1.8
"2011","Lewes 002B","E01021026","Total",2424,1118,1306,2256,168,51,2397.66,1.0
"2011","Lewes 002C","E01021032","Total",2106,1021,1085,2037,69,57,4747.19,0.4
"2011","Lewes 002D","E01021067","Total",1123,546,577,1123,0,38,149.69,7.5
"2011","Lewes 002E","E01021068","Total",1153,565,588,1067,86,72,2692.80,0.4
"2011","Lewes 003A","E01021033","Total",1751,862,889,1751,0,17,53.68,32.6
"2011","Lewes 003B","E01021034","Total",1317,634,683,1317,0,14,100.02,13.2
"2011","Lewes 003C","E01021035","Total",1710,838,872,1710,0,17,310.84,5.5
"2011","Lewes 003D","E01021036","Total",1469,710,759,1455,14,44,55.22,26.6
"2011","Lewes 003E","E01021037","Total",1595,794,801,1595,0,19,40.53,39.4
"2011","Lewes 003F","E01021038","Total",1753,820,933,1719,34,29,46.28,37.9
"2011","Lewes 004A","E01021054","Total",1447,735,712,1447,0,25,2411.35,0.6
"2011","Lewes 004B","E01021055","Total",1747,829,918,1747,0,18,108.85,16.0
"2011","Lewes 004C","E01021056","Total",1703,796,907,1642,61,25,1041.97,1.6
"2011","Lewes 004D","E01021057","Total",1525,752,773,1525,0,24,3806.42,0.4
"2011","Lewes 005A","E01021039","Total",1452,693,759,1423,29,45,129.66,11.2
"2011","Lewes 005B","E01021040","Total",1727,947,780,1426,301,28,32.63,52.9
"2011","Lewes 005C","E01021041","Total",1570,755,815,1567,3,38,279.06,5.6
"2011","Lewes 005D","E01021042","Total",1346,640,706,1346,0,12,55.33,24.3
"2011","Lewes 005E","E01021043","Total",1607,755,852,1607,0,38,37.56,42.8
"2011","Lewes 006A","E01021027","Total",1557,782,775,1557,0,14,94.23,16.5
"2011","Lewes 006B","E01021028","Total",1614,781,833,1614,0,15,38.93,41.5
"2011","Lewes 006C","E01021029","Total",1548,744,804,1530,18,13,259.75,6.0
"2011","Lewes 006D","E01021030","Total",1256,566,690,1225,31,10,28.90,43.5
"2011","Lewes 006E","E01021031","Total",1502,757,745,1449,53,9,51.10,29.4
"2011","Lewes 007A","E01021061","Total",1546,772,774,1546,0,9,28.42,54.4
"2011","Lewes 007B","E01021063","Total",1703,845,858,1703,0,11,81.39,20.9
"2011","Lewes 007C","E01021064","Total",1608,772,836,1608,0,6,42.09,38.2
"2011","Lewes 007D","E01021065","Total",1189,578,611,1189,0,3,20.42,58.2
"2011","Lewes 007E","E01021066","Total",1544,753,791,1539,5,3,36.82,41.9
"2011","Lewes 008A","E01021045","Total",1794,890,904,1794,0,8,252.58,7.1
"2011","Lewes 008B","E01021046","Total",1519,738,781,1474,45,18,70.60,21.5
"2011","Lewes 008C","E01021047","Total",1422,700,722,1416,6,8,106.62,13.3
"2011","Lewes 008D","E01021048","Total",1551,811,740,1551,0,15,20.64,75.1
"2011","Lewes 009A","E01021044","Total",1919,937,982,1919,0,20,87.00,22.1
"2011","Lewes 009B","E01021049","Total",1436,728,708,1431,5,3,19.98,71.9
"2011","Lewes 009C","E01021050","Total",1362,686,676,1349,13,8,56.67,24.0
"2011","Lewes 009D","E01021051","Total",1229,604,625,1229,0,8,103.86,11.8
"2011","Lewes 010A","E01021058","Total",1890,872,1018,1829,61,4,43.74,43.2
"2011","Lewes 010B","E01021059","Total",1523,718,805,1502,21,9,70.13,21.7
"2011","Lewes 010C","E01021060","Total",1598,791,807,1598,0,9,146.53,10.9
"2011","Lewes 010D","E01021062","Total",1466,718,748,1453,13,6,49.26,29.8
"2011","Lewes 011A","E01021069","Total",1594,774,820,1505,89,23,42.43,37.6
"2011","Lewes 011B","E01021075","Total",1793,856,937,1793,0,21,223.49,8.0
"2011","Lewes 011C","E01021077","Total",1482,701,781,1443,39,14,46.38,32.0
"2011","Lewes 011D","E01021081","Total",1603,765,838,1510,93,14,47.29,33.9
"2011","Lewes 011E","E01021082","Total",1632,787,845,1592,40,7,235.09,6.9
"2011","Lewes 011F","E01021083","Total",1376,689,687,1376,0,23,213.78,6.4
"2011","Lewes 012A","E01021072","Total",1542,715,827,1532,10,11,297.76,5.2
"2011","Lewes 012B","E01021073","Total",1482,714,768,1476,6,16,42.86,34.6
"2011","Lewes 012C","E01021074","Total",1656,790,866,1656,0,5,238.65,6.9
"2011","Lewes 012D","E01021076","Total",1894,913,981,1894,0,10,56.91,33.3
"2011","Lewes 012E","E01021078","Total",1279,593,686,1276,3,22,53.25,24.0
"2011","Lewes 013A","E01021070","Total",1565,744,821,1529,36,15,25.05,62.5
"2011","Lewes 013B","E01021071","Total",1710,847,863,1673,37,10,39.12,43.7
"2011","Lewes 013C","E01021079","Total",1547,706,841,1485,62,12,121.51,12.7
"2011","Lewes 013D","E01021080","Total",1416,672,744,1367,49,19,42.96,33.0
"2011","Rother 001A","E01021132","Total",1491,728,763,1200,291,45,533.91,2.8
"2011","Rother 001B","E01021133","Total",1630,796,834,1619,11,36,1929.97,0.8
"2011","Rother 001C","E01021134","Total",1481,762,719,1481,0,31,1035.72,1.4
"2011","Rother 001D","E01021139","Total",1320,635,685,1316,4,16,204.09,6.5
"2011","Rother 001E","E01021140","Total",1817,901,916,1750,67,57,1744.34,1.0
"2011","Rother 001F","E01021141","Total",1542,772,770,1541,1,43,2641.73,0.6
"2011","Rother 002A","E01021103","Total",1483,703,780,1474,9,18,3971.47,0.4
"2011","Rother 002B","E01021114","Total",1528,734,794,1523,5,22,1042.09,1.5
"2011","Rother 002C","E01021115","Total",1592,779,813,1546,46,33,2681.87,0.6
"2011","Rother 002D","E01021116","Total",1526,726,800,1499,27,21,1966.96,0.8
"2011","Rother 003A","E01021098","Total",1718,815,903,1656,62,40,1437.60,1.2
"2011","Rother 003B","E01021099","Total",1658,836,822,1594,64,52,4346.48,0.4
"2011","Rother 003C","E01021100","Total",1844,916,928,1754,90,43,3203.66,0.6
"2011","Rother 003D","E01021104","Total",1355,658,697,1355,0,58,2713.01,0.5
"2011","Rother 003E","E01021105","Total",1251,620,631,1212,39,21,914.83,1.4
"2011","Rother 004A","E01021101","Total",1722,815,907,1719,3,18,1518.68,1.1
"2011","Rother 004B","E01021102","Total",1607,811,796,1607,0,10,1126.14,1.4
"2011","Rother 004C","E01021117","Total",1599,783,816,1577,22,12,145.59,11.0
"2011","Rother 004D","E01021118","Total",1564,781,783,1557,7,14,212.19,7.4
"2011","Rother 004E","E01021119","Total",1092,491,601,1092,0,5,56.40,19.4
"2011","Rother 005A","E01021087","Total",1656,783,873,1612,44,53,3673.55,0.5
"2011","Rother 005B","E01021088","Total",1526,761,765,1488,38,18,923.27,1.7
"2011","Rother 005C","E01021089","Total",1533,735,798,1533,0,11,247.08,6.2
"2011","Rother 005D","E01021109","Total",1689,826,863,1571,118,33,2039.85,0.8
"2011","Rother 005E","E01021110","Total",2259,1085,1174,2242,17,27,817.63,2.8
"2011","Rother 006A","E01021084","Total",1887,893,994,1847,40,43,506.71,3.7
"2011","Rother 006B","E01021085","Total",1696,804,892,1696,0,41,607.45,2.8
"2011","Rother 006C","E01021086","Total",1729,799,930,1689,40,34,416.74,4.1
"2011","Rother 006D","E01021096","Total",1288,631,657,1226,62,25,3459.50,0.4
"2011","Rother 006E","E01021097","Total",1398,674,724,1332,66,20,1590.63,0.9
"2011","Rother 007A","E01021111","Total",1034,460,574,929,105,6,30.00,34.5
"2011","Rother 007B","E01021113","Total",1394,647,747,1394,0,26,111.71,12.5
"2011","Rother 007C","E01021131","Total",1687,832,855,1687,0,20,25.14,67.1
"2011","Rother 007D","E01021135","Total",1836,854,982,1836,0,14,37.93,48.4
"2011","Rother 007E","E01021136","Total",1317,598,719,1317,0,2,46.01,28.6
"2011","Rother 007F","E01021137","Total",1468,683,785,1468,0,12,149.45,9.8
"2011","Rother 008A","E01021112","Total",1505,704,801,1385,120,17,33.81,44.5
"2011","Rother 008B","E01021120","Total",1322,535,787,1251,71,3,58.96,22.4
"2011","Rother 008C","E01021126","Total",1542,745,797,1318,224,15,41.27,37.4
"2011","Rother 008D","E01021127","Total",1563,724,839,1563,0,10,245.38,6.4
"2011","Rother 008E","E01021128","Total",1825,897,928,1825,0,9,51.14,35.7
"2011","Rother 009A","E01021093","Total",1539,730,809,1481,58,19,72.58,21.2
"2011","Rother 009B","E01021095","Total",1291,580,711,1291,0,20,56.02,23.0
"2011","Rother 009C","E01021123","Total",1548,721,827,1545,3,18,278.22,5.6
"2011","Rother 009D","E01021124","Total",1674,768,906,1674,0,10,203.21,8.2
"2011","Rother 009E","E01021125","Total",1294,586,708,1194,100,21,787.77,1.6
"2011","Rother 009F","E01021129","Total",1789,843,946,1789,0,23,68.90,26.0
"2011","Rother 009G","E01021138","Total",1097,508,589,1039,58,15,525.75,2.1
"2011","Rother 010A","E01021094","Total",1530,681,849,1492,38,18,45.19,33.9
"2011","Rother 010B","E01021106","Total",1658,717,941,1658,0,27,79.30,20.9
"2011","Rother 010C","E01021107","Total",1569,748,821,1549,20,18,53.89,29.1
"2011","Rother 010D","E01021108","Total",1480,692,788,1433,47,15,32.63,45.4
"2011","Rother 010E","E01021130","Total",1435,684,751,1416,19,13,52.96,27.1
"2011","Rother 011A","E01021090","Total",1666,793,873,1666,0,6,25.21,66.1
"2011","Rother 011B","E01021091","Total",1923,924,999,1852,71,14,30.28,63.5
"2011","Rother 011C","E01021092","Total",1997,909,1088,1934,63,18,35.15,56.8
"2011","Rother 011D","E01021121","Total",1592,710,882,1549,43,19,36.14,44.1
"2011","Rother 011E","E01021122","Total",1532,695,837,1306,226,5,19.91,76.9
"2011","Wealden 001A","E01021167","Total",2187,1041,1146,2186,1,54,188.80,11.6
"2011","Wealden 001B","E01021168","Total",1677,800,877,1669,8,61,1237.98,1.4
"2011","Wealden 001C","E01021169","Total",1414,679,735,1270,144,65,2511.44,0.6
"2011","Wealden 001D","E01021186","Total",1205,599,606,1205,0,41,1618.30,0.7
"2011","Wealden 002A","E01021171","Total",2050,981,1069,2050,0,79,4128.53,0.5
"2011","Wealden 002B","E01021172","Total",1804,872,932,1802,2,41,1390.46,1.3
"2011","Wealden 002C","E01021173","Total",1420,712,708,1412,8,47,3536.14,0.4
"2011","Wealden 002D","E01021218","Total",1147,551,596,1143,4,34,1047.22,1.1
"2011","Wealden 003A","E01021156","Total",1786,874,912,1786,0,31,51.38,34.8
"2011","Wealden 003B","E01021157","Total",1829,880,949,1829,0,36,104.48,17.5
"2011","Wealden 003C","E01021158","Total",2186,1099,1087,2186,0,57,128.39,17.0
"2011","Wealden 004A","E01021159","Total",2324,1130,1194,2230,94,74,316.21,7.3
"2011","Wealden 004B","E01021160","Total",1649,773,876,1507,142,15,63.73,25.9
"2011","Wealden 004C","E01021161","Total",1577,806,771,1570,7,22,36.98,42.6
"2011","Wealden 004D","E01021162","Total",1618,777,841,1557,61,44,301.82,5.4
"2011","Wealden 005A","E01021202","Total",1123,487,636,1039,84,42,246.84,4.5
"2011","Wealden 005B","E01021203","Total",1491,753,738,1484,7,41,2649.51,0.6
"2011","Wealden 005C","E01021229","Total",1700,837,863,1669,31,56,2056.91,0.8
"2011","Wealden 005D","E01021230","Total",1726,826,900,1723,3,75,2289.26,0.8
"2011","Wealden 005E","E01021231","Total",1755,813,942,1727,28,70,263.84,6.7
"2011","Wealden 006A","E01021151","Total",1769,887,882,1769,0,31,112.47,15.7
"2011","Wealden 006B","E01021152","Total",1605,791,814,1270,335,19,76.21,21.1
"2011","Wealden 006C","E01021153","Total",1963,954,1009,1963,0,40,37.05,53.0
"2011","Wealden 006D","E01021154","Total",1482,753,729,1472,10,18,86.70,17.1
"2011","Wealden 006E","E01021155","Total",1163,574,589,1163,0,12,43.21,26.9
"2011","Wealden 007A","E01021163","Total",2241,1090,1151,2031,210,69,2452.66,0.9
"2011","Wealden 007B","E01021164","Total",1913,937,976,1791,122,63,2433.67,0.8
"2011","Wealden 007C","E01021187","Total",1434,722,712,1401,33,41,2997.54,0.5
"2011","Wealden 008A","E01021144","Total",1799,877,922,1779,20,61,1531.53,1.2
"2011","Wealden 008B","E01021145","Total",1998,1004,994,1933,65,41,2267.43,0.9
"2011","Wealden 008C","E01021170","Total",2741,1317,1424,2727,14,62,3273.25,0.8
"2011","Wealden 008D","E01021217","Total",1286,629,657,1286,0,47,1376.46,0.9
"2011","Wealden 009A","E01021219","Total",1350,657,693,1350,0,34,79.23,17.0
"2011","Wealden 009B","E01021220","Total",1640,772,868,1615,25,19,57.86,28.3
"2011","Wealden 009C","E01021223","Total",1121,534,587,1121,0,20,39.33,28.5
"2011","Wealden 009D","E01021224","Total",1472,712,760,1472,0,12,104.25,14.1
"2011","Wealden 009E","E01021225","Total",1557,738,819,1550,7,22,84.01,18.5
"2011","Wealden 009F","E01021226","Total",1371,654,717,1371,0,16,64.82,21.2
"2011","Wealden 010A","E01021150","Total",1194,587,607,1154,40,28,499.46,2.4
"2011","Wealden 010B","E01021191","Total",1617,781,836,1617,0,25,74.15,21.8
"2011","Wealden 010C","E01021192","Total",1587,761,826,1587,0,30,46.48,34.1
"2011","Wealden 010D","E01021193","Total",1722,840,882,1722,0,18,53.14,32.4
"2011","Wealden 010E","E01021194","Total",1652,782,870,1619,33,24,32.84,50.3
"2011","Wealden 011A","E01021149","Total",1278,632,646,1218,60,35,1385.49,0.9
"2011","Wealden 011B","E01021189","Total",1387,693,694,1339,48,41,1895.32,0.7
"2011","Wealden 011C","E01021190","Total",1524,763,761,1524,0,23,746.09,2.0
"2011","Wealden 011D","E01021200","Total",1106,512,594,1100,6,12,216.53,5.1
"2011","Wealden 011E","E01021201","Total",1536,740,796,1477,59,31,822.73,1.9
"2011","Wealden 012A","E01021221","Total",1270,632,638,1270,0,13,74.26,17.1
"2011","Wealden 012B","E01021222","Total",1506,709,797,1506,0,20,29.76,50.6
"2011","Wealden 012C","E01021227","Total",1693,827,866,1639,54,43,140.60,12.0
"2011","Wealden 012D","E01021228","Total",1513,726,787,1513,0,40,69.18,21.9
"2011","Wealden 013A","E01021146","Total",1737,845,892,1737,0,32,673.56,2.6
"2011","Wealden 013B","E01021147","Total",1654,843,811,1643,11,53,3519.20,0.5
"2011","Wealden 013C","E01021148","Total",1566,757,809,1496,70,24,1656.63,0.9
"2011","Wealden 013D","E01021165","Total",1192,599,593,1187,5,49,2699.69,0.4
"2011","Wealden 014A","E01021188","Total",1136,554,582,1136,0,23,2454.54,0.5
"2011","Wealden 014B","E01021198","Total",1524,732,792,1516,8,16,181.26,8.4
"2011","Wealden 014C","E01021199","Total",1328,622,706,1306,22,38,2740.38,0.5
"2011","Wealden 014D","E01021204","Total",1203,586,617,1203,0,23,609.28,2.0
"2011","Wealden 014E","E01021205","Total",1250,624,626,1192,58,28,2558.18,0.5
"2011","Wealden 015A","E01021174","Total",1627,783,844,1623,4,26,414.12,3.9
"2011","Wealden 015B","E01021175","Total",1489,716,773,1460,29,6,34.16,43.6
"2011","Wealden 015C","E01021176","Total",1405,667,738,1403,2,11,59.17,23.7
"2011","Wealden 015D","E01021177","Total",1109,506,603,1077,32,6,39.76,27.9
"2011","Wealden 016A","E01021180","Total",1317,602,715,1222,95,16,182.63,7.2
"2011","Wealden 016B","E01021181","Total",1298,618,680,1298,0,12,115.47,11.2
"2011","Wealden 016C","E01021182","Total",1569,768,801,1567,2,13,35.88,43.7
"2011","Wealden 016D","E01021183","Total",1341,638,703,1341,0,12,32.92,40.7
"2011","Wealden 017A","E01021178","Total",1393,657,736,1393,0,17,767.82,1.8
"2011","Wealden 017B","E01021179","Total",1497,701,796,1484,13,8,69.20,21.6
"2011","Wealden 017C","E01021184","Total",1545,694,851,1478,67,9,57.67,26.8
"2011","Wealden 017D","E01021185","Total",1496,700,796,1494,2,9,29.29,51.1
"2011","Wealden 018A","E01021142","Total",1112,517,595,1112,0,24,1786.50,0.6
"2011","Wealden 018B","E01021143","Total",1209,562,647,1166,43,17,2141.60,0.6
"2011","Wealden 018C","E01021166","Total",2258,1080,1178,2238,20,42,4236.01,0.5
"2011","Wealden 018D","E01021195","Total",1955,959,996,1804,151,41,1811.30,1.1
"2011","Wealden 018E","E01021196","Total",1942,941,1001,1942,0,15,42.89,45.3
"2011","Wealden 018F","E01021197","Total",2043,1029,1014,1787,256,40,2039.37,1.0
"2011","Wealden 019A","E01021212","Total",1822,861,961,1822,0,12,103.39,17.6
"2011","Wealden 019B","E01021213","Total",1773,830,943,1727,46,11,32.81,54.0
"2011","Wealden 019C","E01021214","Total",1625,758,867,1558,67,9,431.93,3.8
"2011","Wealden 019D","E01021215","Total",1257,588,669,1257,0,10,61.34,20.5
"2011","Wealden 019E","E01021216","Total",1178,552,626,1125,53,10,74.14,15.9
"2011","Wealden 020A","E01021206","Total",1448,655,793,1427,21,18,1909.71,0.8
"2011","Wealden 020B","E01021207","Total",1339,630,709,1339,0,5,123.57,10.8
"2011","Wealden 020C","E01021208","Total",1942,922,1020,1942,0,11,777.28,2.5
"2011","Wealden 020D","E01021209","Total",1615,796,819,1614,1,23,161.89,10.0
"2011","Wealden 020E","E01021210","Total",1598,820,778,1598,0,24,76.09,21.0
"2011","Wealden 020F","E01021211","Total",1525,723,802,1511,14,11,127.23,12.0
"2011","Wealden 021A","E01021232","Total",1652,767,885,1652,0,7,46.46,35.6
"2011","Wealden 021B","E01021233","Total",1483,710,773,1475,8,8,180.42,8.2
"2011","Wealden 021C","E01021234","Total",1475,693,782,1475,0,24,756.96,1.9
"2011","Wealden 021D","E01021235","Total",1341,625,716,1341,0,15,49.87,26.9
"2011","Wealden 021E","E01021236","Total",1489,700,789,1478,11,13,43.44,34.3
"2011","Basingstoke and Deane 001A","E01022553","Total",1457,715,742,1457,0,26,32.93,44.2
"2011","Basingstoke and Deane 001B","E01022554","Total",1676,852,824,1670,6,24,122.99,13.6
"2011","Basingstoke and Deane 001C","E01022555","Total",1508,768,740,1468,40,12,79.27,19.0
"2011","Basingstoke and Deane 001D","E01022556","Total",1599,811,788,1567,32,16,41.84,38.2
"2011","Basingstoke and Deane 001E","E01022560","Total",1177,595,582,1177,0,22,307.53,3.8
"2011","Basingstoke and Deane 002A","E01022493","Total",1338,669,669,1337,1,39,1696.93,0.8
"2011","Basingstoke and Deane 002B","E01022536","Total",1320,683,637,1320,0,32,884.67,1.5
"2011","Basingstoke and Deane 002C","E01022537","Total",1293,652,641,1293,0,25,59.02,21.9
"2011","Basingstoke and Deane 002D","E01022557","Total",1529,767,762,1496,33,25,34.12,44.8
"2011","Basingstoke and Deane 002E","E01022558","Total",1247,635,612,1247,0,16,43.31,28.8
"2011","Basingstoke and Deane 002F","E01022559","Total",1280,629,651,1280,0,23,67.82,18.9
"2011","Basingstoke and Deane 003A","E01022488","Total",1185,585,600,1185,0,60,3252.40,0.4
"2011","Basingstoke and Deane 003B","E01022489","Total",1534,818,716,1389,145,66,2368.45,0.6
"2011","Basingstoke and Deane 003C","E01022499","Total",1537,751,786,1498,39,53,158.25,9.7
"2011","Basingstoke and Deane 003D","E01022500","Total",1377,658,719,1360,17,59,1606.60,0.9
"2011","Basingstoke and Deane 003E","E01022513","Total",1606,778,828,1599,7,72,1653.33,1.0
"2011","Basingstoke and Deane 004A","E01022472","Total",1243,603,640,1243,0,43,1554.52,0.8
"2011","Basingstoke and Deane 004B","E01022473","Total",1246,626,620,1246,0,13,41.07,30.3
"2011","Basingstoke and Deane 004C","E01022520","Total",1642,804,838,1642,0,34,3153.44,0.5
"2011","Basingstoke and Deane 004D","E01022521","Total",1708,838,870,1708,0,31,181.48,9.4
"2011","Basingstoke and Deane 004E","E01022522","Total",1584,800,784,1535,49,59,2692.40,0.6
"2011","Basingstoke and Deane 005A","E01022490","Total",1773,881,892,1773,0,23,215.42,8.2
"2011","Basingstoke and Deane 005B","E01022491","Total",1947,952,995,1947,0,24,264.60,7.4
"2011","Basingstoke and Deane 005C","E01022492","Total",1587,810,777,1549,38,67,2921.88,0.5
"2011","Basingstoke and Deane 005D","E01022546","Total",1407,668,739,1339,68,39,1809.73,0.8
"2011","Basingstoke and Deane 005E","E01022547","Total",1710,859,851,1710,0,45,1613.79,1.1
"2011","Basingstoke and Deane 006A","E01022495","Total",1455,727,728,1455,0,27,33.77,43.1
"2011","Basingstoke and Deane 006B","E01022496","Total",2470,1228,1242,2470,0,53,73.21,33.7
"2011","Basingstoke and Deane 006C","E01022497","Total",1362,662,700,1362,0,19,32.46,42.0
"2011","Basingstoke and Deane 006D","E01022498","Total",1519,759,760,1519,0,39,42.45,35.8
"2011","Basingstoke and Deane 007B","E01022539","Total",1227,617,610,1227,0,13,15.12,81.2
"2011","Basingstoke and Deane 007C","E01022540","Total",1955,909,1046,1955,0,13,37.04,52.8
"2011","Basingstoke and Deane 007E","E01022542","Total",1263,647,616,1263,0,1,20.16,62.6
"2011","Basingstoke and Deane 007F","E01022543","Total",1585,801,784,1572,13,16,51.61,30.7
"2011","Basingstoke and Deane 007H","E01032843","Total",1612,792,820,1609,3,8,31.43,51.3
"2011","Basingstoke and Deane 007I","E01032844","Total",1528,745,783,1528,0,14,64.26,23.8
"2011","Basingstoke and Deane 007J","E01032851","Total",2079,1007,1072,2079,0,5,120.26,17.3
"2011","Basingstoke and Deane 008A","E01022470","Total",1881,948,933,1881,0,40,168.43,11.2
"2011","Basingstoke and Deane 008B","E01022471","Total",1543,767,776,1541,2,47,54.03,28.6
"2011","Basingstoke and Deane 008C","E01022494","Total",2433,1193,1240,2433,0,25,85.92,28.3
"2011","Basingstoke and Deane 008D","E01022523","Total",2041,1001,1040,2037,4,13,157.15,13.0
"2011","Basingstoke and Deane 009A","E01022524","Total",1974,933,1041,1909,65,10,26.89,73.4
"2011","Basingstoke and Deane 009B","E01022525","Total",1651,810,841,1582,69,15,51.55,32.0
"2011","Basingstoke and Deane 009C","E01022526","Total",1674,846,828,1667,7,18,126.20,13.3
"2011","Basingstoke and Deane 009D","E01022527","Total",1599,773,826,1599,0,9,40.58,39.4
"2011","Basingstoke and Deane 010B","E01022566","Total",1297,682,615,1287,10,13,36.15,35.9
"2011","Basingstoke and Deane 010C","E01022567","Total",1277,629,648,1277,0,9,32.87,38.9
"2011","Basingstoke and Deane 010D","E01022568","Total",1421,686,735,1421,0,15,40.55,35.0
"2011","Basingstoke and Deane 010E","E01022570","Total",1566,739,827,1554,12,30,35.15,44.6
"2011","Basingstoke and Deane 010F","E01032840","Total",1925,955,970,1754,171,15,67.82,28.4
"2011","Basingstoke and Deane 010G","E01032841","Total",1655,843,812,1655,0,14,132.62,12.5
"2011","Basingstoke and Deane 011B","E01022502","Total",1541,798,743,1541,0,21,37.98,40.6
"2011","Basingstoke and Deane 011C","E01022506","Total",1265,641,624,1265,0,16,41.39,30.6
"2011","Basingstoke and Deane 011D","E01022507","Total",1557,774,783,1557,0,12,35.19,44.2
"2011","Basingstoke and Deane 011E","E01032842","Total",1239,682,557,1239,0,5,12.85,96.4
"2011","Basingstoke and Deane 011F","E01032847","Total",1348,687,661,1308,40,12,123.50,10.9
"2011","Basingstoke and Deane 012A","E01022481","Total",1799,903,896,1799,0,11,52.06,34.6
"2011","Basingstoke and Deane 012B","E01022482","Total",1573,755,818,1528,45,16,35.20,44.7
"2011","Basingstoke and Deane 012D","E01022503","Total",1406,723,683,1401,5,27,47.29,29.7
"2011","Basingstoke and Deane 012E","E01032845","Total",1695,874,821,1688,7,15,29.94,56.6
"2011","Basingstoke and Deane 012F","E01032846","Total",1512,804,708,1512,0,10,16.83,89.8
"2011","Basingstoke and Deane 013A","E01022484","Total",1318,630,688,1283,35,17,18.14,72.7
"2011","Basingstoke and Deane 013B","E01022485","Total",1179,558,621,1179,0,7,20.04,58.8
"2011","Basingstoke and Deane 013C","E01022486","Total",2047,985,1062,2047,0,14,38.93,52.6
"2011","Basingstoke and Deane 013D","E01022487","Total",1299,644,655,1299,0,6,19.64,66.1
"2011","Basingstoke and Deane 013E","E01022569","Total",1232,627,605,1204,28,11,139.94,8.8
"2011","Basingstoke and Deane 014A","E01022548","Total",1366,661,705,1361,5,15,35.83,38.1
"2011","Basingstoke and Deane 014B","E01022549","Total",1613,768,845,1612,1,7,29.82,54.1
"2011","Basingstoke and Deane 014C","E01022550","Total",1662,818,844,1662,0,7,64.28,25.9
"2011","Basingstoke and Deane 014D","E01022551","Total",1536,748,788,1524,12,18,55.92,27.5
"2011","Basingstoke and Deane 014E","E01022552","Total",1502,733,769,1502,0,14,28.41,52.9
"2011","Basingstoke and Deane 015A","E01022528","Total",1272,627,645,1272,0,26,89.23,14.3
"2011","Basingstoke and Deane 015B","E01022529","Total",1477,699,778,1433,44,29,1704.69,0.9
"2011","Basingstoke and Deane 015C","E01022530","Total",1251,612,639,1251,0,40,71.02,17.6
"2011","Basingstoke and Deane 015D","E01022531","Total",1476,749,727,1476,0,36,1212.57,1.2
"2011","Basingstoke and Deane 016A","E01022475","Total",1653,831,822,1653,0,23,61.78,26.8
"2011","Basingstoke and Deane 016B","E01022476","Total",1847,928,919,1847,0,27,32.24,57.3
"2011","Basingstoke and Deane 016C","E01022480","Total",1320,681,639,1320,0,17,17.39,75.9
"2011","Basingstoke and Deane 016D","E01022504","Total",1504,736,768,1481,23,47,77.57,19.4
"2011","Basingstoke and Deane 016E","E01022505","Total",1549,779,770,1545,4,28,65.93,23.5
"2011","Basingstoke and Deane 017A","E01022467","Total",1660,816,844,1658,2,24,712.64,2.3
"2011","Basingstoke and Deane 017B","E01022468","Total",1792,852,940,1675,117,41,1749.44,1.0
"2011","Basingstoke and Deane 017C","E01022469","Total",1570,759,811,1570,0,33,57.97,27.1
"2011","Basingstoke and Deane 017D","E01022561","Total",1467,742,725,1467,0,71,7288.46,0.2
"2011","Basingstoke and Deane 017E","E01022562","Total",1329,665,664,1321,8,39,3232.70,0.4
"2011","Basingstoke and Deane 018A","E01022515","Total",1291,628,663,1291,0,11,81.42,15.9
"2011","Basingstoke and Deane 018B","E01022516","Total",1484,714,770,1480,4,19,94.02,15.8
"2011","Basingstoke and Deane 018C","E01022517","Total",1241,610,631,1234,7,29,29.35,42.3
"2011","Basingstoke and Deane 018D","E01022518","Total",2008,1012,996,2008,0,33,58.19,34.5
"2011","Basingstoke and Deane 018E","E01022519","Total",1261,644,617,1261,0,25,46.57,27.1
"2011","Basingstoke and Deane 019A","E01022474","Total",1552,725,827,1552,0,11,43.08,36.0
"2011","Basingstoke and Deane 019B","E01022477","Total",1376,679,697,1376,0,11,43.13,31.9
"2011","Basingstoke and Deane 019C","E01022478","Total",1437,693,744,1437,0,7,21.40,67.1
"2011","Basingstoke and Deane 019D","E01022479","Total",1369,657,712,1369,0,11,23.12,59.2
"2011","Basingstoke and Deane 019E","E01022509","Total",1430,708,722,1430,0,22,27.88,51.3
"2011","Basingstoke and Deane 020A","E01022514","Total",1514,754,760,1512,2,53,4171.34,0.4
"2011","Basingstoke and Deane 020B","E01022563","Total",1795,879,916,1738,57,62,2340.49,0.8
"2011","Basingstoke and Deane 020C","E01022564","Total",1811,877,934,1811,0,25,2116.38,0.9
"2011","Basingstoke and Deane 020D","E01022565","Total",1628,769,859,1628,0,31,185.68,8.8
"2011","Basingstoke and Deane 021B","E01022510","Total",1665,814,851,1665,0,52,39.82,41.8
"2011","Basingstoke and Deane 021C","E01022511","Total",1286,644,642,1286,0,33,30.22,42.6
"2011","Basingstoke and Deane 021D","E01022512","Total",1405,699,706,1405,0,33,25.92,54.2
"2011","Basingstoke and Deane 021E","E01032848","Total",1585,786,799,1585,0,14,28.09,56.4
"2011","Basingstoke and Deane 021F","E01032849","Total",1549,756,793,1549,0,17,22.70,68.2
"2011","Basingstoke and Deane 021G","E01032850","Total",1481,736,745,1481,0,26,67.07,22.1
"2011","Basingstoke and Deane 022A","E01022532","Total",1336,677,659,1332,4,36,2376.90,0.6
"2011","Basingstoke and Deane 022B","E01022533","Total",1784,909,875,1784,0,72,5622.40,0.3
"2011","Basingstoke and Deane 022C","E01022534","Total",1639,799,840,1639,0,17,108.32,15.1
"2011","Basingstoke and Deane 022D","E01022535","Total",1514,752,762,1464,50,22,84.97,17.8
"2011","East Hampshire 001A","E01022581","Total",1572,728,844,1455,117,42,1480.33,1.1
"2011","East Hampshire 001B","E01022582","Total",1411,683,728,1411,0,75,2631.71,0.5
"2011","East Hampshire 001C","E01022604","Total",1255,611,644,1201,54,53,3480.44,0.4
"2011","East Hampshire 001D","E01022605","Total",1618,787,831,1457,161,57,304.30,5.3
"2011","East Hampshire 002A","E01022574","Total",1400,670,730,1318,82,16,32.00,43.8
"2011","East Hampshire 002B","E01022575","Total",1522,736,786,1522,0,12,28.84,52.8
"2011","East Hampshire 002C","E01022576","Total",1524,722,802,1520,4,15,34.14,44.6
"2011","East Hampshire 002D","E01022579","Total",1119,565,554,1114,5,7,67.14,16.7
"2011","East Hampshire 003A","E01022571","Total",1203,583,620,1203,0,15,48.76,24.7
"2011","East Hampshire 003B","E01022572","Total",1244,598,646,1244,0,21,33.00,37.7
"2011","East Hampshire 003C","E01022573","Total",2448,1236,1212,2444,4,34,276.07,8.9
"2011","East Hampshire 003D","E01022577","Total",1483,707,776,1483,0,15,44.23,33.5
"2011","East Hampshire 003E","E01022578","Total",3001,1437,1564,2971,30,58,233.38,12.9
"2011","East Hampshire 003F","E01022580","Total",1254,611,643,1180,74,25,27.21,46.1
"2011","East Hampshire 004A","E01022603","Total",1430,707,723,1416,14,26,1179.46,1.2
"2011","East Hampshire 004B","E01022634","Total",1079,510,569,1079,0,11,20.48,52.7
"2011","East Hampshire 004C","E01022639","Total",1886,1065,821,1637,249,20,59.08,31.9
"2011","East Hampshire 004D","E01022640","Total",1463,736,727,1454,9,29,227.69,6.4
"2011","East Hampshire 006A","E01022615","Total",2791,1378,1413,2757,34,37,78.50,35.6
"2011","East Hampshire 006B","E01022633","Total",1339,645,694,1303,36,9,27.25,49.1
"2011","East Hampshire 006C","E01022635","Total",1486,724,762,1486,0,14,33.43,44.5
"2011","East Hampshire 006D","E01022636","Total",1338,666,672,1338,0,14,39.32,34.0
"2011","East Hampshire 006E","E01022641","Total",1245,654,591,1245,0,16,20.65,60.3
"2011","East Hampshire 007A","E01022591","Total",2448,1221,1227,2440,8,108,4669.85,0.5
"2011","East Hampshire 007B","E01022593","Total",1272,626,646,1240,32,35,414.07,3.1
"2011","East Hampshire 007C","E01022594","Total",1437,698,739,1434,3,26,193.34,7.4
"2011","East Hampshire 007D","E01022595","Total",1933,952,981,1903,30,58,170.90,11.3
"2011","East Hampshire 007E","E01022596","Total",1377,691,686,1363,14,46,1002.17,1.4
"2011","East Hampshire 007F","E01022627","Total",2202,1080,1122,2202,0,72,4347.29,0.5
"2011","East Hampshire 008A","E01022630","Total",2249,1118,1131,2248,1,78,4191.95,0.5
"2011","East Hampshire 008D","E01022642","Total",1087,524,563,1078,9,22,1039.29,1.0
"2011","East Hampshire 008E","E01032663","Total",2336,1160,1176,2336,0,35,541.21,4.3
"2011","East Hampshire 009A","E01022583","Total",1684,804,880,1680,4,51,130.38,12.9
"2011","East Hampshire 009B","E01022584","Total",1782,844,938,1737,45,36,45.97,38.8
"2011","East Hampshire 009C","E01022585","Total",1615,790,825,1615,0,62,740.08,2.2
"2011","East Hampshire 009D","E01022586","Total",1691,841,850,1638,53,61,1591.14,1.1
"2011","East Hampshire 009E","E01022587","Total",1719,824,895,1719,0,32,99.22,17.3
"2011","East Hampshire 010A","E01022616","Total",1702,809,893,1670,32,12,71.39,23.8
"2011","East Hampshire 010B","E01022617","Total",1585,754,831,1542,43,38,574.53,2.8
"2011","East Hampshire 010C","E01022618","Total",1834,839,995,1624,210,49,601.24,3.1
"2011","East Hampshire 010D","E01022631","Total",1292,627,665,1292,0,39,1549.11,0.8
"2011","East Hampshire 010E","E01022632","Total",1170,550,620,1118,52,23,230.25,5.1
"2011","East Hampshire 011A","E01022592","Total",2339,1177,1162,2286,53,87,6545.90,0.4
"2011","East Hampshire 011B","E01022597","Total",2847,1363,1484,2487,360,130,5137.35,0.6
"2011","East Hampshire 011C","E01022619","Total",1337,679,658,1268,69,33,84.28,15.9
"2011","East Hampshire 011D","E01022624","Total",2272,1076,1196,2272,0,80,105.61,21.5
"2011","East Hampshire 011E","E01022625","Total",2744,1268,1476,2659,85,59,210.69,13.0
"2011","East Hampshire 012A","E01022620","Total",1137,567,570,1137,0,3,50.67,22.4
"2011","East Hampshire 012B","E01022621","Total",1426,651,775,1426,0,15,35.50,40.2
"2011","East Hampshire 012C","E01022622","Total",1323,628,695,1314,9,19,139.22,9.5
"2011","East Hampshire 012D","E01022623","Total",2294,1101,1193,2294,0,42,244.31,9.4
"2011","East Hampshire 012F","E01032664","Total",1082,502,580,1082,0,14,23.95,45.2
"2011","East Hampshire 012G","E01032665","Total",1359,652,707,1356,3,17,28.38,47.9
"2011","East Hampshire 013A","E01022588","Total",1611,799,812,1611,0,20,72.70,22.2
"2011","East Hampshire 013B","E01022589","Total",1747,860,887,1745,2,30,2056.63,0.8
"2011","East Hampshire 013C","E01022590","Total",1496,750,746,1496,0,17,57.57,26.0
"2011","East Hampshire 013D","E01022607","Total",1192,567,625,1192,0,15,27.34,43.6
"2011","East Hampshire 013E","E01022608","Total",1342,657,685,1335,7,21,30.13,44.5
"2011","East Hampshire 014A","E01022606","Total",2394,1183,1211,2394,0,52,951.74,2.5
"2011","East Hampshire 014B","E01022611","Total",1531,722,809,1531,0,11,31.65,48.4
"2011","East Hampshire 014C","E01022613","Total",1373,672,701,1371,2,31,68.85,19.9
"2011","East Hampshire 014D","E01022614","Total",1089,517,572,1087,2,11,28.64,38.0
"2011","East Hampshire 016A","E01022610","Total",1341,634,707,1286,55,17,589.40,2.3
"2011","East Hampshire 016B","E01022628","Total",1157,566,591,1154,3,23,198.35,5.8
"2011","East Hampshire 016C","E01022629","Total",1373,651,722,1339,34,60,880.63,1.6
"2011","East Hampshire 016D","E01032615","Total",1111,535,576,1075,36,6,54.58,20.4
"2011","East Hampshire 016E","E01032616","Total",1569,769,800,1569,0,24,33.85,46.4
"2011","East Hampshire 017A","E01022599","Total",1291,623,668,1261,30,13,75.52,17.1
"2011","East Hampshire 017B","E01022600","Total",1473,706,767,1452,21,39,204.94,7.2
"2011","East Hampshire 017C","E01022601","Total",1439,695,744,1435,4,29,473.42,3.0
"2011","East Hampshire 017D","E01022602","Total",1271,626,645,1267,4,32,97.20,13.1
"2011","East Hampshire 017E","E01032625","Total",1122,530,592,1096,26,36,294.36,3.8
"2011","Eastleigh 001A","E01022705","Total",1606,741,865,1544,62,36,65.21,24.6
"2011","Eastleigh 001B","E01022706","Total",1667,816,851,1661,6,50,100.06,16.7
"2011","Eastleigh 001C","E01022707","Total",2015,1016,999,2015,0,43,66.57,30.3
"2011","Eastleigh 001D","E01022708","Total",1759,856,903,1759,0,33,48.14,36.5
"2011","Eastleigh 001E","E01022709","Total",1754,835,919,1685,69,39,63.01,27.8
"2011","Eastleigh 002A","E01022659","Total",1599,779,820,1599,0,12,32.11,49.8
"2011","Eastleigh 002B","E01022660","Total",1501,722,779,1501,0,13,35.92,41.8
"2011","Eastleigh 002C","E01022675","Total",1403,709,694,1403,0,22,62.78,22.3
"2011","Eastleigh 002D","E01022676","Total",1512,764,748,1512,0,28,128.22,11.8
"2011","Eastleigh 002E","E01022704","Total",1830,875,955,1830,0,16,43.24,42.3
"2011","Eastleigh 003A","E01022661","Total",1689,833,856,1653,36,18,45.37,37.2
"2011","Eastleigh 003B","E01022662","Total",1344,640,704,1335,9,23,37.29,36.0
"2011","Eastleigh 003C","E01022663","Total",1625,813,812,1625,0,30,74.95,21.7
"2011","Eastleigh 003D","E01022664","Total",1550,739,811,1527,23,33,37.97,40.8
"2011","Eastleigh 003E","E01022665","Total",1497,735,762,1492,5,18,63.34,23.6
"2011","Eastleigh 004A","E01022648","Total",1289,638,651,1286,3,5,96.33,13.4
"2011","Eastleigh 004B","E01022667","Total",1500,769,731,1500,0,9,47.06,31.9
"2011","Eastleigh 004C","E01022672","Total",1581,799,782,1575,6,10,30.85,51.2
"2011","Eastleigh 004D","E01022673","Total",2090,1060,1030,2090,0,15,56.32,37.1
"2011","Eastleigh 004E","E01022674","Total",1595,772,823,1595,0,16,52.15,30.6
"2011","Eastleigh 005A","E01022643","Total",1617,807,810,1611,6,11,99.76,16.2
"2011","Eastleigh 005B","E01022644","Total",1320,646,674,1320,0,10,30.73,43.0
"2011","Eastleigh 005C","E01022646","Total",1569,786,783,1569,0,16,23.17,67.7
"2011","Eastleigh 005D","E01022647","Total",1534,756,778,1509,25,18,139.99,11.0
"2011","Eastleigh 005E","E01022649","Total",1627,797,830,1627,0,18,29.21,55.7
"2011","Eastleigh 005F","E01022650","Total",1149,561,588,1144,5,8,97.76,11.8
"2011","Eastleigh 006A","E01022668","Total",2606,1280,1326,2599,7,12,43.60,59.8
"2011","Eastleigh 006B","E01022677","Total",2007,968,1039,2007,0,9,512.65,3.9
"2011","Eastleigh 006C","E01022678","Total",1891,897,994,1829,62,7,41.36,45.7
"2011","Eastleigh 006D","E01022680","Total",1604,744,860,1604,0,5,34.90,46.0
"2011","Eastleigh 006E","E01022681","Total",1574,758,816,1574,0,4,89.32,17.6
"2011","Eastleigh 007A","E01022666","Total",2133,1102,1031,2124,9,14,35.14,60.7
"2011","Eastleigh 007B","E01022669","Total",1792,893,899,1789,3,5,15.82,113.3
"2011","Eastleigh 007C","E01022670","Total",1604,792,812,1592,12,6,125.16,12.8
"2011","Eastleigh 007D","E01022671","Total",1527,763,764,1519,8,13,88.55,17.2
"2011","Eastleigh 007E","E01022679","Total",1827,933,894,1827,0,12,24.88,73.4
"2011","Eastleigh 008A","E01022645","Total",1172,567,605,1172,0,9,94.51,12.4
"2011","Eastleigh 008B","E01022682","Total",1389,682,707,1354,35,17,374.30,3.7
"2011","Eastleigh 008C","E01022683","Total",1389,688,701,1382,7,25,250.21,5.6
"2011","Eastleigh 008D","E01022684","Total",1514,773,741,1508,6,18,28.65,52.8
"2011","Eastleigh 008E","E01022685","Total",1196,606,590,1196,0,17,28.41,42.1
"2011","Eastleigh 008F","E01022686","Total",1661,831,830,1661,0,19,163.57,10.2
"2011","Eastleigh 008G","E01022687","Total",1760,902,858,1760,0,22,57.56,30.6
"2011","Eastleigh 009A","E01022713","Total",1744,833,911,1620,124,11,811.68,2.1
"2011","Eastleigh 009B","E01022714","Total",1668,828,840,1668,0,29,46.38,36.0
"2011","Eastleigh 009C","E01022715","Total",1589,738,851,1589,0,14,102.07,15.6
"2011","Eastleigh 009D","E01022716","Total",1550,734,816,1550,0,17,27.22,56.9
"2011","Eastleigh 009E","E01022717","Total",1204,600,604,1204,0,13,25.45,47.3
"2011","Eastleigh 009F","E01022718","Total",1462,740,722,1462,0,19,38.68,37.8
"2011","Eastleigh 009G","E01022719","Total",1544,761,783,1516,28,28,162.27,9.5
"2011","Eastleigh 010A","E01022653","Total",1485,735,750,1456,29,20,409.44,3.6
"2011","Eastleigh 010B","E01022691","Total",1583,771,812,1583,0,16,25.94,61.0
"2011","Eastleigh 010C","E01022692","Total",2845,1364,1481,2845,0,19,56.24,50.6
"2011","Eastleigh 010D","E01022693","Total",1531,761,770,1531,0,22,27.02,56.7
"2011","Eastleigh 010E","E01022694","Total",1789,891,898,1789,0,25,114.46,15.6
"2011","Eastleigh 011A","E01022652","Total",1764,838,926,1758,6,20,286.29,6.2
"2011","Eastleigh 011B","E01022695","Total",1332,623,709,1327,5,13,25.82,51.6
"2011","Eastleigh 011C","E01022700","Total",1572,744,828,1572,0,8,69.64,22.6
"2011","Eastleigh 011D","E01022701","Total",1086,518,568,1011,75,15,32.53,33.4
"2011","Eastleigh 011E","E01022703","Total",1467,714,753,1467,0,10,26.52,55.3
"2011","Eastleigh 012A","E01022651","Total",1834,872,962,1834,0,18,153.22,12.0
"2011","Eastleigh 012B","E01022696","Total",1556,755,801,1556,0,12,31.08,50.1
"2011","Eastleigh 012C","E01022697","Total",1592,752,840,1525,67,25,63.89,24.9
"2011","Eastleigh 012D","E01022698","Total",1621,802,819,1565,56,12,125.34,12.9
"2011","Eastleigh 012E","E01022699","Total",1530,765,765,1516,14,9,36.28,42.2
"2011","Eastleigh 012F","E01022702","Total",1286,645,641,1286,0,19,73.69,17.5
"2011","Eastleigh 013A","E01022654","Total",1351,662,689,1344,7,11,21.38,63.2
"2011","Eastleigh 013B","E01022655","Total",1542,713,829,1536,6,4,19.52,79.0
"2011","Eastleigh 013C","E01022656","Total",1476,714,762,1462,14,12,242.57,6.1
"2011","Eastleigh 013D","E01022657","Total",1626,814,812,1618,8,13,282.16,5.8
"2011","Eastleigh 013E","E01022658","Total",1669,811,858,1669,0,34,139.72,11.9
"2011","Eastleigh 014A","E01022710","Total",2010,1005,1005,1947,63,12,134.22,15.0
"2011","Eastleigh 014B","E01022711","Total",1713,805,908,1713,0,12,37.48,45.7
"2011","Eastleigh 014C","E01022712","Total",1609,768,841,1586,23,16,33.42,48.1
"2011","Eastleigh 015A","E01022688","Total",2221,1131,1090,2221,0,22,154.01,14.4
"2011","Eastleigh 015B","E01022689","Total",1517,743,774,1513,4,18,413.25,3.7
"2011","Eastleigh 015C","E01022690","Total",1963,991,972,1963,0,9,112.78,17.4
"2011","Fareham 001A","E01022758","Total",1628,776,852,1522,106,31,78.18,20.8
"2011","Fareham 001B","E01022771","Total",1645,825,820,1645,0,15,57.97,28.4
"2011","Fareham 001C","E01022772","Total",2211,1159,1052,2211,0,27,142.41,15.5
"2011","Fareham 001D","E01022773","Total",1577,774,803,1571,6,28,269.52,5.9
"2011","Fareham 001E","E01022774","Total",1952,985,967,1898,54,47,300.80,6.5
"2011","Fareham 002A","E01022749","Total",1359,667,692,1359,0,22,29.90,45.5
"2011","Fareham 002B","E01022753","Total",1248,596,652,1248,0,17,21.89,57.0
"2011","Fareham 002C","E01022754","Total",1795,874,921,1759,36,24,102.22,17.6
"2011","Fareham 002D","E01022780","Total",1561,795,766,1549,12,15,114.67,13.6
"2011","Fareham 002E","E01022787","Total",1340,661,679,1309,31,18,40.67,32.9
"2011","Fareham 002F","E01022788","Total",1256,607,649,1256,0,12,24.31,51.7
"2011","Fareham 003A","E01022730","Total",1476,701,775,1474,2,29,42.74,34.5
"2011","Fareham 003B","E01022731","Total",1341,669,672,1341,0,8,20.94,64.0
"2011","Fareham 003C","E01022732","Total",1534,725,809,1531,3,7,75.69,20.3
"2011","Fareham 003D","E01022733","Total",1685,815,870,1685,0,24,35.26,47.8
"2011","Fareham 003E","E01022734","Total",1365,659,706,1326,39,9,21.45,63.6
"2011","Fareham 004A","E01022720","Total",1418,721,697,1396,22,35,654.64,2.2
"2011","Fareham 004B","E01022725","Total",1314,622,692,1214,100,32,55.83,23.5
"2011","Fareham 004C","E01022726","Total",1448,712,736,1414,34,21,50.95,28.4
"2011","Fareham 004D","E01022727","Total",1571,749,822,1568,3,22,36.94,42.5
"2011","Fareham 004E","E01022729","Total",1177,607,570,1177,0,10,395.34,3.0
"2011","Fareham 004F","E01022743","Total",1812,888,924,1789,23,28,44.31,40.9
"2011","Fareham 005A","E01022750","Total",1508,702,806,1483,25,25,42.42,35.5
"2011","Fareham 005B","E01022751","Total",1567,766,801,1567,0,31,43.17,36.3
"2011","Fareham 005C","E01022752","Total",1422,716,706,1418,4,30,32.48,43.8
"2011","Fareham 005D","E01022757","Total",1603,791,812,1603,0,15,23.71,67.6
"2011","Fareham 005E","E01022790","Total",1800,908,892,1800,0,35,121.64,14.8
"2011","Fareham 006A","E01022755","Total",1463,694,769,1463,0,25,58.02,25.2
"2011","Fareham 006B","E01022756","Total",1322,651,671,1303,19,29,33.04,40.0
"2011","Fareham 006C","E01022791","Total",2086,1122,964,1883,203,28,88.71,23.5
"2011","Fareham 006D","E01022792","Total",1542,756,786,1542,0,20,565.28,2.7
"2011","Fareham 006E","E01022793","Total",1755,857,898,1732,23,44,155.73,11.3
"2011","Fareham 007A","E01022781","Total",1388,682,706,1388,0,38,695.14,2.0
"2011","Fareham 007B","E01022782","Total",1439,702,737,1403,36,36,256.83,5.6
"2011","Fareham 007C","E01022785","Total",1495,755,740,1493,2,20,29.35,50.9
"2011","Fareham 007D","E01022786","Total",1597,796,801,1597,0,20,83.47,19.1
"2011","Fareham 007E","E01022789","Total",1445,722,723,1438,7,18,33.20,43.5
"2011","Fareham 008A","E01022721","Total",1402,688,714,1384,18,19,151.08,9.3
"2011","Fareham 008B","E01022722","Total",1711,795,916,1612,99,25,39.32,43.5
"2011","Fareham 008C","E01022723","Total",1481,709,772,1464,17,12,45.58,32.5
"2011","Fareham 008D","E01022724","Total",1450,708,742,1450,0,13,36.53,39.7
"2011","Fareham 008E","E01022737","Total",1578,824,754,1562,16,13,28.40,55.6
"2011","Fareham 008F","E01022766","Total",1322,661,661,1283,39,33,210.35,6.3
"2011","Fareham 008G","E01022769","Total",1258,629,629,1223,35,5,28.78,43.7
"2011","Fareham 009A","E01022740","Total",1620,783,837,1620,0,18,32.28,50.2
"2011","Fareham 009B","E01022741","Total",1248,609,639,1212,36,12,30.00,41.6
"2011","Fareham 009C","E01022742","Total",1758,847,911,1753,5,15,77.34,22.7
"2011","Fareham 009D","E01022783","Total",1507,742,765,1477,30,23,51.91,29.0
"2011","Fareham 009E","E01022784","Total",1385,696,689,1334,51,21,37.10,37.3
"2011","Fareham 010A","E01022759","Total",1530,765,765,1530,0,11,64.80,23.6
"2011","Fareham 010B","E01022763","Total",1535,740,795,1535,0,12,81.66,18.8
"2011","Fareham 010C","E01022765","Total",1692,806,886,1692,0,13,41.05,41.2
"2011","Fareham 010D","E01022768","Total",1357,677,680,1357,0,6,52.49,25.9
"2011","Fareham 010E","E01022770","Total",1733,867,866,1706,27,30,56.90,30.5
"2011","Fareham 011A","E01022728","Total",1777,874,903,1733,44,12,28.98,61.3
"2011","Fareham 011B","E01022735","Total",1449,724,725,1441,8,13,49.45,29.3
"2011","Fareham 011C","E01022736","Total",1537,779,758,1537,0,14,28.68,53.6
"2011","Fareham 011D","E01022738","Total",1043,524,519,1043,0,4,64.24,16.2
"2011","Fareham 011E","E01022739","Total",1624,731,893,1621,3,4,20.05,81.0
"2011","Fareham 012A","E01022760","Total",1528,746,782,1528,0,8,31.66,48.3
"2011","Fareham 012B","E01022761","Total",1502,723,779,1502,0,13,62.72,23.9
"2011","Fareham 012C","E01022762","Total",1531,747,784,1531,0,15,23.92,64.0
"2011","Fareham 012D","E01022764","Total",1564,760,804,1564,0,20,45.92,34.1
"2011","Fareham 012E","E01022767","Total",1237,611,626,1237,0,7,24.03,51.5
"2011","Fareham 013B","E01022776","Total",1563,787,776,1563,0,35,30.81,50.7
"2011","Fareham 013C","E01022777","Total",1642,753,889,1637,5,15,46.53,35.3
"2011","Fareham 013D","E01022778","Total",1529,738,791,1441,88,13,293.50,5.2
"2011","Fareham 013F","E01032877","Total",2173,1026,1147,2086,87,22,411.56,5.3
"2011","Fareham 014A","E01022744","Total",1353,666,687,1348,5,24,45.15,30.0
"2011","Fareham 014B","E01022745","Total",1504,725,779,1473,31,37,106.17,14.2
"2011","Fareham 014C","E01022746","Total",1645,771,874,1627,18,34,60.88,27.0
"2011","Fareham 014D","E01022747","Total",1245,546,699,1241,4,24,76.41,16.3
"2011","Fareham 014E","E01022748","Total",1423,650,773,1423,0,33,28.22,50.4
"2011","Gosport 001A","E01022800","Total",1649,828,821,1649,0,10,28.20,58.5
"2011","Gosport 001B","E01022801","Total",1525,735,790,1525,0,7,22.67,67.3
"2011","Gosport 001C","E01022802","Total",1492,737,755,1492,0,12,101.56,14.7
"2011","Gosport 001D","E01022803","Total",1651,808,843,1651,0,7,39.42,41.9
"2011","Gosport 001E","E01022836","Total",1438,696,742,1438,0,7,40.87,35.2
"2011","Gosport 002A","E01022804","Total",1582,796,786,1579,3,8,170.87,9.3
"2011","Gosport 002B","E01022805","Total",1501,721,780,1501,0,8,35.04,42.8
"2011","Gosport 002C","E01022834","Total",1335,654,681,1335,0,4,22.36,59.7
"2011","Gosport 002D","E01022835","Total",1468,706,762,1468,0,4,24.60,59.7
"2011","Gosport 002E","E01022840","Total",1608,794,814,1608,0,12,29.08,55.3
"2011","Gosport 003A","E01022813","Total",1409,718,691,1409,0,9,17.28,81.5
"2011","Gosport 003B","E01022814","Total",1682,812,870,1673,9,18,163.27,10.3
"2011","Gosport 003C","E01022815","Total",1553,768,785,1553,0,20,26.08,59.5
"2011","Gosport 003D","E01022823","Total",1547,767,780,1547,0,13,21.46,72.1
"2011","Gosport 003E","E01022825","Total",1440,734,706,1440,0,20,20.97,68.7
"2011","Gosport 004A","E01022819","Total",1586,778,808,1586,0,8,17.80,89.1
"2011","Gosport 004B","E01022820","Total",1825,892,933,1825,0,18,47.91,38.1
"2011","Gosport 004E","E01022841","Total",1509,718,791,1447,62,3,36.54,41.3
"2011","Gosport 004F","E01022842","Total",1681,841,840,1681,0,14,57.72,29.1
"2011","Gosport 004G","E01032882","Total",2066,998,1068,2066,0,8,70.76,29.2
"2011","Gosport 005A","E01022807","Total",1559,761,798,1559,0,2,12.46,125.1
"2011","Gosport 005B","E01022816","Total",1492,742,750,1492,0,15,15.72,94.9
"2011","Gosport 005C","E01022817","Total",1794,910,884,1783,11,8,23.67,75.8
"2011","Gosport 005D","E01022818","Total",1457,716,741,1457,0,3,16.04,90.8
"2011","Gosport 005E","E01022824","Total",2722,1406,1316,2707,15,16,57.56,47.3
"2011","Gosport 006A","E01022826","Total",1534,742,792,1534,0,19,34.28,44.7
"2011","Gosport 006C","E01022828","Total",1300,583,717,1300,0,7,29.24,44.5
"2011","Gosport 006D","E01022829","Total",2093,1036,1057,1985,108,54,92.66,22.6
"2011","Gosport 006E","E01022830","Total",1408,669,739,1402,6,13,96.32,14.6
"2011","Gosport 006F","E01032880","Total",1415,685,730,1415,0,18,80.27,17.6
"2011","Gosport 006G","E01032881","Total",1744,875,869,1744,0,28,115.22,15.1
"2011","Gosport 006H","E01032883","Total",1366,663,703,1366,0,13,24.64,55.4
"2011","Gosport 007A","E01022806","Total",1490,750,740,1445,45,4,20.39,73.1
"2011","Gosport 007D","E01022832","Total",1651,819,832,1648,3,17,22.47,73.5
"2011","Gosport 007E","E01022839","Total",1355,695,660,1339,16,12,20.74,65.3
"2011","Gosport 007F","E01032884","Total",2095,1029,1066,2094,1,19,149.91,14.0
"2011","Gosport 008A","E01022810","Total",1583,832,751,1574,9,7,18.12,87.4
"2011","Gosport 008B","E01022811","Total",2270,1150,1120,2267,3,10,47.86,47.4
"2011","Gosport 008C","E01022833","Total",1854,935,919,1822,32,16,40.54,45.7
"2011","Gosport 008D","E01022843","Total",1570,737,833,1537,33,5,26.86,58.5
"2011","Gosport 008F","E01032878","Total",1109,572,537,1109,0,7,26.72,41.5
"2011","Gosport 008G","E01032879","Total",1208,634,574,1208,0,0,25.15,48.0
"2011","Gosport 009A","E01022794","Total",1472,709,763,1411,61,47,72.33,20.4
"2011","Gosport 009B","E01022795","Total",1503,751,752,1503,0,14,58.00,25.9
"2011","Gosport 009C","E01022796","Total",1259,598,661,1119,140,17,39.07,32.2
"2011","Gosport 009D","E01022837","Total",1603,776,827,1603,0,34,37.20,43.1
"2011","Gosport 009E","E01022838","Total",1312,617,695,1312,0,16,26.34,49.8
"2011","Gosport 010A","E01022797","Total",1121,558,563,1033,88,15,27.10,41.4
"2011","Gosport 010B","E01022798","Total",1205,629,576,1068,137,18,94.90,12.7
"2011","Gosport 010C","E01022799","Total",1376,661,715,1302,74,39,115.20,11.9
"2011","Gosport 010D","E01022812","Total",1249,613,636,1249,0,18,12.77,97.8
"2011","Gosport 010E","E01022831","Total",1446,718,728,1446,0,15,27.65,52.3
"2011","Gosport 010F","E01022845","Total",1460,664,796,1460,0,10,30.23,48.3
"2011","Hart 001A","E01022890","Total",1470,700,770,1470,0,20,41.90,35.1
"2011","Hart 001B","E01022891","Total",1743,843,900,1741,2,43,206.45,8.4
"2011","Hart 001C","E01022892","Total",1862,920,942,1862,0,34,83.92,22.2
"2011","Hart 001D","E01022893","Total",1611,765,846,1611,0,32,134.92,11.9
"2011","Hart 001E","E01022894","Total",1478,728,750,1478,0,26,54.68,27.0
"2011","Hart 002A","E01022859","Total",1653,807,846,1648,5,37,1262.11,1.3
"2011","Hart 002B","E01022895","Total",1834,890,944,1834,0,29,31.36,58.5
"2011","Hart 002C","E01022896","Total",1618,794,824,1618,0,34,56.41,28.7
"2011","Hart 002D","E01022897","Total",1697,852,845,1697,0,31,48.36,35.1
"2011","Hart 002E","E01022898","Total",1516,751,765,1516,0,36,213.58,7.1
"2011","Hart 003A","E01022846","Total",1182,637,545,1070,112,16,1018.24,1.2
"2011","Hart 003B","E01022847","Total",1738,874,864,1738,0,16,108.88,16.0
"2011","Hart 003C","E01022848","Total",1553,762,791,1553,0,16,37.78,41.1
"2011","Hart 003D","E01022874","Total",1360,678,682,1360,0,8,25.82,52.7
"2011","Hart 003E","E01022875","Total",1466,737,729,1466,0,18,24.77,59.2
"2011","Hart 003F","E01022876","Total",1360,673,687,1360,0,18,55.78,24.4
"2011","Hart 003G","E01022877","Total",1456,738,718,1456,0,20,122.45,11.9
"2011","Hart 004A","E01022858","Total",1055,544,511,1045,10,38,3189.96,0.3
"2011","Hart 004B","E01022878","Total",1731,825,906,1731,0,61,341.42,5.1
"2011","Hart 004C","E01022879","Total",1775,849,926,1775,0,29,1644.12,1.1
"2011","Hart 004D","E01022880","Total",1493,741,752,1493,0,45,195.38,7.6
"2011","Hart 005A","E01022860","Total",1957,907,1050,1882,75,39,71.81,27.3
"2011","Hart 005B","E01022862","Total",1926,987,939,1926,0,24,44.77,43.0
"2011","Hart 005D","E01022867","Total",1516,770,746,1516,0,26,426.19,3.6
"2011","Hart 005E","E01032852","Total",1742,856,886,1742,0,21,44.34,39.3
"2011","Hart 005F","E01032853","Total",1769,876,893,1769,0,15,79.50,22.3
"2011","Hart 005G","E01032854","Total",1672,844,828,1672,0,23,50.89,32.9
"2011","Hart 005H","E01032857","Total",1026,535,491,1026,0,27,95.35,10.8
"2011","Hart 006A","E01022881","Total",2365,1180,1185,2360,5,40,622.99,3.8
"2011","Hart 006B","E01022882","Total",1488,746,742,1438,50,56,938.38,1.6
"2011","Hart 006C","E01022883","Total",1383,677,706,1383,0,59,93.57,14.8
"2011","Hart 006D","E01022884","Total",1619,781,838,1560,59,37,45.96,35.2
"2011","Hart 006E","E01022885","Total",1479,740,739,1479,0,51,63.99,23.1
"2011","Hart 007A","E01022861","Total",1711,879,832,1711,0,44,43.36,39.5
"2011","Hart 007B","E01022863","Total",1573,781,792,1573,0,32,43.65,36.0
"2011","Hart 007C","E01022865","Total",1621,832,789,1621,0,54,47.94,33.8
"2011","Hart 007D","E01022868","Total",1699,831,868,1699,0,39,67.59,25.1
"2011","Hart 007E","E01022870","Total",1453,707,746,1427,26,47,85.40,17.0
"2011","Hart 008A","E01022864","Total",1443,720,723,1443,0,17,55.32,26.1
"2011","Hart 008B","E01022871","Total",1418,698,720,1418,0,30,36.22,39.1
"2011","Hart 008C","E01022872","Total",1792,901,891,1792,0,29,59.18,30.3
"2011","Hart 008D","E01022873","Total",1786,827,959,1672,114,74,190.23,9.4
"2011","Hart 008E","E01022887","Total",1445,752,693,1380,65,47,2915.48,0.5
"2011","Hart 009A","E01022849","Total",1701,829,872,1701,0,28,40.97,41.5
"2011","Hart 009B","E01022850","Total",1532,746,786,1475,57,27,54.34,28.2
"2011","Hart 009C","E01022851","Total",1691,791,900,1653,38,17,182.03,9.3
"2011","Hart 009D","E01022853","Total",1743,841,902,1743,0,26,44.64,39.0
"2011","Hart 009E","E01022869","Total",1440,717,723,1435,5,18,48.70,29.6
"2011","Hart 010A","E01022852","Total",1813,886,927,1813,0,31,38.63,46.9
"2011","Hart 010B","E01022854","Total",1736,864,872,1736,0,51,52.81,32.9
"2011","Hart 010C","E01022855","Total",1239,599,640,1239,0,28,199.80,6.2
"2011","Hart 010D","E01022856","Total",1506,718,788,1477,29,57,1905.42,0.8
"2011","Hart 010E","E01022857","Total",1457,703,754,1424,33,40,664.33,2.2
"2011","Hart 011B","E01022888","Total",1686,796,890,1680,6,53,503.71,3.3
"2011","Hart 011C","E01022889","Total",1479,700,779,1479,0,16,173.97,8.5
"2011","Hart 011D","E01032855","Total",1293,664,629,1102,191,68,1849.75,0.7
"2011","Hart 011E","E01032856","Total",2183,1385,798,1401,782,36,747.03,2.9
"2011","Havant 003A","E01022930","Total",1649,801,848,1649,0,11,38.85,42.4
"2011","Havant 003B","E01022931","Total",1663,794,869,1645,18,21,49.76,33.4
"2011","Havant 003C","E01022935","Total",1514,753,761,1514,0,7,27.97,54.1
"2011","Havant 003D","E01022975","Total",1513,727,786,1513,0,5,73.88,20.5
"2011","Havant 003E","E01022976","Total",1511,773,738,1469,42,14,44.77,33.8
"2011","Havant 004A","E01022922","Total",1499,727,772,1499,0,16,77.41,19.4
"2011","Havant 004B","E01022971","Total",1509,753,756,1509,0,21,34.79,43.4
"2011","Havant 004C","E01022972","Total",1583,780,803,1578,5,20,44.60,35.5
"2011","Havant 004D","E01022974","Total",1425,684,741,1425,0,34,54.85,26.0
"2011","Havant 005A","E01022959","Total",1458,686,772,1458,0,8,26.71,54.6
"2011","Havant 005B","E01022962","Total",1480,709,771,1474,6,10,55.52,26.7
"2011","Havant 005C","E01022965","Total",1478,723,755,1478,0,10,23.84,62.0
"2011","Havant 005D","E01022973","Total",2008,934,1074,1894,114,10,63.99,31.4
"2011","Havant 006A","E01022901","Total",1711,806,905,1676,35,5,98.34,17.4
"2011","Havant 006B","E01022902","Total",1572,786,786,1572,0,8,39.91,39.4
"2011","Havant 006C","E01022966","Total",1373,638,735,1373,0,6,130.01,10.6
"2011","Havant 006D","E01022967","Total",1240,602,638,1240,0,1,17.02,72.9
"2011","Havant 007A","E01022960","Total",1421,686,735,1392,29,8,27.90,50.9
"2011","Havant 007B","E01022961","Total",1382,686,696,1382,0,13,53.00,26.1
"2011","Havant 007C","E01022963","Total",1412,704,708,1412,0,18,38.29,36.9
"2011","Havant 007D","E01022964","Total",1376,672,704,1376,0,4,29.27,47.0
"2011","Havant 008A","E01022903","Total",1814,890,924,1795,19,4,72.34,25.1
"2011","Havant 008B","E01022906","Total",1479,717,762,1479,0,2,149.00,9.9
"2011","Havant 008C","E01022968","Total",1447,696,751,1447,0,5,17.75,81.5
"2011","Havant 008D","E01022969","Total",1667,785,882,1667,0,8,29.51,56.5
"2011","Havant 009A","E01022913","Total",1307,640,667,1307,0,4,13.93,93.8
"2011","Havant 009B","E01022914","Total",1302,651,651,1302,0,2,28.50,45.7
"2011","Havant 009C","E01022915","Total",1468,751,717,1468,0,8,30.15,48.7
"2011","Havant 009D","E01022916","Total",1590,747,843,1586,4,3,59.92,26.5
"2011","Havant 009E","E01022917","Total",1243,603,640,1243,0,3,24.22,51.3
"2011","Havant 010A","E01022900","Total",1854,904,950,1854,0,3,31.81,58.3
"2011","Havant 010B","E01022904","Total",1990,984,1006,1990,0,9,45.75,43.5
"2011","Havant 010C","E01022905","Total",1779,846,933,1779,0,3,27.44,64.8
"2011","Havant 010D","E01022908","Total",1453,692,761,1453,0,4,32.94,44.1
"2011","Havant 010E","E01022970","Total",1892,900,992,1892,0,4,32.60,58.0
"2011","Havant 011A","E01022947","Total",1650,828,822,1645,5,26,59.71,27.6
"2011","Havant 011B","E01022948","Total",1639,780,859,1639,0,18,35.58,46.1
"2011","Havant 011C","E01022949","Total",1525,726,799,1525,0,6,119.27,12.8
"2011","Havant 011D","E01022950","Total",1501,750,751,1453,48,17,37.97,39.5
"2011","Havant 011E","E01022951","Total",1393,701,692,1393,0,17,44.50,31.3
"2011","Havant 011F","E01022952","Total",1463,719,744,1463,0,7,64.94,22.5
"2011","Havant 013A","E01022924","Total",1600,789,811,1568,32,34,62.19,25.7
"2011","Havant 013B","E01022925","Total",1400,669,731,1400,0,5,148.43,9.4
"2011","Havant 013C","E01022926","Total",1529,765,764,1529,0,34,89.93,17.0
"2011","Havant 013D","E01022927","Total",1647,760,887,1544,103,14,50.62,32.5
"2011","Havant 013E","E01022928","Total",1755,809,946,1678,77,33,82.16,21.4
"2011","Havant 013F","E01022929","Total",1561,730,831,1559,2,28,48.87,31.9
"2011","Havant 014A","E01022953","Total",2029,986,1043,1992,37,16,107.37,18.9
"2011","Havant 014B","E01022954","Total",1525,736,789,1503,22,30,183.95,8.3
"2011","Havant 014C","E01022955","Total",1375,651,724,1328,47,33,55.21,24.9
"2011","Havant 014D","E01022956","Total",1214,579,635,1214,0,8,25.17,48.2
"2011","Havant 014E","E01022957","Total",1303,628,675,1271,32,15,57.70,22.6
"2011","Havant 014F","E01022958","Total",1436,719,717,1436,0,28,299.86,4.8
"2011","Havant 015A","E01022937","Total",1438,736,702,1387,51,18,509.10,2.8
"2011","Havant 015B","E01022943","Total",1465,727,738,1408,57,28,247.31,5.9
"2011","Havant 015C","E01022944","Total",1271,628,643,1258,13,17,262.52,4.8
"2011","Havant 015D","E01022946","Total",1803,844,959,1740,63,20,103.78,17.4
"2011","Havant 016A","E01022940","Total",1546,724,822,1539,7,13,50.56,30.6
"2011","Havant 016B","E01022942","Total",1572,735,837,1505,67,13,58.62,26.8
"2011","Havant 016C","E01022945","Total",2266,1062,1204,2231,35,16,86.92,26.1
"2011","Havant 017A","E01022936","Total",1491,751,740,1491,0,7,48.91,30.5
"2011","Havant 017B","E01022938","Total",1449,673,776,1342,107,10,75.62,19.2
"2011","Havant 017C","E01022939","Total",1565,765,800,1528,37,8,49.86,31.4
"2011","Havant 017D","E01022941","Total",1513,745,768,1503,10,10,96.27,15.7
"2011","Havant 018A","E01022899","Total",1381,677,704,1381,0,6,41.86,33.0
"2011","Havant 018B","E01022907","Total",1512,724,788,1477,35,12,64.56,23.4
"2011","Havant 018C","E01022909","Total",1577,781,796,1555,22,34,73.03,21.6
"2011","Havant 018D","E01022910","Total",1429,726,703,1421,8,14,30.90,46.2
"2011","Havant 018E","E01022911","Total",1502,763,739,1496,6,15,42.54,35.3
"2011","Havant 018F","E01032605","Total",1362,642,720,1342,20,9,169.98,8.0
"2011","Havant 019A","E01022919","Total",1630,804,826,1619,11,16,30.12,54.1
"2011","Havant 019B","E01022933","Total",1672,830,842,1672,0,6,20.43,81.8
"2011","Havant 019C","E01022934","Total",1923,949,974,1923,0,5,38.05,50.5
"2011","Havant 019D","E01032618","Total",1486,738,748,1486,0,17,37.79,39.3
"2011","Havant 020A","E01022918","Total",1498,717,781,1498,0,15,60.97,24.6
"2011","Havant 020B","E01022920","Total",1570,751,819,1566,4,8,34.38,45.7
"2011","Havant 020C","E01022921","Total",1563,784,779,1563,0,14,41.21,37.9
"2011","Havant 020D","E01032617","Total",1593,776,817,1561,32,12,41.71,38.2
"2011","New Forest 001A","E01023011","Total",1462,732,730,1459,3,37,6285.87,0.2
"2011","New Forest 001B","E01023012","Total",1372,680,692,1369,3,40,2595.21,0.5
"2011","New Forest 001C","E01023021","Total",1592,791,801,1470,122,33,246.30,6.5
"2011","New Forest 001D","E01023022","Total",1790,848,942,1747,43,18,664.26,2.7
"2011","New Forest 001E","E01023023","Total",1757,841,916,1757,0,39,220.50,8.0
"2011","New Forest 001F","E01023024","Total",1539,737,802,1513,26,30,443.53,3.5
"2011","New Forest 001G","E01023025","Total",1364,664,700,1364,0,38,3431.93,0.4
"2011","New Forest 002A","E01023076","Total",1419,704,715,1419,0,11,40.65,34.9
"2011","New Forest 002B","E01023082","Total",1466,739,727,1466,0,15,29.06,50.4
"2011","New Forest 002C","E01023083","Total",1515,737,778,1515,0,6,24.37,62.2
"2011","New Forest 002D","E01023088","Total",1623,767,856,1600,23,16,36.61,44.3
"2011","New Forest 003A","E01023073","Total",1397,690,707,1375,22,23,37.63,37.1
"2011","New Forest 003B","E01023080","Total",1400,696,704,1336,64,16,125.63,11.1
"2011","New Forest 003C","E01023081","Total",2030,979,1051,2005,25,15,48.17,42.1
"2011","New Forest 003D","E01023089","Total",1545,780,765,1545,0,14,28.26,54.7
"2011","New Forest 003E","E01023090","Total",1886,947,939,1886,0,14,54.51,34.6
"2011","New Forest 004A","E01023074","Total",1451,710,741,1418,33,14,26.48,54.8
"2011","New Forest 004B","E01023077","Total",1518,742,776,1490,28,19,63.26,24.0
"2011","New Forest 004C","E01023078","Total",1405,691,714,1399,6,12,116.21,12.1
"2011","New Forest 004D","E01023079","Total",1733,886,847,1733,0,11,39.21,44.2
"2011","New Forest 004E","E01023085","Total",1543,740,803,1535,8,11,314.68,4.9
"2011","New Forest 005A","E01023072","Total",1302,661,641,1300,2,13,26.83,48.5
"2011","New Forest 005B","E01023075","Total",1191,570,621,1191,0,15,31.55,37.7
"2011","New Forest 005C","E01023084","Total",1540,739,801,1540,0,18,39.27,39.2
"2011","New Forest 005D","E01023086","Total",1526,729,797,1526,0,15,50.65,30.1
"2011","New Forest 005E","E01023087","Total",1480,713,767,1480,0,19,52.61,28.1
"2011","New Forest 006A","E01022977","Total",1486,737,749,1452,34,18,154.84,9.6
"2011","New Forest 006B","E01022978","Total",1528,727,801,1498,30,17,648.29,2.4
"2011","New Forest 006C","E01022979","Total",1203,578,625,1136,67,19,316.78,3.8
"2011","New Forest 006D","E01022980","Total",1547,768,779,1344,203,17,1028.65,1.5
"2011","New Forest 007A","E01022992","Total",1153,578,575,1153,0,18,1722.95,0.7
"2011","New Forest 007B","E01022993","Total",1362,667,695,1272,90,42,6763.56,0.2
"2011","New Forest 007C","E01023045","Total",1580,768,812,1538,42,14,716.75,2.2
"2011","New Forest 007D","E01023046","Total",1449,693,756,1381,68,22,918.76,1.6
"2011","New Forest 008A","E01023007","Total",1139,539,600,1137,2,16,528.77,2.2
"2011","New Forest 008B","E01023010","Total",1537,720,817,1537,0,7,32.19,47.7
"2011","New Forest 008C","E01023047","Total",1328,663,665,1328,0,20,26.81,49.5
"2011","New Forest 008D","E01023048","Total",1358,663,695,1358,0,24,278.50,4.9
"2011","New Forest 008E","E01023049","Total",1662,850,812,1568,94,17,208.78,8.0
"2011","New Forest 008F","E01023050","Total",1793,900,893,1768,25,21,300.45,6.0
"2011","New Forest 009A","E01023008","Total",1533,734,799,1528,5,5,159.46,9.6
"2011","New Forest 009B","E01023009","Total",1503,756,747,1503,0,14,72.98,20.6
"2011","New Forest 009C","E01023038","Total",1458,693,765,1458,0,18,36.84,39.6
"2011","New Forest 009D","E01023039","Total",1433,675,758,1433,0,11,41.56,34.5
"2011","New Forest 009E","E01023040","Total",1450,724,726,1450,0,18,55.27,26.2
"2011","New Forest 010A","E01023026","Total",1171,583,588,1106,65,32,5371.85,0.2
"2011","New Forest 010B","E01023062","Total",1495,740,755,1477,18,28,443.16,3.4
"2011","New Forest 010C","E01023064","Total",1380,663,717,1356,24,22,27.50,50.2
"2011","New Forest 010D","E01023066","Total",1659,800,859,1642,17,28,194.37,8.5
"2011","New Forest 010E","E01023067","Total",1490,719,771,1490,0,22,52.05,28.6
"2011","New Forest 011A","E01023003","Total",1729,837,892,1727,2,34,58.54,29.5
"2011","New Forest 011B","E01023004","Total",1865,921,944,1837,28,18,52.33,35.6
"2011","New Forest 011C","E01023005","Total",1505,745,760,1469,36,28,43.12,34.9
"2011","New Forest 011D","E01023006","Total",1393,656,737,1391,2,5,23.71,58.8
"2011","New Forest 011E","E01023028","Total",2096,1035,1061,2090,6,20,103.82,20.2
"2011","New Forest 011F","E01023037","Total",1885,902,983,1885,0,10,49.07,38.4
"2011","New Forest 012A","E01023065","Total",1643,795,848,1643,0,13,36.56,44.9
"2011","New Forest 012B","E01023068","Total",1338,626,712,1338,0,7,29.58,45.2
"2011","New Forest 012C","E01023069","Total",1557,749,808,1548,9,26,52.42,29.7
"2011","New Forest 012D","E01023070","Total",1773,800,973,1672,101,16,69.43,25.5
"2011","New Forest 012E","E01023071","Total",1377,665,712,1369,8,18,1233.63,1.1
"2011","New Forest 013A","E01023029","Total",1689,768,921,1681,8,9,64.95,26.0
"2011","New Forest 013B","E01023030","Total",1308,647,661,1308,0,9,110.72,11.8
"2011","New Forest 013C","E01023032","Total",1303,625,678,1303,0,8,34.09,38.2
"2011","New Forest 013D","E01023033","Total",1302,612,690,1302,0,7,25.37,51.3
"2011","New Forest 014A","E01023013","Total",1466,723,743,1463,3,11,245.77,6.0
"2011","New Forest 014B","E01023014","Total",1675,833,842,1675,0,20,237.06,7.1
"2011","New Forest 014C","E01023015","Total",1484,750,734,1445,39,15,1843.37,0.8
"2011","New Forest 014D","E01023016","Total",1391,689,702,1388,3,19,155.35,9.0
"2011","New Forest 014E","E01023027","Total",1430,689,741,1430,0,11,102.70,13.9
"2011","New Forest 014F","E01023031","Total",1239,613,626,1239,0,4,46.95,26.4
"2011","New Forest 015A","E01022989","Total",1811,841,970,1717,94,35,202.90,8.9
"2011","New Forest 015B","E01022991","Total",2070,993,1077,2020,50,57,1475.28,1.4
"2011","New Forest 015C","E01022998","Total",1751,839,912,1638,113,51,4772.38,0.4
"2011","New Forest 015D","E01023000","Total",1801,847,954,1725,76,27,109.13,16.5
"2011","New Forest 016A","E01022994","Total",1579,743,836,1579,0,24,79.54,19.9
"2011","New Forest 016B","E01022995","Total",1414,682,732,1414,0,29,37.96,37.2
"2011","New Forest 016C","E01022996","Total",1245,589,656,1218,27,32,1739.85,0.7
"2011","New Forest 016D","E01022997","Total",1384,642,742,1324,60,29,4552.97,0.3
"2011","New Forest 016E","E01023063","Total",1297,650,647,1225,72,25,2306.40,0.6
"2011","New Forest 017A","E01022990","Total",1570,801,769,1489,81,50,1953.58,0.8
"2011","New Forest 017B","E01022999","Total",2111,1074,1037,2089,22,54,12775.15,0.2
"2011","New Forest 017C","E01023041","Total",1514,716,798,1514,0,37,70.05,21.6
"2011","New Forest 017D","E01023042","Total",1507,652,855,1442,65,14,56.25,26.8
"2011","New Forest 017E","E01023043","Total",1724,759,965,1724,0,20,41.07,42.0
"2011","New Forest 018A","E01022984","Total",1507,717,790,1467,40,30,770.86,2.0
"2011","New Forest 018B","E01022985","Total",1224,575,649,1224,0,16,26.69,45.9
"2011","New Forest 018C","E01023020","Total",1434,696,738,1434,0,16,73.28,19.6
"2011","New Forest 018D","E01023034","Total",1738,812,926,1724,14,21,299.35,5.8
"2011","New Forest 018E","E01023035","Total",1754,828,926,1754,0,14,230.20,7.6
"2011","New Forest 018F","E01023036","Total",1984,940,1044,1984,0,14,462.41,4.3
"2011","New Forest 019A","E01023001","Total",1782,868,914,1782,0,19,58.82,30.3
"2011","New Forest 019B","E01023002","Total",1719,788,931,1719,0,16,165.80,10.4
"2011","New Forest 019C","E01023058","Total",1490,704,786,1490,0,14,32.84,45.4
"2011","New Forest 019D","E01023060","Total",1397,680,717,1397,0,24,277.17,5.0
"2011","New Forest 019E","E01023061","Total",1465,702,763,1465,0,4,42.49,34.5
"2011","New Forest 020A","E01023017","Total",1962,935,1027,1954,8,23,58.50,33.5
"2011","New Forest 020B","E01023018","Total",1432,669,763,1380,52,17,31.48,45.5
"2011","New Forest 020C","E01023019","Total",1451,672,779,1451,0,17,29.43,49.3
"2011","New Forest 020D","E01023055","Total",1290,632,658,1290,0,6,119.80,10.8
"2011","New Forest 021A","E01022986","Total",1424,693,731,1398,26,18,61.43,23.2
"2011","New Forest 021B","E01022988","Total",1501,730,771,1454,47,11,82.09,18.3
"2011","New Forest 021C","E01023054","Total",1775,815,960,1704,71,14,52.39,33.9
"2011","New Forest 021D","E01023056","Total",1537,654,883,1484,53,9,42.83,35.9
"2011","New Forest 021E","E01023057","Total",1723,764,959,1667,56,6,42.00,41.0
"2011","New Forest 022A","E01022981","Total",1967,914,1053,1882,85,11,62.06,31.7
"2011","New Forest 022B","E01022982","Total",1834,831,1003,1794,40,23,76.77,23.9
"2011","New Forest 022C","E01022983","Total",1653,760,893,1631,22,18,97.54,16.9
"2011","New Forest 022D","E01022987","Total",2003,880,1123,1838,165,16,457.68,4.4
"2011","New Forest 023A","E01023044","Total",1099,515,584,1058,41,24,165.53,6.6
"2011","New Forest 023B","E01023051","Total",1541,736,805,1517,24,26,727.26,2.1
"2011","New Forest 023C","E01023052","Total",1641,754,887,1626,15,17,97.77,16.8
"2011","New Forest 023D","E01023053","Total",1656,775,881,1615,41,31,246.20,6.7
"2011","New Forest 023E","E01023059","Total",1710,786,924,1636,74,33,457.40,3.7
"2011","Rushmoor 001A","E01023099","Total",1689,770,919,1587,102,8,38.99,43.3
"2011","Rushmoor 001B","E01023104","Total",1670,823,847,1670,0,17,59.99,27.8
"2011","Rushmoor 001C","E01023106","Total",1479,741,738,1479,0,13,30.68,48.2
"2011","Rushmoor 001D","E01023121","Total",2016,960,1056,2016,0,23,39.49,51.1
"2011","Rushmoor 002A","E01023105","Total",1559,746,813,1559,0,21,25.57,61.0
"2011","Rushmoor 002B","E01023119","Total",1308,628,680,1302,6,7,13.34,98.1
"2011","Rushmoor 002C","E01023120","Total",1797,865,932,1797,0,11,22.50,79.9
"2011","Rushmoor 002D","E01023122","Total",1514,711,803,1514,0,23,19.12,79.2
"2011","Rushmoor 002E","E01023146","Total",1374,661,713,1374,0,24,27.95,49.2
"2011","Rushmoor 003A","E01023100","Total",1257,636,621,1257,0,12,45.17,27.8
"2011","Rushmoor 003B","E01023101","Total",1278,638,640,1278,0,16,21.15,60.4
"2011","Rushmoor 003C","E01023102","Total",1374,705,669,1374,0,13,35.64,38.6
"2011","Rushmoor 003D","E01023134","Total",1811,910,901,1811,0,18,33.39,54.2
"2011","Rushmoor 003E","E01023147","Total",1493,729,764,1493,0,15,30.05,49.7
"2011","Rushmoor 004A","E01023096","Total",2133,1070,1063,2113,20,36,78.49,27.2
"2011","Rushmoor 004B","E01023097","Total",1418,699,719,1418,0,33,59.04,24.0
"2011","Rushmoor 004C","E01023103","Total",1621,811,810,1616,5,35,98.23,16.5
"2011","Rushmoor 004D","E01023111","Total",1818,868,950,1754,64,33,49.38,36.8
"2011","Rushmoor 004E","E01023112","Total",1270,614,656,1270,0,29,28.40,44.7
"2011","Rushmoor 005A","E01023092","Total",1465,731,734,1465,0,21,65.08,22.5
"2011","Rushmoor 005B","E01023093","Total",1376,683,693,1376,0,33,103.95,13.2
"2011","Rushmoor 005C","E01023132","Total",1560,770,790,1560,0,20,36.60,42.6
"2011","Rushmoor 005D","E01023133","Total",1353,652,701,1353,0,23,36.56,37.0
"2011","Rushmoor 005E","E01023135","Total",2419,1161,1258,2419,0,44,40.52,59.7
"2011","Rushmoor 006A","E01023091","Total",1722,847,875,1713,9,22,30.77,56.0
"2011","Rushmoor 006B","E01023094","Total",1330,657,673,1330,0,10,39.74,33.5
"2011","Rushmoor 006C","E01023095","Total",1762,842,920,1762,0,6,77.96,22.6
"2011","Rushmoor 006D","E01023098","Total",1558,767,791,1558,0,13,39.40,39.5
"2011","Rushmoor 006E","E01023148","Total",1379,706,673,1379,0,10,27.73,49.7
"2011","Rushmoor 006F","E01023149","Total",1301,652,649,1301,0,15,33.63,38.7
"2011","Rushmoor 007A","E01023113","Total",1595,813,782,1529,66,25,98.95,16.1
"2011","Rushmoor 007B","E01023114","Total",1460,721,739,1460,0,16,33.12,44.1
"2011","Rushmoor 007C","E01023136","Total",1749,909,840,1749,0,65,710.19,2.5
"2011","Rushmoor 007D","E01023137","Total",1286,675,611,1286,0,14,21.09,61.0
"2011","Rushmoor 007E","E01023138","Total",1367,685,682,1311,56,9,24.78,55.2
"2011","Rushmoor 007F","E01023139","Total",1309,636,673,1225,84,9,34.34,38.1
"2011","Rushmoor 007G","E01023140","Total",1616,804,812,1616,0,16,132.23,12.2
"2011","Rushmoor 008A","E01023141","Total",3120,2033,1087,1858,1262,26,233.83,13.3
"2011","Rushmoor 008B","E01023142","Total",1931,985,946,1913,18,6,105.27,18.3
"2011","Rushmoor 008C","E01023143","Total",2011,996,1015,2006,5,40,675.06,3.0
"2011","Rushmoor 008D","E01023144","Total",1754,904,850,1743,11,20,13.90,126.2
"2011","Rushmoor 009A","E01023118","Total",1749,899,850,1749,0,11,29.97,58.4
"2011","Rushmoor 009B","E01023124","Total",1267,629,638,1267,0,8,15.72,80.6
"2011","Rushmoor 009C","E01023125","Total",2388,1199,1189,2388,0,11,38.09,62.7
"2011","Rushmoor 009F","E01032858","Total",2135,1040,1095,2129,6,12,56.39,37.9
"2011","Rushmoor 010A","E01023128","Total",1386,663,723,1386,0,6,24.57,56.4
"2011","Rushmoor 010B","E01023129","Total",1275,637,638,1265,10,14,13.54,94.2
"2011","Rushmoor 010C","E01023130","Total",1376,689,687,1376,0,11,32.44,42.4
"2011","Rushmoor 010D","E01023131","Total",1414,663,751,1323,91,23,39.48,35.8
"2011","Rushmoor 010E","E01023145","Total",1998,983,1015,1989,9,7,23.82,83.9
"2011","Rushmoor 011A","E01023109","Total",1504,745,759,1504,0,12,20.49,73.4
"2011","Rushmoor 011B","E01023115","Total",1368,666,702,1319,49,16,31.29,43.7
"2011","Rushmoor 011C","E01023116","Total",1802,890,912,1802,0,21,26.45,68.1
"2011","Rushmoor 011D","E01023117","Total",1800,902,898,1794,6,25,39.50,45.6
"2011","Rushmoor 012A","E01023107","Total",1440,694,746,1440,0,14,24.81,58.0
"2011","Rushmoor 012B","E01023108","Total",1366,626,740,1328,38,4,48.35,28.3
"2011","Rushmoor 012C","E01023110","Total",1783,896,887,1783,0,14,38.65,46.1
"2011","Rushmoor 012D","E01023123","Total",1454,722,732,1454,0,9,29.63,49.1
"2011","Test Valley 001A","E01023165","Total",2119,1027,1092,2109,10,89,6677.51,0.3
"2011","Test Valley 001B","E01023169","Total",1947,942,1005,1936,11,23,236.16,8.2
"2011","Test Valley 001C","E01023181","Total",1408,702,706,1408,0,29,31.24,45.1
"2011","Test Valley 001D","E01023182","Total",1569,778,791,1569,0,15,45.99,34.1
"2011","Test Valley 002A","E01023153","Total",1668,846,822,1668,0,18,44.37,37.6
"2011","Test Valley 002B","E01023154","Total",1695,807,888,1695,0,10,22.41,75.6
"2011","Test Valley 002C","E01023156","Total",1486,726,760,1475,11,8,17.10,86.9
"2011","Test Valley 002D","E01023157","Total",1426,683,743,1426,0,2,26.26,54.3
"2011","Test Valley 002E","E01023205","Total",1348,657,691,1348,0,12,17.35,77.7
"2011","Test Valley 003A","E01023155","Total",2768,1390,1378,2711,57,37,1319.17,2.1
"2011","Test Valley 003B","E01023201","Total",1649,803,846,1587,62,10,474.32,3.5
"2011","Test Valley 003C","E01023202","Total",1743,839,904,1703,40,8,71.04,24.5
"2011","Test Valley 003D","E01023215","Total",1568,736,832,1558,10,8,208.40,7.5
"2011","Test Valley 003E","E01023219","Total",1411,672,739,1407,4,20,29.43,47.9
"2011","Test Valley 004A","E01023179","Total",1819,908,911,1819,0,23,38.86,46.8
"2011","Test Valley 004B","E01023183","Total",1474,724,750,1414,60,15,43.28,34.1
"2011","Test Valley 004C","E01023190","Total",1231,597,634,1189,42,24,30.12,40.9
"2011","Test Valley 004D","E01023203","Total",1528,747,781,1528,0,10,36.01,42.4
"2011","Test Valley 004E","E01023204","Total",1710,837,873,1666,44,12,78.19,21.9
"2011","Test Valley 005B","E01023180","Total",1663,790,873,1663,0,22,118.15,14.1
"2011","Test Valley 005C","E01023186","Total",1712,839,873,1707,5,24,44.71,38.3
"2011","Test Valley 005D","E01023189","Total",1638,818,820,1599,39,37,116.30,14.1
"2011","Test Valley 005E","E01023196","Total",1709,845,864,1659,50,51,1480.51,1.2
"2011","Test Valley 005F","E01032870","Total",1911,943,968,1911,0,43,398.13,4.8
"2011","Test Valley 005G","E01032871","Total",1531,741,790,1531,0,42,967.29,1.6
"2011","Test Valley 006A","E01023187","Total",1634,766,868,1457,177,26,39.87,41.0
"2011","Test Valley 006B","E01023188","Total",1332,636,696,1332,0,24,30.05,44.3
"2011","Test Valley 006C","E01023216","Total",1828,904,924,1769,59,5,56.80,32.2
"2011","Test Valley 006D","E01023217","Total",1582,766,816,1564,18,41,58.29,27.1
"2011","Test Valley 006E","E01023218","Total",1522,790,732,1522,0,28,49.19,30.9
"2011","Test Valley 007A","E01023159","Total",2261,1135,1126,2174,87,76,3381.66,0.7
"2011","Test Valley 007B","E01023195","Total",2182,1154,1028,1990,192,81,1890.27,1.2
"2011","Test Valley 007C","E01023197","Total",1504,727,777,1503,1,31,1033.72,1.5
"2011","Test Valley 007D","E01023198","Total",1424,706,718,1424,0,36,2276.84,0.6
"2011","Test Valley 008A","E01023160","Total",1536,757,779,1434,102,50,1972.96,0.8
"2011","Test Valley 008B","E01023168","Total",1442,689,753,1435,7,43,2740.10,0.5
"2011","Test Valley 008C","E01023178","Total",2260,1126,1134,2260,0,76,6317.51,0.4
"2011","Test Valley 009A","E01023166","Total",1477,749,728,1477,0,48,3221.10,0.5
"2011","Test Valley 009B","E01023167","Total",1604,770,834,1562,42,55,4223.02,0.4
"2011","Test Valley 009C","E01023177","Total",2234,1099,1135,2172,62,58,4986.11,0.4
"2011","Test Valley 009D","E01023184","Total",1356,688,668,1356,0,63,4755.06,0.3
"2011","Test Valley 009E","E01023185","Total",1227,593,634,1227,0,38,657.14,1.9
"2011","Test Valley 010A","E01023174","Total",1737,870,867,1737,0,35,31.62,54.9
"2011","Test Valley 010B","E01023175","Total",1625,770,855,1625,0,28,50.39,32.2
"2011","Test Valley 010C","E01023176","Total",1562,715,847,1494,68,28,44.91,34.8
"2011","Test Valley 010D","E01023207","Total",1532,759,773,1532,0,16,36.75,41.7
"2011","Test Valley 010E","E01023208","Total",1151,555,596,1151,0,14,22.23,51.8
"2011","Test Valley 010F","E01023209","Total",1362,663,699,1362,0,16,31.04,43.9
"2011","Test Valley 011A","E01023150","Total",1507,689,818,1507,0,28,40.99,36.8
"2011","Test Valley 011B","E01023151","Total",1473,682,791,1454,19,14,26.27,56.1
"2011","Test Valley 011C","E01023152","Total",1645,719,926,1600,45,24,111.61,14.7
"2011","Test Valley 011D","E01023206","Total",1174,552,622,1153,21,20,27.76,42.3
"2011","Test Valley 012A","E01023158","Total",2267,1126,1141,2261,6,67,1892.20,1.2
"2011","Test Valley 012B","E01023191","Total",1874,906,968,1824,50,19,49.38,38.0
"2011","Test Valley 012C","E01023192","Total",1817,845,972,1817,0,11,37.29,48.7
"2011","Test Valley 012D","E01023193","Total",1590,795,795,1590,0,19,666.73,2.4
"2011","Test Valley 012E","E01023194","Total",1542,763,779,1542,0,16,40.09,38.5
"2011","Test Valley 012F","E01023200","Total",1541,727,814,1471,70,48,292.59,5.3
"2011","Test Valley 013A","E01023162","Total",1807,865,942,1671,136,50,1809.00,1.0
"2011","Test Valley 013B","E01023163","Total",1654,826,828,1654,0,39,912.46,1.8
"2011","Test Valley 013C","E01023164","Total",1613,776,837,1540,73,36,926.56,1.7
"2011","Test Valley 013D","E01023199","Total",1735,908,827,1555,180,45,2956.77,0.6
"2011","Test Valley 014A","E01023210","Total",1579,792,787,1579,0,61,50.15,31.5
"2011","Test Valley 014B","E01023211","Total",1925,942,983,1925,0,25,43.90,43.8
"2011","Test Valley 014C","E01023212","Total",1511,727,784,1511,0,48,89.93,16.8
"2011","Test Valley 014D","E01023213","Total",1366,687,679,1366,0,27,46.64,29.3
"2011","Test Valley 014E","E01023214","Total",1332,657,675,1332,0,30,29.37,45.4
"2011","Test Valley 015A","E01023170","Total",1740,842,898,1740,0,27,553.44,3.1
"2011","Test Valley 015B","E01023171","Total",1628,791,837,1568,60,59,1538.01,1.1
"2011","Test Valley 015C","E01023172","Total",1498,750,748,1498,0,25,103.41,14.5
"2011","Test Valley 015D","E01023173","Total",1475,729,746,1475,0,38,34.51,42.7
"2011","Winchester 001A","E01023286","Total",1446,670,776,1419,27,50,2963.27,0.5
"2011","Winchester 001B","E01023287","Total",2811,1398,1413,2811,0,91,524.90,5.4
"2011","Winchester 001C","E01023288","Total",1387,677,710,1387,0,24,4250.46,0.3
"2011","Winchester 002A","E01023236","Total",1896,943,953,1896,0,85,7270.67,0.3
"2011","Winchester 002B","E01023237","Total",1249,590,659,1249,0,19,42.99,29.1
"2011","Winchester 002C","E01023238","Total",1543,786,757,1434,109,36,695.55,2.2
"2011","Winchester 002D","E01023239","Total",1643,798,845,1624,19,38,156.19,10.5
"2011","Winchester 003A","E01023240","Total",2217,1038,1179,2210,7,50,78.19,28.4
"2011","Winchester 003B","E01023241","Total",1360,661,699,1204,156,61,445.68,3.1
"2011","Winchester 003C","E01023248","Total",1710,836,874,1710,0,43,67.39,25.4
"2011","Winchester 003D","E01023253","Total",1631,736,895,1525,106,38,103.39,15.8
"2011","Winchester 003E","E01023274","Total",1866,984,882,1514,352,88,3670.69,0.5
"2011","Winchester 004A","E01023225","Total",2281,1125,1156,2184,97,93,6484.49,0.4
"2011","Winchester 004B","E01023278","Total",1621,755,866,1621,0,33,47.32,34.3
"2011","Winchester 004C","E01023279","Total",1464,734,730,1464,0,49,71.71,20.4
"2011","Winchester 004D","E01023280","Total",1532,758,774,1501,31,52,2910.08,0.5
"2011","Winchester 004E","E01023281","Total",1732,791,941,1729,3,33,97.94,17.7
"2011","Winchester 005A","E01023247","Total",1536,733,803,1475,61,43,59.65,25.8
"2011","Winchester 005B","E01023249","Total",1220,590,630,1220,0,34,34.74,35.1
"2011","Winchester 005C","E01023250","Total",1739,799,940,1661,78,33,36.53,47.6
"2011","Winchester 005D","E01023268","Total",1334,645,689,1289,45,35,25.75,51.8
"2011","Winchester 005E","E01023269","Total",2359,1033,1326,1698,661,88,169.37,13.9
"2011","Winchester 005F","E01023270","Total",1537,918,619,1194,343,24,25.08,61.3
"2011","Winchester 006A","E01023251","Total",1161,525,636,1130,31,9,34.68,33.5
"2011","Winchester 006B","E01023255","Total",1803,775,1028,1484,319,27,58.97,30.6
"2011","Winchester 006C","E01023256","Total",1406,655,751,1406,0,7,63.83,22.0
"2011","Winchester 006D","E01023257","Total",1508,734,774,1508,0,38,33.37,45.2
"2011","Winchester 006E","E01023258","Total",1568,653,915,1315,253,24,184.05,8.5
"2011","Winchester 007A","E01023252","Total",1787,867,920,1725,62,16,22.60,79.1
"2011","Winchester 007B","E01023254","Total",1828,911,917,1782,46,49,43.16,42.4
"2011","Winchester 007C","E01023263","Total",1387,709,678,1249,138,37,59.47,23.3
"2011","Winchester 007D","E01023264","Total",1978,1285,693,1293,685,114,92.53,21.4
"2011","Winchester 007E","E01023265","Total",1814,889,925,1748,66,60,193.73,9.4
"2011","Winchester 007F","E01023267","Total",1292,646,646,1201,91,31,27.81,46.5
"2011","Winchester 008A","E01023260","Total",1640,704,936,1317,323,26,18.92,86.7
"2011","Winchester 008B","E01023261","Total",1584,718,866,1584,0,15,32.40,48.9
"2011","Winchester 008C","E01023262","Total",1551,701,850,1551,0,15,26.43,58.7
"2011","Winchester 008D","E01023266","Total",1561,745,816,1434,127,38,48.45,32.2
"2011","Winchester 009A","E01023229","Total",2031,1016,1015,2016,15,71,4407.78,0.5
"2011","Winchester 009B","E01023242","Total",1209,595,614,1209,0,30,27.00,44.8
"2011","Winchester 009C","E01023243","Total",1292,619,673,1292,0,21,33.08,39.1
"2011","Winchester 009D","E01023244","Total",1547,727,820,1547,0,47,109.44,14.1
"2011","Winchester 009E","E01023259","Total",1515,751,764,1490,25,54,83.51,18.1
"2011","Winchester 010A","E01023226","Total",1589,745,844,1554,35,57,1272.36,1.2
"2011","Winchester 010B","E01023227","Total",1839,918,921,1839,0,32,410.49,4.5
"2011","Winchester 010C","E01023228","Total",2018,976,1042,2018,0,45,280.24,7.2
"2011","Winchester 010D","E01023230","Total",2126,1014,1112,2024,102,65,465.47,4.6
"2011","Winchester 010E","E01023246","Total",1481,740,741,1476,5,63,3690.79,0.4
"2011","Winchester 011A","E01023235","Total",2019,968,1051,2000,19,77,4090.67,0.5
"2011","Winchester 011B","E01023275","Total",1455,692,763,1455,0,55,774.67,1.9
"2011","Winchester 011C","E01023276","Total",1562,766,796,1562,0,38,173.79,9.0
"2011","Winchester 011D","E01023277","Total",1234,611,623,1234,0,53,1485.84,0.8
"2011","Winchester 011E","E01023282","Total",1881,920,961,1873,8,75,5578.99,0.3
"2011","Winchester 012A","E01023220","Total",2016,974,1042,2016,0,35,201.93,10.0
"2011","Winchester 012B","E01023221","Total",1706,798,908,1706,0,26,353.69,4.8
"2011","Winchester 012C","E01023222","Total",1541,700,841,1481,60,40,1169.31,1.3
"2011","Winchester 012D","E01023223","Total",1460,701,759,1460,0,14,253.88,5.8
"2011","Winchester 012E","E01023272","Total",1255,617,638,1255,0,25,107.64,11.7
"2011","Winchester 012F","E01023273","Total",1481,746,735,1481,0,32,238.98,6.2
"2011","Winchester 013A","E01023245","Total",2390,1179,1211,2273,117,63,2198.57,1.1
"2011","Winchester 013B","E01023271","Total",1206,577,629,1143,63,38,676.44,1.8
"2011","Winchester 013D","E01023284","Total",2742,1393,1349,2641,101,41,971.65,2.8
"2011","Winchester 013E","E01023285","Total",1557,741,816,1540,17,12,561.68,2.8
"2011","Winchester 013F","E01032859","Total",1794,903,891,1794,0,20,522.12,3.4
"2011","Winchester 013G","E01032860","Total",1442,718,724,1442,0,13,73.08,19.7
"2011","Winchester 014A","E01023224","Total",1489,740,749,1300,189,24,3064.59,0.5
"2011","Winchester 014B","E01023231","Total",1753,857,896,1753,0,41,793.08,2.2
"2011","Winchester 014C","E01023232","Total",1907,945,962,1885,22,36,752.11,2.5
"2011","Winchester 014D","E01023233","Total",1493,711,782,1454,39,22,67.26,22.2
"2011","Winchester 014E","E01023234","Total",1583,756,827,1583,0,20,34.90,45.4
"2011","Ashford 001B","E01023987","Total",1041,506,535,1039,2,19,513.45,2.0
"2011","Ashford 001C","E01023988","Total",1401,670,731,1391,10,33,4120.29,0.3
"2011","Ashford 001D","E01024040","Total",1167,562,605,1140,27,16,313.13,3.7
"2011","Ashford 001E","E01024041","Total",1115,540,575,1115,0,24,2097.37,0.5
"2011","Ashford 001F","E01032810","Total",1488,709,779,1488,0,14,58.84,25.3
"2011","Ashford 001G","E01032812","Total",1744,861,883,1744,0,23,1306.65,1.3
"2011","Ashford 002A","E01023985","Total",1111,538,573,1103,8,10,1469.54,0.8
"2011","Ashford 002B","E01023986","Total",1245,578,667,1213,32,23,641.92,1.9
"2011","Ashford 002C","E01023989","Total",1182,578,604,1182,0,24,1774.53,0.7
"2011","Ashford 002D","E01023990","Total",1221,587,634,1194,27,19,1848.37,0.7
"2011","Ashford 002E","E01024033","Total",1713,842,871,1713,0,35,2241.44,0.8
"2011","Ashford 002F","E01024035","Total",1073,512,561,1073,0,19,1237.73,0.9
"2011","Ashford 003A","E01023983","Total",1381,645,736,1367,14,13,101.73,13.6
"2011","Ashford 003B","E01023999","Total",2203,1096,1107,2171,32,28,272.11,8.1
"2011","Ashford 003D","E01032811","Total",1646,815,831,1646,0,19,35.65,46.2
"2011","Ashford 003E","E01032822","Total",1450,689,761,1450,0,15,33.71,43.0
"2011","Ashford 004A","E01023980","Total",1150,528,622,1150,0,16,26.43,43.5
"2011","Ashford 004B","E01023981","Total",1225,593,632,1219,6,19,219.28,5.6
"2011","Ashford 004C","E01023984","Total",1210,588,622,1210,0,14,23.61,51.2
"2011","Ashford 004E","E01023992","Total",1501,726,775,1499,2,13,56.76,26.4
"2011","Ashford 004F","E01023993","Total",1464,710,754,1464,0,11,37.68,38.9
"2011","Ashford 004G","E01024021","Total",1298,631,667,1274,24,11,36.70,35.4
"2011","Ashford 004H","E01024022","Total",1415,678,737,1393,22,10,59.21,23.9
"2011","Ashford 004I","E01032820","Total",1559,765,794,1559,0,17,49.30,31.6
"2011","Ashford 004J","E01032821","Total",1714,854,860,1714,0,15,126.70,13.5
"2011","Ashford 005A","E01023973","Total",1591,761,830,1591,0,8,48.08,33.1
"2011","Ashford 005B","E01024002","Total",1439,734,705,1439,0,10,28.27,50.9
"2011","Ashford 005C","E01024023","Total",2527,1213,1314,2454,73,18,108.83,23.2
"2011","Ashford 005D","E01024027","Total",1645,860,785,1529,116,27,98.08,16.8
"2011","Ashford 005E","E01024029","Total",2378,1188,1190,2372,6,17,70.82,33.6
"2011","Ashford 006A","E01023972","Total",1281,618,663,1281,0,5,28.49,45.0
"2011","Ashford 006B","E01023995","Total",1245,608,637,1199,46,17,24.13,51.6
"2011","Ashford 006C","E01023996","Total",1328,640,688,1328,0,12,91.92,14.4
"2011","Ashford 006D","E01024003","Total",1752,842,910,1701,51,14,42.31,41.4
"2011","Ashford 006E","E01024004","Total",1720,819,901,1704,16,32,273.73,6.3
"2011","Ashford 006F","E01024005","Total",1564,766,798,1564,0,25,35.63,43.9
"2011","Ashford 007A","E01023974","Total",1306,639,667,1306,0,8,19.60,66.6
"2011","Ashford 007B","E01023975","Total",1650,790,860,1644,6,5,36.93,44.7
"2011","Ashford 007C","E01023977","Total",1160,568,592,1160,0,8,25.93,44.7
"2011","Ashford 007D","E01024016","Total",1363,668,695,1363,0,7,30.95,44.0
"2011","Ashford 007E","E01024017","Total",1761,852,909,1729,32,19,47.53,37.1
"2011","Ashford 007F","E01024028","Total",1718,827,891,1718,0,16,48.06,35.7
"2011","Ashford 008A","E01023976","Total",1646,801,845,1636,10,11,31.24,52.7
"2011","Ashford 008B","E01024019","Total",1472,705,767,1472,0,11,35.63,41.3
"2011","Ashford 008C","E01024020","Total",1979,923,1056,1979,0,13,16.87,117.3
"2011","Ashford 008E","E01032816","Total",1765,856,909,1765,0,18,71.72,24.6
"2011","Ashford 008F","E01032823","Total",1691,856,835,1673,18,8,26.62,63.5
"2011","Ashford 009A","E01024001","Total",1529,777,752,1529,0,7,133.71,11.4
"2011","Ashford 009B","E01024006","Total",1404,687,717,1308,96,13,68.79,20.4
"2011","Ashford 009D","E01024008","Total",2044,973,1071,2044,0,23,77.91,26.2
"2011","Ashford 009F","E01032815","Total",1044,488,556,1044,0,3,35.33,29.5
"2011","Ashford 009G","E01032817","Total",1205,587,618,1205,0,5,23.25,51.8
"2011","Ashford 009H","E01032818","Total",1581,792,789,1581,0,14,21.41,73.8
"2011","Ashford 009I","E01032819","Total",1808,896,912,1808,0,34,57.36,31.5
"2011","Ashford 009J","E01032824","Total",1483,757,726,1482,1,8,50.18,29.6
"2011","Ashford 010A","E01024013","Total",1706,830,876,1673,33,28,895.29,1.9
"2011","Ashford 010B","E01024014","Total",1708,818,890,1671,37,35,4148.87,0.4
"2011","Ashford 010C","E01024015","Total",1602,783,819,1602,0,37,2619.61,0.6
"2011","Ashford 010D","E01024034","Total",2416,1188,1228,2394,22,29,1972.57,1.2
"2011","Ashford 011A","E01023978","Total",1271,644,627,1267,4,48,2721.00,0.5
"2011","Ashford 011B","E01023979","Total",1303,626,677,1303,0,27,190.80,6.8
"2011","Ashford 011C","E01024032","Total",1584,788,796,1573,11,30,1517.58,1.0
"2011","Ashford 011D","E01024036","Total",1301,643,658,1301,0,28,2179.87,0.6
"2011","Ashford 012B","E01024031","Total",1481,720,761,1470,11,33,2609.82,0.6
"2011","Ashford 012C","E01024038","Total",1903,946,957,1855,48,25,2795.45,0.7
"2011","Ashford 012D","E01024039","Total",1491,705,786,1491,0,23,1142.14,1.3
"2011","Ashford 012E","E01032813","Total",1812,867,945,1812,0,22,28.70,63.1
"2011","Ashford 012F","E01032814","Total",1865,928,937,1865,0,32,1223.35,1.5
"2011","Ashford 013A","E01024009","Total",1094,509,585,1076,18,41,2749.95,0.4
"2011","Ashford 013B","E01024010","Total",1276,600,676,1276,0,36,1573.31,0.8
"2011","Ashford 013C","E01024011","Total",1307,623,684,1232,75,16,451.41,2.9
"2011","Ashford 013D","E01024012","Total",1074,520,554,1074,0,16,316.52,3.4
"2011","Ashford 013E","E01024024","Total",2229,1024,1205,2229,0,23,95.66,23.3
"2011","Ashford 013F","E01024025","Total",1130,486,644,1125,5,14,68.25,16.6
"2011","Ashford 014A","E01023997","Total",1456,716,740,1453,3,37,3910.67,0.4
"2011","Ashford 014B","E01023998","Total",1112,537,575,1112,0,24,1466.14,0.8
"2011","Ashford 014C","E01024026","Total",1262,600,662,1262,0,27,1115.10,1.1
"2011","Ashford 014D","E01024037","Total",1777,839,938,1758,19,17,1858.17,1.0
"2011","Canterbury 001A","E01024078","Total",1676,814,862,1667,9,10,20.52,81.7
"2011","Canterbury 001B","E01024080","Total",1325,613,712,1188,137,16,15.50,85.5
"2011","Canterbury 001C","E01024081","Total",1571,739,832,1438,133,7,23.68,66.3
"2011","Canterbury 001D","E01024082","Total",1406,659,747,1388,18,12,25.20,55.8
"2011","Canterbury 001E","E01024095","Total",1492,717,775,1407,85,23,41.87,35.6
"2011","Canterbury 002A","E01024094","Total",2441,1185,1256,2421,20,22,696.35,3.5
"2011","Canterbury 002B","E01024096","Total",1780,826,954,1703,77,5,70.82,25.1
"2011","Canterbury 002C","E01024097","Total",1542,713,829,1533,9,11,66.86,23.1
"2011","Canterbury 002D","E01024098","Total",1590,735,855,1518,72,22,44.46,35.8
"2011","Canterbury 003A","E01024064","Total",2432,1197,1235,2409,23,39,128.33,19.0
"2011","Canterbury 003B","E01024066","Total",1595,773,822,1595,0,12,28.70,55.6
"2011","Canterbury 003C","E01024079","Total",1493,702,791,1456,37,15,29.03,51.4
"2011","Canterbury 003D","E01024083","Total",1370,647,723,1357,13,7,30.51,44.9
"2011","Canterbury 003E","E01024118","Total",1792,842,950,1757,35,7,32.68,54.8
"2011","Canterbury 004A","E01024059","Total",1529,705,824,1529,0,14,74.27,20.6
"2011","Canterbury 004B","E01024065","Total",2012,995,1017,2012,0,14,585.71,3.4
"2011","Canterbury 004C","E01024117","Total",1416,684,732,1406,10,13,39.02,36.3
"2011","Canterbury 004D","E01024119","Total",1625,773,852,1589,36,14,30.15,53.9
"2011","Canterbury 004E","E01024120","Total",1565,749,816,1565,0,4,99.97,15.7
"2011","Canterbury 005A","E01024056","Total",1946,930,1016,1912,34,39,707.24,2.8
"2011","Canterbury 005B","E01024057","Total",1792,864,928,1792,0,18,100.67,17.8
"2011","Canterbury 005C","E01024058","Total",1612,768,844,1612,0,13,108.16,14.9
"2011","Canterbury 005D","E01024114","Total",1720,792,928,1720,0,32,38.64,44.5
"2011","Canterbury 005E","E01024115","Total",1393,658,735,1391,2,19,39.61,35.2
"2011","Canterbury 006A","E01024073","Total",1963,953,1010,1943,20,17,82.10,23.9
"2011","Canterbury 006B","E01024074","Total",1504,749,755,1477,27,13,32.67,46.0
"2011","Canterbury 006C","E01024075","Total",1627,778,849,1567,60,13,147.95,11.0
"2011","Canterbury 006D","E01024076","Total",1875,923,952,1875,0,23,250.09,7.5
"2011","Canterbury 006E","E01024077","Total",1471,741,730,1467,4,21,583.83,2.5
"2011","Canterbury 007A","E01024055","Total",1519,703,816,1519,0,20,103.70,14.6
"2011","Canterbury 007B","E01024061","Total",1496,687,809,1496,0,7,43.97,34.0
"2011","Canterbury 007C","E01024063","Total",1551,753,798,1551,0,19,43.88,35.3
"2011","Canterbury 007D","E01024071","Total",1682,809,873,1675,7,20,27.41,61.4
"2011","Canterbury 007E","E01024116","Total",1500,692,808,1445,55,26,53.62,28.0
"2011","Canterbury 008A","E01024060","Total",1521,710,811,1519,2,14,28.37,53.6
"2011","Canterbury 008B","E01024069","Total",1380,663,717,1380,0,11,18.94,72.9
"2011","Canterbury 008C","E01024070","Total",1405,668,737,1360,45,16,49.18,28.6
"2011","Canterbury 008D","E01024072","Total",1324,632,692,1300,24,13,25.46,52.0
"2011","Canterbury 008E","E01024106","Total",1578,713,865,1491,87,11,45.75,34.5
"2011","Canterbury 009A","E01024062","Total",1556,772,784,1538,18,16,422.00,3.7
"2011","Canterbury 009B","E01024105","Total",1530,743,787,1530,0,14,48.52,31.5
"2011","Canterbury 009C","E01024107","Total",1466,709,757,1462,4,17,100.24,14.6
"2011","Canterbury 009D","E01024108","Total",1146,546,600,1146,0,8,299.52,3.8
"2011","Canterbury 009E","E01024109","Total",2247,1091,1156,2247,0,21,619.43,3.6
"2011","Canterbury 010A","E01024084","Total",1141,529,612,1113,28,21,834.39,1.4
"2011","Canterbury 010B","E01024085","Total",1577,738,839,1522,55,43,2172.18,0.7
"2011","Canterbury 010C","E01024086","Total",2054,1027,1027,2050,4,16,740.52,2.8
"2011","Canterbury 010D","E01024087","Total",1248,596,652,1147,101,22,2176.13,0.6
"2011","Canterbury 011A","E01024091","Total",1431,735,696,1431,0,14,81.56,17.5
"2011","Canterbury 011B","E01024110","Total",1271,630,641,1269,2,12,1051.83,1.2
"2011","Canterbury 011C","E01024111","Total",1533,737,796,1519,14,9,109.56,14.0
"2011","Canterbury 011D","E01024112","Total",1570,750,820,1570,0,16,31.07,50.5
"2011","Canterbury 011E","E01024113","Total",1324,624,700,1253,71,24,239.91,5.5
"2011","Canterbury 012C","E01024067","Total",1132,552,580,1057,75,35,1244.87,0.9
"2011","Canterbury 012D","E01024068","Total",1524,746,778,1391,133,50,124.90,12.2
"2011","Canterbury 012E","E01024123","Total",1646,784,862,1572,74,31,54.95,30.0
"2011","Canterbury 012F","E01032809","Total",6176,2970,3206,2276,3900,135,1960.06,3.2
"2011","Canterbury 013A","E01024099","Total",1500,724,776,1500,0,11,18.82,79.7
"2011","Canterbury 013B","E01024100","Total",1581,737,844,1580,1,26,48.24,32.8
"2011","Canterbury 013C","E01024101","Total",1844,966,878,1842,2,20,78.34,23.5
"2011","Canterbury 013D","E01024102","Total",1762,871,891,1759,3,21,46.55,37.9
"2011","Canterbury 013E","E01024103","Total",1630,763,867,1625,5,28,19.96,81.7
"2011","Canterbury 014A","E01024047","Total",1583,762,821,1565,18,28,201.09,7.9
"2011","Canterbury 014B","E01024049","Total",1817,1030,787,1477,340,12,30.67,59.2
"2011","Canterbury 014C","E01024090","Total",2446,1143,1303,1884,562,38,44.42,55.1
"2011","Canterbury 014D","E01024092","Total",1554,735,819,1492,62,17,26.63,58.4
"2011","Canterbury 014E","E01024093","Total",1571,718,853,1401,170,22,39.56,39.7
"2011","Canterbury 016A","E01024044","Total",1976,944,1032,1884,92,40,57.51,34.4
"2011","Canterbury 016B","E01024045","Total",1584,735,849,1584,0,25,382.21,4.1
"2011","Canterbury 016C","E01024046","Total",1894,926,968,1702,192,74,176.76,10.7
"2011","Canterbury 016D","E01024048","Total",1963,985,978,1499,464,21,28.04,70.0
"2011","Canterbury 016E","E01024131","Total",1598,784,814,1504,94,40,33.44,47.8
"2011","Canterbury 017A","E01024052","Total",2233,1094,1139,2223,10,19,622.71,3.6
"2011","Canterbury 017B","E01024053","Total",1847,916,931,1847,0,32,1312.96,1.4
"2011","Canterbury 017C","E01024054","Total",1798,874,924,1798,0,53,3805.22,0.5
"2011","Canterbury 017D","E01024127","Total",1552,750,802,1549,3,18,464.99,3.3
"2011","Canterbury 018A","E01024042","Total",1364,669,695,1311,53,32,3070.94,0.4
"2011","Canterbury 018B","E01024043","Total",1393,655,738,1340,53,23,821.21,1.7
"2011","Canterbury 018C","E01024088","Total",1565,717,848,1462,103,36,798.30,2.0
"2011","Canterbury 018D","E01024089","Total",1193,574,619,1193,0,36,1374.29,0.9
"2011","Canterbury 019A","E01024128","Total",1660,819,841,1645,15,12,68.42,24.3
"2011","Canterbury 019B","E01024129","Total",1747,845,902,1600,147,32,24.19,72.2
"2011","Canterbury 019C","E01024130","Total",2534,1179,1355,2499,35,25,152.63,16.6
"2011","Canterbury 020A","E01024104","Total",2005,977,1028,2005,0,29,26.16,76.6
"2011","Canterbury 020B","E01024121","Total",1506,727,779,1494,12,29,21.85,68.9
"2011","Canterbury 020C","E01024122","Total",1407,636,771,1357,50,10,46.97,30.0
"2011","Canterbury 020D","E01024124","Total",1572,782,790,1038,534,20,23.04,68.2
"2011","Canterbury 020E","E01024126","Total",1503,685,818,1502,1,10,22.51,66.8
"2011","Canterbury 020F","E01032807","Total",1463,680,783,1461,2,19,32.62,44.8
"2011","Canterbury 020G","E01032808","Total",1417,703,714,1417,0,11,37.43,37.9
"2011","Dartford 001A","E01024148","Total",1674,810,864,1674,0,3,97.60,17.2
"2011","Dartford 001B","E01024149","Total",2972,1423,1549,2972,0,13,356.57,8.3
"2011","Dartford 001C","E01024154","Total",1266,605,661,1266,0,8,24.63,51.4
"2011","Dartford 001D","E01024155","Total",1492,698,794,1468,24,6,177.44,8.4
"2011","Dartford 002A","E01024140","Total",2692,1356,1336,2692,0,26,57.35,46.9
"2011","Dartford 002B","E01024141","Total",1597,787,810,1513,84,7,321.63,5.0
"2011","Dartford 002C","E01024143","Total",2246,1156,1090,2246,0,29,42.80,52.5
"2011","Dartford 002D","E01024179","Total",2817,1411,1406,2817,0,21,336.42,8.4
"2011","Dartford 003A","E01024180","Total",1436,752,684,1436,0,5,70.49,20.4
"2011","Dartford 003B","E01024181","Total",1355,680,675,1355,0,18,29.20,46.4
"2011","Dartford 003C","E01024182","Total",1571,829,742,1564,7,9,40.13,39.1
"2011","Dartford 003D","E01024183","Total",1384,691,693,1379,5,26,34.21,40.5
"2011","Dartford 003E","E01024184","Total",1986,993,993,1986,0,17,23.85,83.3
"2011","Dartford 003F","E01024185","Total",2079,1004,1075,2054,25,36,52.89,39.3
"2011","Dartford 004A","E01024142","Total",2724,1356,1368,2700,24,4,70.25,38.8
"2011","Dartford 004B","E01024176","Total",1670,820,850,1662,8,7,32.37,51.6
"2011","Dartford 004C","E01024177","Total",1436,702,734,1436,0,13,37.04,38.8
"2011","Dartford 004D","E01024178","Total",1638,829,809,1638,0,8,23.14,70.8
"2011","Dartford 005A","E01024156","Total",1658,852,806,1658,0,13,21.51,77.1
"2011","Dartford 005B","E01024161","Total",1976,1000,976,1976,0,20,20.55,96.2
"2011","Dartford 005C","E01024162","Total",1626,876,750,1579,47,4,57.71,28.2
"2011","Dartford 005D","E01024163","Total",1802,895,907,1783,19,19,34.16,52.8
"2011","Dartford 005E","E01024164","Total",1900,968,932,1900,0,8,22.65,83.9
"2011","Dartford 006A","E01024169","Total",1510,727,783,1510,0,10,30.18,50.0
"2011","Dartford 006B","E01024170","Total",1555,754,801,1543,12,4,96.24,16.2
"2011","Dartford 006C","E01024171","Total",1558,801,757,1546,12,4,70.55,22.1
"2011","Dartford 006D","E01024172","Total",1930,994,936,1930,0,7,297.03,6.5
"2011","Dartford 007A","E01024144","Total",1510,771,739,1510,0,31,26.53,56.9
"2011","Dartford 007B","E01024145","Total",1630,802,828,1630,0,32,56.87,28.7
"2011","Dartford 007C","E01024146","Total",1487,733,754,1465,22,40,147.33,10.1
"2011","Dartford 007D","E01024147","Total",1722,839,883,1722,0,31,28.88,59.6
"2011","Dartford 007E","E01024186","Total",1317,638,679,1317,0,18,23.66,55.7
"2011","Dartford 008A","E01024133","Total",1365,680,685,1275,90,13,228.77,6.0
"2011","Dartford 008B","E01024136","Total",1550,785,765,1550,0,13,38.28,40.5
"2011","Dartford 008C","E01024137","Total",1511,755,756,1511,0,24,74.22,20.4
"2011","Dartford 008D","E01024138","Total",1810,855,955,1663,147,16,140.06,12.9
"2011","Dartford 008E","E01024139","Total",1763,892,871,1763,0,12,28.09,62.8
"2011","Dartford 009A","E01024165","Total",1523,702,821,1523,0,7,14.97,101.7
"2011","Dartford 009B","E01024166","Total",1705,814,891,1705,0,13,22.65,75.3
"2011","Dartford 009C","E01024167","Total",1832,900,932,1829,3,16,81.26,22.5
"2011","Dartford 009D","E01024168","Total",1247,595,652,1247,0,21,35.03,35.6
"2011","Dartford 010A","E01024150","Total",1516,714,802,1516,0,24,185.76,8.2
"2011","Dartford 010B","E01024151","Total",1431,705,726,1431,0,18,172.88,8.3
"2011","Dartford 010C","E01024152","Total",2655,1307,1348,2598,57,34,113.41,23.4
"2011","Dartford 010D","E01024153","Total",1410,699,711,1410,0,26,49.21,28.7
"2011","Dartford 011A","E01024173","Total",1793,895,898,1752,41,15,334.46,5.4
"2011","Dartford 011B","E01024187","Total",1113,530,583,1072,41,17,56.96,19.5
"2011","Dartford 011C","E01024188","Total",1311,622,689,1268,43,22,162.27,8.1
"2011","Dartford 011D","E01024189","Total",1576,752,824,1574,2,13,187.76,8.4
"2011","Dartford 012A","E01024132","Total",1286,634,652,1286,0,12,66.91,19.2
"2011","Dartford 012B","E01024134","Total",1643,800,843,1643,0,8,337.52,4.9
"2011","Dartford 012C","E01024135","Total",1426,692,734,1299,127,16,494.21,2.9
"2011","Dartford 012D","E01024174","Total",1148,563,585,1148,0,15,195.23,5.9
"2011","Dartford 012E","E01024175","Total",1289,617,672,1289,0,11,223.83,5.8
"2011","Dartford 013A","E01024157","Total",1674,799,875,1624,50,34,922.53,1.8
"2011","Dartford 013B","E01024158","Total",1560,717,843,1461,99,19,164.68,9.5
"2011","Dartford 013C","E01024159","Total",1577,759,818,1577,0,44,104.76,15.1
"2011","Dartford 013D","E01024160","Total",1435,726,709,1435,0,37,79.28,18.1
"2011","Dover 001A","E01024206","Total",1799,890,909,1799,0,36,2346.62,0.8
"2011","Dover 001B","E01024207","Total",1817,891,926,1783,34,43,1727.54,1.1
"2011","Dover 001C","E01024208","Total",1620,791,829,1580,40,14,1479.90,1.1
"2011","Dover 001D","E01024209","Total",1775,880,895,1744,31,35,1018.04,1.7
"2011","Dover 002A","E01024202","Total",1914,914,1000,1881,33,14,380.91,5.0
"2011","Dover 002B","E01024242","Total",1810,916,894,1716,94,33,1876.56,1.0
"2011","Dover 002C","E01024243","Total",1682,761,921,1658,24,32,61.64,27.3
"2011","Dover 002D","E01024244","Total",1760,845,915,1760,0,31,381.85,4.6
"2011","Dover 002E","E01024245","Total",1791,891,900,1791,0,30,1198.22,1.5
"2011","Dover 003A","E01024219","Total",1339,617,722,1248,91,14,42.38,31.6
"2011","Dover 003B","E01024220","Total",1600,726,874,1523,77,12,113.82,14.1
"2011","Dover 003C","E01024221","Total",1574,740,834,1546,28,36,33.29,47.3
"2011","Dover 003D","E01024227","Total",1472,718,754,1472,0,9,37.37,39.4
"2011","Dover 003E","E01024229","Total",1460,718,742,1460,0,18,24.60,59.3
"2011","Dover 004A","E01024228","Total",1540,804,736,1514,26,9,30.04,51.3
"2011","Dover 004B","E01024230","Total",1376,661,715,1376,0,10,20.71,66.4
"2011","Dover 004C","E01024231","Total",1538,783,755,1510,28,9,19.58,78.5
"2011","Dover 004D","E01024252","Total",2393,1145,1248,2359,34,29,53.99,44.3
"2011","Dover 005A","E01024201","Total",1534,766,768,1486,48,24,1390.96,1.1
"2011","Dover 005B","E01024217","Total",1688,820,868,1684,4,14,735.54,2.3
"2011","Dover 005C","E01024223","Total",1599,726,873,1585,14,15,40.23,39.7
"2011","Dover 005D","E01024225","Total",1692,839,853,1692,0,12,22.79,74.2
"2011","Dover 005E","E01024226","Total",1475,694,781,1458,17,5,83.21,17.7
"2011","Dover 006A","E01024190","Total",1455,710,745,1455,0,25,1361.70,1.1
"2011","Dover 006B","E01024191","Total",1752,843,909,1752,0,13,92.68,18.9
"2011","Dover 006C","E01024192","Total",1698,816,882,1698,0,3,97.76,17.4
"2011","Dover 006D","E01024204","Total",1593,774,819,1580,13,8,502.94,3.2
"2011","Dover 007A","E01024218","Total",1213,578,635,1213,0,10,31.18,38.9
"2011","Dover 007B","E01024222","Total",1571,749,822,1571,0,15,30.22,52.0
"2011","Dover 007C","E01024224","Total",1514,726,788,1506,8,17,106.53,14.2
"2011","Dover 007D","E01024250","Total",1670,791,879,1643,27,19,39.88,41.9
"2011","Dover 007E","E01024251","Total",1642,771,871,1530,112,14,60.30,27.2
"2011","Dover 008A","E01024200","Total",1751,878,873,1706,45,24,2864.87,0.6
"2011","Dover 008B","E01024203","Total",1602,799,803,1556,46,27,2573.65,0.6
"2011","Dover 008C","E01024205","Total",1620,778,842,1620,0,14,383.29,4.2
"2011","Dover 008D","E01024255","Total",1558,742,816,1499,59,18,258.65,6.0
"2011","Dover 009A","E01024232","Total",2030,975,1055,1989,41,30,637.58,3.2
"2011","Dover 009B","E01024236","Total",1592,777,815,1581,11,21,1672.58,1.0
"2011","Dover 009C","E01024237","Total",1578,777,801,1571,7,27,484.29,3.3
"2011","Dover 009D","E01024253","Total",1729,806,923,1657,72,27,176.26,9.8
"2011","Dover 010C","E01024233","Total",1605,786,819,1605,0,24,43.32,37.0
"2011","Dover 010D","E01024235","Total",1595,760,835,1468,127,15,49.33,32.3
"2011","Dover 010E","E01024254","Total",2162,1073,1089,2162,0,19,215.36,10.0
"2011","Dover 010F","E01024256","Total",1422,693,729,1421,1,15,223.86,6.4
"2011","Dover 010G","E01033210","Total",2342,1147,1195,2227,115,41,1148.16,2.0
"2011","Dover 011A","E01024193","Total",1615,763,852,1604,11,9,18.51,87.3
"2011","Dover 011B","E01024194","Total",1506,779,727,1506,0,5,15.89,94.8
"2011","Dover 011C","E01024195","Total",1404,693,711,1398,6,17,96.35,14.6
"2011","Dover 011D","E01024196","Total",1486,720,766,1486,0,4,37.96,39.1
"2011","Dover 011E","E01024197","Total",1569,772,797,1569,0,9,26.04,60.3
"2011","Dover 011F","E01024240","Total",1688,803,885,1682,6,4,135.41,12.5
"2011","Dover 011G","E01024241","Total",2148,1043,1105,2148,0,17,89.40,24.0
"2011","Dover 011H","E01024248","Total",1900,984,916,1900,0,14,43.03,44.2
"2011","Dover 012B","E01024238","Total",1999,1051,948,1568,431,38,998.47,2.0
"2011","Dover 012C","E01024239","Total",1758,861,897,1746,12,4,19.39,90.7
"2011","Dover 012D","E01024247","Total",1951,1010,941,1886,65,5,24.96,78.2
"2011","Dover 012E","E01033209","Total",1047,564,483,1019,28,20,139.76,7.5
"2011","Dover 012F","E01033211","Total",1129,565,564,1103,26,4,31.37,36.0
"2011","Dover 013A","E01024214","Total",1688,857,831,1642,46,8,17.77,95.0
"2011","Dover 013B","E01024215","Total",1614,856,758,1500,114,26,36.05,44.8
"2011","Dover 013C","E01024216","Total",1491,724,767,1484,7,22,21.33,69.9
"2011","Dover 013D","E01024246","Total",2036,1075,961,2036,0,11,20.31,100.2
"2011","Dover 013E","E01024249","Total",2072,1064,1008,1963,109,6,367.03,5.6
"2011","Dover 014A","E01024198","Total",2347,1166,1181,2326,21,23,1442.79,1.6
"2011","Dover 014B","E01024212","Total",1531,793,738,1512,19,10,206.32,7.4
"2011","Dover 014C","E01024213","Total",1389,678,711,1389,0,18,60.77,22.9
"2011","Dover 014D","E01024234","Total",1364,659,705,1360,4,27,1462.00,0.9
"2011","Gravesham 001A","E01024276","Total",2542,1252,1290,2542,0,18,35.87,70.9
"2011","Gravesham 001B","E01024277","Total",1888,926,962,1828,60,8,100.10,18.9
"2011","Gravesham 001C","E01024278","Total",1863,926,937,1863,0,13,132.64,14.0
"2011","Gravesham 001D","E01024279","Total",1510,745,765,1510,0,14,30.52,49.5
"2011","Gravesham 002A","E01024257","Total",2042,1097,945,2008,34,13,19.25,106.1
"2011","Gravesham 002C","E01024290","Total",1703,850,853,1601,102,39,24.19,70.4
"2011","Gravesham 002D","E01024291","Total",1771,911,860,1771,0,12,14.48,122.3
"2011","Gravesham 002E","E01024295","Total",1788,908,880,1788,0,11,27.41,65.2
"2011","Gravesham 002F","E01032799","Total",1557,836,721,1486,71,12,39.75,39.2
"2011","Gravesham 002G","E01032800","Total",1161,637,524,1161,0,1,15.89,73.1
"2011","Gravesham 003A","E01024258","Total",1607,809,798,1571,36,20,35.44,45.3
"2011","Gravesham 003B","E01024261","Total",2163,1084,1079,2163,0,27,354.32,6.1
"2011","Gravesham 003C","E01024293","Total",1729,865,864,1729,0,12,74.17,23.3
"2011","Gravesham 003D","E01024294","Total",2268,1087,1181,2267,1,23,79.66,28.5
"2011","Gravesham 003E","E01024296","Total",2842,1490,1352,2842,0,19,28.14,101.0
"2011","Gravesham 004A","E01024262","Total",1685,818,867,1685,0,20,24.84,67.8
"2011","Gravesham 004B","E01024263","Total",1524,716,808,1489,35,8,26.24,58.1
"2011","Gravesham 004C","E01024282","Total",1630,799,831,1630,0,16,13.72,118.8
"2011","Gravesham 004D","E01024283","Total",1320,657,663,1320,0,8,17.91,73.7
"2011","Gravesham 004E","E01024284","Total",1558,772,786,1558,0,12,13.84,112.6
"2011","Gravesham 005A","E01024259","Total",1531,759,772,1509,22,29,41.79,36.6
"2011","Gravesham 005B","E01024260","Total",1858,949,909,1813,45,20,35.42,52.5
"2011","Gravesham 005C","E01024292","Total",1638,849,789,1622,16,25,25.40,64.5
"2011","Gravesham 005D","E01024313","Total",1597,749,848,1597,0,16,23.71,67.4
"2011","Gravesham 005E","E01024317","Total",1705,846,859,1702,3,20,33.93,50.3
"2011","Gravesham 005F","E01024318","Total",1579,766,813,1579,0,28,17.27,91.4
"2011","Gravesham 006A","E01024280","Total",1673,789,884,1673,0,8,141.31,11.8
"2011","Gravesham 006B","E01024281","Total",1457,722,735,1457,0,15,47.54,30.6
"2011","Gravesham 006C","E01024285","Total",1391,659,732,1345,46,10,19.18,72.5
"2011","Gravesham 006D","E01024287","Total",1464,702,762,1464,0,6,27.41,53.4
"2011","Gravesham 006E","E01024288","Total",1379,652,727,1266,113,14,35.04,39.4
"2011","Gravesham 007A","E01024308","Total",1420,667,753,1420,0,14,22.27,63.8
"2011","Gravesham 007B","E01024310","Total",1544,762,782,1544,0,10,28.13,54.9
"2011","Gravesham 007C","E01024311","Total",1335,635,700,1335,0,18,20.31,65.7
"2011","Gravesham 007D","E01024314","Total",1283,640,643,1283,0,17,21.33,60.2
"2011","Gravesham 007E","E01024315","Total",1544,764,780,1544,0,15,26.53,58.2
"2011","Gravesham 008A","E01024297","Total",1551,762,789,1551,0,18,19.43,79.8
"2011","Gravesham 008B","E01024298","Total",1416,716,700,1416,0,10,108.51,13.0
"2011","Gravesham 008C","E01024299","Total",1430,701,729,1430,0,16,19.94,71.7
"2011","Gravesham 008D","E01024309","Total",1288,610,678,1288,0,9,21.77,59.2
"2011","Gravesham 008E","E01024312","Total",1297,631,666,1297,0,13,111.17,11.7
"2011","Gravesham 009A","E01024264","Total",1527,736,791,1527,0,5,32.02,47.7
"2011","Gravesham 009B","E01024286","Total",1626,818,808,1626,0,11,31.61,51.4
"2011","Gravesham 009C","E01024316","Total",1849,861,988,1813,36,26,120.54,15.3
"2011","Gravesham 009D","E01024319","Total",1604,766,838,1600,4,29,47.39,33.8
"2011","Gravesham 010A","E01024265","Total",1287,636,651,1270,17,28,288.87,4.5
"2011","Gravesham 010B","E01024266","Total",1153,537,616,1153,0,13,40.13,28.7
"2011","Gravesham 010C","E01024267","Total",1522,748,774,1522,0,17,993.32,1.5
"2011","Gravesham 010D","E01024300","Total",1463,718,745,1457,6,17,960.16,1.5
"2011","Gravesham 010E","E01024301","Total",1247,589,658,1179,68,15,1324.29,0.9
"2011","Gravesham 011A","E01024303","Total",1546,721,825,1546,0,7,22.85,67.7
"2011","Gravesham 011B","E01024304","Total",1549,754,795,1549,0,8,33.36,46.4
"2011","Gravesham 011C","E01024305","Total",1520,733,787,1520,0,10,18.44,82.4
"2011","Gravesham 011D","E01024306","Total",1144,569,575,1144,0,6,21.39,53.5
"2011","Gravesham 011E","E01024307","Total",1462,722,740,1462,0,12,34.72,42.1
"2011","Gravesham 012A","E01024268","Total",1602,786,816,1602,0,25,386.60,4.1
"2011","Gravesham 012B","E01024269","Total",1835,912,923,1835,0,23,352.97,5.2
"2011","Gravesham 012C","E01024270","Total",1450,711,739,1421,29,28,498.24,2.9
"2011","Gravesham 012D","E01024271","Total",1414,666,748,1414,0,16,318.09,4.4
"2011","Gravesham 012E","E01024272","Total",1493,706,787,1493,0,38,276.06,5.4
"2011","Gravesham 013A","E01024273","Total",1529,779,750,1529,0,26,824.89,1.9
"2011","Gravesham 013B","E01024274","Total",1495,721,774,1495,0,24,125.65,11.9
"2011","Gravesham 013C","E01024275","Total",1406,700,706,1406,0,14,47.36,29.7
"2011","Gravesham 013D","E01024302","Total",1466,735,731,1466,0,31,1147.15,1.3
"2011","Maidstone 001A","E01024333","Total",1376,682,694,1376,0,21,64.43,21.4
"2011","Maidstone 001B","E01024334","Total",1023,496,527,1023,0,15,31.29,32.7
"2011","Maidstone 001C","E01024335","Total",1554,771,783,1552,2,27,2002.20,0.8
"2011","Maidstone 001D","E01024338","Total",1387,704,683,1383,4,32,73.18,19.0
"2011","Maidstone 001E","E01024347","Total",1702,837,865,1633,69,43,1903.49,0.9
"2011","Maidstone 002A","E01024353","Total",1812,882,930,1776,36,32,61.84,29.3
"2011","Maidstone 002B","E01024354","Total",1462,708,754,1462,0,15,25.52,57.3
"2011","Maidstone 002C","E01024355","Total",1963,995,968,1963,0,23,24.32,80.7
"2011","Maidstone 002D","E01024385","Total",1602,792,810,1602,0,20,36.28,44.2
"2011","Maidstone 002E","E01024386","Total",1730,837,893,1659,71,25,36.94,46.8
"2011","Maidstone 003A","E01024320","Total",1191,563,628,1191,0,27,54.72,21.8
"2011","Maidstone 003B","E01024321","Total",1718,811,907,1709,9,16,42.02,40.9
"2011","Maidstone 003C","E01024322","Total",1172,581,591,1172,0,20,30.22,38.8
"2011","Maidstone 003D","E01024323","Total",1345,664,681,1339,6,23,43.52,30.9
"2011","Maidstone 003E","E01024324","Total",1452,697,755,1452,0,13,100.41,14.5
"2011","Maidstone 003F","E01024341","Total",1715,829,886,1620,95,30,45.63,37.6
"2011","Maidstone 004A","E01024352","Total",1795,857,938,1793,2,8,22.30,80.5
"2011","Maidstone 004C","E01024382","Total",2052,1368,684,1451,601,14,16.72,122.7
"2011","Maidstone 004D","E01024383","Total",2314,1308,1006,2073,241,28,101.57,22.8
"2011","Maidstone 004E","E01024384","Total",1783,859,924,1783,0,11,46.09,38.7
"2011","Maidstone 004F","E01033090","Total",1235,625,610,1170,65,8,42.28,29.2
"2011","Maidstone 004G","E01033092","Total",1224,672,552,1216,8,10,25.76,47.5
"2011","Maidstone 005A","E01024330","Total",1586,767,819,1586,0,40,50.34,31.5
"2011","Maidstone 005B","E01024336","Total",1667,820,847,1665,2,44,209.85,7.9
"2011","Maidstone 005C","E01024337","Total",1503,749,754,1503,0,21,33.86,44.4
"2011","Maidstone 005D","E01024348","Total",1360,692,668,1360,0,29,27.97,48.6
"2011","Maidstone 005E","E01024351","Total",1507,717,790,1499,8,24,33.14,45.5
"2011","Maidstone 006A","E01024339","Total",1900,910,990,1807,93,25,33.96,55.9
"2011","Maidstone 006B","E01024340","Total",2240,1133,1107,2212,28,19,94.15,23.8
"2011","Maidstone 006C","E01024356","Total",1622,814,808,1529,93,30,23.76,68.3
"2011","Maidstone 006E","E01024373","Total",1823,920,903,1815,8,16,32.46,56.2
"2011","Maidstone 006F","E01033087","Total",1336,694,642,1301,35,6,23.65,56.5
"2011","Maidstone 006G","E01033091","Total",1682,824,858,1615,67,16,18.24,92.2
"2011","Maidstone 007A","E01024326","Total",1882,901,981,1858,24,46,46.95,40.1
"2011","Maidstone 007B","E01024327","Total",1633,782,851,1633,0,7,29.92,54.6
"2011","Maidstone 007C","E01024328","Total",1588,738,850,1536,52,52,66.62,23.8
"2011","Maidstone 007D","E01024329","Total",1520,743,777,1520,0,36,85.85,17.7
"2011","Maidstone 007E","E01024349","Total",1356,686,670,1356,0,11,21.70,62.5
"2011","Maidstone 008A","E01024357","Total",1686,831,855,1686,0,21,17.59,95.8
"2011","Maidstone 008B","E01024358","Total",1722,803,919,1722,0,11,98.21,17.5
"2011","Maidstone 008C","E01024367","Total",1474,728,746,1397,77,28,68.90,21.4
"2011","Maidstone 008E","E01024369","Total",1534,777,757,1531,3,26,26.82,57.2
"2011","Maidstone 008F","E01033088","Total",1446,713,733,1403,43,24,61.72,23.4
"2011","Maidstone 008G","E01033089","Total",1599,760,839,1535,64,20,28.54,56.0
"2011","Maidstone 009A","E01024360","Total",1522,718,804,1522,0,22,62.56,24.3
"2011","Maidstone 009B","E01024372","Total",1966,992,974,1923,43,20,30.39,64.7
"2011","Maidstone 009C","E01024374","Total",1810,865,945,1763,47,12,22.05,82.1
"2011","Maidstone 009D","E01024401","Total",1514,725,789,1485,29,4,65.32,23.2
"2011","Maidstone 009E","E01024403","Total",1767,856,911,1767,0,17,71.46,24.7
"2011","Maidstone 010A","E01024371","Total",1632,834,798,1632,0,21,39.55,41.3
"2011","Maidstone 010B","E01024392","Total",1598,787,811,1598,0,18,108.54,14.7
"2011","Maidstone 010C","E01024393","Total",1552,754,798,1522,30,10,146.24,10.6
"2011","Maidstone 010D","E01024395","Total",1475,708,767,1475,0,7,28.38,52.0
"2011","Maidstone 010E","E01024396","Total",1574,771,803,1568,6,7,40.16,39.2
"2011","Maidstone 011A","E01024361","Total",1686,826,860,1686,0,15,196.11,8.6
"2011","Maidstone 011B","E01024362","Total",1684,833,851,1684,0,29,2152.95,0.8
"2011","Maidstone 011C","E01024363","Total",2113,1063,1050,2063,50,28,1026.30,2.1
"2011","Maidstone 011D","E01024387","Total",2445,1208,1237,2443,2,37,6515.00,0.4
"2011","Maidstone 012A","E01024331","Total",1411,685,726,1411,0,18,268.49,5.3
"2011","Maidstone 012B","E01024394","Total",1409,703,706,1389,20,27,35.52,39.7
"2011","Maidstone 012C","E01024402","Total",1464,695,769,1439,25,16,147.52,9.9
"2011","Maidstone 012D","E01024404","Total",1582,780,802,1582,0,10,65.88,24.0
"2011","Maidstone 012E","E01024405","Total",2004,951,1053,1998,6,10,58.12,34.5
"2011","Maidstone 013A","E01024389","Total",2273,1078,1195,2273,0,14,35.09,64.8
"2011","Maidstone 013B","E01024390","Total",1401,657,744,1401,0,10,36.04,38.9
"2011","Maidstone 013C","E01024391","Total",1435,690,745,1435,0,9,26.50,54.2
"2011","Maidstone 013D","E01024397","Total",1450,709,741,1450,0,3,25.19,57.6
"2011","Maidstone 013E","E01024398","Total",1736,820,916,1736,0,6,31.32,55.4
"2011","Maidstone 013F","E01024399","Total",1308,612,696,1308,0,2,23.53,55.6
"2011","Maidstone 013G","E01024400","Total",1401,656,745,1306,95,2,34.94,40.1
"2011","Maidstone 014A","E01024325","Total",2327,1133,1194,2327,0,29,574.18,4.1
"2011","Maidstone 014B","E01024346","Total",1293,645,648,1293,0,22,730.81,1.8
"2011","Maidstone 014C","E01024377","Total",1614,799,815,1609,5,28,1254.70,1.3
"2011","Maidstone 014D","E01024378","Total",1365,656,709,1365,0,22,335.85,4.1
"2011","Maidstone 015A","E01024332","Total",1198,595,603,1196,2,37,1589.84,0.8
"2011","Maidstone 015B","E01024350","Total",1458,720,738,1458,0,21,353.22,4.1
"2011","Maidstone 015C","E01024375","Total",2394,1206,1188,2384,10,36,1255.59,1.9
"2011","Maidstone 015D","E01024388","Total",2929,1432,1497,2929,0,30,162.65,18.0
"2011","Maidstone 015E","E01024410","Total",1564,749,815,1498,66,18,513.77,3.0
"2011","Maidstone 016A","E01024342","Total",1671,802,869,1642,29,16,100.27,16.7
"2011","Maidstone 016B","E01024343","Total",1419,728,691,1419,0,15,294.38,4.8
"2011","Maidstone 016C","E01024344","Total",1374,672,702,1374,0,20,72.52,18.9
"2011","Maidstone 016D","E01024376","Total",2277,1114,1163,2234,43,41,268.35,8.5
"2011","Maidstone 017A","E01024364","Total",1627,773,854,1626,1,26,2016.44,0.8
"2011","Maidstone 017B","E01024365","Total",1760,848,912,1749,11,21,108.80,16.2
"2011","Maidstone 017C","E01024366","Total",1768,825,943,1655,113,25,3176.30,0.6
"2011","Maidstone 017D","E01024411","Total",1288,673,615,1200,88,27,739.57,1.7
"2011","Maidstone 018A","E01024345","Total",1556,793,763,1529,27,40,1586.52,1.0
"2011","Maidstone 018B","E01024379","Total",1715,871,844,1713,2,46,2851.90,0.6
"2011","Maidstone 018C","E01024380","Total",1688,834,854,1688,0,34,1628.25,1.0
"2011","Maidstone 018D","E01024381","Total",1426,698,728,1426,0,20,75.88,18.8
"2011","Maidstone 019A","E01024406","Total",1513,740,773,1421,92,35,1106.77,1.4
"2011","Maidstone 019B","E01024407","Total",1495,743,752,1472,23,31,1039.62,1.4
"2011","Maidstone 019C","E01024408","Total",1433,704,729,1433,0,19,94.05,15.2
"2011","Maidstone 019D","E01024409","Total",1506,723,783,1479,27,20,145.03,10.4
"2011","Sevenoaks 001A","E01024445","Total",1290,623,667,1288,2,34,61.60,20.9
"2011","Sevenoaks 001B","E01024446","Total",1478,711,767,1478,0,27,80.25,18.4
"2011","Sevenoaks 001C","E01024447","Total",1324,638,686,1324,0,13,56.16,23.6
"2011","Sevenoaks 001D","E01024472","Total",1396,686,710,1396,0,17,306.38,4.6
"2011","Sevenoaks 001E","E01024479","Total",1484,730,754,1484,0,12,80.66,18.4
"2011","Sevenoaks 002A","E01024476","Total",1540,723,817,1540,0,12,35.61,43.2
"2011","Sevenoaks 002B","E01024477","Total",1416,671,745,1416,0,10,32.50,43.6
"2011","Sevenoaks 002C","E01024478","Total",1422,716,706,1422,0,8,42.84,33.2
"2011","Sevenoaks 002D","E01024480","Total",1635,767,868,1635,0,16,37.98,43.0
"2011","Sevenoaks 002E","E01024481","Total",1535,715,820,1535,0,9,49.50,31.0
"2011","Sevenoaks 002F","E01024482","Total",1450,691,759,1450,0,15,19.04,76.2
"2011","Sevenoaks 003A","E01024421","Total",1909,931,978,1909,0,20,1002.89,1.9
"2011","Sevenoaks 003B","E01024473","Total",1597,762,835,1597,0,20,51.56,31.0
"2011","Sevenoaks 003C","E01024474","Total",1267,627,640,1266,1,17,26.91,47.1
"2011","Sevenoaks 003D","E01024475","Total",1484,747,737,1484,0,11,31.61,46.9
"2011","Sevenoaks 004A","E01024441","Total",1524,749,775,1524,0,32,76.83,19.8
"2011","Sevenoaks 004B","E01024442","Total",1512,783,729,1511,1,27,1141.36,1.3
"2011","Sevenoaks 004C","E01024443","Total",1533,682,851,1422,111,30,76.21,20.1
"2011","Sevenoaks 004D","E01024444","Total",1266,602,664,1266,0,13,20.32,62.3
"2011","Sevenoaks 005A","E01024431","Total",1814,856,958,1814,0,33,1453.81,1.2
"2011","Sevenoaks 005B","E01024432","Total",1522,726,796,1487,35,17,450.59,3.4
"2011","Sevenoaks 005C","E01024433","Total",1319,661,658,1308,11,33,964.81,1.4
"2011","Sevenoaks 005D","E01024434","Total",1970,951,1019,1970,0,14,601.91,3.3
"2011","Sevenoaks 007A","E01024435","Total",1545,752,793,1522,23,22,876.19,1.8
"2011","Sevenoaks 007B","E01024436","Total",1504,738,766,1504,0,12,411.20,3.7
"2011","Sevenoaks 007C","E01024437","Total",1509,767,742,1499,10,23,914.77,1.6
"2011","Sevenoaks 007D","E01024438","Total",1504,735,769,1504,0,18,58.57,25.7
"2011","Sevenoaks 008A","E01024422","Total",1858,906,952,1840,18,21,379.19,4.9
"2011","Sevenoaks 008B","E01024423","Total",1721,840,881,1721,0,25,40.38,42.6
"2011","Sevenoaks 008C","E01024439","Total",1563,764,799,1563,0,20,566.35,2.8
"2011","Sevenoaks 008D","E01024440","Total",1922,953,969,1922,0,46,1035.30,1.9
"2011","Sevenoaks 008E","E01024452","Total",1393,697,696,1390,3,41,1619.18,0.9
"2011","Sevenoaks 009A","E01024448","Total",1251,588,663,1220,31,16,50.19,24.9
"2011","Sevenoaks 009B","E01024449","Total",1440,694,746,1440,0,25,115.76,12.4
"2011","Sevenoaks 009C","E01024450","Total",1527,722,805,1511,16,30,728.32,2.1
"2011","Sevenoaks 009D","E01024453","Total",1625,824,801,1625,0,44,265.60,6.1
"2011","Sevenoaks 009E","E01024454","Total",1577,757,820,1577,0,18,262.34,6.0
"2011","Sevenoaks 010A","E01024457","Total",1161,541,620,1161,0,26,102.42,11.3
"2011","Sevenoaks 010B","E01024460","Total",1662,810,852,1662,0,25,35.76,46.5
"2011","Sevenoaks 010C","E01024461","Total",2446,1197,1249,2378,68,56,90.07,27.2
"2011","Sevenoaks 010D","E01024465","Total",1384,673,711,1384,0,12,149.56,9.3
"2011","Sevenoaks 010E","E01024466","Total",1363,667,696,1330,33,11,97.26,14.0
"2011","Sevenoaks 010F","E01024468","Total",1492,718,774,1485,7,25,38.57,38.7
"2011","Sevenoaks 011A","E01024416","Total",1705,837,868,1601,104,42,1512.72,1.1
"2011","Sevenoaks 011B","E01024418","Total",1387,668,719,1387,0,36,46.48,29.8
"2011","Sevenoaks 011C","E01024424","Total",1415,708,707,1405,10,48,256.28,5.5
"2011","Sevenoaks 011D","E01024463","Total",1502,744,758,1502,0,68,95.88,15.7
"2011","Sevenoaks 011E","E01024464","Total",1681,822,859,1606,75,68,170.79,9.8
"2011","Sevenoaks 011F","E01024467","Total",1705,830,875,1705,0,32,89.46,19.1
"2011","Sevenoaks 012A","E01024458","Total",1452,725,727,1398,54,77,1252.97,1.2
"2011","Sevenoaks 012B","E01024459","Total",1581,766,815,1581,0,70,1525.07,1.0
"2011","Sevenoaks 012C","E01024462","Total",1675,814,861,1661,14,73,123.63,13.5
"2011","Sevenoaks 012D","E01024469","Total",1632,827,805,1557,75,56,42.51,38.4
"2011","Sevenoaks 012E","E01024470","Total",1602,772,830,1573,29,52,54.49,29.4
"2011","Sevenoaks 012F","E01024471","Total",1849,825,1024,1497,352,35,486.97,3.8
"2011","Sevenoaks 013A","E01024417","Total",1558,768,790,1558,0,28,933.66,1.7
"2011","Sevenoaks 013B","E01024419","Total",1748,841,907,1748,0,55,2194.66,0.8
"2011","Sevenoaks 013C","E01024483","Total",1574,781,793,1511,63,27,725.14,2.2
"2011","Sevenoaks 013D","E01024484","Total",1219,593,626,1219,0,44,1460.97,0.8
"2011","Sevenoaks 013E","E01024485","Total",1682,819,863,1682,0,22,100.64,16.7
"2011","Sevenoaks 014A","E01024425","Total",1586,761,825,1578,8,11,90.81,17.5
"2011","Sevenoaks 014B","E01024426","Total",1755,847,908,1755,0,22,566.71,3.1
"2011","Sevenoaks 014C","E01024427","Total",1271,599,672,1271,0,16,307.02,4.1
"2011","Sevenoaks 014D","E01024428","Total",1299,625,674,1299,0,12,148.72,8.7
"2011","Sevenoaks 014E","E01024429","Total",1568,752,816,1531,37,19,36.58,42.9
"2011","Sevenoaks 014F","E01024430","Total",1428,690,738,1377,51,18,1052.60,1.4
"2011","Sevenoaks 015A","E01024420","Total",2049,1014,1035,2026,23,74,2742.16,0.7
"2011","Sevenoaks 015B","E01024451","Total",2204,1063,1141,2204,0,71,2515.27,0.9
"2011","Sevenoaks 015C","E01024455","Total",1206,577,629,1206,0,40,1981.37,0.6
"2011","Sevenoaks 015D","E01024456","Total",1261,616,645,1259,2,56,1204.91,1.0
"2011","Sevenoaks 016A","E01024413","Total",1623,749,874,1623,0,12,37.14,43.7
"2011","Sevenoaks 016B","E01024414","Total",1566,753,813,1562,4,14,137.72,11.4
"2011","Sevenoaks 016C","E01024415","Total",1358,669,689,1358,0,37,57.07,23.8
"2011","Sevenoaks 016D","E01032619","Total",1618,797,821,1618,0,18,431.15,3.8
"2011","Shepway 001A","E01024490","Total",2087,1040,1047,2087,0,56,3424.42,0.6
"2011","Shepway 001B","E01024544","Total",1399,684,715,1375,24,17,1430.86,1.0
"2011","Shepway 001C","E01024545","Total",1447,697,750,1447,0,56,3144.04,0.5
"2011","Shepway 001D","E01024547","Total",1342,632,710,1342,0,19,212.12,6.3
"2011","Shepway 002A","E01024492","Total",1522,741,781,1522,0,7,176.91,8.6
"2011","Shepway 002B","E01024541","Total",2439,1206,1233,2429,10,21,189.93,12.8
"2011","Shepway 002C","E01024542","Total",2039,983,1056,2032,7,20,135.59,15.0
"2011","Shepway 002E","E01033213","Total",1789,890,899,1789,0,19,381.79,4.7
"2011","Shepway 002F","E01033214","Total",1735,855,880,1735,0,30,415.47,4.2
"2011","Shepway 003A","E01024496","Total",1583,760,823,1583,0,6,145.34,10.9
"2011","Shepway 003B","E01024497","Total",1661,773,888,1661,0,19,123.24,13.5
"2011","Shepway 003C","E01024498","Total",1662,788,874,1662,0,8,22.91,72.5
"2011","Shepway 003D","E01024503","Total",1721,839,882,1721,0,15,91.23,18.9
"2011","Shepway 003E","E01024518","Total",1721,843,878,1721,0,12,46.13,37.3
"2011","Shepway 004A","E01024499","Total",1676,825,851,1675,1,10,14.18,118.2
"2011","Shepway 004B","E01024500","Total",1207,582,625,1207,0,2,14.44,83.6
"2011","Shepway 004C","E01024501","Total",1576,732,844,1576,0,9,9.56,164.9
"2011","Shepway 004D","E01024502","Total",1404,746,658,1394,10,11,15.39,91.2
"2011","Shepway 004E","E01024505","Total",1882,946,936,1843,39,11,22.91,82.1
"2011","Shepway 005A","E01024491","Total",1528,748,780,1528,0,16,17.23,88.7
"2011","Shepway 005B","E01024493","Total",1471,697,774,1471,0,6,16.99,86.6
"2011","Shepway 005C","E01024494","Total",1651,796,855,1651,0,4,132.11,12.5
"2011","Shepway 005D","E01024495","Total",1787,892,895,1787,0,16,43.83,40.8
"2011","Shepway 005E","E01024520","Total",1404,673,731,1404,0,8,23.28,60.3
"2011","Shepway 005F","E01024528","Total",1252,592,660,1252,0,8,120.68,10.4
"2011","Shepway 006A","E01024511","Total",1400,655,745,1336,64,28,56.63,24.7
"2011","Shepway 006B","E01024512","Total",1743,839,904,1743,0,12,21.82,79.9
"2011","Shepway 006C","E01024513","Total",1676,809,867,1676,0,19,67.35,24.9
"2011","Shepway 006D","E01024514","Total",1378,674,704,1378,0,17,27.29,50.5
"2011","Shepway 006E","E01024515","Total",1434,690,744,1434,0,18,42.84,33.5
"2011","Shepway 006F","E01024516","Total",1397,676,721,1397,0,26,62.84,22.2
"2011","Shepway 006G","E01024519","Total",1554,949,605,1265,289,25,121.53,12.8
"2011","Shepway 006H","E01024521","Total",1681,796,885,1645,36,20,62.41,26.9
"2011","Shepway 008A","E01024523","Total",1548,732,816,1515,33,28,66.32,23.3
"2011","Shepway 008B","E01024526","Total",1526,712,814,1442,84,17,230.74,6.6
"2011","Shepway 008C","E01024527","Total",1466,672,794,1381,85,25,89.08,16.5
"2011","Shepway 008D","E01024550","Total",2022,953,1069,1968,54,26,2940.58,0.7
"2011","Shepway 009A","E01024489","Total",1703,853,850,1698,5,8,201.61,8.4
"2011","Shepway 009B","E01024530","Total",1464,690,774,1460,4,19,435.83,3.4
"2011","Shepway 009C","E01024536","Total",2004,981,1023,1972,32,47,1541.27,1.3
"2011","Shepway 009D","E01024546","Total",1601,769,832,1579,22,19,723.70,2.2
"2011","Shepway 010A","E01024522","Total",1344,630,714,1335,9,15,22.96,58.5
"2011","Shepway 010B","E01024524","Total",1479,668,811,1441,38,8,42.63,34.7
"2011","Shepway 010C","E01024525","Total",1563,733,830,1507,56,19,49.25,31.7
"2011","Shepway 010D","E01024529","Total",1435,676,759,1435,0,5,121.19,11.8
"2011","Shepway 010E","E01024531","Total",1439,695,744,1439,0,9,48.80,29.5
"2011","Shepway 011A","E01024486","Total",2022,960,1062,1945,77,19,378.86,5.3
"2011","Shepway 011B","E01024487","Total",1266,613,653,1233,33,6,104.68,12.1
"2011","Shepway 011C","E01024488","Total",1300,603,697,1300,0,3,44.29,29.4
"2011","Shepway 011D","E01024548","Total",1245,634,611,1245,0,23,5215.47,0.2
"2011","Shepway 011E","E01024549","Total",1113,569,544,1113,0,21,6875.98,0.2
"2011","Shepway 012A","E01024537","Total",1675,843,832,1651,24,17,121.16,13.8
"2011","Shepway 012B","E01024538","Total",1769,855,914,1603,166,24,238.62,7.4
"2011","Shepway 012C","E01024539","Total",2006,931,1075,1996,10,11,161.17,12.4
"2011","Shepway 012D","E01024540","Total",1546,755,791,1531,15,14,120.50,12.8
"2011","Shepway 013A","E01024532","Total",1459,767,692,1455,4,8,81.24,18.0
"2011","Shepway 013B","E01024533","Total",1219,604,615,1216,3,10,868.20,1.4
"2011","Shepway 013C","E01024534","Total",1532,746,786,1529,3,11,62.64,24.5
"2011","Shepway 013D","E01024535","Total",2357,1220,1137,2287,70,8,3811.97,0.6
"2011","Shepway 014A","E01024504","Total",2035,1145,890,2029,6,9,24.55,82.9
"2011","Shepway 014B","E01024507","Total",1995,1096,899,1953,42,11,15.33,130.1
"2011","Shepway 014C","E01033212","Total",1461,820,641,1451,10,7,21.22,68.9
"2011","Shepway 014D","E01033215","Total",1207,669,538,1195,12,4,26.73,45.2
"2011","Shepway 015A","E01024508","Total",1955,986,969,1846,109,9,34.86,56.1
"2011","Shepway 015B","E01024509","Total",1639,832,807,1533,106,6,20.88,78.5
"2011","Shepway 015C","E01024510","Total",1633,807,826,1538,95,12,34.65,47.1
"2011","Shepway 015D","E01024517","Total",1693,868,825,1562,131,22,60.06,28.2
"2011","Swale 001A","E01024609","Total",1172,600,572,1114,58,6,23.25,50.4
"2011","Swale 001B","E01024610","Total",1569,764,805,1569,0,13,36.62,42.8
"2011","Swale 001C","E01024611","Total",1572,782,790,1561,11,4,9.84,159.8
"2011","Swale 001D","E01024612","Total",1529,742,787,1529,0,19,26.55,57.6
"2011","Swale 002A","E01024613","Total",1428,721,707,1408,20,7,65.62,21.8
"2011","Swale 002B","E01024614","Total",1520,729,791,1520,0,4,26.73,56.9
"2011","Swale 002C","E01024615","Total",1495,732,763,1495,0,6,139.07,10.7
"2011","Swale 002D","E01024616","Total",1653,788,865,1653,0,7,153.35,10.8
"2011","Swale 003A","E01024585","Total",1428,677,751,1419,9,3,36.21,39.4
"2011","Swale 003B","E01024587","Total",1441,689,752,1429,12,16,259.18,5.6
"2011","Swale 003C","E01024588","Total",1469,727,742,1407,62,11,53.48,27.5
"2011","Swale 003D","E01024589","Total",1551,766,785,1550,1,18,58.14,26.7
"2011","Swale 004A","E01024595","Total",1492,724,768,1492,0,8,168.91,8.8
"2011","Swale 004B","E01024598","Total",1571,812,759,1571,0,3,68.64,22.9
"2011","Swale 004D","E01024619","Total",1449,689,760,1428,21,14,34.26,42.3
"2011","Swale 004E","E01024621","Total",1255,588,667,1209,46,10,31.89,39.4
"2011","Swale 004F","E01032653","Total",1501,743,758,1501,0,8,36.32,41.3
"2011","Swale 004G","E01032654","Total",1829,921,908,1829,0,23,162.54,11.3
"2011","Swale 005A","E01024594","Total",1395,686,709,1383,12,13,135.03,10.3
"2011","Swale 005B","E01024596","Total",1611,794,817,1611,0,9,274.61,5.9
"2011","Swale 005C","E01024597","Total",1454,716,738,1454,0,9,433.63,3.4
"2011","Swale 005D","E01024620","Total",1242,623,619,1242,0,6,2167.72,0.6
"2011","Swale 006A","E01024580","Total",1678,846,832,1642,36,5,2085.31,0.8
"2011","Swale 006B","E01024581","Total",1341,669,672,1329,12,8,69.44,19.3
"2011","Swale 006C","E01024586","Total",1624,776,848,1624,0,9,213.37,7.6
"2011","Swale 006D","E01024618","Total",3022,2140,882,1774,1248,17,2316.96,1.3
"2011","Swale 007B","E01024576","Total",1648,803,845,1648,0,16,29.52,55.8
"2011","Swale 007C","E01024577","Total",1369,679,690,1366,3,12,108.55,12.6
"2011","Swale 007D","E01024578","Total",1634,782,852,1634,0,19,124.08,13.2
"2011","Swale 007E","E01024579","Total",2970,1467,1503,2970,0,19,175.74,16.9
"2011","Swale 007F","E01024583","Total",1676,789,887,1629,47,13,26.68,62.8
"2011","Swale 007G","E01032655","Total",1584,799,785,1584,0,7,998.07,1.6
"2011","Swale 007H","E01032656","Total",1503,740,763,1503,0,10,310.63,4.8
"2011","Swale 008A","E01024570","Total",1749,810,939,1733,16,24,978.04,1.8
"2011","Swale 008B","E01024571","Total",1545,750,795,1489,56,12,351.31,4.4
"2011","Swale 008C","E01024572","Total",1144,579,565,1144,0,19,1099.35,1.0
"2011","Swale 008D","E01024573","Total",1340,639,701,1340,0,11,90.31,14.8
"2011","Swale 008E","E01024575","Total",1180,583,597,1180,0,20,522.27,2.3
"2011","Swale 009A","E01024554","Total",2432,1195,1237,2379,53,38,718.56,3.4
"2011","Swale 009B","E01024561","Total",1360,709,651,1360,0,4,55.84,24.4
"2011","Swale 009C","E01024567","Total",2774,1353,1421,2772,2,17,55.92,49.6
"2011","Swale 009D","E01024568","Total",2794,1373,1421,2773,21,22,664.07,4.2
"2011","Swale 009E","E01024582","Total",1567,787,780,1525,42,17,30.12,52.0
"2011","Swale 010A","E01024559","Total",1339,647,692,1331,8,17,18.41,72.7
"2011","Swale 010B","E01024584","Total",1704,814,890,1704,0,3,111.02,15.3
"2011","Swale 010C","E01024590","Total",1532,777,755,1480,52,10,88.64,17.3
"2011","Swale 010D","E01024599","Total",1926,924,1002,1926,0,8,22.94,84.0
"2011","Swale 010E","E01024608","Total",1738,866,872,1733,5,21,46.73,37.2
"2011","Swale 011A","E01024591","Total",1810,894,916,1810,0,16,252.53,7.2
"2011","Swale 011B","E01024592","Total",1264,644,620,1264,0,10,18.54,68.2
"2011","Swale 011C","E01024593","Total",1371,663,708,1371,0,9,46.54,29.5
"2011","Swale 011D","E01024600","Total",1484,727,757,1484,0,13,53.54,27.7
"2011","Swale 011E","E01024601","Total",1612,788,824,1605,7,15,34.95,46.1
"2011","Swale 012A","E01024560","Total",1273,611,662,1273,0,5,18.51,68.8
"2011","Swale 012B","E01024562","Total",1479,734,745,1462,17,10,27.36,54.1
"2011","Swale 012C","E01024569","Total",1766,861,905,1704,62,16,55.37,31.9
"2011","Swale 012D","E01024630","Total",1645,783,862,1645,0,11,61.67,26.7
"2011","Swale 012E","E01024632","Total",1560,759,801,1560,0,21,43.36,36.0
"2011","Swale 013A","E01024606","Total",1394,690,704,1322,72,21,50.16,27.8
"2011","Swale 013C","E01024628","Total",1497,746,751,1497,0,30,2293.82,0.7
"2011","Swale 013D","E01024629","Total",1141,566,575,1138,3,21,137.27,8.3
"2011","Swale 013E","E01024631","Total",1676,804,872,1626,50,17,419.43,4.0
"2011","Swale 013F","E01032735","Total",1568,760,808,1568,0,23,62.11,25.2
"2011","Swale 013G","E01032737","Total",1443,732,711,1443,0,19,32.79,44.0
"2011","Swale 014A","E01024564","Total",1012,494,518,1012,0,17,331.25,3.1
"2011","Swale 014B","E01024603","Total",1246,631,615,1246,0,19,18.33,68.0
"2011","Swale 014C","E01024604","Total",1194,572,622,1194,0,6,47.33,25.2
"2011","Swale 014D","E01024605","Total",1339,647,692,1339,0,10,27.15,49.3
"2011","Swale 014E","E01024626","Total",1575,759,816,1538,37,21,109.61,14.4
"2011","Swale 014F","E01024627","Total",1934,936,998,1925,9,13,71.04,27.2
"2011","Swale 015A","E01024551","Total",2241,1050,1191,2214,27,15,39.72,56.4
"2011","Swale 015B","E01024552","Total",1855,887,968,1848,7,10,161.76,11.5
"2011","Swale 015C","E01024553","Total",1988,919,1069,1940,48,32,56.06,35.5
"2011","Swale 015D","E01024563","Total",1581,778,803,1574,7,4,30.03,52.6
"2011","Swale 015E","E01024602","Total",1489,717,772,1475,14,21,23.47,63.4
"2011","Swale 015F","E01024625","Total",1862,906,956,1846,16,23,199.95,9.3
"2011","Swale 016A","E01024565","Total",1305,669,636,1290,15,23,2903.21,0.4
"2011","Swale 016B","E01024566","Total",1483,764,719,1475,8,28,3103.74,0.5
"2011","Swale 016C","E01024622","Total",1681,833,848,1646,35,22,2757.93,0.6
"2011","Swale 016D","E01024623","Total",1838,890,948,1826,12,15,67.71,27.1
"2011","Swale 016E","E01024624","Total",1804,903,901,1778,26,16,1675.88,1.1
"2011","Swale 017A","E01024555","Total",1340,641,699,1219,121,25,1950.32,0.7
"2011","Swale 017B","E01024556","Total",1182,582,600,1182,0,22,2332.32,0.5
"2011","Swale 017C","E01024557","Total",1493,717,776,1493,0,14,117.13,12.7
"2011","Swale 017D","E01024558","Total",1611,786,825,1602,9,27,1993.19,0.8
"2011","Thanet 001A","E01024657","Total",2276,1210,1066,2134,142,12,20.91,108.8
"2011","Thanet 001B","E01024658","Total",2072,1033,1039,2044,28,3,18.46,112.2
"2011","Thanet 001C","E01024659","Total",1527,733,794,1419,108,30,20.89,73.1
"2011","Thanet 001D","E01024660","Total",1760,874,886,1675,85,14,17.46,100.8
"2011","Thanet 001E","E01024678","Total",1918,954,964,1900,18,7,27.51,69.7
"2011","Thanet 002A","E01024653","Total",1601,765,836,1601,0,25,66.89,23.9
"2011","Thanet 002B","E01024654","Total",1519,713,806,1517,2,6,57.55,26.4
"2011","Thanet 002C","E01024655","Total",1475,700,775,1449,26,14,47.68,30.9
"2011","Thanet 002D","E01024656","Total",1673,801,872,1662,11,16,55.73,30.0
"2011","Thanet 002E","E01024675","Total",2147,1010,1137,2054,93,44,235.54,9.1
"2011","Thanet 003A","E01024676","Total",1667,899,768,1589,78,12,37.58,44.4
"2011","Thanet 003B","E01024677","Total",1798,861,937,1684,114,14,22.68,79.3
"2011","Thanet 003C","E01024695","Total",1302,636,666,1296,6,11,21.73,59.9
"2011","Thanet 003D","E01024697","Total",1276,594,682,1276,0,6,22.54,56.6
"2011","Thanet 003E","E01024710","Total",1131,614,517,1118,13,6,23.99,47.1
"2011","Thanet 004A","E01024661","Total",1510,765,745,1499,11,10,15.26,99.0
"2011","Thanet 004B","E01024664","Total",1482,719,763,1475,7,9,35.27,42.0
"2011","Thanet 004C","E01024665","Total",1516,704,812,1508,8,12,18.62,81.4
"2011","Thanet 004D","E01024694","Total",1779,862,917,1752,27,6,109.57,16.2
"2011","Thanet 004E","E01024696","Total",1411,662,749,1348,63,8,130.42,10.8
"2011","Thanet 005A","E01024672","Total",1451,670,781,1451,0,8,100.06,14.5
"2011","Thanet 005B","E01024673","Total",1792,872,920,1792,0,24,116.85,15.3
"2011","Thanet 005C","E01024674","Total",1606,800,806,1606,0,25,31.38,51.2
"2011","Thanet 005D","E01024711","Total",1441,705,736,1385,56,18,34.86,41.3
"2011","Thanet 005E","E01024712","Total",1554,752,802,1517,37,12,45.09,34.5
"2011","Thanet 006A","E01024633","Total",1545,740,805,1545,0,11,24.24,63.7
"2011","Thanet 006B","E01024634","Total",1403,656,747,1403,0,5,62.19,22.6
"2011","Thanet 006C","E01024662","Total",1579,734,845,1579,0,8,47.26,33.4
"2011","Thanet 006D","E01024663","Total",1587,733,854,1587,0,8,38.87,40.8
"2011","Thanet 006E","E01024666","Total",1655,781,874,1655,0,12,21.24,77.9
"2011","Thanet 007A","E01024641","Total",1457,673,784,1457,0,5,156.30,9.3
"2011","Thanet 007B","E01024713","Total",1663,771,892,1640,23,7,51.82,32.1
"2011","Thanet 007C","E01024714","Total",1512,679,833,1371,141,7,53.60,28.2
"2011","Thanet 007D","E01024715","Total",1803,867,936,1676,127,16,26.54,67.9
"2011","Thanet 007E","E01024716","Total",2018,949,1069,2018,0,24,84.80,23.8
"2011","Thanet 008A","E01024636","Total",2028,920,1108,2022,6,27,53.16,38.1
"2011","Thanet 008B","E01024637","Total",1672,784,888,1611,61,23,119.44,14.0
"2011","Thanet 008C","E01024638","Total",1587,725,862,1563,24,15,91.28,17.4
"2011","Thanet 008D","E01024639","Total",1624,755,869,1624,0,12,54.73,29.7
"2011","Thanet 008E","E01024640","Total",1593,755,838,1589,4,11,258.55,6.2
"2011","Thanet 009A","E01024635","Total",1676,810,866,1653,23,21,61.87,27.1
"2011","Thanet 009B","E01024642","Total",1503,689,814,1439,64,24,47.15,31.9
"2011","Thanet 009C","E01024644","Total",1331,629,702,1280,51,23,41.72,31.9
"2011","Thanet 009D","E01024692","Total",1642,728,914,1642,0,14,39.63,41.4
"2011","Thanet 009E","E01024693","Total",1372,643,729,1372,0,31,31.09,44.1
"2011","Thanet 010A","E01024643","Total",1233,617,616,1233,0,14,29.82,41.3
"2011","Thanet 010B","E01024705","Total",1271,630,641,1137,134,17,21.92,58.0
"2011","Thanet 010C","E01024706","Total",1523,733,790,1418,105,24,37.68,40.4
"2011","Thanet 010D","E01024707","Total",1361,645,716,1348,13,28,27.62,49.3
"2011","Thanet 010E","E01024708","Total",1532,732,800,1451,81,21,77.98,19.6
"2011","Thanet 011A","E01024686","Total",1633,784,849,1633,0,5,38.60,42.3
"2011","Thanet 011B","E01024688","Total",1566,750,816,1558,8,8,135.80,11.5
"2011","Thanet 011C","E01024689","Total",1253,589,664,1253,0,17,64.82,19.3
"2011","Thanet 011D","E01024690","Total",1503,682,821,1435,68,23,77.20,19.5
"2011","Thanet 011E","E01024691","Total",1272,618,654,1190,82,8,212.77,6.0
"2011","Thanet 012A","E01024669","Total",1684,803,881,1684,0,9,15.65,107.6
"2011","Thanet 012B","E01024698","Total",1466,692,774,1427,39,18,30.47,48.1
"2011","Thanet 012C","E01024699","Total",1853,902,951,1853,0,10,39.23,47.2
"2011","Thanet 012D","E01024700","Total",1804,842,962,1804,0,28,37.76,47.8
"2011","Thanet 012E","E01024709","Total",1336,636,700,1336,0,21,42.57,31.4
"2011","Thanet 013A","E01024682","Total",1723,796,927,1723,0,11,73.70,23.4
"2011","Thanet 013B","E01024683","Total",1720,820,900,1720,0,8,18.63,92.3
"2011","Thanet 013C","E01024684","Total",1601,786,815,1601,0,10,39.54,40.5
"2011","Thanet 013D","E01024685","Total",1866,867,999,1854,12,7,31.56,59.1
"2011","Thanet 013E","E01024687","Total",1445,722,723,1445,0,9,57.60,25.1
"2011","Thanet 014A","E01024701","Total",1995,979,1016,1985,10,24,2473.86,0.8
"2011","Thanet 014B","E01024702","Total",1339,649,690,1325,14,17,184.63,7.3
"2011","Thanet 014C","E01024703","Total",1736,854,882,1736,0,27,2664.81,0.7
"2011","Thanet 014D","E01024704","Total",1668,809,859,1668,0,16,506.36,3.3
"2011","Thanet 015A","E01024645","Total",1516,752,764,1516,0,12,32.49,46.7
"2011","Thanet 015B","E01024647","Total",1579,796,783,1570,9,19,17.23,91.6
"2011","Thanet 015C","E01024668","Total",1392,686,706,1188,204,16,23.99,58.0
"2011","Thanet 015D","E01024670","Total",1575,746,829,1533,42,11,21.08,74.7
"2011","Thanet 015E","E01024681","Total",1727,834,893,1703,24,12,19.70,87.7
"2011","Thanet 016A","E01024646","Total",1900,939,961,1900,0,24,27.57,68.9
"2011","Thanet 016B","E01024648","Total",1519,764,755,1489,30,12,16.13,94.2
"2011","Thanet 016C","E01024649","Total",1726,861,865,1695,31,14,48.23,35.8
"2011","Thanet 016D","E01024667","Total",1725,890,835,1721,4,8,22.65,76.2
"2011","Thanet 016E","E01024671","Total",1646,772,874,1638,8,9,13.95,118.0
"2011","Thanet 017A","E01024650","Total",1442,696,746,1442,0,18,46.43,31.1
"2011","Thanet 017B","E01024651","Total",1439,696,743,1383,56,25,113.05,12.7
"2011","Thanet 017C","E01024652","Total",1822,879,943,1822,0,24,224.14,8.1
"2011","Thanet 017D","E01024679","Total",1261,604,657,1261,0,6,32.34,39.0
"2011","Thanet 017E","E01024680","Total",1600,774,826,1600,0,10,33.97,47.1
"2011","Tonbridge and Malling 001A","E01024719","Total",1983,1013,970,1968,15,22,522.17,3.8
"2011","Tonbridge and Malling 001B","E01024720","Total",1398,681,717,1394,4,21,47.38,29.5
"2011","Tonbridge and Malling 001C","E01024721","Total",1285,639,646,1282,3,24,432.62,3.0
"2011","Tonbridge and Malling 001D","E01024722","Total",1377,667,710,1374,3,30,35.55,38.7
"2011","Tonbridge and Malling 001E","E01024727","Total",2724,1313,1411,2596,128,28,1177.81,2.3
"2011","Tonbridge and Malling 001F","E01024728","Total",1638,809,829,1638,0,14,321.41,5.1
"2011","Tonbridge and Malling 002C","E01024771","Total",1865,901,964,1835,30,8,117.89,15.8
"2011","Tonbridge and Malling 002D","E01024772","Total",1644,814,830,1644,0,15,54.46,30.2
"2011","Tonbridge and Malling 002E","E01024773","Total",1744,850,894,1704,40,17,53.53,32.6
"2011","Tonbridge and Malling 002F","E01024774","Total",2461,1181,1280,2451,10,11,562.75,4.4
"2011","Tonbridge and Malling 002G","E01032830","Total",2497,1195,1302,2488,9,13,91.48,27.3
"2011","Tonbridge and Malling 003A","E01024741","Total",1538,730,808,1538,0,12,28.45,54.1
"2011","Tonbridge and Malling 003B","E01024761","Total",2214,1092,1122,2214,0,20,113.14,19.6
"2011","Tonbridge and Malling 003C","E01024762","Total",2054,1031,1023,2054,0,18,140.75,14.6
"2011","Tonbridge and Malling 003D","E01024763","Total",1394,676,718,1394,0,9,23.00,60.6
"2011","Tonbridge and Malling 003E","E01024764","Total",1263,630,633,1226,37,11,34.63,36.5
"2011","Tonbridge and Malling 003F","E01024765","Total",1365,685,680,1365,0,17,27.61,49.4
"2011","Tonbridge and Malling 003G","E01024782","Total",1286,627,659,1286,0,23,66.08,19.5
"2011","Tonbridge and Malling 003H","E01024785","Total",1480,713,767,1480,0,21,25.38,58.3
"2011","Tonbridge and Malling 005A","E01024717","Total",1611,733,878,1543,68,14,453.15,3.6
"2011","Tonbridge and Malling 005B","E01024718","Total",1336,664,672,1336,0,20,55.33,24.1
"2011","Tonbridge and Malling 005C","E01024735","Total",1570,769,801,1570,0,16,120.41,13.0
"2011","Tonbridge and Malling 005D","E01024736","Total",1703,817,886,1703,0,21,246.00,6.9
"2011","Tonbridge and Malling 005E","E01024737","Total",2331,1121,1210,2331,0,23,74.50,31.3
"2011","Tonbridge and Malling 006A","E01024723","Total",1587,801,786,1582,5,56,1871.03,0.8
"2011","Tonbridge and Malling 006B","E01024724","Total",1992,967,1025,1950,42,40,705.78,2.8
"2011","Tonbridge and Malling 006C","E01024725","Total",1640,801,839,1600,40,26,121.16,13.5
"2011","Tonbridge and Malling 006D","E01024726","Total",1719,830,889,1719,0,22,86.17,19.9
"2011","Tonbridge and Malling 006E","E01024755","Total",2084,1035,1049,2078,6,74,924.22,2.3
"2011","Tonbridge and Malling 006F","E01024786","Total",1921,921,1000,1906,15,35,1376.47,1.4
"2011","Tonbridge and Malling 007A","E01024746","Total",1083,528,555,1083,0,28,1600.84,0.7
"2011","Tonbridge and Malling 007C","E01024760","Total",1581,785,796,1581,0,22,52.89,29.9
"2011","Tonbridge and Malling 007D","E01024781","Total",2104,1039,1065,2062,42,43,539.74,3.9
"2011","Tonbridge and Malling 007E","E01032825","Total",1576,774,802,1576,0,14,146.52,10.8
"2011","Tonbridge and Malling 007F","E01032826","Total",1613,834,779,1613,0,18,54.60,29.5
"2011","Tonbridge and Malling 007G","E01032827","Total",1762,878,884,1762,0,15,50.52,34.9
"2011","Tonbridge and Malling 007H","E01032828","Total",1238,618,620,1238,0,27,27.22,45.5
"2011","Tonbridge and Malling 008A","E01024743","Total",1829,897,932,1809,20,30,308.75,5.9
"2011","Tonbridge and Malling 008B","E01024744","Total",2042,1035,1007,2042,0,36,1610.57,1.3
"2011","Tonbridge and Malling 008C","E01024745","Total",1872,912,960,1757,115,100,1247.47,1.5
"2011","Tonbridge and Malling 008D","E01024747","Total",1546,746,800,1546,0,7,40.55,38.1
"2011","Tonbridge and Malling 009A","E01024730","Total",1284,616,668,1284,0,17,43.27,29.7
"2011","Tonbridge and Malling 009B","E01024731","Total",1209,583,626,1192,17,21,118.35,10.2
"2011","Tonbridge and Malling 009C","E01024775","Total",1529,731,798,1529,0,10,30.04,50.9
"2011","Tonbridge and Malling 009D","E01024776","Total",1318,615,703,1318,0,6,32.34,40.8
"2011","Tonbridge and Malling 009E","E01024777","Total",1238,596,642,1232,6,9,22.77,54.4
"2011","Tonbridge and Malling 010A","E01024734","Total",1613,759,854,1576,37,33,99.69,16.2
"2011","Tonbridge and Malling 010B","E01024752","Total",1662,815,847,1662,0,40,205.08,8.1
"2011","Tonbridge and Malling 010C","E01024753","Total",1595,801,794,1555,40,37,157.89,10.1
"2011","Tonbridge and Malling 010D","E01024754","Total",1697,853,844,1684,13,49,1337.07,1.3
"2011","Tonbridge and Malling 011A","E01024729","Total",1770,826,944,1770,0,47,47.61,37.2
"2011","Tonbridge and Malling 011B","E01024748","Total",1452,719,733,1452,0,28,104.06,14.0
"2011","Tonbridge and Malling 011C","E01024749","Total",1507,729,778,1507,0,26,24.86,60.6
"2011","Tonbridge and Malling 011D","E01024750","Total",1489,693,796,1489,0,30,53.93,27.6
"2011","Tonbridge and Malling 011E","E01024751","Total",1556,736,820,1548,8,29,263.70,5.9
"2011","Tonbridge and Malling 012A","E01024732","Total",1896,1161,735,1416,480,48,145.68,13.0
"2011","Tonbridge and Malling 012B","E01024733","Total",1773,867,906,1763,10,43,44.86,39.5
"2011","Tonbridge and Malling 012C","E01024756","Total",1653,805,848,1653,0,16,25.60,64.6
"2011","Tonbridge and Malling 012D","E01024766","Total",1974,1007,967,1974,0,42,94.26,20.9
"2011","Tonbridge and Malling 012E","E01024767","Total",1543,749,794,1510,33,25,57.46,26.9
"2011","Tonbridge and Malling 012F","E01024768","Total",1686,823,863,1669,17,47,183.10,9.2
"2011","Tonbridge and Malling 013A","E01024757","Total",1596,789,807,1590,6,25,66.93,23.8
"2011","Tonbridge and Malling 013B","E01024758","Total",1585,773,812,1585,0,28,296.21,5.4
"2011","Tonbridge and Malling 013C","E01024778","Total",1579,783,796,1579,0,32,27.03,58.4
"2011","Tonbridge and Malling 013D","E01024779","Total",1806,921,885,1801,5,20,25.12,71.9
"2011","Tonbridge and Malling 013E","E01024780","Total",1638,772,866,1638,0,28,93.95,17.4
"2011","Tonbridge and Malling 014A","E01024740","Total",1825,895,930,1825,0,35,547.09,3.3
"2011","Tonbridge and Malling 014B","E01024742","Total",1714,818,896,1714,0,13,158.47,10.8
"2011","Tonbridge and Malling 014C","E01024783","Total",1670,769,901,1580,90,24,325.00,5.1
"2011","Tonbridge and Malling 014D","E01024784","Total",1372,659,713,1362,10,31,238.48,5.8
"2011","Tonbridge and Malling 014E","E01032620","Total",2265,1116,1149,2265,0,46,2125.28,1.1
"2011","Tonbridge and Malling 014F","E01032829","Total",1361,676,685,1361,0,17,1428.40,1.0
"2011","Tunbridge Wells 001A","E01024798","Total",2467,1233,1234,2434,33,42,2115.49,1.2
"2011","Tunbridge Wells 001B","E01024811","Total",1220,606,614,1220,0,13,25.67,47.5
"2011","Tunbridge Wells 001C","E01024812","Total",1312,624,688,1305,7,21,574.51,2.3
"2011","Tunbridge Wells 001D","E01024813","Total",1666,823,843,1656,10,13,90.12,18.5
"2011","Tunbridge Wells 001E","E01024814","Total",1338,662,676,1338,0,21,99.36,13.5
"2011","Tunbridge Wells 001F","E01024815","Total",1346,649,697,1346,0,14,16.47,81.7
"2011","Tunbridge Wells 001G","E01024816","Total",1371,686,685,1371,0,30,176.65,7.8
"2011","Tunbridge Wells 002A","E01024837","Total",1963,964,999,1963,0,43,155.14,12.7
"2011","Tunbridge Wells 002B","E01024844","Total",1647,828,819,1645,2,23,15.23,108.1
"2011","Tunbridge Wells 002C","E01024846","Total",1600,781,819,1600,0,24,47.43,33.7
"2011","Tunbridge Wells 002D","E01024849","Total",1655,822,833,1644,11,32,97.09,17.0
"2011","Tunbridge Wells 002E","E01024850","Total",1335,667,668,1322,13,41,349.03,3.8
"2011","Tunbridge Wells 003A","E01024836","Total",1760,882,878,1760,0,21,21.16,83.2
"2011","Tunbridge Wells 003B","E01024839","Total",1750,875,875,1738,12,17,276.39,6.3
"2011","Tunbridge Wells 003C","E01024845","Total",1354,644,710,1348,6,28,39.45,34.3
"2011","Tunbridge Wells 003D","E01024847","Total",1623,776,847,1623,0,22,100.74,16.1
"2011","Tunbridge Wells 003E","E01024848","Total",1358,622,736,1283,75,24,44.35,30.6
"2011","Tunbridge Wells 004A","E01024793","Total",1682,843,839,1682,0,54,1037.68,1.6
"2011","Tunbridge Wells 004B","E01024825","Total",1544,716,828,1355,189,59,1271.34,1.2
"2011","Tunbridge Wells 004C","E01024826","Total",1467,738,729,1467,0,30,43.41,33.8
"2011","Tunbridge Wells 004D","E01024827","Total",1576,772,804,1562,14,28,41.23,38.2
"2011","Tunbridge Wells 004E","E01024828","Total",1541,760,781,1540,1,20,78.38,19.7
"2011","Tunbridge Wells 005A","E01024840","Total",2019,980,1039,2005,14,14,28.13,71.8
"2011","Tunbridge Wells 005B","E01024841","Total",1929,947,982,1929,0,14,33.06,58.3
"2011","Tunbridge Wells 005C","E01024842","Total",1602,786,816,1577,25,25,81.32,19.7
"2011","Tunbridge Wells 005D","E01024843","Total",1489,745,744,1475,14,8,39.41,37.8
"2011","Tunbridge Wells 006A","E01024829","Total",1658,810,848,1658,0,31,28.31,58.6
"2011","Tunbridge Wells 006B","E01024851","Total",1723,813,910,1671,52,53,860.90,2.0
"2011","Tunbridge Wells 006C","E01024852","Total",1355,665,690,1347,8,44,143.88,9.4
"2011","Tunbridge Wells 006D","E01024853","Total",1367,645,722,1316,51,38,440.10,3.1
"2011","Tunbridge Wells 006E","E01024854","Total",1696,841,855,1665,31,54,996.37,1.7
"2011","Tunbridge Wells 007A","E01024799","Total",1991,950,1041,1904,87,37,41.33,48.2
"2011","Tunbridge Wells 007B","E01024800","Total",1678,821,857,1668,10,87,78.03,21.5
"2011","Tunbridge Wells 007C","E01024835","Total",2123,1054,1069,2101,22,50,22.68,93.6
"2011","Tunbridge Wells 007D","E01024838","Total",1741,851,890,1741,0,57,56.36,30.9
"2011","Tunbridge Wells 008A","E01024801","Total",2594,1406,1188,2511,83,31,41.01,63.3
"2011","Tunbridge Wells 008B","E01024802","Total",2040,1132,908,2040,0,38,23.41,87.1
"2011","Tunbridge Wells 008C","E01024823","Total",1819,911,908,1819,0,32,51.81,35.1
"2011","Tunbridge Wells 008D","E01024833","Total",2409,1228,1181,2409,0,17,20.96,114.9
"2011","Tunbridge Wells 009A","E01024821","Total",2054,959,1095,1986,68,29,63.61,32.3
"2011","Tunbridge Wells 009B","E01024822","Total",1881,853,1028,1760,121,68,612.53,3.1
"2011","Tunbridge Wells 009C","E01024824","Total",1609,764,845,1560,49,28,61.55,26.1
"2011","Tunbridge Wells 009D","E01024832","Total",1664,803,861,1607,57,33,19.85,83.8
"2011","Tunbridge Wells 009E","E01024834","Total",2245,1111,1134,2245,0,28,40.52,55.4
"2011","Tunbridge Wells 010A","E01024795","Total",1455,720,735,1455,0,13,19.53,74.5
"2011","Tunbridge Wells 010B","E01024796","Total",1408,703,705,1392,16,25,230.37,6.1
"2011","Tunbridge Wells 010C","E01024830","Total",1869,933,936,1805,64,21,47.26,39.5
"2011","Tunbridge Wells 010D","E01024831","Total",1449,700,749,1449,0,18,96.00,15.1
"2011","Tunbridge Wells 011A","E01024792","Total",1895,946,949,1894,1,65,2082.95,0.9
"2011","Tunbridge Wells 011B","E01024794","Total",1721,836,885,1721,0,35,1076.41,1.6
"2011","Tunbridge Wells 011C","E01024804","Total",1501,756,745,1445,56,47,2549.97,0.6
"2011","Tunbridge Wells 011D","E01024805","Total",1706,872,834,1706,0,49,2166.09,0.8
"2011","Tunbridge Wells 011E","E01024806","Total",1826,979,847,1606,220,46,1342.28,1.4
"2011","Tunbridge Wells 012A","E01024797","Total",1623,819,804,1623,0,38,44.24,36.7
"2011","Tunbridge Wells 012B","E01024817","Total",1829,897,932,1808,21,58,67.74,27.0
"2011","Tunbridge Wells 012C","E01024818","Total",1727,817,910,1688,39,58,86.50,20.0
"2011","Tunbridge Wells 012D","E01024819","Total",1705,863,842,1658,47,38,26.73,63.8
"2011","Tunbridge Wells 012E","E01024820","Total",1706,821,885,1700,6,44,46.98,36.3
"2011","Tunbridge Wells 013A","E01024787","Total",1294,616,678,1246,48,54,1804.02,0.7
"2011","Tunbridge Wells 013B","E01024788","Total",1489,701,788,1489,0,23,130.21,11.4
"2011","Tunbridge Wells 013C","E01024790","Total",1305,653,652,1078,227,41,62.53,20.9
"2011","Tunbridge Wells 013D","E01024791","Total",1337,639,698,1333,4,41,702.48,1.9
"2011","Tunbridge Wells 013E","E01024803","Total",2180,1056,1124,2144,36,90,2916.83,0.7
"2011","Tunbridge Wells 014A","E01024789","Total",2374,958,1416,1860,514,104,2709.87,0.9
"2011","Tunbridge Wells 014B","E01024807","Total",1594,776,818,1567,27,32,502.14,3.2
"2011","Tunbridge Wells 014C","E01024808","Total",1616,786,830,1614,2,36,101.19,16.0
"2011","Tunbridge Wells 014D","E01024809","Total",1478,728,750,1469,9,30,1789.10,0.8
"2011","Tunbridge Wells 014E","E01024810","Total",1701,871,830,1676,25,69,2029.95,0.8
"2011","Cherwell 001A","E01028479","Total",1249,624,625,1249,0,22,2087.45,0.6
"2011","Cherwell 001B","E01028480","Total",1469,719,750,1421,48,33,1875.12,0.8
"2011","Cherwell 001C","E01028508","Total",1089,526,563,1089,0,44,2018.28,0.5
"2011","Cherwell 001D","E01028509","Total",1527,762,765,1475,52,40,2320.24,0.7
"2011","Cherwell 002A","E01028441","Total",2474,1211,1263,2474,0,17,56.80,43.6
"2011","Cherwell 002C","E01028443","Total",1464,718,746,1464,0,16,38.11,38.4
"2011","Cherwell 002D","E01028444","Total",1533,767,766,1533,0,21,31.80,48.2
"2011","Cherwell 002E","E01032943","Total",1632,797,835,1632,0,16,61.28,26.6
"2011","Cherwell 002F","E01032944","Total",1347,682,665,1347,0,18,19.47,69.2
"2011","Cherwell 003A","E01028445","Total",1458,685,773,1458,0,9,64.73,22.5
"2011","Cherwell 003B","E01028446","Total",1544,752,792,1544,0,16,56.49,27.3
"2011","Cherwell 003C","E01028447","Total",1260,651,609,1259,1,6,17.74,71.0
"2011","Cherwell 003D","E01028448","Total",1606,763,843,1564,42,10,23.26,69.0
"2011","Cherwell 004A","E01028435","Total",1696,820,876,1590,106,13,45.04,37.7
"2011","Cherwell 004C","E01028437","Total",1592,776,816,1545,47,17,239.98,6.6
"2011","Cherwell 004D","E01028438","Total",1687,840,847,1685,2,12,268.42,6.3
"2011","Cherwell 004E","E01028439","Total",1423,710,713,1423,0,9,27.14,52.4
"2011","Cherwell 004F","E01028440","Total",1634,833,801,1634,0,9,17.71,92.3
"2011","Cherwell 004G","E01032941","Total",1433,675,758,1433,0,6,118.64,12.1
"2011","Cherwell 004H","E01032942","Total",1415,710,705,1415,0,6,37.39,37.8
"2011","Cherwell 005A","E01028449","Total",1354,673,681,1354,0,9,21.86,61.9
"2011","Cherwell 005B","E01028450","Total",1461,675,786,1461,0,15,37.97,38.5
"2011","Cherwell 005C","E01028451","Total",1308,681,627,1308,0,15,27.13,48.2
"2011","Cherwell 005D","E01028452","Total",1393,677,716,1393,0,7,23.75,58.7
"2011","Cherwell 005E","E01028453","Total",1359,651,708,1359,0,8,19.22,70.7
"2011","Cherwell 005F","E01028454","Total",1595,765,830,1595,0,13,31.30,51.0
"2011","Cherwell 006A","E01028430","Total",1477,739,738,1439,38,18,38.40,38.5
"2011","Cherwell 006B","E01028431","Total",1515,732,783,1498,17,27,52.16,29.0
"2011","Cherwell 006C","E01028432","Total",1551,734,817,1551,0,18,81.70,19.0
"2011","Cherwell 006D","E01028433","Total",1678,788,890,1678,0,17,45.90,36.6
"2011","Cherwell 006E","E01028434","Total",1555,663,892,1326,229,17,420.25,3.7
"2011","Cherwell 007A","E01028426","Total",1378,670,708,1378,0,19,80.63,17.1
"2011","Cherwell 007B","E01028427","Total",1524,775,749,1512,12,18,30.38,50.2
"2011","Cherwell 007C","E01028428","Total",1443,713,730,1443,0,26,36.73,39.3
"2011","Cherwell 007D","E01028429","Total",1064,492,572,1030,34,8,34.46,30.9
"2011","Cherwell 008A","E01028422","Total",1548,765,783,1548,0,31,914.30,1.7
"2011","Cherwell 008B","E01028423","Total",1463,677,786,1419,44,27,714.17,2.0
"2011","Cherwell 008C","E01028475","Total",2126,1044,1082,2105,21,50,433.19,4.9
"2011","Cherwell 008D","E01028476","Total",2405,1201,1204,2195,210,90,259.70,9.3
"2011","Cherwell 009A","E01028474","Total",1582,793,789,1582,0,40,1517.95,1.0
"2011","Cherwell 009B","E01028485","Total",1313,612,701,1313,0,26,124.37,10.6
"2011","Cherwell 009C","E01028486","Total",1283,628,655,1280,3,53,3164.48,0.4
"2011","Cherwell 009D","E01028503","Total",1151,549,602,1151,0,23,1679.51,0.7
"2011","Cherwell 009E","E01028504","Total",1523,780,743,1418,105,74,2256.59,0.7
"2011","Cherwell 010A","E01028481","Total",1471,700,771,1427,44,18,1078.50,1.4
"2011","Cherwell 010B","E01028482","Total",1224,593,631,1224,0,41,1393.45,0.9
"2011","Cherwell 010C","E01028505","Total",1758,870,888,1758,0,16,1180.95,1.5
"2011","Cherwell 010D","E01028506","Total",1753,845,908,1753,0,33,2436.34,0.7
"2011","Cherwell 010E","E01028507","Total",1428,708,720,1419,9,55,1890.93,0.8
"2011","Cherwell 011A","E01028425","Total",2248,1250,998,1946,302,30,725.88,3.1
"2011","Cherwell 011B","E01028477","Total",1536,733,803,1510,26,28,3425.81,0.4
"2011","Cherwell 011C","E01028478","Total",1481,725,756,1404,77,20,57.26,25.9
"2011","Cherwell 011D","E01028483","Total",1270,636,634,1270,0,37,3509.34,0.4
"2011","Cherwell 011E","E01028484","Total",1093,541,552,1093,0,26,2337.01,0.5
"2011","Cherwell 011F","E01028499","Total",1521,743,778,1521,0,27,1826.57,0.8
"2011","Cherwell 012A","E01028459","Total",1476,733,743,1476,0,7,20.07,73.5
"2011","Cherwell 012B","E01028460","Total",2159,1079,1080,2159,0,24,40.27,53.6
"2011","Cherwell 012C","E01028461","Total",1748,824,924,1748,0,18,26.99,64.8
"2011","Cherwell 012D","E01028462","Total",1631,808,823,1631,0,19,36.12,45.2
"2011","Cherwell 013A","E01028455","Total",1442,715,727,1442,0,24,88.70,16.3
"2011","Cherwell 013B","E01028456","Total",1463,725,738,1451,12,16,40.07,36.5
"2011","Cherwell 013C","E01028457","Total",1396,716,680,1395,1,14,30.01,46.5
"2011","Cherwell 013D","E01028458","Total",1545,766,779,1545,0,12,29.51,52.4
"2011","Cherwell 013E","E01028467","Total",1581,737,844,1581,0,9,45.44,34.8
"2011","Cherwell 014A","E01028466","Total",1730,840,890,1730,0,14,45.56,38.0
"2011","Cherwell 014B","E01028469","Total",1527,739,788,1527,0,17,38.63,39.5
"2011","Cherwell 014C","E01028470","Total",1698,855,843,1698,0,13,41.80,40.6
"2011","Cherwell 014D","E01028471","Total",1366,654,712,1366,0,4,15.52,88.0
"2011","Cherwell 014E","E01028472","Total",1295,660,635,1295,0,15,21.62,59.9
"2011","Cherwell 014F","E01028473","Total",1539,737,802,1539,0,19,41.01,37.5
"2011","Cherwell 015A","E01028463","Total",2523,1253,1270,2523,0,20,57.69,43.7
"2011","Cherwell 015B","E01028464","Total",1428,711,717,1428,0,13,50.92,28.0
"2011","Cherwell 015C","E01028465","Total",1460,717,743,1460,0,17,44.24,33.0
"2011","Cherwell 015D","E01028468","Total",1847,898,949,1798,49,12,144.06,12.8
"2011","Cherwell 016A","E01028424","Total",1602,833,769,1521,81,34,2535.35,0.6
"2011","Cherwell 016B","E01028497","Total",1422,690,732,1380,42,43,3003.46,0.5
"2011","Cherwell 016C","E01028498","Total",1633,811,822,1633,0,40,1741.52,0.9
"2011","Cherwell 016D","E01028500","Total",2108,1483,625,1230,878,9,1642.46,1.3
"2011","Cherwell 016E","E01028501","Total",1281,629,652,1185,96,52,3450.67,0.4
"2011","Cherwell 016F","E01028502","Total",1230,608,622,1230,0,29,1525.37,0.8
"2011","Cherwell 017A","E01028487","Total",1274,613,661,1274,0,9,19.64,64.9
"2011","Cherwell 017B","E01028489","Total",1397,682,715,1393,4,33,144.25,9.7
"2011","Cherwell 017C","E01028490","Total",1208,591,617,1208,0,18,102.57,11.8
"2011","Cherwell 017D","E01028491","Total",1499,731,768,1495,4,30,36.46,41.1
"2011","Cherwell 017E","E01028494","Total",1166,570,596,1166,0,5,19.46,59.9
"2011","Cherwell 018A","E01028492","Total",1474,738,736,1474,0,13,36.79,40.1
"2011","Cherwell 018B","E01028493","Total",1410,680,730,1366,44,15,53.60,26.3
"2011","Cherwell 018C","E01028495","Total",1313,640,673,1313,0,28,22.29,58.9
"2011","Cherwell 018D","E01028496","Total",1401,662,739,1401,0,16,79.28,17.7
"2011","Cherwell 019A","E01028488","Total",1581,905,676,1355,226,18,398.15,4.0
"2011","Cherwell 019B","E01028510","Total",1599,803,796,1553,46,40,371.65,4.3
"2011","Cherwell 019C","E01028511","Total",1609,787,822,1609,0,23,1465.23,1.1
"2011","Cherwell 019D","E01028512","Total",1443,661,782,1443,0,29,37.20,38.8
"2011","Oxford 001A","E01028594","Total",1543,732,811,1543,0,54,99.71,15.5
"2011","Oxford 001B","E01028595","Total",1435,679,756,1435,0,20,158.85,9.0
"2011","Oxford 001C","E01028596","Total",1468,696,772,1452,16,55,63.21,23.2
"2011","Oxford 001D","E01028597","Total",1420,702,718,1417,3,24,65.38,21.7
"2011","Oxford 002C","E01028591","Total",1413,770,643,1218,195,52,40.81,34.6
"2011","Oxford 002D","E01028592","Total",1549,824,725,1061,488,74,72.72,21.3
"2011","Oxford 002F","E01032554","Total",2069,950,1119,2032,37,70,40.66,50.9
"2011","Oxford 002G","E01032555","Total",2178,1043,1135,1985,193,37,35.06,62.1
"2011","Oxford 003A","E01028565","Total",1253,609,644,1253,0,56,18.97,66.1
"2011","Oxford 003B","E01028583","Total",1416,652,764,843,573,38,82.79,17.1
"2011","Oxford 003C","E01028584","Total",2598,1268,1330,2583,15,97,67.63,38.4
"2011","Oxford 003D","E01028585","Total",1483,749,734,840,643,98,38.01,39.0
"2011","Oxford 004A","E01028560","Total",1490,714,776,1490,0,22,175.79,8.5
"2011","Oxford 004B","E01028561","Total",1593,745,848,1593,0,40,61.23,26.0
"2011","Oxford 004C","E01028562","Total",1647,767,880,1647,0,24,81.03,20.3
"2011","Oxford 004D","E01028563","Total",1529,751,778,1492,37,27,48.39,31.6
"2011","Oxford 005A","E01028513","Total",2246,1046,1200,2199,47,20,30.00,74.9
"2011","Oxford 005B","E01028514","Total",1502,718,784,1502,0,19,19.17,78.4
"2011","Oxford 005C","E01028516","Total",1772,854,918,1768,4,18,79.80,22.2
"2011","Oxford 005D","E01028538","Total",1493,721,772,1487,6,15,30.71,48.6
"2011","Oxford 006A","E01028534","Total",1139,534,605,1104,35,27,38.51,29.6
"2011","Oxford 006B","E01028535","Total",1601,759,842,1581,20,23,30.05,53.3
"2011","Oxford 006C","E01028536","Total",1381,604,777,1337,44,18,27.79,49.7
"2011","Oxford 006D","E01028537","Total",1643,745,898,1624,19,35,65.75,25.0
"2011","Oxford 006E","E01028539","Total",1885,979,906,1884,1,22,29.07,64.8
"2011","Oxford 006F","E01028540","Total",2846,1288,1558,1353,1493,86,95.14,29.9
"2011","Oxford 007A","E01028515","Total",1682,812,870,1682,0,16,31.55,53.3
"2011","Oxford 007B","E01028571","Total",1584,754,830,1584,0,28,49.26,32.2
"2011","Oxford 007C","E01028572","Total",1633,800,833,1633,0,17,32.49,50.3
"2011","Oxford 007D","E01028573","Total",1746,835,911,1725,21,18,26.63,65.6
"2011","Oxford 007E","E01028574","Total",1345,648,697,1345,0,14,21.98,61.2
"2011","Oxford 008A","E01028521","Total",8300,4705,3595,1283,7017,186,184.85,44.9
"2011","Oxford 008B","E01028522","Total",3486,2024,1462,1196,2290,55,70.63,49.4
"2011","Oxford 008E","E01033282","Total",4556,2301,2255,2633,1923,100,97.55,46.7
"2011","Oxford 009A","E01028548","Total",1708,878,830,1708,0,16,454.82,3.8
"2011","Oxford 009B","E01028549","Total",1644,864,780,1643,1,15,81.67,20.1
"2011","Oxford 009C","E01028550","Total",1402,705,697,1402,0,15,15.42,90.9
"2011","Oxford 009D","E01028551","Total",2066,1100,966,1397,669,29,66.62,31.0
"2011","Oxford 010A","E01028523","Total",1520,712,808,1450,70,17,58.78,25.9
"2011","Oxford 010B","E01028524","Total",1527,748,779,1527,0,10,19.11,79.9
"2011","Oxford 010C","E01028525","Total",1919,895,1024,1661,258,22,37.72,50.9
"2011","Oxford 010D","E01028526","Total",2337,1118,1219,1523,814,63,46.58,50.2
"2011","Oxford 011A","E01028579","Total",1649,766,883,1649,0,24,14.10,117.0
"2011","Oxford 011B","E01028580","Total",1483,776,707,1421,62,16,33.29,44.5
"2011","Oxford 011C","E01028581","Total",1482,730,752,1298,184,52,31.57,46.9
"2011","Oxford 011D","E01028582","Total",1338,655,683,1313,25,8,18.26,73.3
"2011","Oxford 011E","E01028586","Total",1719,857,862,1702,17,31,22.99,74.8
"2011","Oxford 011F","E01028587","Total",2011,1000,1011,1964,47,22,17.54,114.7
"2011","Oxford 011G","E01028588","Total",1600,834,766,1249,351,22,26.93,59.4
"2011","Oxford 012A","E01028541","Total",1472,691,781,1472,0,28,63.29,23.3
"2011","Oxford 012B","E01028542","Total",1831,950,881,1820,11,22,116.74,15.7
"2011","Oxford 012C","E01028543","Total",1320,697,623,1320,0,16,30.47,43.3
"2011","Oxford 012D","E01028544","Total",1321,654,667,1300,21,20,24.10,54.8
"2011","Oxford 013A","E01028531","Total",2169,1083,1086,1884,285,18,75.93,28.6
"2011","Oxford 013B","E01028532","Total",2597,1328,1269,2597,0,25,65.82,39.5
"2011","Oxford 013C","E01028533","Total",2211,1109,1102,2197,14,22,34.57,64.0
"2011","Oxford 013D","E01028556","Total",1784,873,911,1769,15,14,38.92,45.8
"2011","Oxford 013E","E01028557","Total",2172,1027,1145,1929,243,24,182.35,11.9
"2011","Oxford 013F","E01028558","Total",1718,889,829,1698,20,14,35.05,49.0
"2011","Oxford 013G","E01028559","Total",1698,881,817,1698,0,12,27.71,61.3
"2011","Oxford 014A","E01028545","Total",1653,794,859,1596,57,45,48.78,33.9
"2011","Oxford 014B","E01028546","Total",1907,958,949,1900,7,18,46.12,41.3
"2011","Oxford 014C","E01028547","Total",2153,1091,1062,2153,0,17,17.81,120.9
"2011","Oxford 015A","E01028527","Total",1740,859,881,1675,65,15,34.23,50.8
"2011","Oxford 015B","E01028528","Total",1545,800,745,1530,15,18,25.13,61.5
"2011","Oxford 015C","E01028529","Total",1570,770,800,1570,0,8,39.02,40.2
"2011","Oxford 015D","E01028530","Total",1707,847,860,1707,0,13,24.94,68.4
"2011","Oxford 015E","E01028575","Total",1528,750,778,1500,28,34,78.07,19.6
"2011","Oxford 015F","E01028578","Total",1550,774,776,1548,2,20,28.87,53.7
"2011","Oxford 016A","E01028552","Total",1724,831,893,1724,0,8,52.02,33.1
"2011","Oxford 016B","E01028553","Total",1811,923,888,1648,163,9,89.39,20.3
"2011","Oxford 016C","E01028554","Total",1326,655,671,1326,0,14,18.04,73.5
"2011","Oxford 016D","E01028555","Total",1580,785,795,1580,0,13,39.37,40.1
"2011","Oxford 016E","E01028576","Total",1462,718,744,1462,0,9,18.06,81.0
"2011","Oxford 016F","E01028577","Total",1960,962,998,1960,0,17,25.22,77.7
"2011","Oxford 017A","E01028517","Total",1307,628,679,1307,0,2,23.17,56.4
"2011","Oxford 017B","E01028518","Total",1617,777,840,1571,46,10,18.47,87.5
"2011","Oxford 017C","E01028519","Total",1451,717,734,1451,0,7,48.29,30.0
"2011","Oxford 017D","E01028567","Total",1756,848,908,1756,0,9,32.57,53.9
"2011","Oxford 018A","E01028520","Total",1702,853,849,1702,0,6,30.58,55.7
"2011","Oxford 018B","E01028568","Total",1601,722,879,1601,0,9,28.42,56.3
"2011","Oxford 018C","E01028569","Total",1735,762,973,1680,55,6,20.01,86.7
"2011","Oxford 018D","E01028570","Total",1899,913,986,1899,0,4,21.48,88.4
"2011","South Oxfordshire 001A","E01028666","Total",1536,743,793,1536,0,22,27.08,56.7
"2011","South Oxfordshire 001B","E01028667","Total",1384,681,703,1384,0,37,160.59,8.6
"2011","South Oxfordshire 001C","E01028668","Total",1402,686,716,1402,0,52,20.56,68.2
"2011","South Oxfordshire 001D","E01028669","Total",1353,655,698,1353,0,25,102.23,13.2
"2011","South Oxfordshire 002A","E01028638","Total",1382,686,696,1382,0,48,2978.71,0.5
"2011","South Oxfordshire 002B","E01028639","Total",1342,660,682,1240,102,46,1404.58,1.0
"2011","South Oxfordshire 002C","E01028640","Total",1454,726,728,1428,26,27,995.10,1.5
"2011","South Oxfordshire 002D","E01028683","Total",1378,693,685,1378,0,29,466.38,3.0
"2011","South Oxfordshire 003A","E01028670","Total",1496,713,783,1446,50,40,40.32,37.1
"2011","South Oxfordshire 003B","E01028671","Total",1420,689,731,1420,0,16,40.40,35.1
"2011","South Oxfordshire 003C","E01028672","Total",1710,842,868,1710,0,48,822.95,2.1
"2011","South Oxfordshire 003D","E01028673","Total",1260,584,676,1260,0,21,53.61,23.5
"2011","South Oxfordshire 004A","E01028646","Total",1150,562,588,1150,0,29,1245.33,0.9
"2011","South Oxfordshire 004B","E01028647","Total",1577,754,823,1549,28,48,3918.83,0.4
"2011","South Oxfordshire 004C","E01028681","Total",1292,645,647,1292,0,34,144.53,8.9
"2011","South Oxfordshire 004D","E01028682","Total",1198,579,619,1179,19,17,247.23,4.8
"2011","South Oxfordshire 004E","E01028684","Total",1423,689,734,1423,0,32,47.09,30.2
"2011","South Oxfordshire 005A","E01028598","Total",2370,1178,1192,2370,0,70,3840.51,0.6
"2011","South Oxfordshire 005B","E01028613","Total",1437,709,728,1437,0,21,30.53,47.1
"2011","South Oxfordshire 005C","E01028614","Total",1498,734,764,1498,0,26,392.50,3.8
"2011","South Oxfordshire 005D","E01028615","Total",1583,756,827,1553,30,22,875.65,1.8
"2011","South Oxfordshire 005E","E01028616","Total",1406,677,729,1406,0,26,84.11,16.7
"2011","South Oxfordshire 006A","E01028604","Total",1548,773,775,1548,0,8,306.94,5.0
"2011","South Oxfordshire 006B","E01028605","Total",1555,762,793,1555,0,5,187.34,8.3
"2011","South Oxfordshire 006C","E01028607","Total",1331,645,686,1274,57,35,2303.58,0.6
"2011","South Oxfordshire 006D","E01028641","Total",1204,580,624,1204,0,20,1547.17,0.8
"2011","South Oxfordshire 006E","E01028657","Total",1213,612,601,1192,21,12,377.65,3.2
"2011","South Oxfordshire 006F","E01028658","Total",1315,647,668,1240,75,39,2464.08,0.5
"2011","South Oxfordshire 007A","E01028600","Total",1499,743,756,1499,0,36,437.08,3.4
"2011","South Oxfordshire 007B","E01028603","Total",1201,600,601,1199,2,36,2235.69,0.5
"2011","South Oxfordshire 007C","E01028606","Total",1731,846,885,1727,4,45,990.41,1.7
"2011","South Oxfordshire 007D","E01028609","Total",1337,675,662,1337,0,17,101.15,13.2
"2011","South Oxfordshire 007E","E01028610","Total",1493,745,748,1493,0,16,1014.42,1.5
"2011","South Oxfordshire 008A","E01028678","Total",1549,756,793,1545,4,54,4131.68,0.4
"2011","South Oxfordshire 008B","E01028679","Total",2174,1041,1133,2129,45,71,5470.48,0.4
"2011","South Oxfordshire 008C","E01028680","Total",1728,801,927,1728,0,30,270.65,6.4
"2011","South Oxfordshire 009A","E01028625","Total",1962,973,989,1958,4,8,126.44,15.5
"2011","South Oxfordshire 009B","E01028626","Total",1648,836,812,1648,0,18,29.03,56.8
"2011","South Oxfordshire 009C","E01028627","Total",1494,714,780,1494,0,15,27.56,54.2
"2011","South Oxfordshire 009D","E01028628","Total",1493,763,730,1493,0,31,160.51,9.3
"2011","South Oxfordshire 009E","E01028629","Total",1446,710,736,1446,0,23,26.75,54.1
"2011","South Oxfordshire 010A","E01028621","Total",1432,732,700,1370,62,19,96.87,14.8
"2011","South Oxfordshire 010B","E01028622","Total",1214,584,630,1214,0,15,33.04,36.7
"2011","South Oxfordshire 010C","E01028623","Total",1634,805,829,1634,0,18,54.63,29.9
"2011","South Oxfordshire 010D","E01028624","Total",1451,698,753,1367,84,17,60.41,24.0
"2011","South Oxfordshire 011A","E01028599","Total",1378,649,729,1378,0,24,227.70,6.1
"2011","South Oxfordshire 011B","E01028601","Total",1916,1181,735,1223,693,48,2228.33,0.9
"2011","South Oxfordshire 011C","E01028602","Total",1543,767,776,1543,0,24,187.78,8.2
"2011","South Oxfordshire 011D","E01028620","Total",2833,1564,1269,2415,418,49,3593.31,0.8
"2011","South Oxfordshire 012A","E01028608","Total",1223,598,625,1197,26,49,293.70,4.2
"2011","South Oxfordshire 012B","E01028617","Total",1885,872,1013,1856,29,54,815.26,2.3
"2011","South Oxfordshire 012C","E01028674","Total",1326,644,682,1326,0,18,91.39,14.5
"2011","South Oxfordshire 012D","E01028675","Total",1251,610,641,1251,0,18,52.33,23.9
"2011","South Oxfordshire 012E","E01028676","Total",2025,963,1062,1964,61,22,39.22,51.6
"2011","South Oxfordshire 012F","E01028677","Total",1431,680,751,1427,4,13,72.54,19.7
"2011","South Oxfordshire 013A","E01028630","Total",1549,836,713,1549,0,16,33.61,46.1
"2011","South Oxfordshire 013B","E01028631","Total",1104,551,553,1104,0,11,18.83,58.6
"2011","South Oxfordshire 013C","E01028632","Total",1477,728,749,1477,0,15,27.16,54.4
"2011","South Oxfordshire 013D","E01028633","Total",1505,763,742,1505,0,9,25.49,59.0
"2011","South Oxfordshire 014A","E01028634","Total",1337,650,687,1337,0,15,29.56,45.2
"2011","South Oxfordshire 014B","E01028635","Total",1528,770,758,1528,0,8,34.84,43.9
"2011","South Oxfordshire 014C","E01028636","Total",1307,583,724,1307,0,23,34.24,38.2
"2011","South Oxfordshire 014D","E01028637","Total",1559,785,774,1555,4,21,39.05,39.9
"2011","South Oxfordshire 015A","E01028618","Total",1847,935,912,1761,86,46,1533.62,1.2
"2011","South Oxfordshire 015B","E01028619","Total",1835,890,945,1835,0,31,81.87,22.4
"2011","South Oxfordshire 015C","E01028644","Total",1583,781,802,1583,0,51,943.32,1.7
"2011","South Oxfordshire 015D","E01028648","Total",1162,581,581,1162,0,30,603.75,1.9
"2011","South Oxfordshire 015E","E01028649","Total",1555,755,800,1555,0,61,2423.60,0.6
"2011","South Oxfordshire 016A","E01028650","Total",2004,922,1082,1956,48,27,83.26,24.1
"2011","South Oxfordshire 016B","E01028651","Total",1556,724,832,1555,1,39,174.50,8.9
"2011","South Oxfordshire 016C","E01028652","Total",1990,885,1105,1990,0,24,80.91,24.6
"2011","South Oxfordshire 017A","E01028653","Total",1449,697,752,1398,51,15,74.50,19.4
"2011","South Oxfordshire 017B","E01028654","Total",1609,784,825,1609,0,55,34.90,46.1
"2011","South Oxfordshire 017C","E01028655","Total",1714,774,940,1714,0,33,33.53,51.1
"2011","South Oxfordshire 017D","E01028656","Total",1297,628,669,1297,0,44,76.12,17.0
"2011","South Oxfordshire 018A","E01028611","Total",1144,561,583,1142,2,49,1591.70,0.7
"2011","South Oxfordshire 018B","E01028642","Total",1295,617,678,1295,0,40,1168.15,1.1
"2011","South Oxfordshire 018C","E01028643","Total",1402,673,729,1356,46,55,1146.78,1.2
"2011","South Oxfordshire 018D","E01028645","Total",1465,690,775,1389,76,35,151.47,9.7
"2011","South Oxfordshire 018E","E01028685","Total",1195,579,616,1188,7,31,97.04,12.3
"2011","South Oxfordshire 018F","E01028686","Total",1409,810,599,1194,215,62,614.18,2.3
"2011","South Oxfordshire 019A","E01028612","Total",1225,575,650,1225,0,51,2369.84,0.5
"2011","South Oxfordshire 019B","E01028660","Total",1760,879,881,1743,17,69,2561.20,0.7
"2011","South Oxfordshire 019C","E01028661","Total",1829,994,835,1511,318,85,411.28,4.4
"2011","South Oxfordshire 019D","E01028662","Total",1316,618,698,1316,0,57,756.24,1.7
"2011","South Oxfordshire 020A","E01028659","Total",1619,843,776,1603,16,52,2221.88,0.7
"2011","South Oxfordshire 020B","E01028663","Total",1491,700,791,1483,8,23,173.04,8.6
"2011","South Oxfordshire 020C","E01028664","Total",1310,611,699,1289,21,27,142.03,9.2
"2011","South Oxfordshire 020D","E01028665","Total",1316,623,693,1302,14,40,67.94,19.4
"2011","Vale of White Horse 001A","E01028708","Total",1781,833,948,1729,52,35,1237.76,1.4
"2011","Vale of White Horse 001B","E01028709","Total",1572,771,801,1572,0,53,79.12,19.9
"2011","Vale of White Horse 001C","E01028710","Total",1635,819,816,1618,17,51,319.08,5.1
"2011","Vale of White Horse 001D","E01028711","Total",1682,822,860,1673,9,48,1397.43,1.2
"2011","Vale of White Horse 002A","E01028733","Total",1283,627,656,1279,4,41,661.77,1.9
"2011","Vale of White Horse 002B","E01028734","Total",1552,758,794,1520,32,37,88.44,17.5
"2011","Vale of White Horse 002C","E01028735","Total",1634,834,800,1634,0,22,90.73,18.0
"2011","Vale of White Horse 002D","E01028740","Total",1553,785,768,1553,0,34,32.09,48.4
"2011","Vale of White Horse 002E","E01028741","Total",1543,740,803,1307,236,32,188.12,8.2
"2011","Vale of White Horse 002F","E01028742","Total",1575,768,807,1552,23,30,801.14,2.0
"2011","Vale of White Horse 003A","E01028738","Total",2143,1331,812,1427,716,46,611.75,3.5
"2011","Vale of White Horse 003B","E01028739","Total",1905,1022,883,1684,221,36,1017.58,1.9
"2011","Vale of White Horse 003C","E01028743","Total",1605,1124,481,964,641,66,244.20,6.6
"2011","Vale of White Horse 003D","E01028744","Total",1230,597,633,1230,0,29,825.79,1.5
"2011","Vale of White Horse 003E","E01028750","Total",1466,716,750,1466,0,17,114.51,12.8
"2011","Vale of White Horse 003F","E01028751","Total",1472,711,761,1434,38,62,912.32,1.6
"2011","Vale of White Horse 003G","E01028752","Total",1697,833,864,1697,0,46,583.17,2.9
"2011","Vale of White Horse 004A","E01028693","Total",1613,808,805,1612,1,46,34.83,46.3
"2011","Vale of White Horse 004B","E01028694","Total",1470,744,726,1470,0,45,24.38,60.3
"2011","Vale of White Horse 004C","E01028701","Total",1561,762,799,1561,0,25,30.70,50.8
"2011","Vale of White Horse 004D","E01028705","Total",1289,634,655,1289,0,34,31.98,40.3
"2011","Vale of White Horse 004E","E01028706","Total",1497,756,741,1497,0,24,21.10,70.9
"2011","Vale of White Horse 004F","E01028707","Total",1555,762,793,1555,0,23,22.27,69.8
"2011","Vale of White Horse 005A","E01028688","Total",1217,605,612,1211,6,27,22.45,54.2
"2011","Vale of White Horse 005B","E01028689","Total",1471,730,741,1471,0,25,36.34,40.5
"2011","Vale of White Horse 005C","E01028695","Total",1563,783,780,1563,0,29,30.97,50.5
"2011","Vale of White Horse 005D","E01028699","Total",1598,807,791,1598,0,40,49.26,32.4
"2011","Vale of White Horse 006B","E01028696","Total",1406,730,676,1314,92,53,61.31,22.9
"2011","Vale of White Horse 006C","E01028697","Total",1525,721,804,1504,21,17,32.32,47.2
"2011","Vale of White Horse 006D","E01028698","Total",1493,714,779,1493,0,25,88.18,16.9
"2011","Vale of White Horse 006E","E01028700","Total",1676,804,872,1676,0,15,47.13,35.6
"2011","Vale of White Horse 006F","E01028703","Total",1764,817,947,1656,108,14,35.50,49.7
"2011","Vale of White Horse 006G","E01033305","Total",1288,613,675,1287,1,11,55.18,23.3
"2011","Vale of White Horse 006H","E01033306","Total",1588,755,833,1518,70,18,33.86,46.9
"2011","Vale of White Horse 007A","E01028726","Total",2191,1098,1093,2191,0,80,3747.58,0.6
"2011","Vale of White Horse 007B","E01028736","Total",2349,1143,1206,2346,3,69,1254.61,1.9
"2011","Vale of White Horse 007C","E01028737","Total",2341,1157,1184,2334,7,97,5859.11,0.4
"2011","Vale of White Horse 008A","E01028690","Total",1622,823,799,1622,0,15,78.77,20.6
"2011","Vale of White Horse 008B","E01028691","Total",1424,683,741,1424,0,9,32.29,44.1
"2011","Vale of White Horse 008C","E01028692","Total",1411,677,734,1411,0,9,19.01,74.2
"2011","Vale of White Horse 008D","E01028702","Total",1241,590,651,1241,0,25,83.87,14.8
"2011","Vale of White Horse 008E","E01028704","Total",1858,870,988,1858,0,27,38.27,48.5
"2011","Vale of White Horse 009A","E01028716","Total",1883,937,946,1883,0,24,267.42,7.0
"2011","Vale of White Horse 009B","E01028717","Total",1584,752,832,1580,4,26,1043.19,1.5
"2011","Vale of White Horse 009C","E01028718","Total",1499,719,780,1499,0,14,30.48,49.2
"2011","Vale of White Horse 009D","E01028719","Total",1595,788,807,1560,35,40,70.27,22.7
"2011","Vale of White Horse 009E","E01028749","Total",2430,1221,1209,2396,34,51,2295.93,1.1
"2011","Vale of White Horse 010A","E01028714","Total",2353,1152,1201,2353,0,54,1070.03,2.2
"2011","Vale of White Horse 010B","E01028731","Total",1292,636,656,1292,0,20,1106.37,1.2
"2011","Vale of White Horse 010C","E01028732","Total",1224,611,613,1182,42,32,428.48,2.9
"2011","Vale of White Horse 010D","E01028753","Total",1422,676,746,1422,0,20,344.00,4.1
"2011","Vale of White Horse 010E","E01028754","Total",1349,644,705,1347,2,54,786.78,1.7
"2011","Vale of White Horse 011A","E01028721","Total",1348,683,665,1348,0,23,57.20,23.6
"2011","Vale of White Horse 011B","E01028722","Total",1601,808,793,1601,0,26,249.43,6.4
"2011","Vale of White Horse 011C","E01028723","Total",1418,730,688,1418,0,18,490.15,2.9
"2011","Vale of White Horse 011D","E01028724","Total",1299,657,642,1299,0,18,23.91,54.3
"2011","Vale of White Horse 011E","E01028725","Total",1512,764,748,1512,0,19,176.74,8.6
"2011","Vale of White Horse 014A","E01028755","Total",1666,815,851,1664,2,32,99.87,16.7
"2011","Vale of White Horse 014B","E01028756","Total",2417,1145,1272,2322,95,23,101.33,23.9
"2011","Vale of White Horse 014C","E01028758","Total",1553,766,787,1553,0,28,61.44,25.3
"2011","Vale of White Horse 014D","E01028759","Total",1526,772,754,1526,0,19,38.28,39.9
"2011","Vale of White Horse 014E","E01028760","Total",1287,617,670,1238,49,23,34.93,36.8
"2011","Vale of White Horse 014F","E01028761","Total",1354,668,686,1354,0,27,35.67,38.0
"2011","Vale of White Horse 015A","E01028712","Total",2002,962,1040,2002,0,56,2289.51,0.9
"2011","Vale of White Horse 015B","E01028727","Total",1626,784,842,1620,6,53,1005.93,1.6
"2011","Vale of White Horse 015C","E01028728","Total",1166,540,626,1156,10,25,120.64,9.7
"2011","Vale of White Horse 015D","E01028729","Total",1073,533,540,1068,5,27,774.88,1.4
"2011","Vale of White Horse 015E","E01028730","Total",1623,805,818,1623,0,62,4441.30,0.4
"2011","Vale of White Horse 015F","E01028757","Total",1524,697,827,1449,75,20,783.25,1.9
"2011","Vale of White Horse 016E","E01028713","Total",2372,1178,1194,2364,8,100,8169.34,0.3
"2011","Vale of White Horse 016F","E01028715","Total",1398,680,718,1350,48,46,3575.44,0.4
"2011","Vale of White Horse 016G","E01028720","Total",2261,1098,1163,2208,53,50,3814.53,0.6
"2011","Vale of White Horse 016A","E01028745","Total",1383,711,672,1253,130,67,938.60,1.5
"2011","Vale of White Horse 016B","E01028746","Total",1290,650,640,1242,48,32,680.51,1.9
"2011","Vale of White Horse 016C","E01028747","Total",1250,646,604,1250,0,88,1309.75,1.0
"2011","Vale of White Horse 016D","E01028748","Total",1069,536,533,1069,0,25,69.92,15.3
"2011","West Oxfordshire 001A","E01028780","Total",2015,1007,1008,1990,25,26,507.24,4.0
"2011","West Oxfordshire 001B","E01028781","Total",1255,595,660,1255,0,9,168.26,7.5
"2011","West Oxfordshire 001C","E01028782","Total",1551,744,807,1551,0,29,237.91,6.5
"2011","West Oxfordshire 001D","E01028783","Total",1516,710,806,1487,29,17,48.94,31.0
"2011","West Oxfordshire 002A","E01028795","Total",1541,732,809,1540,1,59,5554.45,0.3
"2011","West Oxfordshire 002B","E01028796","Total",1422,721,701,1179,243,46,2447.33,0.6
"2011","West Oxfordshire 002C","E01028797","Total",1139,555,584,1106,33,20,2399.32,0.5
"2011","West Oxfordshire 002D","E01028806","Total",1976,937,1039,1976,0,37,3079.20,0.6
"2011","West Oxfordshire 003A","E01028763","Total",1957,919,1038,1930,27,48,2580.16,0.8
"2011","West Oxfordshire 003B","E01028776","Total",1938,952,986,1910,28,80,6756.90,0.3
"2011","West Oxfordshire 003C","E01028798","Total",2012,979,1033,2010,2,40,2699.30,0.7
"2011","West Oxfordshire 004B","E01028804","Total",1313,654,659,1313,0,25,607.58,2.2
"2011","West Oxfordshire 004D","E01028823","Total",1293,585,708,1239,54,23,38.39,33.7
"2011","West Oxfordshire 004E","E01028824","Total",1540,718,822,1540,0,18,305.60,5.0
"2011","West Oxfordshire 004F","E01028825","Total",1165,559,606,1165,0,23,1330.11,0.9
"2011","West Oxfordshire 004G","E01032954","Total",2716,1310,1406,2716,0,78,4997.85,0.5
"2011","West Oxfordshire 005A","E01028777","Total",1101,515,586,1100,1,37,902.06,1.2
"2011","West Oxfordshire 005B","E01028778","Total",1468,713,755,1468,0,36,67.83,21.6
"2011","West Oxfordshire 005C","E01028779","Total",1058,549,509,1058,0,33,1012.22,1.0
"2011","West Oxfordshire 005D","E01028799","Total",1928,936,992,1911,17,48,1512.61,1.3
"2011","West Oxfordshire 006A","E01028788","Total",1626,773,853,1599,27,33,1178.83,1.4
"2011","West Oxfordshire 006B","E01028789","Total",1448,686,762,1448,0,38,316.09,4.6
"2011","West Oxfordshire 006C","E01028790","Total",1182,597,585,1182,0,23,539.92,2.2
"2011","West Oxfordshire 006D","E01028791","Total",1560,759,801,1487,73,36,424.28,3.7
"2011","West Oxfordshire 007A","E01028784","Total",2110,1069,1041,2110,0,38,2087.38,1.0
"2011","West Oxfordshire 007B","E01028792","Total",1076,518,558,1073,3,26,1370.84,0.8
"2011","West Oxfordshire 007C","E01028793","Total",1574,776,798,1523,51,42,1623.21,1.0
"2011","West Oxfordshire 007D","E01028794","Total",1409,684,725,1404,5,19,789.28,1.8
"2011","West Oxfordshire 008A","E01028810","Total",1358,676,682,1358,0,37,45.00,30.2
"2011","West Oxfordshire 008B","E01028811","Total",1379,657,722,1378,1,17,81.23,17.0
"2011","West Oxfordshire 008D","E01028813","Total",1294,638,656,1294,0,10,26.08,49.6
"2011","West Oxfordshire 008E","E01028814","Total",1414,672,742,1413,1,28,41.00,34.5
"2011","West Oxfordshire 008F","E01028815","Total",1260,620,640,1239,21,44,29.99,42.0
"2011","West Oxfordshire 008G","E01032947","Total",1818,888,930,1818,0,11,30.23,60.1
"2011","West Oxfordshire 008H","E01032948","Total",1943,926,1017,1853,90,29,58.61,33.2
"2011","West Oxfordshire 008I","E01032952","Total",1363,630,733,1333,30,29,36.37,37.5
"2011","West Oxfordshire 009A","E01028809","Total",1363,661,702,1363,0,14,22.39,60.9
"2011","West Oxfordshire 009B","E01028820","Total",1338,671,667,1338,0,29,173.15,7.7
"2011","West Oxfordshire 009C","E01028821","Total",1495,751,744,1495,0,24,22.90,65.3
"2011","West Oxfordshire 009D","E01028822","Total",1417,686,731,1417,0,30,25.35,55.9
"2011","West Oxfordshire 010A","E01028807","Total",2166,1026,1140,2103,63,17,45.46,47.6
"2011","West Oxfordshire 010B","E01028808","Total",1728,846,882,1728,0,28,82.26,21.0
"2011","West Oxfordshire 010C","E01028816","Total",1383,698,685,1383,0,17,24.29,56.9
"2011","West Oxfordshire 010D","E01028817","Total",1481,734,747,1481,0,17,32.46,45.6
"2011","West Oxfordshire 010E","E01028818","Total",1734,800,934,1723,11,22,94.90,18.3
"2011","West Oxfordshire 010F","E01028819","Total",1588,760,828,1586,2,25,50.65,31.4
"2011","West Oxfordshire 011A","E01028785","Total",1556,744,812,1537,19,21,28.37,54.8
"2011","West Oxfordshire 011B","E01028786","Total",1256,618,638,1256,0,23,36.31,34.6
"2011","West Oxfordshire 011C","E01028787","Total",1296,638,658,1296,0,31,2769.24,0.5
"2011","West Oxfordshire 011D","E01028800","Total",1308,650,658,1306,2,44,1761.75,0.7
"2011","West Oxfordshire 012A","E01028762","Total",1772,892,880,1772,0,66,6204.66,0.3
"2011","West Oxfordshire 012B","E01028766","Total",1955,945,1010,1901,54,68,3860.45,0.5
"2011","West Oxfordshire 012C","E01028767","Total",1847,909,938,1763,84,34,2693.72,0.7
"2011","West Oxfordshire 013D","E01028772","Total",1679,832,847,1679,0,22,47.89,35.1
"2011","West Oxfordshire 013E","E01032949","Total",1443,719,724,1443,0,26,20.47,70.5
"2011","West Oxfordshire 013F","E01032950","Total",1800,855,945,1733,67,20,20.41,88.2
"2011","West Oxfordshire 013G","E01032951","Total",1966,982,984,1953,13,29,55.03,35.7
"2011","West Oxfordshire 013H","E01032953","Total",2212,1075,1137,2212,0,34,79.40,27.9
"2011","West Oxfordshire 014A","E01028771","Total",1451,710,741,1451,0,10,45.13,32.2
"2011","West Oxfordshire 014B","E01028773","Total",1323,671,652,1288,35,23,89.80,14.7
"2011","West Oxfordshire 014C","E01028774","Total",2614,1677,937,1475,1139,41,47.18,55.4
"2011","West Oxfordshire 014D","E01028775","Total",1281,670,611,1281,0,17,66.83,19.2
"2011","West Oxfordshire 015A","E01028764","Total",1769,856,913,1739,30,29,1043.96,1.7
"2011","West Oxfordshire 015B","E01028765","Total",1940,965,975,1937,3,38,2099.73,0.9
"2011","West Oxfordshire 015C","E01028801","Total",1374,692,682,1374,0,35,2453.48,0.6
"2011","West Oxfordshire 015D","E01028802","Total",1526,755,771,1446,80,45,1510.71,1.0
"2011","Elmbridge 001A","E01030330","Total",1550,745,805,1549,1,19,30.96,50.1
"2011","Elmbridge 001B","E01030331","Total",1547,736,811,1547,0,18,46.32,33.4
"2011","Elmbridge 001C","E01030332","Total",1473,689,784,1473,0,18,33.01,44.6
"2011","Elmbridge 001D","E01030333","Total",1438,690,748,1438,0,32,53.66,26.8
"2011","Elmbridge 002A","E01030326","Total",1613,801,812,1613,0,35,39.90,40.4
"2011","Elmbridge 002B","E01030327","Total",1576,781,795,1544,32,58,159.71,9.9
"2011","Elmbridge 002C","E01030328","Total",1685,833,852,1673,12,43,55.89,30.1
"2011","Elmbridge 002D","E01030329","Total",1463,688,775,1441,22,41,42.47,34.4
"2011","Elmbridge 003A","E01030334","Total",1437,696,741,1437,0,11,33.64,42.7
"2011","Elmbridge 003B","E01030335","Total",1836,864,972,1836,0,28,35.93,51.1
"2011","Elmbridge 003C","E01030336","Total",1878,921,957,1878,0,14,30.96,60.7
"2011","Elmbridge 003D","E01030337","Total",1592,760,832,1557,35,7,24.94,63.8
"2011","Elmbridge 004A","E01030361","Total",1983,971,1012,1983,0,26,280.50,7.1
"2011","Elmbridge 004B","E01030362","Total",1176,575,601,1176,0,15,117.04,10.0
"2011","Elmbridge 004C","E01030363","Total",1840,910,930,1840,0,18,27.86,66.0
"2011","Elmbridge 004D","E01030364","Total",1512,763,749,1512,0,10,29.30,51.6
"2011","Elmbridge 005A","E01030350","Total",1636,780,856,1636,0,48,40.81,40.1
"2011","Elmbridge 005B","E01030351","Total",1523,743,780,1523,0,24,53.98,28.2
"2011","Elmbridge 005C","E01030352","Total",1561,745,816,1513,48,46,55.92,27.9
"2011","Elmbridge 005D","E01030353","Total",1587,762,825,1510,77,41,37.39,42.4
"2011","Elmbridge 006A","E01030322","Total",1814,869,945,1814,0,27,37.33,48.6
"2011","Elmbridge 006B","E01030323","Total",1383,682,701,1383,0,50,42.46,32.6
"2011","Elmbridge 006C","E01030324","Total",1578,780,798,1578,0,28,29.82,52.9
"2011","Elmbridge 006D","E01030325","Total",1568,762,806,1538,30,34,104.66,15.0
"2011","Elmbridge 007A","E01030357","Total",1566,773,793,1566,0,27,42.19,37.1
"2011","Elmbridge 007B","E01030358","Total",1443,667,776,1443,0,21,25.03,57.7
"2011","Elmbridge 007C","E01030359","Total",2210,1099,1111,2210,0,33,40.70,54.3
"2011","Elmbridge 007D","E01030360","Total",1571,757,814,1571,0,52,81.88,19.2
"2011","Elmbridge 008A","E01030354","Total",1483,691,792,1483,0,17,21.17,70.1
"2011","Elmbridge 008B","E01030355","Total",1461,732,729,1415,46,17,107.47,13.6
"2011","Elmbridge 008C","E01030356","Total",1347,634,713,1347,0,17,16.24,82.9
"2011","Elmbridge 008D","E01030365","Total",1545,733,812,1512,33,26,32.31,47.8
"2011","Elmbridge 008E","E01030368","Total",1594,761,833,1582,12,41,32.63,48.9
"2011","Elmbridge 009A","E01030319","Total",1729,851,878,1729,0,46,145.89,11.9
"2011","Elmbridge 009B","E01030320","Total",1741,869,872,1741,0,50,44.02,39.6
"2011","Elmbridge 009C","E01030321","Total",1598,799,799,1575,23,40,130.52,12.2
"2011","Elmbridge 009D","E01030369","Total",2243,1095,1148,2243,0,66,77.86,28.8
"2011","Elmbridge 009E","E01030370","Total",1633,806,827,1627,6,50,72.46,22.5
"2011","Elmbridge 010A","E01030313","Total",1564,755,809,1559,5,27,53.21,29.4
"2011","Elmbridge 010B","E01030314","Total",1560,765,795,1531,29,35,38.94,40.1
"2011","Elmbridge 010C","E01030366","Total",1786,859,927,1765,21,29,49.05,36.4
"2011","Elmbridge 010D","E01030367","Total",1620,777,843,1606,14,46,61.56,26.3
"2011","Elmbridge 011A","E01030338","Total",1670,825,845,1670,0,37,56.18,29.7
"2011","Elmbridge 011B","E01030339","Total",1401,666,735,1371,30,16,36.49,38.4
"2011","Elmbridge 011C","E01030340","Total",1470,712,758,1470,0,37,54.13,27.2
"2011","Elmbridge 011D","E01030341","Total",1811,883,928,1794,17,50,60.64,29.9
"2011","Elmbridge 012A","E01030371","Total",1481,724,757,1481,0,14,21.37,69.3
"2011","Elmbridge 012B","E01030372","Total",1320,623,697,1272,48,22,35.42,37.3
"2011","Elmbridge 012C","E01030373","Total",1546,769,777,1546,0,28,175.79,8.8
"2011","Elmbridge 012D","E01030374","Total",1600,801,799,1600,0,21,52.99,30.2
"2011","Elmbridge 012E","E01030375","Total",1717,825,892,1698,19,23,37.30,46.0
"2011","Elmbridge 012F","E01030376","Total",1283,658,625,1270,13,28,111.80,11.5
"2011","Elmbridge 013A","E01030307","Total",1690,845,845,1690,0,83,108.64,15.6
"2011","Elmbridge 013B","E01030308","Total",1614,792,822,1607,7,70,111.71,14.4
"2011","Elmbridge 013C","E01030309","Total",1558,723,835,1520,38,76,523.56,3.0
"2011","Elmbridge 013D","E01030310","Total",1881,906,975,1881,0,25,186.09,10.1
"2011","Elmbridge 014A","E01030311","Total",1544,734,810,1544,0,19,83.89,18.4
"2011","Elmbridge 014B","E01030312","Total",1324,672,652,1324,0,13,54.45,24.3
"2011","Elmbridge 014C","E01030315","Total",1618,778,840,1618,0,20,52.55,30.8
"2011","Elmbridge 014D","E01030316","Total",1597,772,825,1597,0,44,100.05,16.0
"2011","Elmbridge 014E","E01030317","Total",1668,799,869,1668,0,14,61.42,27.2
"2011","Elmbridge 014F","E01030318","Total",1539,680,859,1427,112,33,585.35,2.6
"2011","Elmbridge 015A","E01030296","Total",1755,857,898,1755,0,58,165.31,10.6
"2011","Elmbridge 015B","E01030297","Total",2196,1064,1132,2122,74,68,140.96,15.6
"2011","Elmbridge 015C","E01030298","Total",1581,749,832,1581,0,31,61.54,25.7
"2011","Elmbridge 015D","E01030299","Total",1636,791,845,1636,0,48,103.34,15.8
"2011","Elmbridge 016A","E01030346","Total",1501,715,786,1412,89,76,526.24,2.9
"2011","Elmbridge 016B","E01030347","Total",1664,814,850,1664,0,36,243.41,6.8
"2011","Elmbridge 016C","E01030348","Total",1631,807,824,1605,26,54,91.01,17.9
"2011","Elmbridge 016D","E01030349","Total",1706,813,893,1610,96,34,77.53,22.0
"2011","Elmbridge 017A","E01030300","Total",1609,736,873,1600,9,33,27.40,58.7
"2011","Elmbridge 017B","E01030301","Total",1553,769,784,1553,0,57,96.69,16.1
"2011","Elmbridge 017C","E01030302","Total",1576,753,823,1500,76,36,883.06,1.8
"2011","Elmbridge 017D","E01030304","Total",1628,763,865,1628,0,10,31.37,51.9
"2011","Elmbridge 017E","E01030305","Total",1620,814,806,1542,78,90,124.50,13.0
"2011","Elmbridge 017F","E01030306","Total",1503,762,741,1400,103,71,397.18,3.8
"2011","Elmbridge 018A","E01030303","Total",1826,879,947,1797,29,71,151.74,12.0
"2011","Elmbridge 018B","E01030342","Total",1728,810,918,1647,81,97,611.65,2.8
"2011","Elmbridge 018C","E01030343","Total",1693,838,855,1692,1,60,359.12,4.7
"2011","Elmbridge 018D","E01030344","Total",1530,752,778,1530,0,81,204.93,7.5
"2011","Elmbridge 018E","E01030345","Total",1664,820,844,1664,0,53,181.68,9.2
"2011","Epsom and Ewell 001A","E01030386","Total",1446,718,728,1446,0,41,37.15,38.9
"2011","Epsom and Ewell 001B","E01030387","Total",1673,821,852,1673,0,24,22.96,72.9
"2011","Epsom and Ewell 001C","E01030388","Total",1308,638,670,1307,1,19,42.66,30.7
"2011","Epsom and Ewell 001D","E01030389","Total",1507,734,773,1507,0,21,32.54,46.3
"2011","Epsom and Ewell 001E","E01030393","Total",1900,936,964,1898,2,38,49.06,38.7
"2011","Epsom and Ewell 002A","E01030394","Total",1763,889,874,1763,0,31,49.15,35.9
"2011","Epsom and Ewell 002B","E01030399","Total",2053,970,1083,2053,0,19,35.10,58.5
"2011","Epsom and Ewell 002C","E01030400","Total",1656,753,903,1656,0,21,21.40,77.4
"2011","Epsom and Ewell 002D","E01030414","Total",1325,646,679,1321,4,11,27.47,48.2
"2011","Epsom and Ewell 003A","E01030377","Total",2381,1169,1212,2381,0,38,50.84,46.8
"2011","Epsom and Ewell 003B","E01030378","Total",1551,767,784,1551,0,20,41.13,37.7
"2011","Epsom and Ewell 003C","E01030406","Total",1600,799,801,1600,0,25,34.07,47.0
"2011","Epsom and Ewell 003D","E01030407","Total",1390,678,712,1390,0,34,30.76,45.2
"2011","Epsom and Ewell 003E","E01030408","Total",1819,875,944,1819,0,37,35.92,50.6
"2011","Epsom and Ewell 004A","E01030395","Total",1754,851,903,1754,0,14,48.04,36.5
"2011","Epsom and Ewell 004B","E01030413","Total",2070,989,1081,2063,7,26,28.27,73.2
"2011","Epsom and Ewell 004C","E01030415","Total",1653,829,824,1653,0,19,34.51,47.9
"2011","Epsom and Ewell 004D","E01030416","Total",1329,661,668,1321,8,26,32.91,40.4
"2011","Epsom and Ewell 005A","E01030383","Total",2472,1250,1222,2373,99,26,121.98,20.3
"2011","Epsom and Ewell 005B","E01030384","Total",2701,1327,1374,2670,31,39,50.25,53.8
"2011","Epsom and Ewell 005C","E01030401","Total",2465,1230,1235,2454,11,22,183.91,13.4
"2011","Epsom and Ewell 005D","E01030402","Total",1331,633,698,1286,45,15,149.64,8.9
"2011","Epsom and Ewell 007A","E01030385","Total",1657,820,837,1654,3,19,40.97,40.4
"2011","Epsom and Ewell 007B","E01030391","Total",1819,879,940,1819,0,30,37.44,48.6
"2011","Epsom and Ewell 007C","E01030403","Total",1549,752,797,1545,4,31,46.51,33.3
"2011","Epsom and Ewell 007D","E01030404","Total",1576,747,829,1576,0,31,46.74,33.7
"2011","Epsom and Ewell 007E","E01030409","Total",1488,703,785,1488,0,36,24.69,60.3
"2011","Epsom and Ewell 007F","E01030410","Total",1416,680,736,1416,0,12,36.23,39.1
"2011","Epsom and Ewell 008A","E01030381","Total",1467,709,758,1430,37,47,37.95,38.7
"2011","Epsom and Ewell 008B","E01030411","Total",2180,999,1181,2062,118,16,46.47,46.9
"2011","Epsom and Ewell 008C","E01030412","Total",1895,906,989,1852,43,16,28.55,66.4
"2011","Epsom and Ewell 008D","E01030419","Total",1674,773,901,1604,70,26,68.26,24.5
"2011","Epsom and Ewell 009A","E01030379","Total",1603,820,783,1263,340,31,95.16,16.8
"2011","Epsom and Ewell 009B","E01030380","Total",1406,674,732,1374,32,37,136.08,10.3
"2011","Epsom and Ewell 009C","E01030405","Total",1632,769,863,1614,18,16,193.17,8.4
"2011","Epsom and Ewell 009D","E01030417","Total",1340,639,701,1327,13,43,287.63,4.7
"2011","Epsom and Ewell 009E","E01030418","Total",1470,725,745,1465,5,29,300.05,4.9
"2011","Epsom and Ewell 009F","E01030420","Total",1235,544,691,1195,40,33,47.55,26.0
"2011","Epsom and Ewell 010A","E01030382","Total",1397,679,718,1388,9,31,46.71,29.9
"2011","Epsom and Ewell 010B","E01030390","Total",1831,851,980,1755,76,19,56.09,32.6
"2011","Epsom and Ewell 010C","E01030392","Total",1882,930,952,1857,25,37,61.37,30.7
"2011","Epsom and Ewell 010D","E01030396","Total",1827,885,942,1792,35,52,298.11,6.1
"2011","Epsom and Ewell 010E","E01030398","Total",1760,873,887,1760,0,49,215.49,8.2
"2011","Epsom and Ewell 010F","E01032624","Total",1851,892,959,1851,0,71,96.35,19.2
"2011","Guildford 001A","E01030440","Total",1631,793,838,1599,32,55,1543.97,1.1
"2011","Guildford 001B","E01030458","Total",1251,629,622,1248,3,29,1967.51,0.6
"2011","Guildford 001C","E01030459","Total",1373,554,819,1103,270,12,620.46,2.2
"2011","Guildford 001D","E01030475","Total",1317,643,674,1308,9,53,343.04,3.8
"2011","Guildford 001E","E01030476","Total",1257,607,650,1222,35,26,57.33,21.9
"2011","Guildford 001F","E01030477","Total",1671,841,830,1671,0,23,295.06,5.7
"2011","Guildford 002A","E01030465","Total",1435,698,737,1429,6,33,567.05,2.5
"2011","Guildford 002B","E01030466","Total",1546,770,776,1546,0,30,1069.92,1.4
"2011","Guildford 002C","E01030473","Total",1732,841,891,1723,9,37,1445.49,1.2
"2011","Guildford 002D","E01030474","Total",1959,1199,760,1461,498,22,456.36,4.3
"2011","Guildford 003A","E01030441","Total",1276,599,677,1256,20,54,877.42,1.5
"2011","Guildford 003B","E01030442","Total",1490,713,777,1490,0,90,463.06,3.2
"2011","Guildford 003C","E01030443","Total",1346,674,672,1346,0,50,168.38,8.0
"2011","Guildford 003D","E01030444","Total",1552,760,792,1552,0,45,206.14,7.5
"2011","Guildford 003E","E01030445","Total",1454,676,778,1389,65,60,108.99,13.3
"2011","Guildford 003F","E01030446","Total",1369,637,732,1310,59,51,1116.72,1.2
"2011","Guildford 003G","E01030447","Total",1342,645,697,1341,1,45,81.29,16.5
"2011","Guildford 004A","E01030426","Total",1496,737,759,1491,5,13,74.13,20.2
"2011","Guildford 004B","E01030427","Total",1502,742,760,1502,0,15,31.11,48.3
"2011","Guildford 004C","E01030428","Total",1197,605,592,1196,1,15,218.95,5.5
"2011","Guildford 004D","E01030429","Total",1491,728,763,1489,2,5,37.97,39.3
"2011","Guildford 004E","E01030430","Total",1494,742,752,1448,46,18,161.69,9.2
"2011","Guildford 005A","E01030499","Total",1549,757,792,1541,8,23,232.82,6.7
"2011","Guildford 005B","E01030500","Total",1530,768,762,1527,3,20,121.54,12.6
"2011","Guildford 005C","E01030501","Total",1638,820,818,1625,13,28,433.56,3.8
"2011","Guildford 005D","E01030502","Total",1244,619,625,1191,53,43,450.90,2.8
"2011","Guildford 005E","E01030503","Total",1445,691,754,1445,0,6,349.17,4.1
"2011","Guildford 005F","E01030504","Total",1123,522,601,1120,3,21,206.03,5.5
"2011","Guildford 006A","E01030485","Total",1729,886,843,1729,0,10,23.68,73.0
"2011","Guildford 006B","E01030487","Total",1630,846,784,1630,0,18,23.83,68.4
"2011","Guildford 006C","E01030488","Total",2269,1162,1107,1982,287,43,27.33,83.0
"2011","Guildford 006D","E01030489","Total",2533,1236,1297,2457,76,40,45.06,56.2
"2011","Guildford 007A","E01030481","Total",1744,883,861,1744,0,14,37.59,46.4
"2011","Guildford 007B","E01030482","Total",1405,706,699,1398,7,4,35.56,39.5
"2011","Guildford 007C","E01030483","Total",1377,711,666,1376,1,6,40.82,33.7
"2011","Guildford 007D","E01030484","Total",1661,855,806,1661,0,20,168.69,9.8
"2011","Guildford 008A","E01030434","Total",1650,806,844,1650,0,31,74.97,22.0
"2011","Guildford 008B","E01030435","Total",1800,868,932,1772,28,42,91.78,19.6
"2011","Guildford 008C","E01030462","Total",1654,777,877,1654,0,43,39.56,41.8
"2011","Guildford 008D","E01030463","Total",1487,731,756,1487,0,48,54.73,27.2
"2011","Guildford 008E","E01030464","Total",1676,824,852,1676,0,26,25.54,65.6
"2011","Guildford 009A","E01030486","Total",1644,850,794,1644,0,35,27.46,59.9
"2011","Guildford 009B","E01030493","Total",1295,625,670,1291,4,11,23.74,54.5
"2011","Guildford 009C","E01030495","Total",1749,942,807,1748,1,28,34.52,50.7
"2011","Guildford 009D","E01030498","Total",1399,703,696,1394,5,25,22.24,62.9
"2011","Guildford 010A","E01030424","Total",1518,744,774,1518,0,14,45.46,33.4
"2011","Guildford 010B","E01030431","Total",1469,737,732,1457,12,14,80.34,18.3
"2011","Guildford 010C","E01030432","Total",1514,750,764,1514,0,5,34.94,43.3
"2011","Guildford 010D","E01030433","Total",1643,820,823,1638,5,6,45.44,36.2
"2011","Guildford 011A","E01030436","Total",2246,1105,1141,2244,2,41,64.61,34.8
"2011","Guildford 011B","E01030437","Total",1792,847,945,1726,66,67,67.13,26.7
"2011","Guildford 011C","E01030439","Total",1719,836,883,1712,7,58,90.12,19.1
"2011","Guildford 011D","E01030460","Total",1570,771,799,1570,0,52,63.55,24.7
"2011","Guildford 011E","E01030461","Total",1649,788,861,1619,30,48,257.49,6.4
"2011","Guildford 012A","E01030470","Total",2943,1440,1503,1428,1515,51,177.44,16.6
"2011","Guildford 012B","E01030494","Total",1630,826,804,1630,0,10,26.46,61.6
"2011","Guildford 012C","E01030496","Total",1619,795,824,1619,0,9,31.82,50.9
"2011","Guildford 012D","E01030497","Total",1615,788,827,1615,0,6,30.87,52.3
"2011","Guildford 013A","E01030438","Total",1590,774,816,1590,0,39,102.58,15.5
"2011","Guildford 013B","E01030450","Total",2348,1269,1079,2346,2,35,51.05,46.0
"2011","Guildford 013C","E01030451","Total",1884,1033,851,1834,50,10,25.32,74.4
"2011","Guildford 013D","E01030453","Total",1479,765,714,1471,8,27,27.61,53.6
"2011","Guildford 013E","E01030455","Total",1565,834,731,1533,32,33,50.40,31.1
"2011","Guildford 013F","E01030457","Total",1601,847,754,1578,23,28,18.36,87.2
"2011","Guildford 014A","E01030421","Total",1467,713,754,1461,6,20,157.78,9.3
"2011","Guildford 014B","E01030422","Total",1449,687,762,1449,0,9,49.74,29.1
"2011","Guildford 014C","E01030423","Total",1652,796,856,1643,9,11,315.61,5.2
"2011","Guildford 014D","E01030425","Total",1588,779,809,1580,8,17,49.56,32.0
"2011","Guildford 015A","E01030452","Total",1976,1037,939,1903,73,18,61.21,32.3
"2011","Guildford 015B","E01030467","Total",1632,800,832,1632,0,55,67.98,24.0
"2011","Guildford 015C","E01030468","Total",3499,1710,1789,1235,2264,70,85.90,40.7
"2011","Guildford 015D","E01030469","Total",1418,709,709,1417,1,40,33.10,42.8
"2011","Guildford 016A","E01030448","Total",1489,742,747,1489,0,54,174.53,8.5
"2011","Guildford 016B","E01030449","Total",1293,636,657,1221,72,27,33.22,38.9
"2011","Guildford 016C","E01030454","Total",1703,855,848,1703,0,61,431.27,3.9
"2011","Guildford 016D","E01030456","Total",1445,707,738,1445,0,73,197.14,7.3
"2011","Guildford 017A","E01030471","Total",1242,616,626,1218,24,53,1643.20,0.8
"2011","Guildford 017B","E01030472","Total",1371,706,665,1283,88,45,1589.82,0.9
"2011","Guildford 017C","E01030478","Total",2041,884,1157,1698,343,51,1607.35,1.3
"2011","Guildford 017D","E01030479","Total",1793,841,952,1769,24,21,99.72,18.0
"2011","Guildford 017E","E01030480","Total",1821,830,991,1819,2,54,279.26,6.5
"2011","Guildford 018A","E01030490","Total",1600,776,824,1598,2,52,1518.02,1.1
"2011","Guildford 018B","E01030491","Total",1874,920,954,1843,31,34,1604.59,1.2
"2011","Guildford 018C","E01030492","Total",2024,989,1035,2010,14,65,1300.11,1.6
"2011","Mole Valley 001A","E01030506","Total",1353,670,683,1353,0,30,62.29,21.7
"2011","Mole Valley 001B","E01030508","Total",1342,666,676,1288,54,52,374.88,3.6
"2011","Mole Valley 001C","E01030509","Total",1072,503,569,1072,0,24,46.53,23.0
"2011","Mole Valley 001D","E01030513","Total",1409,675,734,1409,0,38,34.01,41.4
"2011","Mole Valley 001E","E01030514","Total",1478,688,790,1478,0,38,42.30,34.9
"2011","Mole Valley 002A","E01030505","Total",1536,768,768,1520,16,36,83.76,18.3
"2011","Mole Valley 002B","E01030507","Total",1240,595,645,1232,8,28,294.47,4.2
"2011","Mole Valley 002C","E01030511","Total",1533,738,795,1449,84,42,66.25,23.1
"2011","Mole Valley 002D","E01030512","Total",1578,742,836,1540,38,38,55.64,28.4
"2011","Mole Valley 003A","E01030548","Total",1876,939,937,1818,58,21,426.22,4.4
"2011","Mole Valley 003B","E01030549","Total",1830,937,893,1829,1,13,61.37,29.8
"2011","Mole Valley 003C","E01030550","Total",1731,903,828,1731,0,17,66.21,26.1
"2011","Mole Valley 003D","E01030551","Total",1598,786,812,1598,0,11,63.17,25.3
"2011","Mole Valley 004A","E01030510","Total",1628,759,869,1583,45,56,98.85,16.5
"2011","Mole Valley 004B","E01030552","Total",1443,720,723,1291,152,21,30.76,46.9
"2011","Mole Valley 004C","E01030553","Total",1705,830,875,1672,33,33,102.72,16.6
"2011","Mole Valley 004D","E01030554","Total",1133,549,584,1133,0,70,503.06,2.3
"2011","Mole Valley 005A","E01030539","Total",1780,901,879,1755,25,33,75.09,23.7
"2011","Mole Valley 005B","E01030540","Total",2056,1032,1024,2056,0,83,353.45,5.8
"2011","Mole Valley 005C","E01030541","Total",1343,659,684,1343,0,48,59.20,22.7
"2011","Mole Valley 005D","E01030542","Total",1271,620,651,1271,0,21,30.67,41.4
"2011","Mole Valley 005E","E01030543","Total",1546,755,791,1484,62,42,453.27,3.4
"2011","Mole Valley 006A","E01030516","Total",1295,602,693,1257,38,22,44.22,29.3
"2011","Mole Valley 006B","E01030517","Total",1549,735,814,1549,0,44,252.58,6.1
"2011","Mole Valley 006C","E01030518","Total",1346,640,706,1346,0,45,59.63,22.6
"2011","Mole Valley 006D","E01030519","Total",1589,762,827,1589,0,38,77.28,20.6
"2011","Mole Valley 007A","E01030520","Total",1461,665,796,1461,0,15,74.45,19.6
"2011","Mole Valley 007B","E01030521","Total",1647,791,856,1623,24,49,484.93,3.4
"2011","Mole Valley 007C","E01030522","Total",1295,654,641,1295,0,46,52.29,24.8
"2011","Mole Valley 007D","E01030523","Total",1193,566,627,1193,0,24,61.19,19.5
"2011","Mole Valley 008A","E01030524","Total",2007,1032,975,2001,6,30,1029.08,2.0
"2011","Mole Valley 008B","E01030525","Total",1524,720,804,1524,0,38,622.36,2.4
"2011","Mole Valley 008C","E01030526","Total",1344,662,682,1344,0,30,67.69,19.9
"2011","Mole Valley 008D","E01030527","Total",1614,788,826,1529,85,48,1541.43,1.0
"2011","Mole Valley 009A","E01030532","Total",1499,730,769,1499,0,38,34.79,43.1
"2011","Mole Valley 009B","E01030533","Total",1388,692,696,1388,0,32,100.55,13.8
"2011","Mole Valley 009C","E01030534","Total",1270,593,677,1258,12,20,119.22,10.7
"2011","Mole Valley 009D","E01030556","Total",1995,963,1032,1811,184,65,1118.45,1.8
"2011","Mole Valley 010A","E01030535","Total",1864,879,985,1823,41,49,82.15,22.7
"2011","Mole Valley 010B","E01030536","Total",1806,849,957,1728,78,51,70.65,25.6
"2011","Mole Valley 010C","E01030537","Total",1730,848,882,1663,67,68,219.30,7.9
"2011","Mole Valley 010D","E01030538","Total",1601,808,793,1586,15,16,29.52,54.2
"2011","Mole Valley 011A","E01030544","Total",1604,790,814,1547,57,56,1142.69,1.4
"2011","Mole Valley 011B","E01030545","Total",1556,764,792,1556,0,24,39.12,39.8
"2011","Mole Valley 011C","E01030546","Total",1656,805,851,1645,11,9,110.93,14.9
"2011","Mole Valley 011D","E01030547","Total",1601,785,816,1601,0,11,32.40,49.4
"2011","Mole Valley 012A","E01030529","Total",1680,838,842,1680,0,22,1250.58,1.3
"2011","Mole Valley 012B","E01030555","Total",1745,879,866,1727,18,64,4365.49,0.4
"2011","Mole Valley 012C","E01030557","Total",1885,938,947,1877,8,72,2886.40,0.7
"2011","Mole Valley 012D","E01030558","Total",2251,1087,1164,2183,68,57,977.52,2.3
"2011","Mole Valley 013A","E01030515","Total",1881,946,935,1880,1,26,744.98,2.5
"2011","Mole Valley 013B","E01030528","Total",1413,696,717,1413,0,31,1586.04,0.9
"2011","Mole Valley 013C","E01030530","Total",1279,635,644,1279,0,46,1714.59,0.7
"2011","Mole Valley 013D","E01030531","Total",2326,1172,1154,2225,101,43,1455.59,1.6
"2011","Reigate and Banstead 001A","E01030603","Total",1504,731,773,1462,42,36,42.45,35.4
"2011","Reigate and Banstead 001B","E01030604","Total",1530,760,770,1530,0,30,99.30,15.4
"2011","Reigate and Banstead 001C","E01030605","Total",1464,710,754,1464,0,40,41.96,34.9
"2011","Reigate and Banstead 001D","E01030607","Total",1744,857,887,1733,11,44,109.87,15.9
"2011","Reigate and Banstead 002A","E01030559","Total",1292,579,713,1198,94,30,71.62,18.0
"2011","Reigate and Banstead 002B","E01030560","Total",1614,704,910,1485,129,14,47.51,34.0
"2011","Reigate and Banstead 002C","E01030561","Total",1440,620,820,1301,139,25,102.87,14.0
"2011","Reigate and Banstead 002D","E01030562","Total",1286,597,689,1284,2,27,36.14,35.6
"2011","Reigate and Banstead 002E","E01030563","Total",2067,1211,856,1159,908,23,178.30,11.6
"2011","Reigate and Banstead 002F","E01030564","Total",1411,693,718,1402,9,30,26.05,54.2
"2011","Reigate and Banstead 003A","E01030606","Total",1314,655,659,1314,0,33,69.53,18.9
"2011","Reigate and Banstead 003B","E01030641","Total",1613,761,852,1591,22,32,48.69,33.1
"2011","Reigate and Banstead 003C","E01030642","Total",1599,759,840,1599,0,25,43.69,36.6
"2011","Reigate and Banstead 003D","E01030644","Total",1278,646,632,1278,0,25,72.44,17.6
"2011","Reigate and Banstead 004A","E01030565","Total",1468,718,750,1373,95,25,338.16,4.3
"2011","Reigate and Banstead 004B","E01030566","Total",1521,737,784,1521,0,28,95.02,16.0
"2011","Reigate and Banstead 004C","E01030567","Total",1575,778,797,1540,35,45,852.04,1.8
"2011","Reigate and Banstead 004D","E01030568","Total",1561,791,770,1551,10,42,108.42,14.4
"2011","Reigate and Banstead 004E","E01030569","Total",2698,1330,1368,2696,2,44,431.32,6.3
"2011","Reigate and Banstead 005A","E01030608","Total",1421,657,764,1421,0,20,24.72,57.5
"2011","Reigate and Banstead 005B","E01030609","Total",1529,740,789,1529,0,9,39.27,38.9
"2011","Reigate and Banstead 005C","E01030640","Total",1532,751,781,1532,0,13,23.81,64.3
"2011","Reigate and Banstead 005D","E01030643","Total",1348,635,713,1348,0,7,56.12,24.0
"2011","Reigate and Banstead 006A","E01030635","Total",1597,776,821,1549,48,25,227.62,7.0
"2011","Reigate and Banstead 006B","E01030636","Total",1250,612,638,1199,51,47,42.42,29.5
"2011","Reigate and Banstead 006C","E01030637","Total",1249,624,625,1249,0,44,99.40,12.6
"2011","Reigate and Banstead 006D","E01030638","Total",1542,767,775,1540,2,29,61.79,25.0
"2011","Reigate and Banstead 006E","E01030639","Total",1485,692,793,1369,116,37,964.74,1.5
"2011","Reigate and Banstead 007A","E01030589","Total",1725,847,878,1725,0,71,265.64,6.5
"2011","Reigate and Banstead 007B","E01030590","Total",1870,915,955,1864,6,26,474.35,3.9
"2011","Reigate and Banstead 007C","E01030591","Total",1412,680,732,1320,92,29,207.31,6.8
"2011","Reigate and Banstead 007D","E01030592","Total",1884,907,977,1842,42,29,462.10,4.1
"2011","Reigate and Banstead 008A","E01030599","Total",1552,783,769,1552,0,6,31.91,48.6
"2011","Reigate and Banstead 008B","E01030600","Total",1556,743,813,1518,38,20,102.00,15.3
"2011","Reigate and Banstead 008C","E01030601","Total",1623,794,829,1592,31,15,63.23,25.7
"2011","Reigate and Banstead 008D","E01030602","Total",1797,855,942,1742,55,18,38.75,46.4
"2011","Reigate and Banstead 009A","E01030598","Total",1595,798,797,1545,50,29,702.10,2.3
"2011","Reigate and Banstead 009B","E01030623","Total",2143,1027,1116,2033,110,26,471.02,4.5
"2011","Reigate and Banstead 009C","E01030624","Total",1355,645,710,1270,85,26,60.42,22.4
"2011","Reigate and Banstead 009D","E01030625","Total",1671,814,857,1227,444,98,350.10,4.8
"2011","Reigate and Banstead 009E","E01030626","Total",1038,494,544,1010,28,35,208.36,5.0
"2011","Reigate and Banstead 009F","E01030627","Total",1631,795,836,1631,0,15,39.77,41.0
"2011","Reigate and Banstead 010A","E01030615","Total",1563,766,797,1558,5,10,20.66,75.7
"2011","Reigate and Banstead 010B","E01030616","Total",1597,782,815,1593,4,22,57.70,27.7
"2011","Reigate and Banstead 010C","E01030617","Total",1640,779,861,1620,20,32,39.19,41.8
"2011","Reigate and Banstead 010D","E01030618","Total",1882,937,945,1877,5,16,29.95,62.8
"2011","Reigate and Banstead 010E","E01030619","Total",1503,745,758,1484,19,11,29.21,51.5
"2011","Reigate and Banstead 010F","E01030622","Total",1868,942,926,1811,57,37,31.17,59.9
"2011","Reigate and Banstead 011A","E01030610","Total",1296,622,674,1290,6,16,41.66,31.1
"2011","Reigate and Banstead 011B","E01030611","Total",2684,1335,1349,2584,100,33,61.29,43.8
"2011","Reigate and Banstead 011C","E01030612","Total",2496,1274,1222,2472,24,25,201.19,12.4
"2011","Reigate and Banstead 011D","E01030613","Total",1886,953,933,1866,20,17,32.29,58.4
"2011","Reigate and Banstead 011E","E01030614","Total",1616,821,795,1611,5,37,53.05,30.5
"2011","Reigate and Banstead 012A","E01030593","Total",1388,689,699,1388,0,40,65.29,21.3
"2011","Reigate and Banstead 012B","E01030596","Total",1529,753,776,1482,47,47,55.03,27.8
"2011","Reigate and Banstead 012C","E01030597","Total",1592,757,835,1592,0,31,21.52,74.0
"2011","Reigate and Banstead 012D","E01030620","Total",1766,864,902,1764,2,28,138.19,12.8
"2011","Reigate and Banstead 012E","E01030621","Total",1584,742,842,1534,50,39,41.52,38.2
"2011","Reigate and Banstead 013A","E01030594","Total",1788,866,922,1788,0,22,55.27,32.4
"2011","Reigate and Banstead 013B","E01030595","Total",1498,729,769,1498,0,30,42.32,35.4
"2011","Reigate and Banstead 013C","E01030630","Total",1641,797,844,1641,0,27,46.09,35.6
"2011","Reigate and Banstead 013D","E01030631","Total",1500,692,808,1500,0,15,75.61,19.8
"2011","Reigate and Banstead 014A","E01030570","Total",1587,763,824,1587,0,14,232.99,6.8
"2011","Reigate and Banstead 014B","E01030571","Total",1588,795,793,1584,4,26,222.92,7.1
"2011","Reigate and Banstead 014C","E01030572","Total",2123,1009,1114,2045,78,23,96.09,22.1
"2011","Reigate and Banstead 014D","E01030573","Total",1784,880,904,1753,31,16,66.71,26.7
"2011","Reigate and Banstead 014E","E01030574","Total",1775,883,892,1759,16,19,38.57,46.0
"2011","Reigate and Banstead 015A","E01030628","Total",1410,701,709,1394,16,29,1277.51,1.1
"2011","Reigate and Banstead 015B","E01030629","Total",1201,597,604,1191,10,15,403.45,3.0
"2011","Reigate and Banstead 015C","E01030632","Total",1357,670,687,1351,6,21,369.63,3.7
"2011","Reigate and Banstead 015D","E01030633","Total",1382,690,692,1350,32,16,56.82,24.3
"2011","Reigate and Banstead 015E","E01030634","Total",1451,685,766,1451,0,9,54.21,26.8
"2011","Reigate and Banstead 016A","E01030584","Total",1631,798,833,1631,0,28,128.38,12.7
"2011","Reigate and Banstead 016B","E01030585","Total",1593,791,802,1593,0,19,43.95,36.2
"2011","Reigate and Banstead 016C","E01030586","Total",1695,821,874,1695,0,11,51.54,32.9
"2011","Reigate and Banstead 016D","E01030587","Total",1464,727,737,1464,0,14,33.96,43.1
"2011","Reigate and Banstead 016E","E01030588","Total",1471,715,756,1465,6,19,39.29,37.4
"2011","Reigate and Banstead 017A","E01030580","Total",1924,961,963,1924,0,13,95.97,20.0
"2011","Reigate and Banstead 017B","E01030581","Total",1257,621,636,1257,0,20,180.61,7.0
"2011","Reigate and Banstead 017C","E01030582","Total",1264,595,669,1264,0,20,23.63,53.5
"2011","Reigate and Banstead 017D","E01030583","Total",1480,746,734,1462,18,24,280.60,5.3
"2011","Reigate and Banstead 018A","E01030575","Total",2092,1062,1030,2074,18,15,44.40,47.1
"2011","Reigate and Banstead 018B","E01030576","Total",1681,853,828,1662,19,17,42.82,39.3
"2011","Reigate and Banstead 018C","E01030577","Total",1636,818,818,1636,0,14,79.41,20.6
"2011","Reigate and Banstead 018D","E01030578","Total",1455,732,723,1448,7,13,33.38,43.6
"2011","Reigate and Banstead 018E","E01030579","Total",1433,676,757,1265,168,13,46.04,31.1
"2011","Runnymede 001A","E01030667","Total",1427,692,735,1427,0,12,44.16,32.3
"2011","Runnymede 001B","E01030668","Total",1820,827,993,1820,0,11,130.50,13.9
"2011","Runnymede 001C","E01030669","Total",1634,816,818,1634,0,21,29.80,54.8
"2011","Runnymede 001D","E01030670","Total",1503,674,829,1503,0,25,59.35,25.3
"2011","Runnymede 002A","E01030671","Total",2938,1276,1662,1014,1924,81,84.61,34.7
"2011","Runnymede 002B","E01030672","Total",2489,1186,1303,2064,425,64,166.75,14.9
"2011","Runnymede 002C","E01030673","Total",1061,538,523,1014,47,32,574.20,1.8
"2011","Runnymede 002D","E01030674","Total",1408,680,728,1408,0,10,32.10,43.9
"2011","Runnymede 002E","E01030675","Total",1347,641,706,1347,0,26,30.06,44.8
"2011","Runnymede 002F","E01030676","Total",1364,637,727,1361,3,20,33.47,40.8
"2011","Runnymede 003A","E01030663","Total",1582,767,815,1582,0,27,48.68,32.5
"2011","Runnymede 003B","E01030664","Total",1653,800,853,1644,9,14,40.06,41.3
"2011","Runnymede 003C","E01030665","Total",1519,750,769,1519,0,8,44.88,33.8
"2011","Runnymede 003D","E01030666","Total",1720,858,862,1716,4,20,57.09,30.1
"2011","Runnymede 003E","E01030687","Total",1172,578,594,1145,27,27,161.21,7.3
"2011","Runnymede 003F","E01030688","Total",1474,736,738,1474,0,14,72.18,20.4
"2011","Runnymede 004A","E01030656","Total",1601,786,815,1543,58,21,208.84,7.7
"2011","Runnymede 004B","E01030658","Total",1347,668,679,1300,47,6,236.80,5.7
"2011","Runnymede 004C","E01030685","Total",1425,738,687,1314,111,30,458.27,3.1
"2011","Runnymede 004D","E01030686","Total",1394,707,687,1394,0,27,164.33,8.5
"2011","Runnymede 005A","E01030689","Total",1390,699,691,1384,6,49,127.20,10.9
"2011","Runnymede 005B","E01030690","Total",1658,782,876,1577,81,47,188.33,8.8
"2011","Runnymede 005C","E01030691","Total",1583,773,810,1583,0,55,227.54,7.0
"2011","Runnymede 005D","E01030692","Total",1309,634,675,1257,52,54,936.02,1.4
"2011","Runnymede 006A","E01030652","Total",1659,831,828,1659,0,10,43.60,38.1
"2011","Runnymede 006B","E01030653","Total",1398,686,712,1392,6,7,40.23,34.8
"2011","Runnymede 006C","E01030654","Total",1424,705,719,1424,0,15,107.06,13.3
"2011","Runnymede 006D","E01030657","Total",1488,750,738,1488,0,12,42.11,35.3
"2011","Runnymede 006E","E01030659","Total",1604,801,803,1595,9,25,57.32,28.0
"2011","Runnymede 007A","E01030647","Total",1620,797,823,1620,0,14,151.09,10.7
"2011","Runnymede 007B","E01030648","Total",1624,753,871,1558,66,22,46.97,34.6
"2011","Runnymede 007C","E01030649","Total",1663,807,856,1659,4,25,87.51,19.0
"2011","Runnymede 007D","E01030650","Total",1284,645,639,1271,13,11,37.89,33.9
"2011","Runnymede 007E","E01030651","Total",1334,661,673,1334,0,5,92.08,14.5
"2011","Runnymede 007F","E01030655","Total",1557,754,803,1557,0,28,115.01,13.5
"2011","Runnymede 007G","E01030662","Total",1570,767,803,1548,22,13,122.90,12.8
"2011","Runnymede 008A","E01030677","Total",1576,764,812,1565,11,9,807.31,2.0
"2011","Runnymede 008B","E01030678","Total",1319,629,690,1263,56,19,84.11,15.7
"2011","Runnymede 008C","E01030679","Total",1243,617,626,1203,40,36,821.99,1.5
"2011","Runnymede 008D","E01030680","Total",1534,744,790,1527,7,27,121.16,12.7
"2011","Runnymede 009A","E01030645","Total",1926,933,993,1926,0,25,32.13,59.9
"2011","Runnymede 009B","E01030646","Total",2050,1007,1043,2050,0,21,40.13,51.1
"2011","Runnymede 009C","E01030660","Total",2088,996,1092,2066,22,36,79.67,26.2
"2011","Runnymede 009D","E01030661","Total",1670,802,868,1601,69,23,115.78,14.4
"2011","Runnymede 009E","E01030684","Total",1474,720,754,1474,0,14,62.21,23.7
"2011","Runnymede 010A","E01030681","Total",1587,782,805,1571,16,36,82.57,19.2
"2011","Runnymede 010B","E01030682","Total",1354,695,659,1330,24,21,42.17,32.1
"2011","Runnymede 010C","E01030683","Total",1342,668,674,1342,0,12,170.52,7.9
"2011","Runnymede 010D","E01030693","Total",1201,571,630,1201,0,9,35.18,34.1
"2011","Runnymede 010E","E01030694","Total",1362,673,689,1362,0,18,28.63,47.6
"2011","Runnymede 010F","E01030695","Total",1266,619,647,1266,0,37,102.52,12.3
"2011","Runnymede 010G","E01030696","Total",1475,728,747,1470,5,20,78.04,18.9
"2011","Spelthorne 001A","E01030743","Total",1499,747,752,1499,0,13,60.09,24.9
"2011","Spelthorne 001B","E01030744","Total",1578,847,731,1578,0,8,34.00,46.4
"2011","Spelthorne 001C","E01030745","Total",1587,746,841,1587,0,16,209.37,7.6
"2011","Spelthorne 001D","E01030747","Total",1371,696,675,1371,0,10,262.96,5.2
"2011","Spelthorne 002A","E01030709","Total",1540,768,772,1540,0,9,98.94,15.6
"2011","Spelthorne 002B","E01030710","Total",1668,831,837,1668,0,4,24.87,67.1
"2011","Spelthorne 002C","E01030711","Total",1775,874,901,1727,48,10,29.56,60.0
"2011","Spelthorne 002D","E01030746","Total",1632,798,834,1628,4,9,55.95,29.2
"2011","Spelthorne 003A","E01030707","Total",1625,854,771,1603,22,15,69.49,23.4
"2011","Spelthorne 003B","E01030708","Total",1649,826,823,1649,0,13,28.68,57.5
"2011","Spelthorne 003C","E01030712","Total",1333,649,684,1292,41,21,34.22,39.0
"2011","Spelthorne 003D","E01030713","Total",1229,631,598,1229,0,21,18.48,66.5
"2011","Spelthorne 003E","E01030714","Total",1490,602,888,1240,250,12,55.61,26.8
"2011","Spelthorne 003F","E01030715","Total",1512,777,735,1512,0,27,24.47,61.8
"2011","Spelthorne 003G","E01030716","Total",1525,762,763,1525,0,17,21.28,71.7
"2011","Spelthorne 004A","E01030734","Total",1517,735,782,1517,0,31,94.75,16.0
"2011","Spelthorne 004B","E01030735","Total",1597,796,801,1571,26,10,305.67,5.2
"2011","Spelthorne 004C","E01030736","Total",1797,948,849,1792,5,15,69.24,26.0
"2011","Spelthorne 004D","E01030737","Total",1446,751,695,1427,19,9,42.06,34.4
"2011","Spelthorne 004E","E01030738","Total",1504,721,783,1504,0,13,38.05,39.5
"2011","Spelthorne 005A","E01030701","Total",1577,758,819,1577,0,15,27.66,57.0
"2011","Spelthorne 005B","E01030702","Total",1143,555,588,1143,0,9,16.99,67.3
"2011","Spelthorne 005C","E01030703","Total",1579,772,807,1579,0,16,48.15,32.8
"2011","Spelthorne 005D","E01030704","Total",1475,736,739,1460,15,19,28.74,51.3
"2011","Spelthorne 005E","E01030705","Total",1628,797,831,1618,10,16,70.33,23.1
"2011","Spelthorne 005F","E01030706","Total",1394,684,710,1394,0,15,26.16,53.3
"2011","Spelthorne 006A","E01030697","Total",1562,781,781,1562,0,14,24.48,63.8
"2011","Spelthorne 006B","E01030698","Total",1676,806,870,1676,0,16,27.11,61.8
"2011","Spelthorne 006C","E01030699","Total",1509,758,751,1509,0,12,43.47,34.7
"2011","Spelthorne 006D","E01030700","Total",1721,842,879,1721,0,16,31.24,55.1
"2011","Spelthorne 006E","E01030725","Total",1755,880,875,1755,0,6,76.67,22.9
"2011","Spelthorne 007A","E01030729","Total",1537,749,788,1537,0,25,71.28,21.6
"2011","Spelthorne 007B","E01030739","Total",1662,788,874,1649,13,16,35.27,47.1
"2011","Spelthorne 007C","E01030740","Total",1770,863,907,1770,0,13,35.62,49.7
"2011","Spelthorne 007D","E01030741","Total",1765,862,903,1758,7,14,30.88,57.2
"2011","Spelthorne 008A","E01030748","Total",1753,889,864,1753,0,14,42.55,41.2
"2011","Spelthorne 008B","E01030749","Total",1556,737,819,1556,0,15,47.87,32.5
"2011","Spelthorne 008C","E01030750","Total",1590,776,814,1590,0,12,24.94,63.8
"2011","Spelthorne 008D","E01030751","Total",1537,783,754,1537,0,19,23.70,64.9
"2011","Spelthorne 008E","E01030752","Total",1640,815,825,1551,89,7,35.40,46.3
"2011","Spelthorne 009A","E01030726","Total",1701,831,870,1701,0,23,40.52,42.0
"2011","Spelthorne 009B","E01030727","Total",1818,871,947,1818,0,20,34.59,52.6
"2011","Spelthorne 009C","E01030728","Total",1662,827,835,1662,0,25,70.14,23.7
"2011","Spelthorne 009D","E01030742","Total",1926,956,970,1914,12,14,29.40,65.5
"2011","Spelthorne 010A","E01030753","Total",1681,834,847,1681,0,28,60.09,28.0
"2011","Spelthorne 010B","E01030754","Total",1520,759,761,1512,8,36,59.20,25.7
"2011","Spelthorne 010C","E01030755","Total",1935,915,1020,1935,0,20,189.50,10.2
"2011","Spelthorne 010D","E01030756","Total",1662,823,839,1662,0,33,57.17,29.1
"2011","Spelthorne 011A","E01030717","Total",1599,778,821,1599,0,15,91.80,17.4
"2011","Spelthorne 011B","E01030718","Total",1353,655,698,1353,0,20,42.62,31.7
"2011","Spelthorne 011C","E01030719","Total",1574,770,804,1545,29,24,128.30,12.3
"2011","Spelthorne 011D","E01030720","Total",1580,749,831,1502,78,13,91.73,17.2
"2011","Spelthorne 012A","E01030721","Total",1544,735,809,1476,68,17,420.96,3.7
"2011","Spelthorne 012B","E01030722","Total",1587,783,804,1587,0,15,128.29,12.4
"2011","Spelthorne 012C","E01030723","Total",1566,796,770,1566,0,26,101.16,15.5
"2011","Spelthorne 012D","E01030724","Total",1510,725,785,1510,0,5,56.84,26.6
"2011","Spelthorne 013A","E01030730","Total",1756,867,889,1756,0,30,289.60,6.1
"2011","Spelthorne 013B","E01030731","Total",1871,925,946,1871,0,29,43.51,43.0
"2011","Spelthorne 013C","E01030732","Total",1472,685,787,1455,17,16,155.28,9.5
"2011","Spelthorne 013D","E01030733","Total",1578,779,799,1578,0,25,51.49,30.6
"2011","Surrey Heath 001A","E01030763","Total",1175,576,599,1175,0,42,1606.11,0.7
"2011","Surrey Heath 001B","E01030764","Total",1229,612,617,1218,11,36,662.87,1.9
"2011","Surrey Heath 001C","E01030765","Total",1395,684,711,1395,0,13,43.65,32.0
"2011","Surrey Heath 001D","E01030809","Total",1433,710,723,1433,0,45,260.05,5.5
"2011","Surrey Heath 001E","E01030810","Total",1469,756,713,1406,63,49,243.59,6.0
"2011","Surrey Heath 001F","E01030811","Total",1490,719,771,1490,0,56,451.69,3.3
"2011","Surrey Heath 002A","E01030757","Total",1591,812,779,1591,0,36,89.84,17.7
"2011","Surrey Heath 002B","E01030758","Total",1181,563,618,1109,72,24,350.74,3.4
"2011","Surrey Heath 002C","E01030759","Total",1588,793,795,1588,0,10,67.60,23.5
"2011","Surrey Heath 002D","E01030760","Total",1232,623,609,1220,12,19,356.95,3.5
"2011","Surrey Heath 003A","E01030778","Total",1820,901,919,1820,0,34,45.37,40.1
"2011","Surrey Heath 003B","E01030779","Total",1765,832,933,1765,0,48,51.19,34.5
"2011","Surrey Heath 003C","E01030780","Total",1628,797,831,1593,35,42,191.36,8.5
"2011","Surrey Heath 003D","E01030781","Total",1578,777,801,1578,0,23,131.14,12.0
"2011","Surrey Heath 004A","E01030786","Total",1791,841,950,1791,0,14,168.03,10.7
"2011","Surrey Heath 004B","E01030787","Total",1444,709,735,1444,0,15,75.29,19.2
"2011","Surrey Heath 004C","E01030788","Total",1401,664,737,1401,0,8,60.88,23.0
"2011","Surrey Heath 004D","E01030801","Total",1613,796,817,1607,6,31,88.90,18.1
"2011","Surrey Heath 004E","E01030802","Total",1678,851,827,1659,19,33,59.35,28.3
"2011","Surrey Heath 005A","E01030796","Total",1398,673,725,1398,0,35,56.86,24.6
"2011","Surrey Heath 005B","E01030797","Total",1486,730,756,1424,62,32,52.71,28.2
"2011","Surrey Heath 005C","E01030798","Total",1518,768,750,1510,8,47,75.21,20.2
"2011","Surrey Heath 005D","E01030799","Total",1388,687,701,1376,12,42,61.83,22.4
"2011","Surrey Heath 005E","E01030800","Total",1621,775,846,1574,47,56,114.39,14.2
"2011","Surrey Heath 006A","E01030761","Total",2072,1302,770,1545,527,24,263.24,7.9
"2011","Surrey Heath 006B","E01030762","Total",1893,952,941,1879,14,46,102.62,18.4
"2011","Surrey Heath 006C","E01030806","Total",1574,785,789,1574,0,54,296.86,5.3
"2011","Surrey Heath 006D","E01030807","Total",1544,759,785,1375,169,38,323.44,4.8
"2011","Surrey Heath 006E","E01030808","Total",1575,780,795,1575,0,24,832.00,1.9
"2011","Surrey Heath 007A","E01030774","Total",1382,677,705,1359,23,32,34.12,40.5
"2011","Surrey Heath 007B","E01030775","Total",1450,723,727,1450,0,46,57.10,25.4
"2011","Surrey Heath 007C","E01030776","Total",1613,780,833,1613,0,46,52.05,31.0
"2011","Surrey Heath 007D","E01030777","Total",1604,784,820,1604,0,29,33.42,48.0
"2011","Surrey Heath 008A","E01030793","Total",1527,792,735,1527,0,29,119.57,12.8
"2011","Surrey Heath 008B","E01030794","Total",1598,815,783,1542,56,15,29.07,55.0
"2011","Surrey Heath 008C","E01030795","Total",2072,989,1083,2024,48,29,53.24,38.9
"2011","Surrey Heath 008D","E01030803","Total",1705,862,843,1705,0,13,73.16,23.3
"2011","Surrey Heath 008E","E01030804","Total",1822,886,936,1720,102,43,78.99,23.1
"2011","Surrey Heath 008F","E01030805","Total",1625,821,804,1625,0,16,59.39,27.4
"2011","Surrey Heath 009A","E01030789","Total",1479,746,733,1460,19,43,105.55,14.0
"2011","Surrey Heath 009B","E01030790","Total",1705,853,852,1703,2,27,41.46,41.1
"2011","Surrey Heath 009C","E01030791","Total",1660,815,845,1660,0,28,46.31,35.8
"2011","Surrey Heath 009D","E01030792","Total",1336,650,686,1336,0,39,79.42,16.8
"2011","Surrey Heath 010A","E01030766","Total",1641,808,833,1579,62,17,77.42,21.2
"2011","Surrey Heath 010B","E01030767","Total",1622,792,830,1622,0,11,31.22,52.0
"2011","Surrey Heath 010C","E01030768","Total",1384,678,706,1342,42,29,56.64,24.4
"2011","Surrey Heath 010D","E01030769","Total",1531,752,779,1531,0,43,48.51,31.6
"2011","Surrey Heath 011A","E01030770","Total",1495,734,761,1495,0,28,65.05,23.0
"2011","Surrey Heath 011B","E01030771","Total",1270,609,661,1270,0,42,27.32,46.5
"2011","Surrey Heath 011C","E01030772","Total",1515,768,747,1515,0,16,67.50,22.4
"2011","Surrey Heath 011D","E01030773","Total",1437,709,728,1437,0,25,74.50,19.3
"2011","Surrey Heath 012A","E01030782","Total",1575,790,785,1575,0,18,81.46,19.3
"2011","Surrey Heath 012B","E01030783","Total",1614,777,837,1614,0,22,241.31,6.7
"2011","Surrey Heath 012C","E01030784","Total",2477,1296,1181,2190,287,60,588.16,4.2
"2011","Surrey Heath 012D","E01030785","Total",1435,735,700,1429,6,21,103.58,13.9
"2011","Tandridge 002A","E01030855","Total",1831,922,909,1825,6,61,114.58,16.0
"2011","Tandridge 002B","E01030856","Total",1486,706,780,1486,0,24,170.93,8.7
"2011","Tandridge 002C","E01030859","Total",1881,961,920,1879,2,14,159.55,11.8
"2011","Tandridge 002D","E01030860","Total",2019,998,1021,2019,0,18,57.05,35.4
"2011","Tandridge 003A","E01030844","Total",1816,894,922,1805,11,26,42.22,43.0
"2011","Tandridge 003B","E01030845","Total",1272,606,666,1272,0,14,18.41,69.1
"2011","Tandridge 003C","E01030846","Total",1536,745,791,1459,77,49,66.22,23.2
"2011","Tandridge 003D","E01030857","Total",2199,1035,1164,2156,43,23,43.08,51.0
"2011","Tandridge 003E","E01030858","Total",2153,1047,1106,2101,52,20,40.84,52.7
"2011","Tandridge 004A","E01030828","Total",1372,727,645,1215,157,40,338.51,4.1
"2011","Tandridge 004B","E01030829","Total",1447,707,740,1379,68,27,51.22,28.3
"2011","Tandridge 004C","E01030830","Total",1327,661,666,1327,0,18,72.22,18.4
"2011","Tandridge 004D","E01030850","Total",2149,1010,1139,2149,0,20,64.14,33.5
"2011","Tandridge 004E","E01030851","Total",2053,998,1055,2044,9,36,62.16,33.0
"2011","Tandridge 004F","E01030861","Total",2141,901,1240,1864,277,74,1087.30,2.0
"2011","Tandridge 005A","E01030820","Total",1735,845,890,1675,60,43,472.40,3.7
"2011","Tandridge 005B","E01030847","Total",1628,753,875,1516,112,53,93.77,17.4
"2011","Tandridge 005C","E01030848","Total",2138,1060,1078,2128,10,28,47.65,44.9
"2011","Tandridge 006A","E01030831","Total",2246,1100,1146,2202,44,86,528.33,4.3
"2011","Tandridge 006B","E01030832","Total",1323,636,687,1302,21,67,1325.70,1.0
"2011","Tandridge 006C","E01030836","Total",1594,755,839,1594,0,34,52.93,30.1
"2011","Tandridge 006D","E01030837","Total",1542,697,845,1435,107,31,431.66,3.6
"2011","Tandridge 006E","E01030838","Total",1267,625,642,1258,9,28,1163.29,1.1
"2011","Tandridge 006F","E01030839","Total",1445,702,743,1435,10,48,123.29,11.7
"2011","Tandridge 007A","E01030840","Total",1499,726,773,1473,26,13,30.72,48.8
"2011","Tandridge 007B","E01030841","Total",1264,616,648,1264,0,46,82.14,15.4
"2011","Tandridge 007C","E01030842","Total",1821,876,945,1801,20,19,71.00,25.6
"2011","Tandridge 007D","E01030843","Total",1545,763,782,1468,77,32,657.45,2.3
"2011","Tandridge 008A","E01030812","Total",1529,717,812,1510,19,32,1458.66,1.0
"2011","Tandridge 008B","E01030813","Total",1532,763,769,1507,25,17,575.69,2.7
"2011","Tandridge 008C","E01030814","Total",1304,630,674,1209,95,27,793.87,1.6
"2011","Tandridge 008D","E01030815","Total",1444,697,747,1438,6,34,885.52,1.6
"2011","Tandridge 009A","E01030824","Total",1503,692,811,1456,47,12,69.17,21.7
"2011","Tandridge 009B","E01030825","Total",1396,660,736,1369,27,17,579.00,2.4
"2011","Tandridge 009C","E01030826","Total",1461,702,759,1461,0,17,70.66,20.7
"2011","Tandridge 009D","E01030827","Total",1589,780,809,1546,43,30,1087.62,1.5
"2011","Tandridge 010A","E01030821","Total",2230,1104,1126,1896,334,39,1159.65,1.9
"2011","Tandridge 010B","E01030822","Total",1836,913,923,1753,83,53,1917.75,1.0
"2011","Tandridge 010C","E01030833","Total",1327,588,739,1271,56,18,241.00,5.5
"2011","Tandridge 010D","E01030834","Total",1393,683,710,1393,0,12,1155.92,1.2
"2011","Tandridge 010E","E01030835","Total",1481,707,774,1478,3,30,88.03,16.8
"2011","Tandridge 011A","E01030816","Total",1561,779,782,1561,0,22,1628.63,1.0
"2011","Tandridge 011B","E01030817","Total",1405,701,704,1405,0,34,788.91,1.8
"2011","Tandridge 011C","E01030818","Total",1250,616,634,1250,0,10,27.95,44.7
"2011","Tandridge 011D","E01030819","Total",1485,760,725,1420,65,15,830.88,1.8
"2011","Tandridge 011E","E01030823","Total",2096,1017,1079,2075,21,51,848.51,2.5
"2011","Tandridge 012A","E01030852","Total",1974,934,1040,1914,60,12,1564.25,1.3
"2011","Tandridge 012B","E01030853","Total",1690,801,889,1690,0,25,78.74,21.5
"2011","Tandridge 012C","E01030854","Total",1920,910,1010,1920,0,44,163.57,11.7
"2011","Tandridge 012D","E01032571","Total",1863,932,931,1863,0,47,1336.24,1.4
"2011","Waverley 001A","E01030890","Total",1556,731,825,1556,0,17,59.15,26.3
"2011","Waverley 001B","E01030902","Total",1319,656,663,1319,0,16,136.54,9.7
"2011","Waverley 001C","E01030903","Total",1582,794,788,1582,0,15,186.67,8.5
"2011","Waverley 001D","E01030904","Total",1394,692,702,1394,0,14,56.70,24.6
"2011","Waverley 002A","E01030891","Total",1575,778,797,1575,0,33,41.34,38.1
"2011","Waverley 002B","E01030892","Total",1307,649,658,1307,0,11,32.54,40.2
"2011","Waverley 002C","E01030899","Total",1606,810,796,1606,0,38,109.30,14.7
"2011","Waverley 002D","E01030900","Total",1222,603,619,1222,0,23,229.05,5.3
"2011","Waverley 002E","E01030901","Total",1416,697,719,1416,0,17,19.86,71.3
"2011","Waverley 003A","E01030884","Total",1473,708,765,1473,0,16,53.15,27.7
"2011","Waverley 003B","E01030885","Total",1479,620,859,1112,367,26,164.56,9.0
"2011","Waverley 003C","E01030886","Total",1253,615,638,1251,2,40,595.13,2.1
"2011","Waverley 003D","E01030893","Total",1883,895,988,1859,24,40,82.08,22.9
"2011","Waverley 003E","E01030895","Total",1529,728,801,1466,63,26,43.16,35.4
"2011","Waverley 004A","E01030881","Total",1430,716,714,1409,21,53,308.82,4.6
"2011","Waverley 004B","E01030883","Total",1377,666,711,1336,41,45,228.47,6.0
"2011","Waverley 004C","E01030888","Total",1516,742,774,1509,7,36,55.70,27.2
"2011","Waverley 004D","E01030894","Total",1604,789,815,1565,39,64,472.36,3.4
"2011","Waverley 005A","E01030911","Total",1539,746,793,1539,0,17,43.14,35.7
"2011","Waverley 005B","E01030912","Total",1305,604,701,1305,0,19,47.34,27.6
"2011","Waverley 005C","E01030913","Total",1243,613,630,1243,0,6,24.65,50.4
"2011","Waverley 005D","E01030920","Total",1506,738,768,1445,61,10,63.50,23.7
"2011","Waverley 005E","E01030921","Total",1678,776,902,1678,0,15,61.46,27.3
"2011","Waverley 006A","E01030882","Total",1360,686,674,1360,0,46,76.62,17.7
"2011","Waverley 006B","E01030887","Total",1373,665,708,1353,20,36,43.58,31.5
"2011","Waverley 006C","E01030889","Total",1495,713,782,1464,31,16,45.63,32.8
"2011","Waverley 006D","E01030896","Total",1169,582,587,1162,7,18,24.91,46.9
"2011","Waverley 006E","E01030897","Total",1340,666,674,1340,0,32,46.25,29.0
"2011","Waverley 007A","E01030916","Total",1712,870,842,1663,49,26,77.37,22.1
"2011","Waverley 007B","E01030917","Total",1090,599,491,1090,0,13,87.28,12.5
"2011","Waverley 007C","E01030918","Total",1116,521,595,1067,49,24,38.33,29.1
"2011","Waverley 007D","E01030919","Total",1899,1186,713,1261,638,98,98.23,19.3
"2011","Waverley 007E","E01030922","Total",1416,694,722,1416,0,25,53.08,26.7
"2011","Waverley 008A","E01030863","Total",1914,897,1017,1870,44,68,655.19,2.9
"2011","Waverley 008B","E01030865","Total",1538,675,863,1378,160,47,635.38,2.4
"2011","Waverley 008C","E01030866","Total",1558,729,829,1558,0,50,124.73,12.5
"2011","Waverley 008D","E01030940","Total",1761,854,907,1755,6,65,1685.11,1.0
"2011","Waverley 009A","E01030898","Total",1614,828,786,1614,0,57,71.90,22.4
"2011","Waverley 009B","E01030905","Total",1536,752,784,1496,40,17,136.41,11.3
"2011","Waverley 009C","E01030906","Total",1707,846,861,1707,0,31,128.55,13.3
"2011","Waverley 009D","E01030907","Total",1373,709,664,1177,196,42,204.14,6.7
"2011","Waverley 010A","E01030914","Total",1354,661,693,1270,84,14,90.18,15.0
"2011","Waverley 010B","E01030915","Total",1626,806,820,1626,0,22,84.21,19.3
"2011","Waverley 010C","E01030923","Total",1460,736,724,1460,0,65,62.35,23.4
"2011","Waverley 010D","E01030924","Total",1246,622,624,1237,9,54,47.88,26.0
"2011","Waverley 010E","E01030925","Total",1614,746,868,1553,61,69,89.50,18.0
"2011","Waverley 011A","E01030877","Total",1173,570,603,1155,18,23,834.05,1.4
"2011","Waverley 011B","E01030878","Total",1569,777,792,1569,0,52,802.81,2.0
"2011","Waverley 011C","E01030937","Total",1645,804,841,1645,0,17,509.62,3.2
"2011","Waverley 011D","E01030938","Total",1324,596,728,1324,0,28,207.31,6.4
"2011","Waverley 011E","E01030939","Total",1187,581,606,1187,0,22,135.92,8.7
"2011","Waverley 012A","E01030864","Total",1549,777,772,1392,157,83,2643.85,0.6
"2011","Waverley 012B","E01030879","Total",1124,551,573,1124,0,49,3129.89,0.4
"2011","Waverley 012C","E01030941","Total",1577,756,821,1273,304,62,502.63,3.1
"2011","Waverley 012D","E01030942","Total",1419,702,717,1389,30,79,1340.05,1.1
"2011","Waverley 012E","E01030943","Total",1310,638,672,1310,0,10,46.08,28.4
"2011","Waverley 013A","E01030870","Total",1613,782,831,1603,10,50,145.79,11.1
"2011","Waverley 013B","E01030871","Total",1641,822,819,1639,2,25,269.81,6.1
"2011","Waverley 013C","E01030872","Total",1783,871,912,1757,26,16,48.91,36.5
"2011","Waverley 013D","E01030873","Total",1431,701,730,1431,0,42,43.67,32.8
"2011","Waverley 013E","E01030874","Total",1688,889,799,1239,449,73,334.37,5.0
"2011","Waverley 013F","E01030875","Total",1301,638,663,1259,42,22,282.94,4.6
"2011","Waverley 013G","E01030876","Total",1235,608,627,1235,0,31,643.83,1.9
"2011","Waverley 015A","E01030862","Total",1848,859,989,1793,55,38,3139.21,0.6
"2011","Waverley 015B","E01030867","Total",1384,661,723,1367,17,56,2712.53,0.5
"2011","Waverley 015C","E01030868","Total",1324,667,657,1324,0,43,226.09,5.9
"2011","Waverley 015D","E01030869","Total",1241,617,624,1174,67,47,1485.47,0.8
"2011","Waverley 015E","E01030880","Total",2228,997,1231,1898,330,51,1636.57,1.4
"2011","Waverley 016A","E01030930","Total",1622,776,846,1596,26,62,387.34,4.2
"2011","Waverley 016B","E01030931","Total",1685,785,900,1682,3,38,135.30,12.5
"2011","Waverley 016C","E01030932","Total",1493,718,775,1493,0,58,335.57,4.4
"2011","Waverley 016D","E01030933","Total",1753,841,912,1750,3,44,136.10,12.9
"2011","Waverley 017A","E01030926","Total",1535,713,822,1437,98,36,66.02,23.3
"2011","Waverley 017B","E01030927","Total",1297,638,659,1297,0,24,42.68,30.4
"2011","Waverley 017C","E01030928","Total",1735,818,917,1674,61,27,63.15,27.5
"2011","Waverley 017D","E01030929","Total",1414,649,765,1226,188,46,477.95,3.0
"2011","Waverley 018A","E01030908","Total",1685,853,832,1570,115,69,2014.72,0.8
"2011","Waverley 018B","E01030909","Total",1202,583,619,1202,0,44,865.03,1.4
"2011","Waverley 018C","E01030910","Total",1202,578,624,1187,15,51,467.83,2.6
"2011","Waverley 018D","E01030934","Total",1543,750,793,1330,213,27,234.04,6.6
"2011","Waverley 018E","E01030935","Total",1324,658,666,1292,32,37,231.75,5.7
"2011","Waverley 018F","E01032626","Total",1425,693,732,1352,73,35,216.57,6.6
"2011","Woking 001A","E01030946","Total",1337,651,686,1337,0,3,72.98,18.3
"2011","Woking 001B","E01030947","Total",1480,734,746,1471,9,16,65.65,22.5
"2011","Woking 001C","E01030948","Total",1577,749,828,1575,2,15,30.30,52.0
"2011","Woking 001D","E01030949","Total",1732,850,882,1681,51,19,61.37,28.2
"2011","Woking 001E","E01030950","Total",1598,753,845,1598,0,15,55.01,29.0
"2011","Woking 002A","E01030996","Total",1600,769,831,1557,43,49,94.41,16.9
"2011","Woking 002B","E01030998","Total",1898,923,975,1876,22,51,89.36,21.2
"2011","Woking 002C","E01031002","Total",1755,839,916,1715,40,70,107.63,16.3
"2011","Woking 002D","E01031003","Total",1791,886,905,1791,0,81,183.55,9.8
"2011","Woking 002E","E01031004","Total",2080,982,1098,2080,0,23,59.93,34.7
"2011","Woking 003A","E01030963","Total",1550,730,820,1472,78,56,109.67,14.1
"2011","Woking 003B","E01030964","Total",1772,902,870,1759,13,57,167.76,10.6
"2011","Woking 003C","E01030965","Total",1467,725,742,1448,19,33,386.50,3.8
"2011","Woking 003D","E01030966","Total",1481,740,741,1463,18,22,37.64,39.3
"2011","Woking 003E","E01030967","Total",1641,783,858,1587,54,35,302.05,5.4
"2011","Woking 003F","E01030968","Total",1293,626,667,1280,13,27,44.47,29.1
"2011","Woking 004A","E01030980","Total",1706,903,803,1706,0,10,16.42,103.9
"2011","Woking 004B","E01030981","Total",1647,851,796,1647,0,21,22.69,72.6
"2011","Woking 004C","E01030982","Total",1836,1000,836,1836,0,19,31.43,58.4
"2011","Woking 004D","E01030983","Total",1782,944,838,1771,11,10,19.97,89.2
"2011","Woking 004E","E01030984","Total",2038,991,1047,2038,0,24,49.93,40.8
"2011","Woking 004F","E01030985","Total",1565,782,783,1565,0,14,30.86,50.7
"2011","Woking 005A","E01030951","Total",1320,640,680,1320,0,12,41.26,32.0
"2011","Woking 005B","E01030952","Total",1561,782,779,1561,0,9,13.94,112.0
"2011","Woking 005C","E01030953","Total",1472,705,767,1472,0,16,31.79,46.3
"2011","Woking 005D","E01030956","Total",1331,677,654,1327,4,20,25.09,53.0
"2011","Woking 005E","E01030957","Total",1319,638,681,1319,0,11,15.23,86.6
"2011","Woking 005F","E01030958","Total",1459,693,766,1459,0,18,21.46,68.0
"2011","Woking 005G","E01030959","Total",1026,465,561,1026,0,12,17.32,59.2
"2011","Woking 006A","E01030988","Total",2004,1035,969,1904,100,44,58.86,34.0
"2011","Woking 006B","E01030989","Total",1721,840,881,1652,69,35,55.62,30.9
"2011","Woking 006C","E01030990","Total",1486,732,754,1486,0,68,221.75,6.7
"2011","Woking 006D","E01030997","Total",1524,737,787,1524,0,21,430.85,3.5
"2011","Woking 007A","E01030974","Total",1556,792,764,1556,0,11,26.91,57.8
"2011","Woking 007B","E01030975","Total",1415,695,720,1415,0,22,229.06,6.2
"2011","Woking 007C","E01030976","Total",1538,743,795,1538,0,18,23.84,64.5
"2011","Woking 007D","E01030977","Total",1780,908,872,1749,31,27,51.60,34.5
"2011","Woking 007E","E01030979","Total",2163,1058,1105,2154,9,34,48.15,44.9
"2011","Woking 008A","E01030954","Total",2223,1157,1066,2218,5,19,64.29,34.6
"2011","Woking 008B","E01030969","Total",1457,746,711,1451,6,43,36.31,40.1
"2011","Woking 008C","E01030970","Total",1476,732,744,1474,2,30,26.51,55.7
"2011","Woking 008D","E01030991","Total",1927,953,974,1904,23,14,33.56,57.4
"2011","Woking 008E","E01030993","Total",2451,1277,1174,2398,53,14,28.44,86.2
"2011","Woking 009A","E01030960","Total",1721,847,874,1721,0,24,37.50,45.9
"2011","Woking 009B","E01030961","Total",1927,969,958,1927,0,30,49.48,38.9
"2011","Woking 009C","E01030962","Total",1682,807,875,1682,0,22,27.50,61.2
"2011","Woking 009D","E01031000","Total",1536,761,775,1517,19,22,174.67,8.8
"2011","Woking 010A","E01030955","Total",1394,675,719,1394,0,25,27.95,49.9
"2011","Woking 010B","E01030992","Total",1674,813,861,1661,13,38,48.44,34.6
"2011","Woking 010C","E01030999","Total",1433,680,753,1372,61,67,113.43,12.6
"2011","Woking 010D","E01031001","Total",1687,820,867,1664,23,32,58.33,28.9
"2011","Woking 011A","E01030971","Total",1930,949,981,1930,0,15,68.19,28.3
"2011","Woking 011B","E01030972","Total",1876,925,951,1803,73,27,70.23,26.7
"2011","Woking 011C","E01030973","Total",1770,920,850,1767,3,24,108.05,16.4
"2011","Woking 011D","E01030994","Total",1806,901,905,1805,1,17,202.39,8.9
"2011","Woking 011E","E01030995","Total",1386,714,672,1386,0,17,21.70,63.9
"2011","Woking 012A","E01030944","Total",1397,711,686,1378,19,46,609.05,2.3
"2011","Woking 012B","E01030945","Total",1168,566,602,1168,0,23,130.22,9.0
"2011","Woking 012C","E01030978","Total",1506,747,759,1477,29,30,49.45,30.5
"2011","Woking 012D","E01030986","Total",1074,531,543,1074,0,34,143.72,7.5
"2011","Woking 012E","E01030987","Total",1396,690,706,1396,0,40,877.85,1.6
"2011","Adur 001A","E01031349","Total",1340,649,691,1340,0,11,39.01,34.4
"2011","Adur 001B","E01031350","Total",1209,582,627,1201,8,12,31.60,38.3
"2011","Adur 001C","E01031351","Total",1557,759,798,1557,0,13,503.36,3.1
"2011","Adur 001D","E01031352","Total",1455,705,750,1455,0,9,28.94,50.3
"2011","Adur 001E","E01031370","Total",1451,699,752,1451,0,7,22.98,63.1
"2011","Adur 001F","E01031374","Total",1512,746,766,1493,19,10,27.11,55.8
"2011","Adur 002A","E01031338","Total",1165,565,600,1165,0,22,29.04,40.1
"2011","Adur 002B","E01031339","Total",1175,574,601,1175,0,15,23.72,49.5
"2011","Adur 002C","E01031340","Total",1473,731,742,1473,0,19,463.84,3.2
"2011","Adur 002D","E01031365","Total",1539,715,824,1473,66,21,34.09,45.1
"2011","Adur 002E","E01031367","Total",1282,633,649,1282,0,21,33.83,37.9
"2011","Adur 003A","E01031345","Total",1472,723,749,1472,0,6,205.31,7.2
"2011","Adur 003B","E01031353","Total",1367,718,649,1097,270,55,773.21,1.8
"2011","Adur 003C","E01031354","Total",1231,610,621,1231,0,5,29.72,41.4
"2011","Adur 003D","E01031355","Total",1649,801,848,1635,14,12,31.22,52.8
"2011","Adur 003E","E01031359","Total",1381,687,694,1381,0,12,19.95,69.2
"2011","Adur 004A","E01031347","Total",1624,782,842,1624,0,11,59.36,27.4
"2011","Adur 004B","E01031348","Total",1643,799,844,1643,0,10,50.63,32.5
"2011","Adur 004C","E01031366","Total",1406,671,735,1311,95,11,52.32,26.9
"2011","Adur 004D","E01031371","Total",1260,581,679,1260,0,9,16.86,74.7
"2011","Adur 004E","E01031372","Total",1270,610,660,1270,0,8,24.02,52.9
"2011","Adur 004F","E01031373","Total",1468,690,778,1441,27,8,36.24,40.5
"2011","Adur 004G","E01031375","Total",1456,676,780,1439,17,19,55.92,26.0
"2011","Adur 005A","E01031356","Total",2283,1144,1139,2283,0,28,62.15,36.7
"2011","Adur 005B","E01031357","Total",2241,1132,1109,2237,4,30,54.97,40.8
"2011","Adur 005C","E01031364","Total",1455,700,755,1454,1,9,29.07,50.1
"2011","Adur 005D","E01031368","Total",1245,595,650,1225,20,10,30.05,41.4
"2011","Adur 005E","E01031369","Total",1302,565,737,1265,37,15,22.98,56.7
"2011","Adur 006A","E01031344","Total",1345,692,653,1345,0,15,30.67,43.9
"2011","Adur 006B","E01031346","Total",1381,668,713,1367,14,7,29.14,47.4
"2011","Adur 006C","E01031361","Total",1515,738,777,1515,0,9,37.75,40.1
"2011","Adur 006D","E01031362","Total",1277,631,646,1240,37,10,625.39,2.0
"2011","Adur 006E","E01031363","Total",1571,730,841,1571,0,10,106.72,14.7
"2011","Adur 007A","E01031358","Total",1522,705,817,1522,0,5,198.93,7.7
"2011","Adur 007B","E01031360","Total",1534,738,796,1534,0,18,45.17,34.0
"2011","Adur 007C","E01031376","Total",1248,609,639,1237,11,6,68.92,18.1
"2011","Adur 007D","E01031378","Total",1361,676,685,1361,0,3,78.48,17.3
"2011","Adur 008A","E01031341","Total",1351,623,728,1351,0,8,31.77,42.5
"2011","Adur 008B","E01031342","Total",1665,771,894,1614,51,5,53.15,31.3
"2011","Adur 008C","E01031343","Total",1395,649,746,1395,0,12,23.18,60.2
"2011","Adur 008D","E01031377","Total",1533,723,810,1492,41,12,28.29,54.2
"2011","Adur 008E","E01031379","Total",1573,718,855,1547,26,8,31.65,49.7
"2011","Arun 001A","E01031390","Total",1350,662,688,1348,2,12,885.25,1.5
"2011","Arun 001B","E01031391","Total",1475,693,782,1475,0,16,135.42,10.9
"2011","Arun 001C","E01031392","Total",1473,709,764,1418,55,31,3648.59,0.4
"2011","Arun 001D","E01031465","Total",1443,708,735,1367,76,30,2613.99,0.6
"2011","Arun 002A","E01031386","Total",1468,710,758,1464,4,14,1517.42,1.0
"2011","Arun 002B","E01031387","Total",1521,709,812,1521,0,25,68.40,22.2
"2011","Arun 002C","E01031425","Total",1363,629,734,1363,0,21,201.66,6.8
"2011","Arun 002D","E01031426","Total",1194,585,609,1180,14,18,2773.99,0.4
"2011","Arun 003A","E01031393","Total",1759,821,938,1703,56,34,523.87,3.4
"2011","Arun 003B","E01031394","Total",1656,824,832,1652,4,17,27.79,59.6
"2011","Arun 003C","E01031395","Total",1534,751,783,1525,9,16,447.18,3.4
"2011","Arun 003D","E01031396","Total",1919,910,1009,1904,15,34,462.00,4.2
"2011","Arun 003E","E01031397","Total",1759,858,901,1656,103,45,535.67,3.3
"2011","Arun 003F","E01031466","Total",1446,705,741,1409,37,15,482.25,3.0
"2011","Arun 004A","E01031427","Total",1363,639,724,1363,0,10,53.10,25.7
"2011","Arun 004B","E01031429","Total",1451,690,761,1451,0,17,23.27,62.4
"2011","Arun 004C","E01031430","Total",1431,698,733,1431,0,6,19.80,72.3
"2011","Arun 004D","E01031467","Total",1717,841,876,1698,19,14,238.31,7.2
"2011","Arun 004E","E01031468","Total",2297,1124,1173,2297,0,13,161.75,14.2
"2011","Arun 005A","E01031388","Total",2645,1275,1370,2644,1,26,348.48,7.6
"2011","Arun 005B","E01031389","Total",2154,1019,1135,2147,7,17,167.69,12.8
"2011","Arun 005C","E01031414","Total",1508,733,775,1508,0,10,29.68,50.8
"2011","Arun 005D","E01031415","Total",1535,710,825,1496,39,9,50.32,30.5
"2011","Arun 005E","E01031459","Total",1789,807,982,1731,58,10,35.28,50.7
"2011","Arun 006A","E01031470","Total",1883,1080,803,1483,400,17,985.68,1.9
"2011","Arun 006B","E01031471","Total",1285,646,639,1285,0,18,83.40,15.4
"2011","Arun 006C","E01031472","Total",1527,718,809,1499,28,22,569.93,2.7
"2011","Arun 006D","E01031473","Total",1231,589,642,1195,36,10,20.45,60.2
"2011","Arun 007A","E01031407","Total",1572,743,829,1572,0,18,36.86,42.6
"2011","Arun 007B","E01031408","Total",1935,915,1020,1935,0,9,45.03,43.0
"2011","Arun 007C","E01031410","Total",1266,587,679,1266,0,21,20.67,61.2
"2011","Arun 007D","E01031462","Total",1470,674,796,1470,0,7,27.69,53.1
"2011","Arun 007E","E01031463","Total",1624,736,888,1567,57,21,43.97,36.9
"2011","Arun 007F","E01031464","Total",1585,691,894,1584,1,10,34.53,45.9
"2011","Arun 008A","E01031412","Total",1390,662,728,1390,0,23,196.20,7.1
"2011","Arun 008B","E01031422","Total",1502,677,825,1461,41,12,86.23,17.4
"2011","Arun 008C","E01031423","Total",1624,758,866,1624,0,21,229.04,7.1
"2011","Arun 008D","E01031424","Total",1354,606,748,1323,31,16,66.31,20.4
"2011","Arun 009A","E01031398","Total",1490,725,765,1451,39,21,29.07,51.3
"2011","Arun 009B","E01031399","Total",1668,785,883,1668,0,10,50.44,33.1
"2011","Arun 009C","E01031409","Total",1398,691,707,1398,0,6,45.30,30.9
"2011","Arun 009D","E01031455","Total",1421,653,768,1373,48,20,33.34,42.6
"2011","Arun 009E","E01031461","Total",1760,817,943,1760,0,16,37.38,47.1
"2011","Arun 009F","E01031469","Total",1677,810,867,1677,0,12,34.50,48.6
"2011","Arun 010A","E01031411","Total",1380,623,757,1330,50,11,79.99,17.3
"2011","Arun 010B","E01031413","Total",1336,588,748,1218,118,20,43.70,30.6
"2011","Arun 010C","E01031457","Total",1585,723,862,1581,4,18,45.07,35.2
"2011","Arun 010D","E01031458","Total",1785,812,973,1769,16,26,72.79,24.5
"2011","Arun 010E","E01031460","Total",1699,778,921,1661,38,7,47.31,35.9
"2011","Arun 011A","E01031400","Total",1623,806,817,1531,92,7,30.94,52.5
"2011","Arun 011B","E01031428","Total",1550,791,759,1541,9,3,15.16,102.2
"2011","Arun 011C","E01031454","Total",2155,1095,1060,2036,119,16,148.03,14.6
"2011","Arun 011D","E01031456","Total",1781,893,888,1670,111,12,21.38,83.3
"2011","Arun 012A","E01031401","Total",1558,725,833,1533,25,14,229.63,6.8
"2011","Arun 012B","E01031402","Total",1617,787,830,1617,0,15,394.52,4.1
"2011","Arun 012C","E01031403","Total",1413,674,739,1413,0,8,24.98,56.6
"2011","Arun 012D","E01031405","Total",1377,663,714,1377,0,5,26.04,52.9
"2011","Arun 012E","E01031406","Total",1333,661,672,1333,0,6,19.35,68.9
"2011","Arun 013A","E01031417","Total",1603,771,832,1603,0,18,208.12,7.7
"2011","Arun 013B","E01031438","Total",1620,767,853,1607,13,17,56.21,28.8
"2011","Arun 013C","E01031439","Total",1914,874,1040,1914,0,30,172.82,11.1
"2011","Arun 013D","E01031440","Total",1543,729,814,1533,10,16,125.16,12.3
"2011","Arun 014A","E01031404","Total",1198,572,626,1198,0,4,18.18,65.9
"2011","Arun 014B","E01031433","Total",1440,685,755,1440,0,11,27.90,51.6
"2011","Arun 014C","E01031434","Total",1609,766,843,1534,75,13,25.75,62.5
"2011","Arun 014D","E01031441","Total",1640,777,863,1628,12,16,45.90,35.7
"2011","Arun 014E","E01031442","Total",1589,784,805,1562,27,8,27.03,58.8
"2011","Arun 015A","E01031416","Total",1582,763,819,1573,9,23,59.83,26.4
"2011","Arun 015B","E01031418","Total",1683,797,886,1683,0,19,52.28,32.2
"2011","Arun 015C","E01031419","Total",1631,727,904,1588,43,19,53.66,30.4
"2011","Arun 015D","E01031420","Total",1628,760,868,1611,17,28,48.87,33.3
"2011","Arun 015E","E01031421","Total",1725,814,911,1699,26,15,138.07,12.5
"2011","Arun 016A","E01031443","Total",1348,645,703,1348,0,8,25.06,53.8
"2011","Arun 016B","E01031444","Total",1590,785,805,1577,13,17,22.54,70.5
"2011","Arun 016C","E01031450","Total",1252,604,648,1246,6,11,15.55,80.5
"2011","Arun 016D","E01031451","Total",1467,727,740,1443,24,5,43.44,33.8
"2011","Arun 016E","E01031452","Total",1491,698,793,1403,88,14,30.65,48.6
"2011","Arun 017A","E01031431","Total",1615,763,852,804,811,13,53.19,30.4
"2011","Arun 017B","E01031432","Total",1892,929,963,1796,96,5,32.41,58.4
"2011","Arun 017C","E01031435","Total",1687,803,884,1487,200,16,27.93,60.4
"2011","Arun 017D","E01031436","Total",1803,889,914,1770,33,4,20.11,89.7
"2011","Arun 017E","E01031437","Total",1980,981,999,1745,235,7,23.30,85.0
"2011","Arun 017F","E01031453","Total",1661,806,855,1500,161,13,19.82,83.8
"2011","Arun 018A","E01031380","Total",1554,733,821,1541,13,25,68.50,22.7
"2011","Arun 018B","E01031381","Total",1601,759,842,1549,52,15,49.47,32.4
"2011","Arun 018C","E01031382","Total",1688,788,900,1688,0,15,56.93,29.7
"2011","Arun 018D","E01031383","Total",1571,725,846,1543,28,21,71.39,22.0
"2011","Arun 018E","E01031384","Total",1710,791,919,1710,0,21,53.88,31.7
"2011","Arun 019A","E01031385","Total",1561,701,860,1561,0,4,36.89,42.3
"2011","Arun 019B","E01031445","Total",1549,750,799,1529,20,10,783.50,2.0
"2011","Arun 019C","E01031446","Total",1330,629,701,1330,0,8,27.53,48.3
"2011","Arun 019D","E01031447","Total",1528,714,814,1528,0,12,69.61,22.0
"2011","Arun 019E","E01031448","Total",1534,732,802,1534,0,7,107.45,14.3
"2011","Arun 019F","E01031449","Total",1597,773,824,1597,0,15,45.82,34.9
"2011","Chichester 001A","E01031502","Total",1576,795,781,1576,0,63,508.99,3.1
"2011","Chichester 001B","E01031503","Total",1674,845,829,1453,221,64,977.86,1.7
"2011","Chichester 001C","E01031504","Total",2084,984,1100,2081,3,43,1753.04,1.2
"2011","Chichester 001D","E01031519","Total",1406,709,697,1370,36,40,3459.15,0.4
"2011","Chichester 002A","E01031517","Total",1827,900,927,1827,0,66,1866.94,1.0
"2011","Chichester 002B","E01031518","Total",1551,764,787,1551,0,62,2059.15,0.8
"2011","Chichester 002C","E01031544","Total",1279,622,657,1279,0,46,2816.06,0.5
"2011","Chichester 002D","E01031545","Total",1198,581,617,1198,0,27,949.11,1.3
"2011","Chichester 003A","E01031508","Total",2026,994,1032,2008,18,94,5572.81,0.4
"2011","Chichester 003B","E01031520","Total",1322,636,686,1275,47,56,2028.38,0.7
"2011","Chichester 003C","E01031521","Total",1125,569,556,1120,5,52,2665.52,0.4
"2011","Chichester 003D","E01031536","Total",1148,564,584,1146,2,59,2602.43,0.4
"2011","Chichester 004A","E01031497","Total",1358,673,685,1320,38,37,661.78,2.1
"2011","Chichester 004C","E01031511","Total",1460,644,816,1460,0,22,81.85,17.8
"2011","Chichester 004D","E01031512","Total",1874,887,987,1874,0,18,56.72,33.0
"2011","Chichester 004F","E01032717","Total",2546,1169,1377,2491,55,49,2394.17,1.1
"2011","Chichester 005A","E01031478","Total",1134,547,587,1036,98,62,2778.47,0.4
"2011","Chichester 005B","E01031479","Total",1067,497,570,992,75,43,3096.09,0.3
"2011","Chichester 005C","E01031498","Total",1134,539,595,1132,2,51,2379.57,0.5
"2011","Chichester 005D","E01031514","Total",1696,783,913,1596,100,34,3967.45,0.4
"2011","Chichester 005E","E01031515","Total",1593,755,838,1593,0,18,296.00,5.4
"2011","Chichester 005F","E01031516","Total",1453,697,756,1450,3,52,2595.41,0.6
"2011","Chichester 006A","E01031477","Total",2235,1051,1184,2166,69,56,8249.39,0.3
"2011","Chichester 006B","E01031485","Total",1511,731,780,1511,0,45,71.52,21.1
"2011","Chichester 006C","E01031487","Total",1528,721,807,1528,0,29,66.15,23.1
"2011","Chichester 006D","E01031509","Total",2365,1102,1263,2294,71,41,2540.33,0.9
"2011","Chichester 007A","E01031506","Total",1268,616,652,1268,0,36,1280.60,1.0
"2011","Chichester 007B","E01031507","Total",1403,696,707,1379,24,47,6032.16,0.2
"2011","Chichester 007C","E01031531","Total",1316,639,677,1298,18,21,101.78,12.9
"2011","Chichester 007D","E01031533","Total",1150,516,634,1150,0,14,82.33,14.0
"2011","Chichester 007E","E01031543","Total",2309,1112,1197,2309,0,36,747.00,3.1
"2011","Chichester 008A","E01031482","Total",1497,713,784,1497,0,17,42.18,35.5
"2011","Chichester 008B","E01031483","Total",2354,1119,1235,2349,5,14,47.43,49.6
"2011","Chichester 008C","E01031486","Total",1792,773,1019,1469,323,30,63.02,28.4
"2011","Chichester 008D","E01031488","Total",1894,906,988,1853,41,18,117.88,16.1
"2011","Chichester 008E","E01031494","Total",1591,748,843,1591,0,11,35.06,45.4
"2011","Chichester 008F","E01031495","Total",1577,730,847,1577,0,20,27.21,58.0
"2011","Chichester 009A","E01031475","Total",1356,666,690,1234,122,35,638.70,2.1
"2011","Chichester 009B","E01031476","Total",1480,709,771,1471,9,52,810.16,1.8
"2011","Chichester 009C","E01031532","Total",1642,969,673,1241,401,25,751.28,2.2
"2011","Chichester 009D","E01031534","Total",1718,800,918,1704,14,21,143.33,12.0
"2011","Chichester 009E","E01031535","Total",1622,775,847,1553,69,27,280.91,5.8
"2011","Chichester 010A","E01031480","Total",1337,640,697,1337,0,6,23.99,55.7
"2011","Chichester 010B","E01031481","Total",1511,730,781,1494,17,13,30.30,49.9
"2011","Chichester 010C","E01031484","Total",1781,857,924,1780,1,23,27.54,64.7
"2011","Chichester 010D","E01031490","Total",1909,852,1057,1630,279,40,122.97,15.5
"2011","Chichester 010E","E01031491","Total",1836,884,952,1824,12,32,31.62,58.1
"2011","Chichester 011A","E01031474","Total",1420,689,731,1420,0,30,290.22,4.9
"2011","Chichester 011B","E01031493","Total",1679,784,895,1646,33,32,239.52,7.0
"2011","Chichester 011C","E01031496","Total",2228,1051,1177,2193,35,45,824.70,2.7
"2011","Chichester 011D","E01031505","Total",2325,1115,1210,2260,65,53,360.96,6.4
"2011","Chichester 012A","E01031489","Total",1534,726,808,1490,44,19,65.59,23.4
"2011","Chichester 012B","E01031492","Total",1464,697,767,1464,0,9,54.61,26.8
"2011","Chichester 012C","E01031513","Total",2252,1107,1145,2160,92,54,2418.06,0.9
"2011","Chichester 012D","E01031530","Total",1257,616,641,1245,12,14,462.08,2.7
"2011","Chichester 012E","E01031538","Total",1553,715,838,1553,0,18,173.63,8.9
"2011","Chichester 012F","E01031539","Total",1072,504,568,1072,0,13,293.51,3.7
"2011","Chichester 013A","E01031499","Total",1831,877,954,1800,31,23,50.32,36.4
"2011","Chichester 013B","E01031500","Total",1887,890,997,1760,127,31,899.56,2.1
"2011","Chichester 013C","E01031501","Total",1399,667,732,1377,22,13,46.56,30.0
"2011","Chichester 013D","E01031529","Total",1171,602,569,1156,15,34,1678.90,0.7
"2011","Chichester 013E","E01031540","Total",1364,626,738,1337,27,49,976.72,1.4
"2011","Chichester 013F","E01031541","Total",1336,607,729,1336,0,8,76.93,17.4
"2011","Chichester 013G","E01031542","Total",1772,869,903,1772,0,49,812.94,2.2
"2011","Chichester 014A","E01031522","Total",1970,910,1060,1955,15,9,114.45,17.2
"2011","Chichester 014B","E01031523","Total",1565,737,828,1535,30,12,170.45,9.2
"2011","Chichester 014C","E01031524","Total",1485,704,781,1431,54,7,526.03,2.8
"2011","Chichester 014D","E01031525","Total",1345,612,733,1345,0,10,28.89,46.6
"2011","Chichester 014E","E01031526","Total",1381,639,742,1276,105,5,39.50,35.0
"2011","Chichester 014F","E01031527","Total",1539,734,805,1514,25,13,39.59,38.9
"2011","Chichester 014G","E01031528","Total",1452,714,738,1405,47,21,47.57,30.5
"2011","Crawley 001A","E01031573","Total",1623,804,819,1623,0,10,30.83,52.6
"2011","Crawley 001B","E01031574","Total",1868,938,930,1868,0,15,58.42,32.0
"2011","Crawley 001C","E01031575","Total",1776,966,810,1640,136,13,1036.63,1.7
"2011","Crawley 001D","E01031576","Total",1629,812,817,1629,0,6,22.40,72.7
"2011","Crawley 001E","E01031577","Total",1359,715,644,1359,0,16,19.17,70.9
"2011","Crawley 002A","E01031586","Total",1787,882,905,1787,0,22,24.84,71.9
"2011","Crawley 002B","E01031587","Total",1681,865,816,1669,12,30,569.01,3.0
"2011","Crawley 002C","E01031588","Total",1498,764,734,1498,0,36,35.49,42.2
"2011","Crawley 002D","E01031590","Total",1593,779,814,1593,0,32,39.77,40.1
"2011","Crawley 002E","E01031593","Total",1399,691,708,1399,0,25,30.68,45.6
"2011","Crawley 003A","E01031570","Total",1394,679,715,1325,69,12,34.44,40.5
"2011","Crawley 003B","E01031571","Total",1645,793,852,1645,0,12,24.68,66.7
"2011","Crawley 003C","E01031572","Total",1511,717,794,1424,87,15,46.34,32.6
"2011","Crawley 003D","E01031609","Total",1571,754,817,1571,0,7,31.83,49.4
"2011","Crawley 003E","E01031610","Total",1801,884,917,1801,0,11,58.88,30.6
"2011","Crawley 004A","E01031583","Total",1978,1027,951,1978,0,14,327.44,6.0
"2011","Crawley 004B","E01031584","Total",1663,834,829,1663,0,11,38.43,43.3
"2011","Crawley 004C","E01031585","Total",1657,857,800,1648,9,11,64.83,25.6
"2011","Crawley 004D","E01031601","Total",1244,627,617,1244,0,8,25.13,49.5
"2011","Crawley 004F","E01032835","Total",1473,773,700,1473,0,2,22.39,65.8
"2011","Crawley 004G","E01032836","Total",1658,832,826,1604,54,11,60.28,27.5
"2011","Crawley 005A","E01031589","Total",1767,920,847,1767,0,21,43.35,40.8
"2011","Crawley 005B","E01031591","Total",1814,906,908,1814,0,9,31.40,57.8
"2011","Crawley 005C","E01031594","Total",1418,678,740,1415,3,10,27.27,52.0
"2011","Crawley 005D","E01031600","Total",1394,671,723,1384,10,15,34.27,40.7
"2011","Crawley 005E","E01031603","Total",1484,751,733,1484,0,14,101.61,14.6
"2011","Crawley 006A","E01031564","Total",1478,728,750,1471,7,17,26.35,56.1
"2011","Crawley 006B","E01031565","Total",2168,1035,1133,2168,0,19,36.61,59.2
"2011","Crawley 006C","E01031566","Total",1606,807,799,1606,0,20,51.16,31.4
"2011","Crawley 006D","E01031567","Total",1364,657,707,1299,65,18,75.72,18.0
"2011","Crawley 006E","E01031568","Total",1391,670,721,1391,0,11,20.56,67.7
"2011","Crawley 007A","E01031596","Total",1875,914,961,1875,0,12,27.03,69.4
"2011","Crawley 007B","E01031597","Total",1498,730,768,1470,28,24,43.89,34.1
"2011","Crawley 007C","E01031598","Total",1717,808,909,1588,129,18,51.18,33.5
"2011","Crawley 007D","E01031599","Total",1751,881,870,1735,16,10,33.19,52.8
"2011","Crawley 007E","E01031608","Total",1748,874,874,1712,36,11,32.24,54.2
"2011","Crawley 008A","E01031578","Total",1790,891,899,1790,0,26,35.52,50.4
"2011","Crawley 008B","E01031580","Total",2348,1139,1209,2348,0,30,47.11,49.8
"2011","Crawley 008C","E01031581","Total",1785,911,874,1785,0,21,32.62,54.7
"2011","Crawley 008D","E01031592","Total",2020,1019,1001,2009,11,46,81.01,24.9
"2011","Crawley 009A","E01031560","Total",1476,750,726,1472,4,23,129.02,11.4
"2011","Crawley 009B","E01031561","Total",1432,737,695,1427,5,15,43.26,33.1
"2011","Crawley 009C","E01031562","Total",1287,621,666,1287,0,11,33.20,38.8
"2011","Crawley 009D","E01031563","Total",1304,606,698,1247,57,24,41.85,31.2
"2011","Crawley 009E","E01031579","Total",1628,816,812,1628,0,12,34.82,46.8
"2011","Crawley 009F","E01031582","Total",1818,897,921,1818,0,12,31.49,57.7
"2011","Crawley 010A","E01031547","Total",1332,637,695,1332,0,14,22.72,58.6
"2011","Crawley 010B","E01031548","Total",1596,800,796,1596,0,21,28.58,55.8
"2011","Crawley 010C","E01031549","Total",1482,749,733,1482,0,18,26.87,55.2
"2011","Crawley 010D","E01031550","Total",1455,713,742,1455,0,15,35.06,41.5
"2011","Crawley 010E","E01031569","Total",1577,771,806,1577,0,8,19.64,80.3
"2011","Crawley 011A","E01031595","Total",1692,792,900,1692,0,11,25.86,65.4
"2011","Crawley 011B","E01031604","Total",1563,740,823,1563,0,13,36.64,42.7
"2011","Crawley 011C","E01031605","Total",1574,747,827,1574,0,17,45.65,34.5
"2011","Crawley 011D","E01031606","Total",1523,755,768,1523,0,18,179.95,8.5
"2011","Crawley 011E","E01031607","Total",1418,695,723,1418,0,5,20.82,68.1
"2011","Crawley 012A","E01031546","Total",1455,740,715,1455,0,16,16.67,87.3
"2011","Crawley 012B","E01031551","Total",1545,766,779,1545,0,16,15.66,98.7
"2011","Crawley 012C","E01031553","Total",1559,760,799,1559,0,22,39.48,39.5
"2011","Crawley 012D","E01031554","Total",1714,827,887,1714,0,17,26.16,65.5
"2011","Crawley 012E","E01031555","Total",1563,773,790,1563,0,14,24.23,64.5
"2011","Crawley 013A","E01031552","Total",1898,924,974,1898,0,12,37.23,51.0
"2011","Crawley 013B","E01031556","Total",1655,782,873,1655,0,13,67.80,24.4
"2011","Crawley 013C","E01031557","Total",1726,844,882,1726,0,17,46.45,37.2
"2011","Crawley 013D","E01031558","Total",1572,719,853,1572,0,7,16.09,97.7
"2011","Crawley 013E","E01031559","Total",1529,754,775,1529,0,11,17.87,85.6
"2011","Horsham 001A","E01031670","Total",1564,768,796,1547,17,18,29.63,52.8
"2011","Horsham 001B","E01031671","Total",1628,822,806,1628,0,24,29.25,55.7
"2011","Horsham 001C","E01031673","Total",1567,777,790,1511,56,13,91.84,17.1
"2011","Horsham 001D","E01031676","Total",2722,1351,1371,2636,86,60,4832.20,0.6
"2011","Horsham 002A","E01031644","Total",1441,715,726,1441,0,22,41.47,34.7
"2011","Horsham 002B","E01031645","Total",1439,689,750,1439,0,40,36.63,39.3
"2011","Horsham 002C","E01031646","Total",1529,714,815,1529,0,43,46.62,32.8
"2011","Horsham 002D","E01031647","Total",1197,568,629,1197,0,16,18.42,65.0
"2011","Horsham 002E","E01031649","Total",1147,567,580,1147,0,12,18.80,61.0
"2011","Horsham 002F","E01031650","Total",1320,637,683,1320,0,31,574.38,2.3
"2011","Horsham 002G","E01031666","Total",1602,762,840,1602,0,26,48.05,33.3
"2011","Horsham 002H","E01031668","Total",1531,770,761,1531,0,18,34.65,44.2
"2011","Horsham 003A","E01031620","Total",1601,776,825,1601,0,30,60.31,26.5
"2011","Horsham 003B","E01031648","Total",1670,820,850,1670,0,17,112.59,14.8
"2011","Horsham 003C","E01031651","Total",1693,798,895,1634,59,21,36.87,45.9
"2011","Horsham 003D","E01031658","Total",2068,985,1083,2003,65,53,1979.87,1.0
"2011","Horsham 003E","E01031689","Total",1566,779,787,1566,0,23,24.52,63.9
"2011","Horsham 004A","E01031654","Total",1597,789,808,1567,30,32,44.72,35.7
"2011","Horsham 004B","E01031655","Total",1524,760,764,1524,0,23,20.57,74.1
"2011","Horsham 004C","E01031667","Total",1565,751,814,1565,0,12,32.67,47.9
"2011","Horsham 004D","E01031669","Total",1570,756,814,1570,0,19,34.77,45.2
"2011","Horsham 004E","E01031672","Total",1730,830,900,1676,54,27,55.08,31.4
"2011","Horsham 005A","E01031657","Total",2055,990,1065,1851,204,47,1694.47,1.2
"2011","Horsham 005B","E01031659","Total",1565,785,780,1468,97,48,1091.35,1.4
"2011","Horsham 005C","E01031674","Total",1337,642,695,1239,98,49,1503.95,0.9
"2011","Horsham 005D","E01031675","Total",1385,676,709,1367,18,47,964.64,1.4
"2011","Horsham 006A","E01031636","Total",2199,1035,1164,2107,92,22,72.35,30.4
"2011","Horsham 006B","E01031652","Total",1767,865,902,1728,39,19,28.03,63.0
"2011","Horsham 006C","E01031653","Total",1731,847,884,1622,109,21,71.94,24.1
"2011","Horsham 006D","E01031656","Total",1740,836,904,1733,7,19,31.39,55.4
"2011","Horsham 006E","E01031688","Total",1371,656,715,1371,0,23,56.49,24.3
"2011","Horsham 006F","E01031691","Total",1652,800,852,1652,0,32,30.68,53.8
"2011","Horsham 007A","E01031619","Total",1511,761,750,1511,0,34,155.86,9.7
"2011","Horsham 007B","E01031637","Total",1883,911,972,1883,0,28,118.46,15.9
"2011","Horsham 007C","E01031638","Total",1791,883,908,1791,0,31,38.37,46.7
"2011","Horsham 007D","E01031690","Total",1516,739,777,1516,0,44,75.25,20.1
"2011","Horsham 008A","E01031639","Total",1874,880,994,1823,51,35,119.99,15.6
"2011","Horsham 008B","E01031640","Total",1808,867,941,1808,0,62,291.29,6.2
"2011","Horsham 008C","E01031660","Total",1242,598,644,1240,2,40,1578.44,0.8
"2011","Horsham 008D","E01031661","Total",1557,755,802,1531,26,41,1963.72,0.8
"2011","Horsham 008E","E01031679","Total",2038,1002,1036,1260,778,86,1015.76,2.0
"2011","Horsham 009A","E01031677","Total",1490,739,751,1490,0,20,65.05,22.9
"2011","Horsham 009B","E01031678","Total",1631,828,803,1631,0,46,84.85,19.2
"2011","Horsham 009C","E01031680","Total",1394,714,680,1394,0,40,112.09,12.4
"2011","Horsham 009D","E01031681","Total",1512,747,765,1512,0,13,58.80,25.7
"2011","Horsham 009E","E01031682","Total",1188,593,595,1188,0,22,22.06,53.9
"2011","Horsham 009F","E01031683","Total",1477,748,729,1477,0,20,41.24,35.8
"2011","Horsham 010A","E01031611","Total",1612,798,814,1606,6,79,4230.24,0.4
"2011","Horsham 010B","E01031612","Total",2109,1047,1062,2109,0,25,49.55,42.6
"2011","Horsham 010C","E01031613","Total",2063,1044,1019,2063,0,33,1152.38,1.8
"2011","Horsham 010D","E01031614","Total",2054,1006,1048,1994,60,18,855.16,2.4
"2011","Horsham 010E","E01031615","Total",1541,723,818,1541,0,33,57.40,26.8
"2011","Horsham 011A","E01031632","Total",1475,758,717,1450,25,31,2741.58,0.5
"2011","Horsham 011B","E01031633","Total",1293,656,637,1293,0,28,1313.57,1.0
"2011","Horsham 011C","E01031634","Total",1306,629,677,1229,77,27,910.72,1.4
"2011","Horsham 011D","E01031635","Total",1426,694,732,1426,0,35,314.46,4.5
"2011","Horsham 012A","E01031621","Total",1664,806,858,1664,0,51,191.45,8.7
"2011","Horsham 012B","E01031623","Total",1713,843,870,1711,2,52,1541.08,1.1
"2011","Horsham 012C","E01031627","Total",1992,953,1039,1992,0,43,221.96,9.0
"2011","Horsham 012D","E01031664","Total",1615,807,808,1608,7,63,1831.12,0.9
"2011","Horsham 013A","E01031626","Total",1490,709,781,1490,0,31,3543.64,0.4
"2011","Horsham 013B","E01031630","Total",1697,791,906,1693,4,11,78.48,21.6
"2011","Horsham 013C","E01031631","Total",1559,730,829,1559,0,18,55.43,28.1
"2011","Horsham 013D","E01031662","Total",1554,726,828,1481,73,28,128.41,12.1
"2011","Horsham 013E","E01031663","Total",1773,841,932,1773,0,25,113.68,15.6
"2011","Horsham 013F","E01031665","Total",1205,601,604,1205,0,26,900.88,1.3
"2011","Horsham 014A","E01031618","Total",1339,650,689,1329,10,24,1217.77,1.1
"2011","Horsham 014B","E01031641","Total",1638,720,918,1567,71,35,352.53,4.6
"2011","Horsham 014C","E01031642","Total",1849,886,963,1849,0,38,1007.30,1.8
"2011","Horsham 014D","E01031643","Total",1639,774,865,1590,49,19,111.47,14.7
"2011","Horsham 014E","E01031687","Total",1668,776,892,1598,70,30,2047.96,0.8
"2011","Horsham 015A","E01031622","Total",1609,808,801,1609,0,32,1861.54,0.9
"2011","Horsham 015B","E01031624","Total",1517,753,764,1517,0,35,1189.38,1.3
"2011","Horsham 015C","E01031625","Total",1435,735,700,1433,2,26,313.23,4.6
"2011","Horsham 015D","E01031628","Total",1470,732,738,1231,239,28,1673.37,0.9
"2011","Horsham 015E","E01031629","Total",1435,668,767,1435,0,27,527.81,2.7
"2011","Horsham 016A","E01031616","Total",1600,780,820,1600,0,17,71.64,22.3
"2011","Horsham 016B","E01031617","Total",2375,1160,1215,2344,31,46,2404.37,1.0
"2011","Horsham 016C","E01031684","Total",1457,682,775,1457,0,33,96.71,15.1
"2011","Horsham 016D","E01031685","Total",1723,765,958,1669,54,39,46.21,37.3
"2011","Horsham 016E","E01031686","Total",1421,674,747,1421,0,24,384.16,3.7
"2011","Mid Sussex 001A","E01031731","Total",2010,963,1047,2010,0,21,50.01,40.2
"2011","Mid Sussex 001B","E01031732","Total",1881,900,981,1806,75,29,38.23,49.2
"2011","Mid Sussex 001C","E01031733","Total",1764,836,928,1714,50,28,40.55,43.5
"2011","Mid Sussex 001D","E01031734","Total",1664,830,834,1664,0,36,38.30,43.4
"2011","Mid Sussex 001E","E01031741","Total",1646,811,835,1644,2,23,57.12,28.8
"2011","Mid Sussex 001F","E01031742","Total",1871,879,992,1829,42,30,47.13,39.7
"2011","Mid Sussex 001G","E01031743","Total",1644,833,811,1635,9,23,35.96,45.7
"2011","Mid Sussex 002A","E01031718","Total",1846,913,933,1781,65,26,127.57,14.5
"2011","Mid Sussex 002B","E01031719","Total",1792,858,934,1767,25,30,866.61,2.1
"2011","Mid Sussex 002C","E01031720","Total",1454,742,712,1422,32,27,116.61,12.5
"2011","Mid Sussex 002D","E01031722","Total",1435,833,602,1139,296,37,1157.36,1.2
"2011","Mid Sussex 003A","E01031695","Total",1565,767,798,1446,119,35,375.78,4.2
"2011","Mid Sussex 003B","E01031696","Total",1319,646,673,1319,0,28,84.24,15.7
"2011","Mid Sussex 003C","E01031729","Total",1792,890,902,1792,0,38,221.40,8.1
"2011","Mid Sussex 003D","E01031730","Total",1821,942,879,1821,0,19,62.09,29.3
"2011","Mid Sussex 003E","E01031735","Total",1691,830,861,1691,0,37,42.06,40.2
"2011","Mid Sussex 004A","E01031736","Total",1676,837,839,1577,99,51,1079.42,1.6
"2011","Mid Sussex 004B","E01031737","Total",1539,762,777,1539,0,18,175.94,8.7
"2011","Mid Sussex 004C","E01031738","Total",1246,616,630,1246,0,31,137.65,9.1
"2011","Mid Sussex 004D","E01031739","Total",1762,867,895,1762,0,47,45.45,38.8
"2011","Mid Sussex 004E","E01031740","Total",1325,648,677,1312,13,28,163.48,8.1
"2011","Mid Sussex 005A","E01031721","Total",1502,720,782,1502,0,30,530.21,2.8
"2011","Mid Sussex 005B","E01031723","Total",1408,723,685,1387,21,45,438.55,3.2
"2011","Mid Sussex 005C","E01031724","Total",1386,680,706,1386,0,21,108.65,12.8
"2011","Mid Sussex 005D","E01031725","Total",1474,715,759,1474,0,21,39.60,37.2
"2011","Mid Sussex 006A","E01031694","Total",1936,991,945,1695,241,43,1609.09,1.2
"2011","Mid Sussex 006B","E01031764","Total",1457,722,735,1437,20,46,1035.81,1.4
"2011","Mid Sussex 006C","E01031765","Total",1604,807,797,1580,24,50,2340.89,0.7
"2011","Mid Sussex 006D","E01031766","Total",2181,1101,1080,2065,116,67,2138.99,1.0
"2011","Mid Sussex 007A","E01031692","Total",2178,1097,1081,2170,8,32,1498.00,1.5
"2011","Mid Sussex 007B","E01031693","Total",1917,951,966,1833,84,43,2104.84,0.9
"2011","Mid Sussex 007C","E01031697","Total",1239,606,633,1205,34,50,1582.04,0.8
"2011","Mid Sussex 007D","E01031727","Total",1753,856,897,1643,110,53,2249.51,0.8
"2011","Mid Sussex 008A","E01031758","Total",1392,707,685,1389,3,23,53.10,26.2
"2011","Mid Sussex 008B","E01031760","Total",1767,843,924,1726,41,30,60.07,29.4
"2011","Mid Sussex 008C","E01031772","Total",1663,767,896,1601,62,24,169.11,9.8
"2011","Mid Sussex 008D","E01031773","Total",1973,943,1030,1952,21,51,75.88,26.0
"2011","Mid Sussex 008E","E01031774","Total",1637,829,808,1637,0,39,92.80,17.6
"2011","Mid Sussex 008F","E01031775","Total",1721,788,933,1721,0,42,71.66,24.0
"2011","Mid Sussex 009A","E01031751","Total",2613,1322,1291,2611,2,24,45.20,57.8
"2011","Mid Sussex 009B","E01031759","Total",1647,827,820,1647,0,42,56.06,29.4
"2011","Mid Sussex 009C","E01031761","Total",2035,1007,1028,1959,76,21,57.74,35.2
"2011","Mid Sussex 009E","E01032837","Total",1406,628,778,1219,187,5,94.20,14.9
"2011","Mid Sussex 009F","E01032838","Total",1319,651,668,1319,0,10,33.40,39.5
"2011","Mid Sussex 009G","E01032839","Total",1133,581,552,1133,0,19,30.66,37.0
"2011","Mid Sussex 010A","E01031752","Total",1432,658,774,1432,0,8,37.78,37.9
"2011","Mid Sussex 010B","E01031753","Total",1363,650,713,1363,0,27,40.60,33.6
"2011","Mid Sussex 010C","E01031754","Total",1580,770,810,1580,0,17,27.97,56.5
"2011","Mid Sussex 010D","E01031755","Total",1323,625,698,1323,0,11,22.88,57.8
"2011","Mid Sussex 010E","E01031757","Total",1520,738,782,1520,0,12,36.10,42.1
"2011","Mid Sussex 011A","E01031726","Total",1474,693,781,1472,2,25,96.04,15.3
"2011","Mid Sussex 011B","E01031728","Total",2029,979,1050,1996,33,66,1955.82,1.0
"2011","Mid Sussex 011C","E01031749","Total",1475,714,761,1470,5,26,29.82,49.5
"2011","Mid Sussex 011D","E01031750","Total",1478,751,727,1478,0,11,28.38,52.1
"2011","Mid Sussex 011E","E01031756","Total",1829,901,928,1829,0,43,146.31,12.5
"2011","Mid Sussex 011F","E01031763","Total",1745,855,890,1745,0,61,173.64,10.0
"2011","Mid Sussex 012A","E01031699","Total",1677,804,873,1677,0,23,30.68,54.7
"2011","Mid Sussex 012B","E01031700","Total",1711,852,859,1711,0,25,33.87,50.5
"2011","Mid Sussex 012C","E01031701","Total",1847,901,946,1846,1,21,29.04,63.6
"2011","Mid Sussex 012D","E01031714","Total",1538,737,801,1480,58,17,55.45,27.7
"2011","Mid Sussex 013A","E01031704","Total",1745,856,889,1745,0,16,34.72,50.3
"2011","Mid Sussex 013B","E01031706","Total",1694,836,858,1687,7,29,51.16,33.1
"2011","Mid Sussex 013C","E01031711","Total",1748,860,888,1748,0,14,94.26,18.5
"2011","Mid Sussex 013D","E01031712","Total",1486,690,796,1478,8,3,26.15,56.8
"2011","Mid Sussex 013E","E01031713","Total",1393,704,689,1393,0,25,59.73,23.3
"2011","Mid Sussex 014A","E01031705","Total",1568,744,824,1568,0,14,50.95,30.8
"2011","Mid Sussex 014B","E01031707","Total",1578,765,813,1538,40,17,37.55,42.0
"2011","Mid Sussex 014C","E01031708","Total",1659,829,830,1614,45,13,36.74,45.2
"2011","Mid Sussex 014D","E01031709","Total",1606,791,815,1606,0,23,52.86,30.4
"2011","Mid Sussex 014E","E01031716","Total",1266,599,667,1266,0,7,28.43,44.5
"2011","Mid Sussex 014F","E01031717","Total",1406,708,698,1397,9,12,29.62,47.5
"2011","Mid Sussex 015A","E01031702","Total",1487,743,744,1427,60,35,72.82,20.4
"2011","Mid Sussex 015B","E01031703","Total",1702,790,912,1571,131,39,102.38,16.6
"2011","Mid Sussex 015C","E01031710","Total",1431,692,739,1431,0,17,65.51,21.8
"2011","Mid Sussex 015D","E01031715","Total",1567,785,782,1567,0,27,54.91,28.5
"2011","Mid Sussex 016A","E01031698","Total",1668,844,824,1610,58,47,2387.88,0.7
"2011","Mid Sussex 016B","E01031767","Total",1533,735,798,1374,159,47,770.06,2.0
"2011","Mid Sussex 016C","E01031769","Total",1783,866,917,1760,23,25,65.47,27.2
"2011","Mid Sussex 016D","E01031770","Total",1666,805,861,1662,4,27,3329.32,0.5
"2011","Mid Sussex 016E","E01031771","Total",1576,790,786,1576,0,17,624.12,2.5
"2011","Mid Sussex 017A","E01031744","Total",1469,711,758,1469,0,30,400.69,3.7
"2011","Mid Sussex 017B","E01031745","Total",1796,816,980,1758,38,18,116.10,15.5
"2011","Mid Sussex 017C","E01031746","Total",1640,807,833,1640,0,26,45.11,36.4
"2011","Mid Sussex 017D","E01031747","Total",1433,639,794,1433,0,27,109.55,13.1
"2011","Mid Sussex 017E","E01031748","Total",1329,652,677,1318,11,27,416.37,3.2
"2011","Mid Sussex 017F","E01031768","Total",1526,712,814,1526,0,19,116.53,13.1
"2011","Worthing 001A","E01031793","Total",1338,645,693,1338,0,14,31.84,42.0
"2011","Worthing 001B","E01031820","Total",1701,813,888,1701,0,18,178.18,9.5
"2011","Worthing 001C","E01031821","Total",1663,800,863,1663,0,19,65.33,25.5
"2011","Worthing 001D","E01031828","Total",1317,641,676,1281,36,22,180.68,7.3
"2011","Worthing 001E","E01031829","Total",1562,749,813,1505,57,23,84.88,18.4
"2011","Worthing 002A","E01031822","Total",1576,757,819,1548,28,24,44.45,35.5
"2011","Worthing 002B","E01031825","Total",1609,782,827,1609,0,15,42.20,38.1
"2011","Worthing 002C","E01031826","Total",1359,676,683,1359,0,12,26.58,51.1
"2011","Worthing 002D","E01031827","Total",1429,709,720,1423,6,10,29.46,48.5
"2011","Worthing 002E","E01031839","Total",1738,843,895,1709,29,32,25.44,68.3
"2011","Worthing 003A","E01031792","Total",1356,633,723,1356,0,6,28.74,47.2
"2011","Worthing 003B","E01031794","Total",1327,630,697,1322,5,2,29.74,44.6
"2011","Worthing 003C","E01031795","Total",1507,719,788,1494,13,9,19.19,78.5
"2011","Worthing 003D","E01031818","Total",2080,1006,1074,2065,15,14,39.98,52.0
"2011","Worthing 003E","E01031830","Total",1617,760,857,1599,18,13,25.93,62.4
"2011","Worthing 004A","E01031778","Total",1514,754,760,1497,17,22,26.80,56.5
"2011","Worthing 004B","E01031797","Total",1293,630,663,1293,0,22,28.33,45.6
"2011","Worthing 004C","E01031800","Total",1566,755,811,1566,0,26,31.00,50.5
"2011","Worthing 004D","E01031823","Total",1430,714,716,1430,0,30,474.83,3.0
"2011","Worthing 004E","E01031824","Total",1349,653,696,1349,0,41,36.19,37.3
"2011","Worthing 005A","E01031776","Total",1575,732,843,1575,0,12,16.23,97.0
"2011","Worthing 005B","E01031777","Total",1682,819,863,1682,0,18,41.20,40.8
"2011","Worthing 005C","E01031780","Total",1556,758,798,1556,0,11,26.29,59.2
"2011","Worthing 005D","E01031781","Total",1668,806,862,1668,0,10,51.80,32.2
"2011","Worthing 005E","E01031798","Total",1534,780,754,1521,13,17,30.80,49.8
"2011","Worthing 006A","E01031783","Total",1533,737,796,1533,0,9,23.43,65.4
"2011","Worthing 006B","E01031785","Total",1473,707,766,1473,0,5,55.38,26.6
"2011","Worthing 006C","E01031786","Total",1510,722,788,1510,0,11,26.15,57.7
"2011","Worthing 006D","E01031817","Total",1593,774,819,1589,4,26,39.98,39.8
"2011","Worthing 006E","E01031819","Total",1300,631,669,1298,2,4,264.69,4.9
"2011","Worthing 007A","E01031782","Total",1676,804,872,1676,0,10,58.83,28.5
"2011","Worthing 007B","E01031784","Total",1828,857,971,1828,0,18,51.66,35.4
"2011","Worthing 007C","E01031836","Total",1680,832,848,1680,0,14,29.73,56.5
"2011","Worthing 007D","E01031838","Total",1620,785,835,1529,91,24,31.03,52.2
"2011","Worthing 007E","E01031840","Total",1691,829,862,1691,0,21,29.26,57.8
"2011","Worthing 008A","E01031791","Total",2111,995,1116,2039,72,16,19.21,109.9
"2011","Worthing 008B","E01031796","Total",1587,760,827,1587,0,12,18.72,84.8
"2011","Worthing 008C","E01031799","Total",1585,747,838,1585,0,11,34.43,46.0
"2011","Worthing 008D","E01031801","Total",1808,894,914,1808,0,8,18.10,99.9
"2011","Worthing 008E","E01031837","Total",1917,940,977,1917,0,29,21.12,90.8
"2011","Worthing 009A","E01031779","Total",1378,665,713,1378,0,8,36.81,37.4
"2011","Worthing 009B","E01031831","Total",1680,808,872,1550,130,13,24.74,67.9
"2011","Worthing 009C","E01031832","Total",1628,774,854,1628,0,18,62.66,26.0
"2011","Worthing 009D","E01031833","Total",1645,787,858,1580,65,9,18.35,89.6
"2011","Worthing 009E","E01031834","Total",1599,772,827,1599,0,12,42.43,37.7
"2011","Worthing 010A","E01031790","Total",1822,822,1000,1639,183,10,24.65,73.9
"2011","Worthing 010B","E01031807","Total",1723,797,926,1512,211,17,24.15,71.3
"2011","Worthing 010C","E01031809","Total",1531,765,766,1503,28,16,22.27,68.7
"2011","Worthing 010D","E01031810","Total",1586,775,811,1577,9,19,18.81,84.3
"2011","Worthing 010E","E01031811","Total",1485,701,784,1174,311,16,18.04,82.3
"2011","Worthing 011A","E01031787","Total",1893,957,936,1860,33,19,30.15,62.8
"2011","Worthing 011B","E01031788","Total",2109,1034,1075,2095,14,23,23.25,90.7
"2011","Worthing 011C","E01031789","Total",1955,974,981,1887,68,17,52.32,37.4
"2011","Worthing 011D","E01031808","Total",1534,773,761,1337,197,1,12.36,124.1
"2011","Worthing 011E","E01031835","Total",1825,906,919,1760,65,16,29.15,62.6
"2011","Worthing 012A","E01031812","Total",1559,720,839,1487,72,17,28.91,53.9
"2011","Worthing 012B","E01031813","Total",1795,845,950,1771,24,22,29.61,60.6
"2011","Worthing 012C","E01031814","Total",1501,736,765,1501,0,20,38.99,38.5
"2011","Worthing 012D","E01031815","Total",1534,716,818,1509,25,21,28.20,54.4
"2011","Worthing 012E","E01031816","Total",1610,766,844,1610,0,18,28.90,55.7
"2011","Worthing 013A","E01031802","Total",1556,711,845,1556,0,9,97.34,16.0
"2011","Worthing 013B","E01031803","Total",1507,716,791,1507,0,27,65.50,23.0
"2011","Worthing 013C","E01031804","Total",1653,793,860,1606,47,22,56.47,29.3
"2011","Worthing 013D","E01031805","Total",1610,722,888,1610,0,20,55.98,28.8
"2011","Worthing 013E","E01031806","Total",1664,771,893,1664,0,13,40.36,41.2
"2011","Bath and North East Somerset 001A","E01014399","Total",1624,789,835,1624,0,16,412.44,3.9
"2011","Bath and North East Somerset 001B","E01014400","Total",1944,933,1011,1906,38,36,87.03,22.3
"2011","Bath and North East Somerset 001C","E01014401","Total",1645,784,861,1617,28,11,29.68,55.4
"2011","Bath and North East Somerset 002A","E01014402","Total",1684,804,880,1684,0,4,92.49,18.2
"2011","Bath and North East Somerset 002B","E01014403","Total",1671,749,922,1620,51,13,35.61,46.9
"2011","Bath and North East Somerset 002C","E01014404","Total",1669,769,900,1668,1,14,71.26,23.4
"2011","Bath and North East Somerset 003A","E01014395","Total",1235,612,623,1235,0,27,151.98,8.1
"2011","Bath and North East Somerset 003B","E01014396","Total",1434,669,765,1401,33,11,156.62,9.2
"2011","Bath and North East Somerset 003C","E01014397","Total",1312,656,656,1312,0,29,40.51,32.4
"2011","Bath and North East Somerset 003D","E01014398","Total",1423,708,715,1423,0,27,136.66,10.4
"2011","Bath and North East Somerset 004A","E01014409","Total",1590,738,852,1559,31,21,31.88,49.9
"2011","Bath and North East Somerset 004B","E01014410","Total",1770,865,905,1770,0,29,49.49,35.8
"2011","Bath and North East Somerset 004C","E01014411","Total",2109,1025,1084,2084,25,40,92.78,22.7
"2011","Bath and North East Somerset 005A","E01014477","Total",1454,691,763,1454,0,21,46.64,31.2
"2011","Bath and North East Somerset 005B","E01014478","Total",1189,561,628,1189,0,15,63.86,18.6
"2011","Bath and North East Somerset 005C","E01014479","Total",1420,664,756,1377,43,52,66.00,21.5
"2011","Bath and North East Somerset 005D","E01014480","Total",1261,625,636,1261,0,14,20.87,60.4
"2011","Bath and North East Somerset 006A","E01014465","Total",1517,722,795,1502,15,16,17.89,84.8
"2011","Bath and North East Somerset 006B","E01014466","Total",1263,653,610,1262,1,14,13.03,96.9
"2011","Bath and North East Somerset 006C","E01014467","Total",1620,851,769,1620,0,26,32.88,49.3
"2011","Bath and North East Somerset 006D","E01014468","Total",1520,797,723,1503,17,27,23.15,65.7
"2011","Bath and North East Somerset 007A","E01014370","Total",1800,924,876,1666,134,22,37.69,47.8
"2011","Bath and North East Somerset 007B","E01014371","Total",1866,942,924,1830,36,34,40.96,45.6
"2011","Bath and North East Somerset 007C","E01014372","Total",2004,1037,967,1984,20,12,16.67,120.2
"2011","Bath and North East Somerset 007D","E01014412","Total",1462,709,753,1462,0,42,33.82,43.2
"2011","Bath and North East Somerset 007E","E01014413","Total",1598,729,869,1378,220,68,226.11,7.1
"2011","Bath and North East Somerset 007F","E01014414","Total",1529,770,759,1474,55,16,20.33,75.2
"2011","Bath and North East Somerset 008A","E01014427","Total",1351,661,690,1349,2,25,20.47,66.0
"2011","Bath and North East Somerset 008B","E01014428","Total",1432,690,742,1332,100,41,44.76,32.0
"2011","Bath and North East Somerset 008C","E01014429","Total",1614,771,843,1609,5,25,37.11,43.5
"2011","Bath and North East Somerset 008D","E01014430","Total",1541,674,867,1541,0,37,84.05,18.3
"2011","Bath and North East Somerset 009A","E01014405","Total",2076,997,1079,2037,39,49,54.08,38.4
"2011","Bath and North East Somerset 009C","E01014407","Total",1235,626,609,1045,190,10,23.14,53.4
"2011","Bath and North East Somerset 009E","E01033080","Total",2205,1149,1056,2187,18,39,52.42,42.1
"2011","Bath and North East Somerset 010A","E01014373","Total",1545,751,794,1545,0,18,106.01,14.6
"2011","Bath and North East Somerset 010B","E01014374","Total",1441,682,759,1392,49,19,500.20,2.9
"2011","Bath and North East Somerset 010C","E01014375","Total",1254,610,644,1247,7,54,3184.15,0.4
"2011","Bath and North East Somerset 010D","E01014376","Total",1499,724,775,1466,33,55,456.24,3.3
"2011","Bath and North East Somerset 010E","E01014377","Total",1408,685,723,1407,1,38,508.20,2.8
"2011","Bath and North East Somerset 010G","E01033078","Total",1888,943,945,1693,195,72,1551.27,1.2
"2011","Bath and North East Somerset 010H","E01033079","Total",1164,561,603,1164,0,22,1966.73,0.6
"2011","Bath and North East Somerset 011A","E01014461","Total",1174,578,596,1172,2,10,30.11,39.0
"2011","Bath and North East Somerset 011B","E01014462","Total",1476,702,774,1476,0,4,38.00,38.8
"2011","Bath and North East Somerset 011C","E01014463","Total",1384,681,703,1297,87,8,56.16,24.6
"2011","Bath and North East Somerset 011D","E01014464","Total",1281,613,668,1248,33,8,30.23,42.4
"2011","Bath and North East Somerset 012A","E01014380","Total",3383,1714,1669,1172,2211,73,276.84,12.2
"2011","Bath and North East Somerset 012B","E01014381","Total",1480,698,782,1332,148,47,50.91,29.1
"2011","Bath and North East Somerset 012C","E01014481","Total",1445,722,723,1299,146,36,24.71,58.5
"2011","Bath and North East Somerset 012D","E01014482","Total",1278,666,612,1188,90,41,190.91,6.7
"2011","Bath and North East Somerset 012E","E01014483","Total",1477,724,753,1401,76,36,43.73,33.8
"2011","Bath and North East Somerset 012F","E01014484","Total",1570,754,816,1549,21,16,41.55,37.8
"2011","Bath and North East Somerset 013A","E01014473","Total",1672,831,841,1588,84,13,19.18,87.2
"2011","Bath and North East Somerset 013B","E01014474","Total",1183,577,606,1183,0,9,17.06,69.3
"2011","Bath and North East Somerset 013C","E01014475","Total",2175,1011,1164,1613,562,39,41.84,52.0
"2011","Bath and North East Somerset 013D","E01014476","Total",1439,712,727,1439,0,13,15.65,91.9
"2011","Bath and North East Somerset 014A","E01014435","Total",1593,809,784,1593,0,15,11.89,134.0
"2011","Bath and North East Somerset 014B","E01014436","Total",1584,770,814,1539,45,29,24.06,65.8
"2011","Bath and North East Somerset 014C","E01014437","Total",1425,687,738,1407,18,26,37.77,37.7
"2011","Bath and North East Somerset 014D","E01014438","Total",1280,658,622,1280,0,13,22.47,57.0
"2011","Bath and North East Somerset 015A","E01014455","Total",1317,675,642,1317,0,14,47.76,27.6
"2011","Bath and North East Somerset 015B","E01014456","Total",1503,717,786,1503,0,20,43.87,34.3
"2011","Bath and North East Somerset 015C","E01014457","Total",1320,648,672,1320,0,15,23.36,56.5
"2011","Bath and North East Somerset 015D","E01014458","Total",1389,659,730,1389,0,10,19.90,69.8
"2011","Bath and North East Somerset 016A","E01014391","Total",1432,722,710,1432,0,30,1533.36,0.9
"2011","Bath and North East Somerset 016B","E01014392","Total",1073,521,552,1001,72,22,2097.56,0.5
"2011","Bath and North East Somerset 016C","E01014452","Total",1471,721,750,1471,0,29,245.04,6.0
"2011","Bath and North East Somerset 016D","E01014453","Total",1262,611,651,1243,19,27,134.18,9.4
"2011","Bath and North East Somerset 016E","E01014454","Total",1340,663,677,1340,0,35,176.80,7.6
"2011","Bath and North East Somerset 016F","E01014459","Total",1456,737,719,1412,44,12,163.09,8.9
"2011","Bath and North East Somerset 016G","E01014460","Total",1168,549,619,1143,25,23,307.83,3.8
"2011","Bath and North East Somerset 017A","E01014415","Total",2001,999,1002,1975,26,71,29.60,67.6
"2011","Bath and North East Somerset 017B","E01014416","Total",1714,795,919,1665,49,41,102.35,16.7
"2011","Bath and North East Somerset 017C","E01014417","Total",1790,909,881,1770,20,62,74.42,24.1
"2011","Bath and North East Somerset 018A","E01014387","Total",1232,597,635,1232,0,28,41.75,29.5
"2011","Bath and North East Somerset 018B","E01014388","Total",1305,620,685,1270,35,35,150.93,8.6
"2011","Bath and North East Somerset 018C","E01014389","Total",1361,665,696,1361,0,35,62.83,21.7
"2011","Bath and North East Somerset 018D","E01014390","Total",1521,700,821,1517,4,6,17.68,86.0
"2011","Bath and North East Somerset 019A","E01014431","Total",1225,612,613,1225,0,13,20.06,61.1
"2011","Bath and North East Somerset 019B","E01014432","Total",1277,638,639,1277,0,16,21.87,58.4
"2011","Bath and North East Somerset 019C","E01014433","Total",1358,635,723,1358,0,6,27.83,48.8
"2011","Bath and North East Somerset 019D","E01014434","Total",1821,888,933,1821,0,16,60.17,30.3
"2011","Bath and North East Somerset 020A","E01014385","Total",1380,667,713,1351,29,30,1586.27,0.9
"2011","Bath and North East Somerset 020B","E01014386","Total",1157,587,570,1157,0,11,220.71,5.2
"2011","Bath and North East Somerset 020C","E01014419","Total",1292,644,648,1245,47,30,659.50,2.0
"2011","Bath and North East Somerset 020D","E01014446","Total",1119,553,566,1119,0,13,697.85,1.6
"2011","Bath and North East Somerset 020E","E01014447","Total",1354,633,721,1301,53,8,342.46,4.0
"2011","Bath and North East Somerset 021A","E01014382","Total",2386,1182,1204,2384,2,58,2825.43,0.8
"2011","Bath and North East Somerset 021B","E01014383","Total",1016,484,532,1016,0,36,1666.67,0.6
"2011","Bath and North East Somerset 021C","E01014384","Total",1361,659,702,1361,0,47,768.53,1.8
"2011","Bath and North East Somerset 021D","E01014418","Total",1391,681,710,1391,0,50,1889.42,0.7
"2011","Bath and North East Somerset 022A","E01014379","Total",2435,1161,1274,2032,403,57,3562.12,0.7
"2011","Bath and North East Somerset 022B","E01014442","Total",1727,844,883,1727,0,20,68.42,25.2
"2011","Bath and North East Somerset 022C","E01014443","Total",1575,784,791,1571,4,27,172.80,9.1
"2011","Bath and North East Somerset 022D","E01014444","Total",1523,760,763,1523,0,25,185.27,8.2
"2011","Bath and North East Somerset 022E","E01014445","Total",1621,802,819,1621,0,10,54.32,29.8
"2011","Bath and North East Somerset 023A","E01014393","Total",1350,642,708,1282,68,19,107.71,12.5
"2011","Bath and North East Somerset 023B","E01014394","Total",1655,836,819,1655,0,27,734.36,2.3
"2011","Bath and North East Somerset 023C","E01014439","Total",1789,839,950,1690,99,13,193.12,9.3
"2011","Bath and North East Somerset 023D","E01014440","Total",1897,974,923,1897,0,17,62.70,30.3
"2011","Bath and North East Somerset 023E","E01014441","Total",1616,782,834,1616,0,18,395.41,4.1
"2011","Bath and North East Somerset 024A","E01014448","Total",1577,788,789,1577,0,10,260.79,6.0
"2011","Bath and North East Somerset 024B","E01014449","Total",1468,705,763,1468,0,19,76.15,19.3
"2011","Bath and North East Somerset 024C","E01014450","Total",1316,642,674,1316,0,14,101.46,13.0
"2011","Bath and North East Somerset 024D","E01014451","Total",1259,625,634,1246,13,14,173.70,7.2
"2011","Bath and North East Somerset 025A","E01014420","Total",1571,770,801,1571,0,19,156.80,10.0
"2011","Bath and North East Somerset 025B","E01014421","Total",1423,697,726,1423,0,29,45.63,31.2
"2011","Bath and North East Somerset 025C","E01014422","Total",1509,746,763,1509,0,23,49.11,30.7
"2011","Bath and North East Somerset 025D","E01014423","Total",1372,673,699,1354,18,14,55.82,24.6
"2011","Bath and North East Somerset 026A","E01014469","Total",1266,641,625,1266,0,6,31.09,40.7
"2011","Bath and North East Somerset 026B","E01014470","Total",1620,781,839,1620,0,16,89.25,18.2
"2011","Bath and North East Somerset 026C","E01014471","Total",1550,776,774,1533,17,14,58.23,26.6
"2011","Bath and North East Somerset 026D","E01014472","Total",1418,697,721,1388,30,17,60.05,23.6
"2011","Bath and North East Somerset 027A","E01014424","Total",1691,843,848,1680,11,27,102.97,16.4
"2011","Bath and North East Somerset 027B","E01014425","Total",1991,973,1018,1982,9,27,64.11,31.1
"2011","Bath and North East Somerset 027C","E01014426","Total",1440,713,727,1408,32,9,43.38,33.2
"2011","Bournemouth 001A","E01015301","Total",1483,727,756,1481,2,10,36.48,40.7
"2011","Bournemouth 001B","E01015303","Total",1520,783,737,1520,0,6,132.39,11.5
"2011","Bournemouth 001C","E01015305","Total",1554,747,807,1554,0,18,33.02,47.1
"2011","Bournemouth 001D","E01015306","Total",1670,819,851,1670,0,22,54.83,30.5
"2011","Bournemouth 002A","E01015302","Total",1850,880,970,1837,13,0,81.15,22.8
"2011","Bournemouth 002B","E01015304","Total",1711,817,894,1711,0,8,48.42,35.3
"2011","Bournemouth 002C","E01015308","Total",1707,817,890,1707,0,7,60.26,28.3
"2011","Bournemouth 002D","E01015311","Total",1340,655,685,1340,0,2,42.07,31.9
"2011","Bournemouth 003A","E01015332","Total",1524,733,791,1524,0,21,84.81,18.0
"2011","Bournemouth 003B","E01015333","Total",1581,758,823,1581,0,11,32.25,49.0
"2011","Bournemouth 003C","E01015334","Total",1611,738,873,1536,75,14,36.25,44.4
"2011","Bournemouth 003D","E01015335","Total",1683,826,857,1683,0,12,42.53,39.6
"2011","Bournemouth 003E","E01015337","Total",1697,837,860,1697,0,7,25.42,66.8
"2011","Bournemouth 004A","E01015343","Total",1551,740,811,1551,0,14,26.97,57.5
"2011","Bournemouth 004B","E01015349","Total",1514,699,815,1494,20,18,30.26,50.0
"2011","Bournemouth 004C","E01015351","Total",1509,736,773,1474,35,19,35.65,42.3
"2011","Bournemouth 004D","E01015352","Total",1529,728,801,1529,0,8,27.99,54.6
"2011","Bournemouth 004E","E01015353","Total",1150,544,606,1148,2,8,165.08,7.0
"2011","Bournemouth 004F","E01015354","Total",1729,831,898,1729,0,15,29.02,59.6
"2011","Bournemouth 005A","E01015307","Total",1393,664,729,1389,4,18,79.46,17.5
"2011","Bournemouth 005B","E01015309","Total",1450,676,774,1450,0,6,28.78,50.4
"2011","Bournemouth 005C","E01015312","Total",1241,573,668,1238,3,6,54.46,22.8
"2011","Bournemouth 005D","E01015313","Total",1369,670,699,1369,0,10,18.37,74.5
"2011","Bournemouth 005E","E01015359","Total",1566,780,786,1566,0,10,34.90,44.9
"2011","Bournemouth 006A","E01015320","Total",1686,827,859,1686,0,27,28.10,60.0
"2011","Bournemouth 006B","E01015323","Total",1585,787,798,1579,6,26,25.76,61.5
"2011","Bournemouth 006C","E01015324","Total",1549,767,782,1549,0,18,28.86,53.7
"2011","Bournemouth 006D","E01015325","Total",1706,813,893,1706,0,16,27.67,61.7
"2011","Bournemouth 006E","E01015350","Total",1451,718,733,1451,0,12,32.62,44.5
"2011","Bournemouth 007A","E01015310","Total",1536,750,786,1536,0,5,29.91,51.4
"2011","Bournemouth 007B","E01015336","Total",1601,797,804,1601,0,12,39.06,41.0
"2011","Bournemouth 007C","E01015355","Total",1689,847,842,1689,0,13,43.36,39.0
"2011","Bournemouth 007D","E01015357","Total",1561,754,807,1558,3,14,56.27,27.7
"2011","Bournemouth 007E","E01015358","Total",1955,946,1009,1908,47,16,32.24,60.6
"2011","Bournemouth 008A","E01015338","Total",1815,847,968,1815,0,8,43.93,41.3
"2011","Bournemouth 008B","E01015339","Total",1587,787,800,1587,0,12,82.53,19.2
"2011","Bournemouth 008C","E01015340","Total",1577,759,818,1577,0,13,42.04,37.5
"2011","Bournemouth 008D","E01015341","Total",1490,705,785,1446,44,17,96.35,15.5
"2011","Bournemouth 009A","E01015321","Total",1861,944,917,1861,0,19,21.18,87.9
"2011","Bournemouth 009B","E01015356","Total",1766,854,912,1762,4,31,31.76,55.6
"2011","Bournemouth 009C","E01015374","Total",2310,1137,1173,2308,2,21,23.91,96.6
"2011","Bournemouth 009D","E01015375","Total",1907,916,991,1842,65,12,24.21,78.8
"2011","Bournemouth 009E","E01015377","Total",1637,786,851,1637,0,12,18.74,87.4
"2011","Bournemouth 010A","E01015322","Total",1660,829,831,1660,0,24,29.90,55.5
"2011","Bournemouth 010B","E01015330","Total",1820,862,958,1733,87,30,40.16,45.3
"2011","Bournemouth 010C","E01015342","Total",1577,751,826,1549,28,45,67.18,23.5
"2011","Bournemouth 010D","E01015373","Total",1704,864,840,1703,1,14,19.48,87.5
"2011","Bournemouth 010E","E01015378","Total",1735,865,870,1735,0,25,20.30,85.5
"2011","Bournemouth 011A","E01015314","Total",1527,753,774,1521,6,24,97.70,15.6
"2011","Bournemouth 011B","E01015315","Total",1932,961,971,1932,0,38,90.12,21.4
"2011","Bournemouth 011C","E01015318","Total",1664,805,859,1664,0,21,27.59,60.3
"2011","Bournemouth 011D","E01015319","Total",1438,661,777,1386,52,28,101.75,14.1
"2011","Bournemouth 012A","E01015344","Total",1787,846,941,1683,104,45,144.42,12.4
"2011","Bournemouth 012B","E01015346","Total",1665,857,808,1637,28,35,33.77,49.3
"2011","Bournemouth 012C","E01015348","Total",1830,886,944,1769,61,35,69.81,26.2
"2011","Bournemouth 012D","E01015360","Total",1787,838,949,1780,7,38,41.94,42.6
"2011","Bournemouth 013A","E01015326","Total",1924,993,931,1901,23,25,22.73,84.6
"2011","Bournemouth 013B","E01015331","Total",2315,1213,1102,2254,61,21,24.38,95.0
"2011","Bournemouth 013C","E01015345","Total",1899,1020,879,1845,54,22,46.17,41.1
"2011","Bournemouth 013D","E01015376","Total",1773,893,880,1751,22,20,28.41,62.4
"2011","Bournemouth 014A","E01015316","Total",1591,772,819,1591,0,25,38.92,40.9
"2011","Bournemouth 014B","E01015317","Total",1574,764,810,1574,0,15,43.62,36.1
"2011","Bournemouth 014C","E01015361","Total",1415,697,718,1415,0,6,18.90,74.9
"2011","Bournemouth 014D","E01015362","Total",1249,600,649,1246,3,14,24.05,51.9
"2011","Bournemouth 014E","E01015363","Total",1695,831,864,1672,23,17,20.36,83.3
"2011","Bournemouth 015A","E01015292","Total",1696,881,815,1696,0,16,19.44,87.2
"2011","Bournemouth 015B","E01015293","Total",1530,762,768,1530,0,18,13.80,110.9
"2011","Bournemouth 015C","E01015294","Total",1949,1022,927,1949,0,17,17.29,112.7
"2011","Bournemouth 015D","E01015327","Total",1964,989,975,1960,4,30,20.26,96.9
"2011","Bournemouth 015E","E01015329","Total",1660,904,756,1660,0,22,92.82,17.9
"2011","Bournemouth 016A","E01015272","Total",1722,825,897,1671,51,20,70.82,24.3
"2011","Bournemouth 016B","E01015273","Total",1964,1003,961,1964,0,18,21.05,93.3
"2011","Bournemouth 016C","E01015275","Total",1780,939,841,1737,43,17,23.99,74.2
"2011","Bournemouth 016D","E01015276","Total",1700,826,874,1646,54,14,18.72,90.8
"2011","Bournemouth 016E","E01015277","Total",1944,993,951,1944,0,18,20.34,95.6
"2011","Bournemouth 017A","E01015283","Total",1871,1013,858,1782,89,10,42.21,44.3
"2011","Bournemouth 017C","E01015286","Total",1910,955,955,1870,40,16,39.85,47.9
"2011","Bournemouth 017D","E01015287","Total",2229,1131,1098,1722,507,16,41.36,53.9
"2011","Bournemouth 017E","E01015328","Total",1850,955,895,1747,103,14,30.31,61.0
"2011","Bournemouth 017F","E01033242","Total",1010,561,449,982,28,3,15.87,63.6
"2011","Bournemouth 017G","E01033285","Total",1080,617,463,1080,0,4,18.04,59.9
"2011","Bournemouth 018A","E01015274","Total",1766,869,897,1766,0,23,27.69,63.8
"2011","Bournemouth 018B","E01015297","Total",1491,656,835,1330,161,10,30.88,48.3
"2011","Bournemouth 018C","E01015364","Total",1600,786,814,1585,15,24,38.30,41.8
"2011","Bournemouth 018D","E01015365","Total",1708,879,829,1646,62,17,20.51,83.3
"2011","Bournemouth 018E","E01015366","Total",1807,851,956,1591,216,19,26.90,67.2
"2011","Bournemouth 019B","E01015279","Total",1841,960,881,1776,65,7,16.18,113.8
"2011","Bournemouth 019C","E01015280","Total",1983,1068,915,1777,206,2,18.51,107.1
"2011","Bournemouth 019D","E01015281","Total",1723,917,806,1722,1,8,20.85,82.6
"2011","Bournemouth 019E","E01015282","Total",1973,1195,778,1907,66,11,18.33,107.6
"2011","Bournemouth 019F","E01033241","Total",1112,600,512,1087,25,5,10.73,103.6
"2011","Bournemouth 019G","E01033283","Total",1211,608,603,1137,74,3,14.48,83.6
"2011","Bournemouth 020A","E01015295","Total",1444,685,759,1427,17,23,81.00,17.8
"2011","Bournemouth 020B","E01015296","Total",1726,827,899,1671,55,6,34.62,49.9
"2011","Bournemouth 020C","E01015298","Total",1555,715,840,1512,43,25,206.12,7.5
"2011","Bournemouth 020D","E01015299","Total",1700,803,897,1700,0,29,47.73,35.6
"2011","Bournemouth 020E","E01015300","Total",1570,733,837,1552,18,17,36.30,43.3
"2011","Bournemouth 021A","E01015285","Total",2671,1439,1232,1948,723,42,58.99,45.3
"2011","Bournemouth 021B","E01015288","Total",1877,999,878,1855,22,15,21.31,88.1
"2011","Bournemouth 021C","E01015289","Total",1871,1013,858,1814,57,11,27.45,68.2
"2011","Bournemouth 021D","E01015290","Total",1826,1030,796,1632,194,12,26.63,68.6
"2011","Bournemouth 021E","E01015291","Total",1939,996,943,1905,34,8,55.12,35.2
"2011","Bournemouth 023A","E01015371","Total",1534,815,719,1518,16,7,19.01,80.7
"2011","Bournemouth 023B","E01015372","Total",1824,831,993,1672,152,9,22.26,81.9
"2011","Bournemouth 023C","E01033286","Total",1066,544,522,1064,2,6,24.26,43.9
"2011","Bournemouth 023D","E01033288","Total",1045,527,518,1045,0,7,22.90,45.6
"2011","Bournemouth 024A","E01015367","Total",2021,1129,892,1913,108,24,42.87,47.1
"2011","Bournemouth 024B","E01015368","Total",1680,807,873,1655,25,5,44.41,37.8
"2011","Bournemouth 024C","E01015369","Total",1668,824,844,1614,54,7,30.68,54.4
"2011","Bournemouth 024D","E01015370","Total",1638,824,814,1500,138,9,45.71,35.8
"2011","Bristol 001A","E01014601","Total",1662,780,882,1570,92,8,45.34,36.7
"2011","Bristol 001B","E01014602","Total",1841,883,958,1841,0,9,41.98,43.9
"2011","Bristol 001C","E01014603","Total",2134,994,1140,2134,0,16,50.54,42.2
"2011","Bristol 001E","E01014605","Total",1615,765,850,1601,14,6,29.25,55.2
"2011","Bristol 001G","E01032516","Total",1881,877,1004,1881,0,19,146.88,12.8
"2011","Bristol 001H","E01032517","Total",1566,736,830,1555,11,6,33.05,47.4
"2011","Bristol 002A","E01014688","Total",1716,796,920,1716,0,14,24.65,69.6
"2011","Bristol 002B","E01014689","Total",1604,791,813,1604,0,6,26.79,59.9
"2011","Bristol 002C","E01014690","Total",2025,999,1026,2025,0,14,26.36,76.8
"2011","Bristol 002D","E01014691","Total",1939,871,1068,1877,62,4,61.60,31.5
"2011","Bristol 002E","E01014692","Total",1664,819,845,1613,51,6,27.68,60.1
"2011","Bristol 002F","E01014693","Total",1372,670,702,1372,0,10,76.26,18.0
"2011","Bristol 002G","E01014694","Total",1636,831,805,1617,19,12,33.69,48.6
"2011","Bristol 003A","E01014497","Total",1563,783,780,1563,0,5,62.19,25.1
"2011","Bristol 003B","E01014498","Total",1583,755,828,1583,0,7,811.32,2.0
"2011","Bristol 003C","E01014638","Total",1624,755,869,1611,13,6,53.30,30.5
"2011","Bristol 003D","E01014639","Total",1494,682,812,1494,0,11,53.79,27.8
"2011","Bristol 003E","E01014640","Total",1491,749,742,1464,27,12,105.49,14.1
"2011","Bristol 004A","E01014631","Total",1187,586,601,1163,24,5,48.91,24.3
"2011","Bristol 004B","E01014632","Total",1543,774,769,1538,5,21,41.51,37.2
"2011","Bristol 004C","E01014633","Total",1575,775,800,1571,4,19,36.88,42.7
"2011","Bristol 004D","E01014636","Total",1496,688,808,1465,31,6,26.88,55.7
"2011","Bristol 005A","E01014630","Total",2091,1028,1063,2091,0,10,27.27,76.7
"2011","Bristol 005B","E01014634","Total",1699,930,769,1699,0,11,15.87,107.1
"2011","Bristol 005C","E01014659","Total",2075,1021,1054,2069,6,27,27.74,74.8
"2011","Bristol 005D","E01014661","Total",1664,817,847,1622,42,5,36.71,45.3
"2011","Bristol 006A","E01014616","Total",1521,730,791,1475,46,23,37.91,40.1
"2011","Bristol 006B","E01014719","Total",1366,674,692,1366,0,27,27.29,50.1
"2011","Bristol 006C","E01014720","Total",1598,749,849,1598,0,15,31.41,50.9
"2011","Bristol 006D","E01014721","Total",1557,701,856,1438,119,32,41.56,37.5
"2011","Bristol 007A","E01014641","Total",1403,676,727,1403,0,29,73.98,19.0
"2011","Bristol 007B","E01014642","Total",1449,708,741,1449,0,13,81.26,17.8
"2011","Bristol 007C","E01014643","Total",1364,646,718,1364,0,15,88.49,15.4
"2011","Bristol 007D","E01014644","Total",1512,739,773,1512,0,10,30.19,50.1
"2011","Bristol 008A","E01014492","Total",1478,691,787,1478,0,6,46.50,31.8
"2011","Bristol 008B","E01014493","Total",1488,718,770,1482,6,12,26.74,55.6
"2011","Bristol 008C","E01014494","Total",1473,742,731,1472,1,10,61.97,23.8
"2011","Bristol 008D","E01014495","Total",1661,795,866,1638,23,15,36.19,45.9
"2011","Bristol 008E","E01014496","Total",1628,844,784,1628,0,7,440.31,3.7
"2011","Bristol 008F","E01014499","Total",1611,760,851,1563,48,8,128.93,12.5
"2011","Bristol 009A","E01014715","Total",1611,801,810,1607,4,48,45.30,35.6
"2011","Bristol 009B","E01014716","Total",1527,729,798,1494,33,35,71.50,21.4
"2011","Bristol 009C","E01014717","Total",1700,660,1040,1404,296,40,54.10,31.4
"2011","Bristol 009D","E01014718","Total",1395,680,715,1387,8,25,82.18,17.0
"2011","Bristol 010A","E01014510","Total",1960,1013,947,1951,9,16,23.80,82.4
"2011","Bristol 010B","E01014635","Total",1865,988,877,1865,0,9,25.06,74.4
"2011","Bristol 010C","E01014637","Total",1371,711,660,1352,19,14,16.93,81.0
"2011","Bristol 010D","E01014662","Total",1575,806,769,1569,6,9,42.04,37.5
"2011","Bristol 011A","E01014615","Total",1525,749,776,1525,0,35,42.86,35.6
"2011","Bristol 011B","E01014617","Total",1339,646,693,1339,0,38,28.34,47.2
"2011","Bristol 011C","E01014618","Total",1547,719,828,1547,0,23,32.46,47.7
"2011","Bristol 011D","E01014620","Total",1456,693,763,1445,11,42,24.04,60.6
"2011","Bristol 012A","E01014571","Total",1589,761,828,1588,1,30,37.76,42.1
"2011","Bristol 012B","E01014577","Total",1525,772,753,1496,29,29,58.57,26.0
"2011","Bristol 012C","E01014586","Total",1486,688,798,1454,32,16,88.26,16.8
"2011","Bristol 012D","E01014587","Total",1371,688,683,1342,29,9,70.76,19.4
"2011","Bristol 013A","E01014588","Total",2137,1040,1097,1606,531,16,56.06,38.1
"2011","Bristol 013B","E01014589","Total",1419,659,760,1407,12,12,23.74,59.8
"2011","Bristol 013C","E01014590","Total",1813,899,914,1699,114,13,33.70,53.8
"2011","Bristol 013D","E01014591","Total",1780,841,939,1759,21,10,31.34,56.8
"2011","Bristol 013E","E01014592","Total",1610,784,826,1590,20,14,28.31,56.9
"2011","Bristol 014A","E01014660","Total",1572,766,806,1555,17,8,127.95,12.3
"2011","Bristol 014B","E01014663","Total",1438,727,711,1438,0,6,38.20,37.6
"2011","Bristol 014C","E01014664","Total",1654,853,801,1609,45,11,77.83,21.3
"2011","Bristol 014D","E01014665","Total",2102,1062,1040,2099,3,11,77.02,27.3
"2011","Bristol 015A","E01014709","Total",1161,564,597,1135,26,31,204.79,5.7
"2011","Bristol 015B","E01014710","Total",1368,704,664,1067,301,40,30.27,45.2
"2011","Bristol 015C","E01014711","Total",1217,567,650,1217,0,46,45.17,26.9
"2011","Bristol 015D","E01014712","Total",1273,590,683,1250,23,32,44.31,28.7
"2011","Bristol 015E","E01014713","Total",1270,613,657,1270,0,37,67.42,18.8
"2011","Bristol 015F","E01014714","Total",2980,1483,1497,1322,1658,84,60.91,48.9
"2011","Bristol 016A","E01014507","Total",1664,805,859,1664,0,28,13.63,122.1
"2011","Bristol 016B","E01014508","Total",1722,1027,695,1410,312,22,18.32,94.0
"2011","Bristol 016C","E01014509","Total",2061,1052,1009,2061,0,30,29.51,69.8
"2011","Bristol 016D","E01014511","Total",1468,709,759,1454,14,28,12.15,120.8
"2011","Bristol 016E","E01014512","Total",1505,740,765,1485,20,34,17.73,84.9
"2011","Bristol 016F","E01014513","Total",1591,759,832,1580,11,32,36.48,43.6
"2011","Bristol 016G","E01014514","Total",1900,940,960,1900,0,10,24.83,76.5
"2011","Bristol 017A","E01014619","Total",1545,787,758,1442,103,49,29.73,52.0
"2011","Bristol 017B","E01014621","Total",1469,719,750,1469,0,32,14.49,101.4
"2011","Bristol 017C","E01014666","Total",1824,912,912,1824,0,48,33.86,53.9
"2011","Bristol 017D","E01014667","Total",1637,826,811,1637,0,33,21.72,75.4
"2011","Bristol 017E","E01014672","Total",2049,1064,985,1940,109,31,26.75,76.6
"2011","Bristol 018A","E01014624","Total",1738,828,910,1733,5,7,31.59,55.0
"2011","Bristol 018D","E01014629","Total",1477,706,771,1473,4,10,26.07,56.7
"2011","Bristol 018E","E01032518","Total",1848,878,970,1838,10,6,28.02,66.0
"2011","Bristol 018F","E01032519","Total",1159,569,590,1159,0,11,15.88,73.0
"2011","Bristol 019A","E01014572","Total",1857,952,905,1835,22,12,24.63,75.4
"2011","Bristol 019B","E01014573","Total",1837,922,915,1837,0,30,48.06,38.2
"2011","Bristol 019C","E01014575","Total",1562,805,757,1531,31,20,53.86,29.0
"2011","Bristol 019D","E01014576","Total",1920,945,975,1919,1,11,46.83,41.0
"2011","Bristol 020A","E01014487","Total",2000,1070,930,1995,5,42,19.35,103.4
"2011","Bristol 020B","E01014491","Total",1962,997,965,1917,45,37,31.88,61.5
"2011","Bristol 020C","E01014668","Total",1638,821,817,1638,0,44,17.21,95.2
"2011","Bristol 020D","E01014669","Total",1505,764,741,1499,6,34,21.42,70.3
"2011","Bristol 020E","E01014670","Total",1513,788,725,1501,12,38,13.98,108.2
"2011","Bristol 020F","E01014671","Total",1635,857,778,1533,102,27,18.56,88.1
"2011","Bristol 021A","E01014622","Total",1530,758,772,1530,0,9,27.86,54.9
"2011","Bristol 021B","E01014623","Total",1631,822,809,1610,21,14,38.90,41.9
"2011","Bristol 021C","E01014626","Total",1976,946,1030,1960,16,8,71.55,27.6
"2011","Bristol 021D","E01014627","Total",2145,1066,1079,2100,45,12,31.49,68.1
"2011","Bristol 022A","E01014557","Total",1635,812,823,1634,1,42,19.37,84.4
"2011","Bristol 022B","E01014558","Total",1875,1005,870,1798,77,23,12.93,145.0
"2011","Bristol 022C","E01014559","Total",1982,1075,907,1963,19,47,22.01,90.0
"2011","Bristol 022D","E01014560","Total",1669,841,828,1669,0,17,14.21,117.5
"2011","Bristol 022E","E01014562","Total",1838,930,908,1832,6,17,10.05,182.9
"2011","Bristol 023A","E01014485","Total",1817,874,943,1807,10,12,27.47,66.1
"2011","Bristol 023B","E01014486","Total",2317,1188,1129,2297,20,15,27.62,83.9
"2011","Bristol 023C","E01014488","Total",1993,1022,971,1971,22,25,18.81,106.0
"2011","Bristol 023D","E01014489","Total",2403,1279,1124,2390,13,12,17.18,139.9
"2011","Bristol 023F","E01033347","Total",1122,644,478,1114,8,3,19.50,57.5
"2011","Bristol 023G","E01033348","Total",1104,587,517,1104,0,1,6.62,166.8
"2011","Bristol 023H","E01033366","Total",1507,749,758,1507,0,16,9.26,162.7
"2011","Bristol 025A","E01014539","Total",1834,944,890,1823,11,32,15.78,116.2
"2011","Bristol 025C","E01014561","Total",1741,887,854,1703,38,30,22.48,77.4
"2011","Bristol 025D","E01014563","Total",1814,912,902,1807,7,15,13.80,131.4
"2011","Bristol 025E","E01033342","Total",1881,1052,829,1383,498,34,18.19,103.4
"2011","Bristol 025F","E01033367","Total",1287,741,546,1218,69,7,9.10,141.4
"2011","Bristol 026A","E01014551","Total",1781,860,921,1767,14,19,14.88,119.7
"2011","Bristol 026B","E01014552","Total",1826,1003,823,1826,0,35,17.81,102.5
"2011","Bristol 026C","E01014553","Total",1718,894,824,1711,7,23,16.53,103.9
"2011","Bristol 026D","E01014554","Total",1697,883,814,1661,36,21,16.80,101.0
"2011","Bristol 026E","E01014556","Total",1712,883,829,1689,23,27,16.77,102.1
"2011","Bristol 027A","E01014673","Total",1743,862,881,1734,9,7,22.65,77.0
"2011","Bristol 027B","E01014674","Total",1572,774,798,1568,4,7,22.83,68.9
"2011","Bristol 027C","E01014675","Total",1509,750,759,1494,15,8,24.33,62.0
"2011","Bristol 027D","E01014676","Total",1535,746,789,1535,0,10,23.85,64.4
"2011","Bristol 028A","E01014682","Total",1576,753,823,1489,87,6,26.27,60.0
"2011","Bristol 028B","E01014683","Total",1677,868,809,1655,22,11,18.56,90.4
"2011","Bristol 028C","E01014685","Total",1582,766,816,1582,0,5,21.48,73.6
"2011","Bristol 028D","E01014686","Total",1630,746,884,1630,0,8,27.05,60.3
"2011","Bristol 028E","E01014687","Total",1580,770,810,1580,0,8,22.32,70.8
"2011","Bristol 029A","E01014565","Total",1697,849,848,1652,45,6,13.48,125.9
"2011","Bristol 029B","E01014566","Total",1669,848,821,1669,0,6,13.48,123.8
"2011","Bristol 029C","E01014567","Total",1909,1010,899,1909,0,12,33.16,57.6
"2011","Bristol 029D","E01014681","Total",2142,1048,1094,2139,3,12,36.12,59.3
"2011","Bristol 029E","E01014684","Total",1708,880,828,1654,54,3,36.55,46.7
"2011","Bristol 030A","E01014544","Total",1524,806,718,1203,321,23,54.50,28.0
"2011","Bristol 030B","E01014545","Total",1575,829,746,1575,0,35,25.47,61.8
"2011","Bristol 030C","E01014546","Total",1449,763,686,1446,3,14,14.79,98.0
"2011","Bristol 030D","E01014547","Total",1646,850,796,1629,17,28,17.76,92.7
"2011","Bristol 032A","E01014538","Total",1940,1006,934,1801,139,20,23.22,83.5
"2011","Bristol 032B","E01014540","Total",2676,1480,1196,2450,226,26,71.25,37.6
"2011","Bristol 032C","E01014542","Total",2316,1243,1073,2045,271,30,49.78,46.5
"2011","Bristol 032E","E01033344","Total",1627,818,809,1494,133,17,28.00,58.1
"2011","Bristol 032F","E01033345","Total",1344,690,654,1341,3,10,36.07,37.3
"2011","Bristol 032G","E01033350","Total",1035,598,437,1035,0,8,39.24,26.4
"2011","Bristol 033A","E01014677","Total",1413,739,674,1413,0,7,48.38,29.2
"2011","Bristol 033B","E01014678","Total",1558,766,792,1549,9,9,22.97,67.8
"2011","Bristol 033C","E01014679","Total",1540,730,810,1535,5,6,30.11,51.1
"2011","Bristol 033D","E01014680","Total",1287,636,651,1287,0,11,35.49,36.3
"2011","Bristol 034A","E01014548","Total",1690,899,791,1690,0,19,17.91,94.4
"2011","Bristol 034B","E01014549","Total",1191,646,545,1191,0,13,10.54,113.0
"2011","Bristol 034C","E01014550","Total",2162,1109,1053,1930,232,36,22.52,96.0
"2011","Bristol 034D","E01014555","Total",1847,981,866,1288,559,17,12.38,149.2
"2011","Bristol 035A","E01014528","Total",1497,747,750,1497,0,9,49.45,30.3
"2011","Bristol 035B","E01014529","Total",1431,659,772,1431,0,7,18.73,76.4
"2011","Bristol 035C","E01014530","Total",1384,696,688,1384,0,6,29.58,46.8
"2011","Bristol 035D","E01014531","Total",1661,846,815,1647,14,8,33.78,49.2
"2011","Bristol 035E","E01014532","Total",1468,706,762,1468,0,10,14.20,103.4
"2011","Bristol 035F","E01014537","Total",1773,870,903,1773,0,7,33.71,52.6
"2011","Bristol 036A","E01014695","Total",1711,848,863,1692,19,11,110.05,15.5
"2011","Bristol 036B","E01014696","Total",1696,843,853,1666,30,19,12.10,140.2
"2011","Bristol 036C","E01014698","Total",1839,963,876,1839,0,8,14.61,125.9
"2011","Bristol 036D","E01014699","Total",1542,761,781,1412,130,10,15.48,99.6
"2011","Bristol 036E","E01014700","Total",1559,766,793,1559,0,15,25.25,61.7
"2011","Bristol 036F","E01014701","Total",1690,899,791,1684,6,17,12.94,130.6
"2011","Bristol 037A","E01014730","Total",1613,837,776,1604,9,12,26.31,61.3
"2011","Bristol 037B","E01014731","Total",1526,753,773,1524,2,19,10.41,146.6
"2011","Bristol 037C","E01014732","Total",1697,878,819,1689,8,23,16.74,101.4
"2011","Bristol 037D","E01014735","Total",1680,867,813,1680,0,9,35.52,47.3
"2011","Bristol 038A","E01014523","Total",1351,690,661,1277,74,11,59.68,22.6
"2011","Bristol 038B","E01014524","Total",1474,733,741,1443,31,9,31.44,46.9
"2011","Bristol 038C","E01014525","Total",1586,761,825,1586,0,11,18.33,86.5
"2011","Bristol 038D","E01014526","Total",1517,763,754,1513,4,16,161.97,9.4
"2011","Bristol 038E","E01014527","Total",1344,692,652,1344,0,9,41.28,32.6
"2011","Bristol 039A","E01014500","Total",1559,754,805,1534,25,12,25.28,61.7
"2011","Bristol 039B","E01014502","Total",1716,860,856,1716,0,10,29.61,58.0
"2011","Bristol 039E","E01033359","Total",1242,695,547,1184,58,2,42.51,29.2
"2011","Bristol 039F","E01033361","Total",1264,684,580,1255,9,3,25.59,49.4
"2011","Bristol 039G","E01033362","Total",1114,560,554,1114,0,2,9.15,121.7
"2011","Bristol 039H","E01033364","Total",1557,791,766,1557,0,6,15.29,101.8
"2011","Bristol 040A","E01014729","Total",1435,683,752,1435,0,7,36.10,39.8
"2011","Bristol 040B","E01014733","Total",1728,889,839,1728,0,10,15.01,115.1
"2011","Bristol 040C","E01014734","Total",1578,781,797,1578,0,13,20.54,76.8
"2011","Bristol 040D","E01014736","Total",1923,926,997,1923,0,16,24.62,78.1
"2011","Bristol 041A","E01014501","Total",1684,808,876,1679,5,7,88.34,19.1
"2011","Bristol 041B","E01014504","Total",1499,732,767,1499,0,3,13.17,113.8
"2011","Bristol 041C","E01014505","Total",1740,838,902,1740,0,12,12.44,139.9
"2011","Bristol 041D","E01014506","Total",1579,744,835,1579,0,9,60.69,26.0
"2011","Bristol 042A","E01014645","Total",1565,755,810,1564,1,16,34.94,44.8
"2011","Bristol 042B","E01014646","Total",1573,774,799,1573,0,6,30.23,52.0
"2011","Bristol 042C","E01014648","Total",1648,850,798,1617,31,24,36.04,45.7
"2011","Bristol 042D","E01014649","Total",1649,801,848,1631,18,15,23.33,70.7
"2011","Bristol 042E","E01014651","Total",1631,838,793,1627,4,8,19.51,83.6
"2011","Bristol 043A","E01014533","Total",1469,778,691,1440,29,16,29.18,50.3
"2011","Bristol 043B","E01014534","Total",1619,827,792,1602,17,5,44.82,36.1
"2011","Bristol 043C","E01014535","Total",1928,933,995,1928,0,14,46.24,41.7
"2011","Bristol 043D","E01014536","Total",1437,710,727,1421,16,4,124.84,11.5
"2011","Bristol 044A","E01014578","Total",1679,778,901,1679,0,11,40.77,41.2
"2011","Bristol 044B","E01014583","Total",1440,667,773,1440,0,7,29.96,48.1
"2011","Bristol 044C","E01014585","Total",1932,888,1044,1932,0,12,22.02,87.7
"2011","Bristol 044D","E01014647","Total",1685,827,858,1685,0,6,24.58,68.6
"2011","Bristol 044E","E01014650","Total",1564,763,801,1564,0,12,24.38,64.2
"2011","Bristol 045A","E01014579","Total",1404,673,731,1404,0,9,53.66,26.2
"2011","Bristol 045B","E01014580","Total",1490,676,814,1490,0,6,46.88,31.8
"2011","Bristol 045C","E01014581","Total",1529,737,792,1529,0,11,39.21,39.0
"2011","Bristol 045D","E01014582","Total",1400,694,706,1400,0,10,19.51,71.8
"2011","Bristol 045E","E01014584","Total",1393,649,744,1379,14,14,22.17,62.8
"2011","Bristol 046A","E01014518","Total",1651,829,822,1651,0,5,53.74,30.7
"2011","Bristol 046B","E01014519","Total",1312,621,691,1305,7,10,54.00,24.3
"2011","Bristol 046C","E01014520","Total",1527,763,764,1527,0,6,95.16,16.0
"2011","Bristol 046D","E01014521","Total",1332,637,695,1288,44,17,35.74,37.3
"2011","Bristol 047A","E01014607","Total",1361,645,716,1326,35,4,103.98,13.1
"2011","Bristol 047B","E01014608","Total",1692,810,882,1692,0,7,38.52,43.9
"2011","Bristol 047C","E01014609","Total",1777,852,925,1713,64,9,24.88,71.4
"2011","Bristol 047D","E01014610","Total",1423,665,758,1423,0,5,21.49,66.2
"2011","Bristol 047E","E01014613","Total",1483,732,751,1483,0,3,22.34,66.4
"2011","Bristol 047F","E01014614","Total",1251,615,636,1236,15,6,53.94,23.2
"2011","Bristol 048A","E01014594","Total",1506,670,836,1506,0,10,35.84,42.0
"2011","Bristol 048B","E01014598","Total",1465,731,734,1465,0,4,70.28,20.8
"2011","Bristol 048C","E01014599","Total",1280,637,643,1280,0,4,29.43,43.5
"2011","Bristol 048D","E01014600","Total",1387,658,729,1387,0,6,28.04,49.5
"2011","Bristol 049A","E01014702","Total",1433,701,732,1433,0,11,39.86,36.0
"2011","Bristol 049B","E01014703","Total",1420,671,749,1420,0,10,84.62,16.8
"2011","Bristol 049C","E01014704","Total",1889,898,991,1826,63,27,39.39,48.0
"2011","Bristol 049D","E01014705","Total",1401,663,738,1371,30,2,27.68,50.6
"2011","Bristol 049E","E01014706","Total",1248,584,664,1248,0,4,23.69,52.7
"2011","Bristol 049F","E01014707","Total",1591,783,808,1591,0,7,34.80,45.7
"2011","Bristol 049G","E01014708","Total",1820,894,926,1772,48,23,54.79,33.2
"2011","Bristol 050A","E01014515","Total",1488,682,806,1481,7,2,32.15,46.3
"2011","Bristol 050B","E01014516","Total",1407,648,759,1407,0,3,24.84,56.6
"2011","Bristol 050C","E01014517","Total",1209,574,635,1209,0,3,28.38,42.6
"2011","Bristol 050D","E01014522","Total",1650,743,907,1650,0,8,32.29,51.1
"2011","Bristol 051A","E01014593","Total",1515,703,812,1512,3,5,32.89,46.1
"2011","Bristol 051B","E01014595","Total",1417,695,722,1417,0,4,24.11,58.8
"2011","Bristol 051C","E01014596","Total",1584,747,837,1526,58,4,31.08,51.0
"2011","Bristol 051D","E01014597","Total",1320,663,657,1313,7,1,39.26,33.6
"2011","Bristol 052A","E01014611","Total",1285,658,627,1285,0,8,62.13,20.7
"2011","Bristol 052B","E01014612","Total",1451,705,746,1451,0,4,25.01,58.0
"2011","Bristol 052C","E01014722","Total",1492,756,736,1488,4,5,28.36,52.6
"2011","Bristol 052D","E01014723","Total",1344,663,681,1344,0,9,29.29,45.9
"2011","Bristol 052E","E01014725","Total",1468,738,730,1468,0,5,25.72,57.1
"2011","Bristol 053B","E01014726","Total",1650,805,845,1650,0,7,44.21,37.3
"2011","Bristol 053C","E01014727","Total",1539,704,835,1539,0,5,31.32,49.1
"2011","Bristol 053E","E01032514","Total",1970,894,1076,1964,6,4,27.25,72.3
"2011","Bristol 053F","E01032515","Total",1376,665,711,1371,5,3,106.58,12.9
"2011","Bristol 054A","E01033352","Total",1253,744,509,1231,22,7,54.94,22.8
"2011","Bristol 054B","E01033353","Total",1129,626,503,1129,0,0,69.58,16.2
"2011","Bristol 054C","E01033355","Total",1075,633,442,998,77,4,32.37,33.2
"2011","Bristol 054D","E01033358","Total",2052,1059,993,1542,510,8,26.08,78.7
"2011","Bristol 054E","E01033370","Total",1125,634,491,1125,0,6,11.65,96.6
"2011","Bristol 055A","E01014564","Total",1863,913,950,1863,0,11,22.82,81.6
"2011","Bristol 055B","E01014653","Total",2596,1396,1200,2572,24,17,32.88,79.0
"2011","Bristol 055C","E01014655","Total",2365,1230,1135,2357,8,24,18.04,131.1
"2011","Bristol 056A","E01014654","Total",2323,1199,1124,2323,0,6,37.87,61.3
"2011","Bristol 056B","E01014658","Total",2177,1085,1092,2177,0,10,76.02,28.6
"2011","Bristol 056C","E01033356","Total",1419,729,690,1419,0,3,16.47,86.2
"2011","Bristol 056D","E01033369","Total",1428,725,703,1428,0,3,29.94,47.7
"2011","Bristol 057A","E01014568","Total",2431,1217,1214,2431,0,15,19.89,122.2
"2011","Bristol 057B","E01014569","Total",2148,1046,1102,2144,4,22,16.81,127.8
"2011","Bristol 057C","E01014570","Total",1824,913,911,1824,0,5,27.43,66.5
"2011","Bristol 057D","E01014574","Total",2165,1137,1028,2162,3,16,37.06,58.4
"2011","Cornwall 010A","E01018753","Total",1608,768,840,1608,0,36,1155.17,1.4
"2011","Cornwall 010B","E01018754","Total",1543,748,795,1543,0,20,234.60,6.6
"2011","Cornwall 010C","E01018755","Total",1490,735,755,1490,0,34,417.21,3.6
"2011","Cornwall 010D","E01018756","Total",1612,772,840,1612,0,28,537.79,3.0
"2011","Cornwall 012A","E01018777","Total",2015,1032,983,2015,0,39,4508.17,0.4
"2011","Cornwall 012B","E01018782","Total",1476,702,774,1476,0,13,1067.27,1.4
"2011","Cornwall 012C","E01018783","Total",1536,776,760,1536,0,28,1162.42,1.3
"2011","Cornwall 012D","E01018784","Total",1454,703,751,1454,0,16,8455.87,0.2
"2011","Cornwall 013A","E01018750","Total",2265,1126,1139,2265,0,22,174.70,13.0
"2011","Cornwall 013B","E01018751","Total",1505,761,744,1505,0,9,630.73,2.4
"2011","Cornwall 013C","E01018752","Total",2016,979,1037,2016,0,25,328.16,6.1
"2011","Cornwall 013D","E01018779","Total",2231,1088,1143,2231,0,14,2385.95,0.9
"2011","Cornwall 016A","E01018758","Total",2425,1137,1288,2425,0,22,2855.03,0.8
"2011","Cornwall 016B","E01018768","Total",1973,943,1030,1973,0,21,91.04,21.7
"2011","Cornwall 016C","E01018769","Total",1851,875,976,1851,0,19,663.37,2.8
"2011","Cornwall 016D","E01018778","Total",1716,833,883,1716,0,33,3047.62,0.6
"2011","Cornwall 017A","E01018767","Total",1490,682,808,1490,0,11,53.14,28.0
"2011","Cornwall 017B","E01018770","Total",1246,603,643,1246,0,7,32.58,38.2
"2011","Cornwall 017C","E01018771","Total",1300,670,630,1300,0,19,45.94,28.3
"2011","Cornwall 017D","E01018772","Total",1557,761,796,1557,0,28,208.13,7.5
"2011","Cornwall 022A","E01018764","Total",1436,713,723,1436,0,33,2257.80,0.6
"2011","Cornwall 022B","E01018787","Total",1560,779,781,1560,0,34,700.83,2.2
"2011","Cornwall 022C","E01018795","Total",1210,589,621,1210,0,23,1028.93,1.2
"2011","Cornwall 022D","E01018796","Total",1206,584,622,1206,0,11,18.53,65.1
"2011","Cornwall 023A","E01018757","Total",2066,988,1078,2066,0,21,3031.14,0.7
"2011","Cornwall 023B","E01018763","Total",1115,566,549,1115,0,8,1469.43,0.8
"2011","Cornwall 023C","E01018765","Total",1479,743,736,1479,0,21,2769.65,0.5
"2011","Cornwall 023D","E01018785","Total",1946,956,990,1946,0,37,3980.45,0.5
"2011","Cornwall 025A","E01018786","Total",1305,652,653,1305,0,14,23.98,54.4
"2011","Cornwall 025B","E01018788","Total",1413,634,779,1384,29,10,30.23,46.7
"2011","Cornwall 025C","E01018790","Total",1180,565,615,1180,0,13,30.76,38.4
"2011","Cornwall 025D","E01018794","Total",1382,653,729,1382,0,11,29.00,47.7
"2011","Cornwall 026A","E01018789","Total",1456,692,764,1456,0,15,34.90,41.7
"2011","Cornwall 026B","E01018791","Total",1222,612,610,1222,0,20,71.87,17.0
"2011","Cornwall 026C","E01018792","Total",2782,1356,1426,2782,0,28,163.03,17.1
"2011","Cornwall 026D","E01018793","Total",1703,841,862,1703,0,18,38.77,43.9
"2011","Cornwall 028A","E01018759","Total",1494,721,773,1494,0,20,2721.69,0.5
"2011","Cornwall 028B","E01018760","Total",1242,625,617,1240,2,10,4369.60,0.3
"2011","Cornwall 028C","E01018761","Total",1489,711,778,1489,0,19,3097.41,0.5
"2011","Cornwall 028D","E01018766","Total",1825,885,940,1825,0,24,6863.79,0.3
"2011","Cornwall 028E","E01018774","Total",1403,672,731,1403,0,16,951.01,1.5
"2011","Cornwall 029A","E01018797","Total",1127,536,591,1127,0,10,19.91,56.6
"2011","Cornwall 029B","E01018798","Total",1484,732,752,1481,3,11,28.80,51.5
"2011","Cornwall 029C","E01018799","Total",1182,551,631,1182,0,13,56.69,20.9
"2011","Cornwall 029D","E01018800","Total",1618,763,855,1618,0,16,43.46,37.2
"2011","Cornwall 034A","E01018780","Total",2278,1099,1179,2278,0,23,457.45,5.0
"2011","Cornwall 034B","E01018781","Total",1839,896,943,1839,0,25,2280.15,0.8
"2011","Cornwall 034E","E01033294","Total",2306,1133,1173,2287,19,24,251.82,9.2
"2011","Cornwall 037A","E01018762","Total",1203,592,611,1203,0,14,723.84,1.7
"2011","Cornwall 037B","E01018773","Total",1517,737,780,1517,0,20,380.60,4.0
"2011","Cornwall 037C","E01018775","Total",1436,697,739,1390,46,14,61.27,23.4
"2011","Cornwall 037D","E01018776","Total",1169,582,587,1159,10,5,45.10,25.9
"2011","Cornwall 032A","E01018815","Total",2026,1015,1011,2026,0,34,4032.67,0.5
"2011","Cornwall 032B","E01018831","Total",1307,638,669,1307,0,16,2577.34,0.5
"2011","Cornwall 032C","E01018832","Total",1327,650,677,1327,0,23,1382.95,1.0
"2011","Cornwall 032D","E01018847","Total",1513,726,787,1513,0,32,2821.69,0.5
"2011","Cornwall 033A","E01018833","Total",1486,739,747,1486,0,25,2078.20,0.7
"2011","Cornwall 033B","E01018842","Total",1402,680,722,1402,0,17,133.63,10.5
"2011","Cornwall 033C","E01018843","Total",1292,630,662,1292,0,19,2055.74,0.6
"2011","Cornwall 033D","E01018844","Total",1226,598,628,1226,0,8,110.32,11.1
"2011","Cornwall 040A","E01018825","Total",1554,747,807,1554,0,20,881.41,1.8
"2011","Cornwall 040B","E01018826","Total",2127,974,1153,2127,0,19,756.19,2.8
"2011","Cornwall 040C","E01018851","Total",1383,646,737,1383,0,17,117.58,11.8
"2011","Cornwall 040D","E01018852","Total",2501,1188,1313,2501,0,50,1825.70,1.4
"2011","Cornwall 042A","E01018823","Total",1464,677,787,1464,0,36,35.06,41.8
"2011","Cornwall 042B","E01018824","Total",2553,1212,1341,2553,0,38,89.76,28.4
"2011","Cornwall 042C","E01018853","Total",2499,1196,1303,2499,0,37,77.14,32.4
"2011","Cornwall 042D","E01018854","Total",1344,631,713,1344,0,29,156.22,8.6
"2011","Cornwall 043A","E01018819","Total",1475,699,776,1475,0,25,503.09,2.9
"2011","Cornwall 043B","E01018822","Total",1234,595,639,1234,0,12,75.54,16.3
"2011","Cornwall 043C","E01018855","Total",2382,1148,1234,2316,66,42,238.14,10.0
"2011","Cornwall 043D","E01018856","Total",1391,684,707,1391,0,11,87.12,16.0
"2011","Cornwall 043E","E01018857","Total",1173,544,629,1173,0,6,151.92,7.7
"2011","Cornwall 043F","E01018858","Total",1458,679,779,1400,58,24,74.21,19.6
"2011","Cornwall 044A","E01018807","Total",1303,615,688,1303,0,22,179.13,7.3
"2011","Cornwall 044B","E01018808","Total",1451,692,759,1451,0,29,30.64,47.4
"2011","Cornwall 044C","E01018809","Total",1960,913,1047,1951,9,15,56.58,34.6
"2011","Cornwall 044D","E01018810","Total",1354,651,703,1354,0,33,62.65,21.6
"2011","Cornwall 047A","E01018816","Total",1683,803,880,1683,0,51,921.97,1.8
"2011","Cornwall 047B","E01018817","Total",2049,995,1054,2049,0,33,2429.00,0.8
"2011","Cornwall 047C","E01018818","Total",1616,754,862,1616,0,27,330.05,4.9
"2011","Cornwall 047D","E01018820","Total",1806,869,937,1806,0,19,1369.44,1.3
"2011","Cornwall 047E","E01018821","Total",1227,622,605,1227,0,14,1578.61,0.8
"2011","Cornwall 048A","E01018845","Total",1578,724,854,1578,0,25,3720.11,0.4
"2011","Cornwall 048B","E01018846","Total",1321,637,684,1321,0,29,3677.78,0.4
"2011","Cornwall 048C","E01018848","Total",1614,779,835,1614,0,21,133.24,12.1
"2011","Cornwall 048D","E01018849","Total",1863,876,987,1857,6,19,2450.52,0.8
"2011","Cornwall 048E","E01018850","Total",1334,652,682,1334,0,40,4103.31,0.3
"2011","Cornwall 056A","E01018827","Total",1503,710,793,1503,0,30,924.19,1.6
"2011","Cornwall 056B","E01018828","Total",1489,696,793,1489,0,13,588.27,2.5
"2011","Cornwall 056C","E01018829","Total",1353,683,670,1353,0,28,1405.88,1.0
"2011","Cornwall 056D","E01018830","Total",1459,705,754,1459,0,24,761.59,1.9
"2011","Cornwall 060A","E01018834","Total",1798,870,928,1798,0,21,88.93,20.2
"2011","Cornwall 060B","E01018835","Total",1758,882,876,1758,0,20,49.61,35.4
"2011","Cornwall 060C","E01018836","Total",1580,759,821,1580,0,8,32.66,48.4
"2011","Cornwall 060D","E01018837","Total",1957,971,986,1957,0,10,166.86,11.7
"2011","Cornwall 062A","E01018838","Total",1557,734,823,1557,0,11,30.78,50.6
"2011","Cornwall 062B","E01018839","Total",1178,562,616,1178,0,9,18.22,64.7
"2011","Cornwall 062C","E01018840","Total",1636,772,864,1636,0,26,26.92,60.8
"2011","Cornwall 062D","E01018841","Total",1435,682,753,1435,0,4,26.13,54.9
"2011","Cornwall 062E","E01018860","Total",1919,884,1035,1919,0,7,44.90,42.7
"2011","Cornwall 063A","E01018803","Total",1748,845,903,1748,0,21,108.14,16.2
"2011","Cornwall 063B","E01018804","Total",1878,881,997,1876,2,25,20.94,89.7
"2011","Cornwall 063C","E01018805","Total",1458,688,770,1458,0,26,70.73,20.6
"2011","Cornwall 063D","E01018806","Total",1532,744,788,1532,0,28,21.69,70.6
"2011","Cornwall 064A","E01018811","Total",1490,715,775,1490,0,9,37.02,40.2
"2011","Cornwall 064B","E01018812","Total",1374,661,713,1374,0,12,50.81,27.0
"2011","Cornwall 064C","E01018813","Total",1424,705,719,1424,0,20,199.60,7.1
"2011","Cornwall 064D","E01018814","Total",1437,694,743,1437,0,17,58.48,24.6
"2011","Cornwall 064E","E01018859","Total",1731,839,892,1731,0,24,63.84,27.1
"2011","Cornwall 045A","E01018889","Total",1334,642,692,1334,0,12,70.87,18.8
"2011","Cornwall 045B","E01018890","Total",1420,699,721,1420,0,10,332.95,4.3
"2011","Cornwall 045C","E01018891","Total",1297,618,679,1297,0,14,694.33,1.9
"2011","Cornwall 045D","E01018892","Total",1336,657,679,1336,0,23,888.33,1.5
"2011","Cornwall 045E","E01018893","Total",1353,661,692,1353,0,7,115.12,11.8
"2011","Cornwall 046A","E01018908","Total",1668,838,830,1668,0,8,894.98,1.9
"2011","Cornwall 046B","E01018909","Total",1591,765,826,1591,0,9,55.07,28.9
"2011","Cornwall 046C","E01018910","Total",1861,878,983,1861,0,10,79.60,23.4
"2011","Cornwall 046D","E01018911","Total",1684,837,847,1620,64,9,63.47,26.5
"2011","Cornwall 049A","E01018912","Total",1467,709,758,1443,24,4,194.58,7.5
"2011","Cornwall 049B","E01018913","Total",1837,930,907,1760,77,15,35.04,52.4
"2011","Cornwall 049C","E01018914","Total",1873,916,957,1873,0,7,269.33,7.0
"2011","Cornwall 049D","E01018915","Total",2037,976,1061,1987,50,13,58.01,35.1
"2011","Cornwall 050A","E01018916","Total",1328,624,704,1328,0,8,432.57,3.1
"2011","Cornwall 050B","E01018917","Total",1373,637,736,1370,3,12,158.86,8.6
"2011","Cornwall 050C","E01018918","Total",1772,850,922,1771,1,12,414.42,4.3
"2011","Cornwall 050D","E01018919","Total",1348,645,703,1347,1,4,171.37,7.9
"2011","Cornwall 051A","E01018894","Total",1810,899,911,1778,32,14,547.46,3.3
"2011","Cornwall 051B","E01018895","Total",1674,822,852,1674,0,13,154.97,10.8
"2011","Cornwall 051C","E01018896","Total",1528,777,751,1528,0,17,94.31,16.2
"2011","Cornwall 051D","E01018897","Total",1416,711,705,1416,0,7,371.28,3.8
"2011","Cornwall 051E","E01018898","Total",1293,617,676,1290,3,7,22.87,56.5
"2011","Cornwall 052A","E01018865","Total",1900,971,929,1900,0,12,104.95,18.1
"2011","Cornwall 052B","E01018866","Total",1601,769,832,1585,16,14,42.00,38.1
"2011","Cornwall 052C","E01018867","Total",1935,937,998,1888,47,11,70.94,27.3
"2011","Cornwall 052D","E01018868","Total",1768,854,914,1768,0,9,32.39,54.6
"2011","Cornwall 053A","E01018874","Total",1304,611,693,1297,7,13,57.87,22.5
"2011","Cornwall 053B","E01018875","Total",1348,598,750,1346,2,5,26.95,50.0
"2011","Cornwall 053C","E01018876","Total",1389,677,712,1389,0,7,1268.60,1.1
"2011","Cornwall 053D","E01018877","Total",1420,671,749,1420,0,20,176.16,8.1
"2011","Cornwall 053E","E01018878","Total",1405,685,720,1404,1,8,24.26,57.9
"2011","Cornwall 055A","E01018869","Total",1570,776,794,1570,0,8,138.27,11.4
"2011","Cornwall 055B","E01018870","Total",1293,611,682,1293,0,6,22.82,56.7
"2011","Cornwall 055C","E01018871","Total",1657,832,825,1657,0,17,63.87,25.9
"2011","Cornwall 055D","E01018872","Total",1250,606,644,1250,0,10,678.72,1.8
"2011","Cornwall 055E","E01018873","Total",1297,626,671,1297,0,7,102.47,12.7
"2011","Cornwall 059A","E01018863","Total",1652,813,839,1652,0,17,1878.50,0.9
"2011","Cornwall 059B","E01018864","Total",1639,807,832,1639,0,18,2231.62,0.7
"2011","Cornwall 059C","E01018921","Total",2101,1052,1049,2101,0,33,1747.53,1.2
"2011","Cornwall 059D","E01018922","Total",2372,1177,1195,2372,0,36,3649.57,0.6
"2011","Cornwall 066A","E01018879","Total",1753,828,925,1727,26,26,1535.80,1.1
"2011","Cornwall 066B","E01018880","Total",2137,1065,1072,2110,27,22,3375.34,0.6
"2011","Cornwall 066C","E01018899","Total",2601,1257,1344,1448,1153,26,1079.34,2.4
"2011","Cornwall 066D","E01018900","Total",1486,731,755,1486,0,15,967.65,1.5
"2011","Cornwall 066E","E01018901","Total",1668,808,860,1651,17,17,834.72,2.0
"2011","Cornwall 071A","E01018882","Total",1521,734,787,1521,0,27,100.21,15.2
"2011","Cornwall 071B","E01018883","Total",1570,778,792,1561,9,16,424.76,3.7
"2011","Cornwall 071C","E01018884","Total",1655,788,867,1654,1,24,43.40,38.1
"2011","Cornwall 071D","E01018885","Total",1486,735,751,1453,33,23,37.55,39.6
"2011","Cornwall 071E","E01018886","Total",1951,958,993,1946,5,27,520.90,3.7
"2011","Cornwall 071F","E01018887","Total",1587,764,823,1586,1,15,279.99,5.7
"2011","Cornwall 071G","E01018888","Total",1912,878,1034,1912,0,21,63.94,29.9
"2011","Cornwall 072A","E01018861","Total",1434,701,733,1434,0,20,1143.34,1.3
"2011","Cornwall 072B","E01018862","Total",1384,665,719,1384,0,21,1209.29,1.1
"2011","Cornwall 072C","E01018905","Total",1316,653,663,1316,0,13,2018.21,0.7
"2011","Cornwall 072D","E01018906","Total",1225,588,637,1225,0,12,91.47,13.4
"2011","Cornwall 072E","E01018907","Total",1226,584,642,1226,0,7,56.68,21.6
"2011","Cornwall 073A","E01018881","Total",1842,934,908,1842,0,27,2931.94,0.6
"2011","Cornwall 073B","E01018902","Total",1200,597,603,1183,17,25,2873.74,0.4
"2011","Cornwall 073C","E01018903","Total",1776,1151,625,1026,750,15,3123.19,0.6
"2011","Cornwall 073D","E01018904","Total",2091,1013,1078,2091,0,30,2029.13,1.0
"2011","Cornwall 073E","E01018920","Total",2008,1007,1001,2008,0,27,4174.54,0.5
"2011","Cornwall 001A","E01018936","Total",1518,755,763,1495,23,22,135.28,11.2
"2011","Cornwall 001B","E01018937","Total",1898,904,994,1874,24,23,74.41,25.5
"2011","Cornwall 001C","E01018938","Total",1675,809,866,1641,34,17,281.91,5.9
"2011","Cornwall 001D","E01018959","Total",1445,669,776,1387,58,25,728.38,2.0
"2011","Cornwall 001E","E01018960","Total",1920,930,990,1891,29,33,453.20,4.2
"2011","Cornwall 001F","E01018961","Total",1478,730,748,1428,50,24,66.06,22.4
"2011","Cornwall 002A","E01018943","Total",2121,1087,1034,2116,5,31,6724.27,0.3
"2011","Cornwall 002B","E01018951","Total",2254,1089,1165,2227,27,46,5548.69,0.4
"2011","Cornwall 002C","E01018974","Total",2570,1262,1308,2454,116,33,9723.19,0.3
"2011","Cornwall 003A","E01018940","Total",1558,747,811,1538,20,16,2846.86,0.5
"2011","Cornwall 003B","E01018941","Total",1554,760,794,1544,10,13,1220.18,1.3
"2011","Cornwall 003C","E01018942","Total",1519,733,786,1459,60,8,958.04,1.6
"2011","Cornwall 003D","E01018969","Total",2250,1084,1166,2209,41,28,6471.99,0.3
"2011","Cornwall 004B","E01018953","Total",1209,613,596,1209,0,21,4890.14,0.2
"2011","Cornwall 004C","E01018968","Total",2515,1231,1284,2440,75,23,11899.36,0.2
"2011","Cornwall 004D","E01033291","Total",1596,780,816,1573,23,16,1380.10,1.2
"2011","Cornwall 004E","E01033292","Total",1349,636,713,1349,0,13,51.86,26.0
"2011","Cornwall 005A","E01018946","Total",1491,700,791,1468,23,16,94.45,15.8
"2011","Cornwall 005B","E01018947","Total",2988,1438,1550,2850,138,25,470.45,6.4
"2011","Cornwall 005C","E01018948","Total",1677,818,859,1632,45,20,193.96,8.6
"2011","Cornwall 005D","E01018949","Total",1421,693,728,1402,19,16,52.89,26.9
"2011","Cornwall 005E","E01018950","Total",1639,803,836,1625,14,22,70.14,23.4
"2011","Cornwall 006A","E01018925","Total",2153,1032,1121,2092,61,34,10216.69,0.2
"2011","Cornwall 006B","E01018952","Total",1167,580,587,1162,5,20,2172.38,0.5
"2011","Cornwall 006C","E01018965","Total",2478,1185,1293,2318,160,35,5045.25,0.5
"2011","Cornwall 006D","E01018966","Total",1092,552,540,1086,6,19,3537.21,0.3
"2011","Cornwall 006E","E01018967","Total",1367,706,661,1291,76,22,1936.61,0.7
"2011","Cornwall 007A","E01018924","Total",1140,563,577,1118,22,25,5198.33,0.2
"2011","Cornwall 007B","E01018962","Total",2174,1058,1116,2046,128,30,4592.79,0.5
"2011","Cornwall 007E","E01033289","Total",2239,1071,1168,2093,146,34,3096.26,0.7
"2011","Cornwall 008A","E01018954","Total",1236,606,630,1227,9,10,2449.92,0.5
"2011","Cornwall 008B","E01018955","Total",1606,777,829,1543,63,14,1594.36,1.0
"2011","Cornwall 008C","E01018956","Total",1085,539,546,1076,9,13,2333.37,0.5
"2011","Cornwall 008D","E01018957","Total",1282,609,673,1280,2,17,1232.23,1.0
"2011","Cornwall 008E","E01018958","Total",1352,636,716,1307,45,8,113.19,11.9
"2011","Cornwall 009A","E01018970","Total",1521,725,796,1521,0,34,82.62,18.4
"2011","Cornwall 009B","E01018971","Total",2015,894,1121,1872,143,23,133.95,15.0
"2011","Cornwall 009C","E01018972","Total",1789,827,962,1749,40,15,44.75,40.0
"2011","Cornwall 009D","E01018973","Total",1396,633,763,1387,9,24,102.47,13.6
"2011","Cornwall 011A","E01018923","Total",1250,623,627,1235,15,26,2988.25,0.4
"2011","Cornwall 011B","E01018926","Total",2354,1139,1215,2335,19,32,12101.77,0.2
"2011","Cornwall 011C","E01018944","Total",1194,593,601,1148,46,10,1951.37,0.6
"2011","Cornwall 011D","E01018945","Total",1291,621,670,1264,27,11,2926.06,0.4
"2011","Cornwall 014A","E01018932","Total",1680,814,866,1633,47,14,235.64,7.1
"2011","Cornwall 014B","E01018933","Total",1418,716,702,1384,34,20,43.25,32.8
"2011","Cornwall 014C","E01018934","Total",1990,995,995,1988,2,30,378.01,5.3
"2011","Cornwall 014D","E01018935","Total",2259,1081,1178,2259,0,21,221.70,10.2
"2011","Cornwall 015A","E01018927","Total",1574,746,828,1554,20,15,93.83,16.8
"2011","Cornwall 015B","E01018928","Total",1754,830,924,1697,57,33,27.25,64.4
"2011","Cornwall 015C","E01018929","Total",1274,628,646,1215,59,7,195.09,6.5
"2011","Cornwall 015D","E01018930","Total",1603,754,849,1570,33,8,40.84,39.3
"2011","Cornwall 015E","E01018931","Total",1184,578,606,1175,9,9,104.84,11.3
"2011","Cornwall 054A","E01019008","Total",1428,643,785,1374,54,14,22.81,62.6
"2011","Cornwall 054B","E01019009","Total",1520,744,776,1517,3,12,661.47,2.3
"2011","Cornwall 054C","E01019010","Total",1372,642,730,1362,10,10,43.60,31.5
"2011","Cornwall 054D","E01019011","Total",1445,673,772,1350,95,17,230.73,6.3
"2011","Cornwall 054E","E01019012","Total",1778,853,925,1740,38,22,43.97,40.4
"2011","Cornwall 057A","E01018978","Total",1481,696,785,1481,0,6,775.66,1.9
"2011","Cornwall 057B","E01018981","Total",2046,965,1081,2012,34,22,93.60,21.9
"2011","Cornwall 057C","E01018982","Total",2149,1028,1121,2139,10,10,203.25,10.6
"2011","Cornwall 057D","E01018983","Total",1609,768,841,1532,77,18,110.67,14.5
"2011","Cornwall 057E","E01018984","Total",2118,1041,1077,2061,57,16,149.64,14.2
"2011","Cornwall 058A","E01018985","Total",2324,1111,1213,2185,139,32,623.73,3.7
"2011","Cornwall 058B","E01018986","Total",1568,722,846,1475,93,27,119.00,13.2
"2011","Cornwall 058C","E01018987","Total",2081,1032,1049,2076,5,46,2902.66,0.7
"2011","Cornwall 061A","E01018975","Total",1994,909,1085,1911,83,30,178.93,11.1
"2011","Cornwall 061B","E01018979","Total",1390,715,675,1317,73,16,1224.75,1.1
"2011","Cornwall 061C","E01018980","Total",1407,685,722,1323,84,6,1622.65,0.9
"2011","Cornwall 061D","E01018990","Total",1810,844,966,1753,57,13,563.98,3.2
"2011","Cornwall 061E","E01019007","Total",2202,1081,1121,2178,24,33,2704.78,0.8
"2011","Cornwall 065A","E01018988","Total",1537,734,803,1500,37,19,681.23,2.3
"2011","Cornwall 065B","E01018989","Total",1776,852,924,1695,81,28,5039.34,0.4
"2011","Cornwall 065C","E01018991","Total",1518,746,772,1518,0,22,1227.24,1.2
"2011","Cornwall 065D","E01019006","Total",1616,782,834,1557,59,23,3816.24,0.4
"2011","Cornwall 067A","E01018976","Total",2144,996,1148,2092,52,23,327.86,6.5
"2011","Cornwall 067B","E01018977","Total",1428,665,763,1411,17,17,19.78,72.2
"2011","Cornwall 067C","E01018994","Total",1632,764,868,1601,31,19,78.15,20.9
"2011","Cornwall 067D","E01018996","Total",1590,754,836,1531,59,23,58.67,27.1
"2011","Cornwall 067E","E01018997","Total",1471,683,788,1471,0,7,26.47,55.6
"2011","Cornwall 068A","E01018995","Total",2069,994,1075,1989,80,18,38.05,54.4
"2011","Cornwall 068B","E01018998","Total",1467,716,751,1434,33,8,12.73,115.2
"2011","Cornwall 068C","E01018999","Total",1447,698,749,1422,25,18,18.97,76.3
"2011","Cornwall 068D","E01019001","Total",1685,768,917,1631,54,11,32.03,52.6
"2011","Cornwall 069A","E01018992","Total",1624,799,825,1567,57,20,2325.48,0.7
"2011","Cornwall 069B","E01018993","Total",1670,809,861,1626,44,22,66.85,25.0
"2011","Cornwall 069C","E01019005","Total",2081,1032,1049,2030,51,18,3646.02,0.6
"2011","Cornwall 070A","E01019000","Total",1403,652,751,1370,33,21,61.15,22.9
"2011","Cornwall 070B","E01019002","Total",1390,695,695,1380,10,23,401.31,3.5
"2011","Cornwall 070C","E01019003","Total",1716,828,888,1687,29,28,167.01,10.3
"2011","Cornwall 070D","E01019004","Total",1603,768,835,1590,13,6,49.20,32.6
"2011","Cornwall 018A","E01019048","Total",1828,893,935,1734,94,26,463.71,3.9
"2011","Cornwall 018B","E01019049","Total",1817,906,911,1751,66,20,487.57,3.7
"2011","Cornwall 018C","E01019050","Total",1428,705,723,1366,62,12,1852.80,0.8
"2011","Cornwall 018D","E01019051","Total",1598,769,829,1583,15,11,64.97,24.6
"2011","Cornwall 019A","E01019060","Total",1659,805,854,1492,167,28,4008.94,0.4
"2011","Cornwall 019B","E01019061","Total",1728,850,878,1713,15,24,240.90,7.2
"2011","Cornwall 019C","E01019062","Total",1944,943,1001,1917,27,12,57.54,33.8
"2011","Cornwall 019D","E01019063","Total",1963,937,1026,1934,29,21,2614.85,0.8
"2011","Cornwall 019E","E01019064","Total",1931,952,979,1928,3,13,3163.76,0.6
"2011","Cornwall 019F","E01019065","Total",1326,674,652,1326,0,14,86.55,15.3
"2011","Cornwall 020A","E01019028","Total",2098,1016,1082,1997,101,15,84.37,24.9
"2011","Cornwall 020B","E01019029","Total",1453,699,754,1368,85,13,36.13,40.2
"2011","Cornwall 020C","E01019030","Total",1782,880,902,1754,28,33,75.60,23.6
"2011","Cornwall 020D","E01019031","Total",1558,766,792,1481,77,18,533.61,2.9
"2011","Cornwall 021A","E01019018","Total",1611,792,819,1598,13,20,64.41,25.0
"2011","Cornwall 021B","E01019019","Total",1417,693,724,1366,51,18,61.12,23.2
"2011","Cornwall 021C","E01019020","Total",1441,734,707,1414,27,12,39.56,36.4
"2011","Cornwall 021D","E01019021","Total",1486,738,748,1486,0,12,58.98,25.2
"2011","Cornwall 021E","E01019022","Total",1726,812,914,1695,31,14,37.06,46.6
"2011","Cornwall 021F","E01019023","Total",1596,788,808,1596,0,12,27.71,57.6
"2011","Cornwall 024A","E01019052","Total",1808,890,918,1771,37,17,3087.34,0.6
"2011","Cornwall 024B","E01019053","Total",1942,968,974,1942,0,14,1421.90,1.4
"2011","Cornwall 024C","E01019054","Total",1816,901,915,1816,0,11,1762.16,1.0
"2011","Cornwall 024D","E01019055","Total",1484,715,769,1484,0,5,58.39,25.4
"2011","Cornwall 027A","E01019035","Total",1519,715,804,1452,67,18,426.38,3.6
"2011","Cornwall 027B","E01019036","Total",1687,852,835,1667,20,10,3691.82,0.5
"2011","Cornwall 027C","E01019037","Total",1508,717,791,1448,60,8,1387.22,1.1
"2011","Cornwall 027D","E01019074","Total",1785,907,878,1775,10,7,359.72,5.0
"2011","Cornwall 027E","E01019075","Total",1731,854,877,1720,11,16,1377.42,1.3
"2011","Cornwall 027F","E01019076","Total",1870,953,917,1868,2,12,343.42,5.4
"2011","Cornwall 030A","E01019069","Total",1308,646,662,1308,0,5,640.01,2.0
"2011","Cornwall 030B","E01019070","Total",1999,970,1029,1999,0,9,399.24,5.0
"2011","Cornwall 030C","E01019071","Total",1580,774,806,1580,0,35,2048.74,0.8
"2011","Cornwall 030D","E01019072","Total",1514,730,784,1513,1,11,63.54,23.8
"2011","Cornwall 030E","E01019073","Total",1426,700,726,1415,11,21,753.18,1.9
"2011","Cornwall 031A","E01019056","Total",1628,805,823,1551,77,5,76.29,21.3
"2011","Cornwall 031B","E01019057","Total",1918,921,997,1849,69,12,134.46,14.3
"2011","Cornwall 031C","E01019058","Total",1773,857,916,1768,5,9,117.36,15.1
"2011","Cornwall 031D","E01019059","Total",1554,744,810,1550,4,16,363.39,4.3
"2011","Cornwall 035A","E01019024","Total",1446,702,744,1397,49,9,739.66,2.0
"2011","Cornwall 035B","E01019025","Total",1441,657,784,1326,115,32,1823.47,0.8
"2011","Cornwall 035C","E01019026","Total",1458,687,771,1444,14,20,137.65,10.6
"2011","Cornwall 035D","E01019027","Total",1513,712,801,1455,58,26,89.98,16.8
"2011","Cornwall 036A","E01019013","Total",2214,1084,1130,2191,23,11,79.65,27.8
"2011","Cornwall 036B","E01019014","Total",1395,650,745,1377,18,25,31.51,44.3
"2011","Cornwall 036C","E01019015","Total",1467,726,741,1432,35,19,31.78,46.2
"2011","Cornwall 036D","E01019016","Total",1881,903,978,1881,0,19,29.20,64.4
"2011","Cornwall 036E","E01019017","Total",2342,1133,1209,2302,40,34,551.99,4.2
"2011","Cornwall 038A","E01019032","Total",1482,744,738,1413,69,20,59.48,24.9
"2011","Cornwall 038B","E01019034","Total",1523,746,777,1474,49,13,381.19,4.0
"2011","Cornwall 038C","E01019045","Total",2145,1032,1113,2064,81,16,138.17,15.5
"2011","Cornwall 038D","E01019047","Total",1194,553,641,1066,128,13,65.31,18.3
"2011","Cornwall 039A","E01019033","Total",1403,671,732,1375,28,6,53.16,26.4
"2011","Cornwall 039B","E01019041","Total",1763,804,959,1649,114,16,42.01,42.0
"2011","Cornwall 039C","E01019042","Total",1709,827,882,1679,30,15,38.05,44.9
"2011","Cornwall 039D","E01019043","Total",1558,759,799,1503,55,9,78.69,19.8
"2011","Cornwall 039E","E01019044","Total",1487,698,789,1485,2,8,43.64,34.1
"2011","Cornwall 039F","E01019046","Total",1367,660,707,1367,0,13,22.98,59.5
"2011","Cornwall 041A","E01019038","Total",1106,516,590,1062,44,5,225.09,4.9
"2011","Cornwall 041B","E01019039","Total",1411,680,731,1345,66,23,2293.61,0.6
"2011","Cornwall 041C","E01019040","Total",1220,580,640,1213,7,11,538.86,2.3
"2011","Cornwall 041D","E01019066","Total",1212,590,622,1167,45,20,2509.18,0.5
"2011","Cornwall 041E","E01019067","Total",1143,545,598,1097,46,12,2185.34,0.5
"2011","Cornwall 041F","E01019068","Total",1620,799,821,1604,16,17,421.19,3.8
"2011","Isles of Scilly 001A","E01019077","Total",2203,1102,1101,2123,80,79,1637.47,1.3
"2011","North Somerset 001B","E01014790","Total",1489,735,754,1436,53,34,80.23,18.6
"2011","North Somerset 001C","E01014795","Total",1366,685,681,1366,0,11,33.50,40.8
"2011","North Somerset 001D","E01014797","Total",1727,869,858,1727,0,25,50.96,33.9
"2011","North Somerset 001E","E01032675","Total",1355,700,655,1355,0,10,17.87,75.8
"2011","North Somerset 001F","E01032676","Total",1334,674,660,1334,0,9,37.19,35.9
"2011","North Somerset 001G","E01032681","Total",1232,570,662,1232,0,13,40.89,30.1
"2011","North Somerset 002A","E01014789","Total",1327,668,659,1287,40,24,77.09,17.2
"2011","North Somerset 002B","E01014793","Total",1512,720,792,1512,0,30,67.47,22.4
"2011","North Somerset 002C","E01014794","Total",1643,781,862,1643,0,43,64.81,25.4
"2011","North Somerset 002D","E01014798","Total",1532,769,763,1532,0,36,50.25,30.5
"2011","North Somerset 003B","E01014792","Total",1818,849,969,1818,0,18,88.12,20.6
"2011","North Somerset 003C","E01014796","Total",1695,812,883,1663,32,22,177.17,9.6
"2011","North Somerset 003D","E01032677","Total",1365,652,713,1365,0,6,32.20,42.4
"2011","North Somerset 003E","E01032678","Total",1589,807,782,1589,0,15,25.53,62.2
"2011","North Somerset 003F","E01032682","Total",1059,501,558,1059,0,12,22.72,46.6
"2011","North Somerset 004A","E01014766","Total",1352,675,677,1267,85,39,1030.96,1.3
"2011","North Somerset 004B","E01014767","Total",1303,657,646,1303,0,19,614.21,2.1
"2011","North Somerset 004C","E01014786","Total",1596,811,785,1596,0,7,31.23,51.1
"2011","North Somerset 004D","E01014787","Total",1929,942,987,1892,37,28,132.16,14.6
"2011","North Somerset 005A","E01014752","Total",1515,752,763,1510,5,25,510.59,3.0
"2011","North Somerset 005B","E01014754","Total",1145,546,599,1114,31,12,30.64,37.4
"2011","North Somerset 005C","E01014758","Total",1353,608,745,1199,154,31,81.31,16.6
"2011","North Somerset 005D","E01014759","Total",1396,692,704,1353,43,32,54.24,25.7
"2011","North Somerset 006B","E01014849","Total",1550,780,770,1547,3,30,822.43,1.9
"2011","North Somerset 006C","E01014850","Total",2073,1014,1059,2043,30,67,480.72,4.3
"2011","North Somerset 006D","E01014851","Total",2559,1247,1312,2559,0,26,186.29,13.7
"2011","North Somerset 006E","E01014852","Total",1611,790,821,1554,57,48,1495.53,1.1
"2011","North Somerset 006F","E01032674","Total",2483,1265,1218,2483,0,21,1086.75,2.3
"2011","North Somerset 006G","E01032680","Total",1832,912,920,1832,0,36,1988.02,0.9
"2011","North Somerset 007A","E01014750","Total",1621,768,853,1547,74,21,28.46,57.0
"2011","North Somerset 007B","E01014751","Total",1627,780,847,1584,43,17,31.58,51.5
"2011","North Somerset 007C","E01014753","Total",1810,890,920,1777,33,14,37.49,48.3
"2011","North Somerset 007D","E01014755","Total",1386,613,773,1165,221,14,42.80,32.4
"2011","North Somerset 007E","E01014760","Total",1457,704,753,1457,0,11,53.49,27.2
"2011","North Somerset 008A","E01014780","Total",1545,737,808,1545,0,10,40.08,38.5
"2011","North Somerset 008B","E01014781","Total",1605,753,852,1605,0,15,40.95,39.2
"2011","North Somerset 008C","E01014782","Total",1391,686,705,1391,0,16,82.14,16.9
"2011","North Somerset 008D","E01014783","Total",1549,766,783,1549,0,31,103.76,14.9
"2011","North Somerset 008E","E01014784","Total",1569,741,828,1569,0,27,35.86,43.8
"2011","North Somerset 008F","E01014785","Total",1386,663,723,1386,0,30,643.99,2.2
"2011","North Somerset 009A","E01014775","Total",1231,613,618,1231,0,39,24.35,50.6
"2011","North Somerset 009B","E01014776","Total",1317,646,671,1317,0,38,50.09,26.3
"2011","North Somerset 009C","E01014777","Total",1547,739,808,1547,0,26,39.46,39.2
"2011","North Somerset 009D","E01014778","Total",1298,649,649,1298,0,36,97.43,13.3
"2011","North Somerset 009E","E01014779","Total",1192,566,626,1153,39,24,36.67,32.5
"2011","North Somerset 010A","E01014756","Total",1623,779,844,1622,1,14,28.15,57.7
"2011","North Somerset 010B","E01014757","Total",1473,727,746,1473,0,18,33.06,44.6
"2011","North Somerset 010C","E01014761","Total",1614,768,846,1614,0,17,160.77,10.0
"2011","North Somerset 010D","E01014762","Total",1437,696,741,1437,0,23,159.00,9.0
"2011","North Somerset 010E","E01014763","Total",1824,896,928,1821,3,26,27.29,66.8
"2011","North Somerset 011A","E01014737","Total",1507,736,771,1507,0,53,217.43,6.9
"2011","North Somerset 011B","E01014738","Total",1465,710,755,1457,8,30,87.44,16.8
"2011","North Somerset 011C","E01014739","Total",1488,726,762,1462,26,47,1202.98,1.2
"2011","North Somerset 011D","E01014740","Total",1328,644,684,1321,7,34,1275.93,1.0
"2011","North Somerset 012A","E01014855","Total",1437,700,737,1406,31,22,520.90,2.8
"2011","North Somerset 012B","E01014856","Total",1540,772,768,1536,4,32,945.60,1.6
"2011","North Somerset 012C","E01014857","Total",1521,743,778,1521,0,33,90.45,16.8
"2011","North Somerset 012D","E01014858","Total",1721,847,874,1717,4,28,1909.27,0.9
"2011","North Somerset 012E","E01014859","Total",1571,767,804,1514,57,19,49.82,31.5
"2011","North Somerset 012F","E01014860","Total",1483,739,744,1483,0,28,51.27,28.9
"2011","North Somerset 013A","E01014847","Total",1713,847,866,1713,0,43,1398.17,1.2
"2011","North Somerset 013B","E01014848","Total",1269,638,631,1268,1,22,1035.42,1.2
"2011","North Somerset 013C","E01014853","Total",1645,778,867,1645,0,31,181.79,9.0
"2011","North Somerset 013D","E01014854","Total",1348,638,710,1348,0,28,2643.96,0.5
"2011","North Somerset 014A","E01014764","Total",1606,738,868,1606,0,31,469.77,3.4
"2011","North Somerset 014B","E01014765","Total",1891,864,1027,1838,53,36,1080.89,1.7
"2011","North Somerset 014C","E01014773","Total",1690,846,844,1690,0,26,1434.68,1.2
"2011","North Somerset 014D","E01014774","Total",1690,815,875,1583,107,15,855.87,2.0
"2011","North Somerset 015A","E01014821","Total",1218,566,652,1218,0,11,13.62,89.4
"2011","North Somerset 015B","E01014822","Total",1474,718,756,1474,0,19,33.97,43.4
"2011","North Somerset 015C","E01014823","Total",1292,651,641,1292,0,23,24.83,52.0
"2011","North Somerset 015D","E01014824","Total",1457,698,759,1457,0,17,43.83,33.2
"2011","North Somerset 015E","E01014825","Total",1226,609,617,1226,0,13,25.77,47.6
"2011","North Somerset 015F","E01014826","Total",1573,749,824,1573,0,18,33.23,47.3
"2011","North Somerset 015G","E01014827","Total",1359,692,667,1359,0,7,19.21,70.7
"2011","North Somerset 016A","E01014817","Total",1520,735,785,1520,0,15,64.67,23.5
"2011","North Somerset 016B","E01014820","Total",1401,656,745,1392,9,17,31.62,44.3
"2011","North Somerset 016C","E01014835","Total",1414,655,759,1414,0,10,22.88,61.8
"2011","North Somerset 016D","E01014836","Total",1468,689,779,1468,0,9,27.71,53.0
"2011","North Somerset 016E","E01014838","Total",1396,659,737,1396,0,19,31.85,43.8
"2011","North Somerset 016F","E01014840","Total",1390,652,738,1390,0,14,27.30,50.9
"2011","North Somerset 017A","E01014812","Total",1406,676,730,1406,0,16,31.47,44.7
"2011","North Somerset 017B","E01014813","Total",1734,863,871,1734,0,18,35.02,49.5
"2011","North Somerset 017C","E01014815","Total",1340,677,663,1340,0,18,23.89,56.1
"2011","North Somerset 017D","E01014816","Total",1457,706,751,1457,0,21,36.20,40.2
"2011","North Somerset 017E","E01014818","Total",1698,827,871,1698,0,24,93.22,18.2
"2011","North Somerset 017F","E01014819","Total",1531,734,797,1531,0,14,51.04,30.0
"2011","North Somerset 018A","E01014841","Total",1670,884,786,1587,83,7,112.95,14.8
"2011","North Somerset 018B","E01014842","Total",1486,746,740,1378,108,4,35.84,41.5
"2011","North Somerset 018C","E01014843","Total",1465,674,791,1252,213,9,41.66,35.2
"2011","North Somerset 018D","E01014844","Total",1233,599,634,1180,53,6,17.22,71.6
"2011","North Somerset 018E","E01014845","Total",1221,581,640,1206,15,14,70.57,17.3
"2011","North Somerset 018F","E01014846","Total",1508,720,788,1382,126,27,33.55,44.9
"2011","North Somerset 020A","E01014799","Total",1564,802,762,1503,61,15,21.14,74.0
"2011","North Somerset 020B","E01014800","Total",1535,815,720,1535,0,2,13.82,111.1
"2011","North Somerset 020C","E01014801","Total",1549,772,777,1330,219,6,59.19,26.2
"2011","North Somerset 020D","E01014802","Total",1549,741,808,1347,202,10,21.97,70.5
"2011","North Somerset 020E","E01014809","Total",1715,859,856,1680,35,8,55.42,30.9
"2011","North Somerset 020F","E01014811","Total",1594,757,837,1561,33,14,30.63,52.0
"2011","North Somerset 021A","E01014829","Total",1826,859,967,1793,33,10,62.49,29.2
"2011","North Somerset 021B","E01014830","Total",1571,779,792,1562,9,12,37.75,41.6
"2011","North Somerset 021C","E01014831","Total",1253,609,644,1253,0,6,17.74,70.6
"2011","North Somerset 021D","E01014832","Total",1418,688,730,1418,0,3,30.54,46.4
"2011","North Somerset 021E","E01014833","Total",1466,695,771,1466,0,4,47.18,31.1
"2011","North Somerset 022A","E01014804","Total",1347,630,717,1249,98,15,113.39,11.9
"2011","North Somerset 022B","E01014806","Total",1643,751,892,1377,266,12,27.50,59.7
"2011","North Somerset 022C","E01014807","Total",1637,825,812,1613,24,13,19.86,82.4
"2011","North Somerset 022D","E01014808","Total",1426,687,739,1426,0,22,29.06,49.1
"2011","North Somerset 023A","E01014744","Total",1342,644,698,1342,0,26,1157.94,1.2
"2011","North Somerset 023B","E01014746","Total",1410,681,729,1410,0,17,96.86,14.6
"2011","North Somerset 023C","E01014769","Total",2349,1153,1196,2349,0,14,530.17,4.4
"2011","North Somerset 023D","E01014770","Total",1354,657,697,1354,0,16,110.42,12.3
"2011","North Somerset 023E","E01014771","Total",1386,667,719,1383,3,19,275.06,5.0
"2011","North Somerset 023F","E01014772","Total",1328,632,696,1319,9,16,1082.31,1.2
"2011","North Somerset 024A","E01014741","Total",1438,655,783,1388,50,23,633.48,2.3
"2011","North Somerset 024B","E01014742","Total",1565,790,775,1416,149,32,311.57,5.0
"2011","North Somerset 024C","E01014745","Total",1543,726,817,1451,92,27,618.29,2.5
"2011","North Somerset 024D","E01014747","Total",1353,656,697,1353,0,37,1067.27,1.3
"2011","North Somerset 024E","E01014748","Total",1106,540,566,1097,9,25,582.86,1.9
"2011","North Somerset 024F","E01014749","Total",1356,667,689,1337,19,35,647.15,2.1
"2011","North Somerset 025A","E01014803","Total",1507,738,769,1445,62,25,159.89,9.4
"2011","North Somerset 025B","E01014805","Total",1437,704,733,1422,15,16,89.87,16.0
"2011","North Somerset 025C","E01014828","Total",1440,691,749,1440,0,9,33.37,43.2
"2011","North Somerset 025D","E01014834","Total",1393,613,780,1393,0,8,43.38,32.1
"2011","North Somerset 026A","E01014839","Total",1600,777,823,1600,0,12,51.87,30.8
"2011","North Somerset 026B","E01032666","Total",1153,573,580,1153,0,9,1019.12,1.1
"2011","North Somerset 026C","E01032667","Total",1089,553,536,1089,0,13,33.88,32.1
"2011","North Somerset 026D","E01032668","Total",1496,738,758,1496,0,18,71.22,21.0
"2011","North Somerset 026E","E01032672","Total",1330,642,688,1321,9,10,93.39,14.2
"2011","North Somerset 026F","E01032673","Total",1302,614,688,1247,55,6,40.44,32.2
"2011","North Somerset 027A","E01014810","Total",1312,631,681,1312,0,8,313.05,4.2
"2011","North Somerset 027B","E01032669","Total",1469,716,753,1469,0,7,21.23,69.2
"2011","North Somerset 027C","E01032670","Total",1645,799,846,1645,0,12,26.13,63.0
"2011","North Somerset 027D","E01032671","Total",1397,680,717,1397,0,8,18.46,75.7
"2011","North Somerset 027E","E01032679","Total",1281,630,651,1281,0,3,19.53,65.6
"2011","Plymouth 001A","E01015025","Total",1576,738,838,1504,72,23,76.03,20.7
"2011","Plymouth 001B","E01015097","Total",1669,810,859,1667,2,10,180.82,9.2
"2011","Plymouth 001C","E01015160","Total",1485,703,782,1485,0,9,49.65,29.9
"2011","Plymouth 001D","E01015164","Total",1999,962,1037,1988,11,19,54.62,36.6
"2011","Plymouth 002A","E01015027","Total",1623,791,832,1623,0,12,67.79,23.9
"2011","Plymouth 002B","E01015159","Total",1609,735,874,1600,9,2,53.36,30.2
"2011","Plymouth 002C","E01015161","Total",1483,705,778,1483,0,8,29.94,49.5
"2011","Plymouth 002D","E01015162","Total",1447,692,755,1447,0,6,35.22,41.1
"2011","Plymouth 002E","E01015166","Total",1871,924,947,1865,6,6,89.03,21.0
"2011","Plymouth 003A","E01015023","Total",1644,802,842,1640,4,9,91.48,18.0
"2011","Plymouth 003B","E01015026","Total",1582,775,807,1582,0,6,23.84,66.4
"2011","Plymouth 003C","E01015028","Total",1446,701,745,1446,0,7,27.33,52.9
"2011","Plymouth 003D","E01015163","Total",1451,702,749,1406,45,9,80.51,18.0
"2011","Plymouth 003E","E01015165","Total",1684,814,870,1684,0,22,53.43,31.5
"2011","Plymouth 004A","E01015024","Total",1431,719,712,1431,0,13,39.92,35.8
"2011","Plymouth 004B","E01015082","Total",1625,793,832,1625,0,7,108.68,15.0
"2011","Plymouth 004C","E01015083","Total",1472,723,749,1448,24,3,126.25,11.7
"2011","Plymouth 004D","E01015084","Total",1467,702,765,1467,0,9,52.54,27.9
"2011","Plymouth 005A","E01015090","Total",1370,684,686,1370,0,9,79.38,17.3
"2011","Plymouth 005B","E01015091","Total",1539,757,782,1539,0,16,113.29,13.6
"2011","Plymouth 005C","E01015092","Total",1570,726,844,1089,481,22,246.16,6.4
"2011","Plymouth 005D","E01015093","Total",1378,672,706,1378,0,6,25.34,54.4
"2011","Plymouth 005E","E01015094","Total",1405,642,763,1403,2,3,44.12,31.8
"2011","Plymouth 006A","E01015085","Total",1611,754,857,1611,0,7,51.30,31.4
"2011","Plymouth 006B","E01015087","Total",1594,800,794,1594,0,8,33.71,47.3
"2011","Plymouth 006C","E01015088","Total",1601,736,865,1584,17,4,18.51,86.5
"2011","Plymouth 006D","E01015147","Total",1249,599,650,1202,47,4,24.66,50.6
"2011","Plymouth 006E","E01015148","Total",1515,743,772,1515,0,3,62.69,24.2
"2011","Plymouth 007A","E01015030","Total",1566,756,810,1550,16,5,40.28,38.9
"2011","Plymouth 007B","E01015070","Total",2519,1238,1281,2500,19,20,57.46,43.8
"2011","Plymouth 007C","E01015081","Total",1555,734,821,1555,0,7,28.69,54.2
"2011","Plymouth 007D","E01015086","Total",1342,604,738,1342,0,6,31.73,42.3
"2011","Plymouth 007E","E01015089","Total",1672,800,872,1606,66,4,49.35,33.9
"2011","Plymouth 008A","E01015029","Total",1910,905,1005,1910,0,22,92.28,20.7
"2011","Plymouth 008B","E01015064","Total",1623,765,858,1620,3,18,53.42,30.4
"2011","Plymouth 008C","E01015065","Total",1464,693,771,1464,0,14,25.50,57.4
"2011","Plymouth 008D","E01015071","Total",1524,732,792,1524,0,19,48.45,31.5
"2011","Plymouth 009A","E01015076","Total",1438,704,734,1438,0,3,27.06,53.1
"2011","Plymouth 009B","E01015142","Total",1312,647,665,1312,0,5,37.99,34.5
"2011","Plymouth 009C","E01015143","Total",1344,665,679,1344,0,10,23.92,56.2
"2011","Plymouth 009D","E01015144","Total",1529,754,775,1529,0,8,20.59,74.3
"2011","Plymouth 009E","E01015146","Total",1772,840,932,1772,0,15,28.30,62.6
"2011","Plymouth 009F","E01015149","Total",1451,712,739,1451,0,5,20.31,71.4
"2011","Plymouth 009G","E01015150","Total",1378,701,677,1378,0,5,29.35,47.0
"2011","Plymouth 010A","E01015063","Total",1440,674,766,1440,0,7,39.32,36.6
"2011","Plymouth 010B","E01015068","Total",1628,801,827,1628,0,6,42.52,38.3
"2011","Plymouth 010C","E01015069","Total",1594,744,850,1594,0,1,42.47,37.5
"2011","Plymouth 010D","E01015095","Total",1394,682,712,1394,0,9,103.00,13.5
"2011","Plymouth 010E","E01015096","Total",1443,671,772,1443,0,10,44.48,32.4
"2011","Plymouth 011A","E01015074","Total",1519,712,807,1510,9,6,57.67,26.3
"2011","Plymouth 011B","E01015077","Total",1714,826,888,1683,31,14,54.24,31.6
"2011","Plymouth 011C","E01015079","Total",1481,728,753,1481,0,13,26.93,55.0
"2011","Plymouth 011D","E01015102","Total",1687,838,849,1683,4,14,27.33,61.7
"2011","Plymouth 011E","E01015104","Total",1534,744,790,1534,0,20,20.80,73.8
"2011","Plymouth 012A","E01015035","Total",1537,745,792,1537,0,16,29.19,52.7
"2011","Plymouth 012B","E01015037","Total",1340,635,705,1340,0,8,21.15,63.4
"2011","Plymouth 012C","E01015058","Total",1471,690,781,1471,0,10,34.61,42.5
"2011","Plymouth 012D","E01015066","Total",1485,719,766,1485,0,9,50.83,29.2
"2011","Plymouth 012E","E01015067","Total",1514,764,750,1482,32,13,41.91,36.1
"2011","Plymouth 013A","E01015072","Total",1597,783,814,1588,9,7,24.84,64.3
"2011","Plymouth 013B","E01015073","Total",1450,708,742,1450,0,8,69.59,20.8
"2011","Plymouth 013C","E01015078","Total",1245,597,648,1245,0,1,20.26,61.5
"2011","Plymouth 013D","E01015080","Total",1406,702,704,1406,0,9,15.53,90.5
"2011","Plymouth 013E","E01015106","Total",1232,605,627,1232,0,10,62.89,19.6
"2011","Plymouth 014A","E01015039","Total",1292,689,603,1081,211,5,37.67,34.3
"2011","Plymouth 014B","E01015040","Total",1505,757,748,1505,0,10,28.49,52.8
"2011","Plymouth 014C","E01015041","Total",1419,713,706,1419,0,4,79.71,17.8
"2011","Plymouth 014D","E01015075","Total",1444,660,784,1444,0,7,40.00,36.1
"2011","Plymouth 014E","E01015145","Total",1819,856,963,1815,4,10,77.04,23.6
"2011","Plymouth 015A","E01015120","Total",1566,757,809,1516,50,30,177.01,8.8
"2011","Plymouth 015B","E01015121","Total",1508,696,812,1508,0,11,54.22,27.8
"2011","Plymouth 015C","E01015123","Total",1695,759,936,1522,173,7,51.44,33.0
"2011","Plymouth 015D","E01015124","Total",1598,768,830,1571,27,10,70.55,22.7
"2011","Plymouth 015E","E01015125","Total",1538,738,800,1538,0,27,70.03,22.0
"2011","Plymouth 016A","E01015033","Total",1570,788,782,1570,0,25,40.53,38.7
"2011","Plymouth 016B","E01015034","Total",1401,671,730,1326,75,42,36.46,38.4
"2011","Plymouth 016C","E01015036","Total",1481,705,776,1481,0,22,39.58,37.4
"2011","Plymouth 016D","E01015038","Total",1718,860,858,1695,23,27,37.62,45.7
"2011","Plymouth 016E","E01015101","Total",1624,764,860,1541,83,37,40.89,39.7
"2011","Plymouth 017A","E01015098","Total",1565,774,791,1565,0,26,16.96,92.3
"2011","Plymouth 017B","E01015099","Total",1476,684,792,1476,0,14,72.74,20.3
"2011","Plymouth 017C","E01015100","Total",1477,744,733,1477,0,12,18.02,82.0
"2011","Plymouth 017D","E01015103","Total",1476,719,757,1459,17,19,15.33,96.3
"2011","Plymouth 017E","E01015105","Total",1482,710,772,1468,14,12,15.02,98.7
"2011","Plymouth 018A","E01015107","Total",1552,760,792,1552,0,6,31.85,48.7
"2011","Plymouth 018B","E01015110","Total",1588,831,757,1588,0,15,29.25,54.3
"2011","Plymouth 018C","E01015111","Total",1641,776,865,1641,0,14,23.40,70.1
"2011","Plymouth 018D","E01015119","Total",1725,857,868,1725,0,8,44.14,39.1
"2011","Plymouth 019A","E01015112","Total",1497,713,784,1416,81,10,116.09,12.9
"2011","Plymouth 019B","E01015113","Total",1495,731,764,1495,0,16,110.01,13.6
"2011","Plymouth 019C","E01015114","Total",1479,714,765,1455,24,15,59.84,24.7
"2011","Plymouth 019D","E01015118","Total",1634,783,851,1634,0,20,50.68,32.2
"2011","Plymouth 019E","E01015122","Total",1592,763,829,1582,10,3,31.45,50.6
"2011","Plymouth 020A","E01015042","Total",1473,732,741,1473,0,13,10.17,144.8
"2011","Plymouth 020B","E01015044","Total",1454,768,686,1408,46,5,15.11,96.2
"2011","Plymouth 020C","E01015167","Total",1547,801,746,1543,4,17,15.46,100.1
"2011","Plymouth 020D","E01015168","Total",1810,922,888,1810,0,14,20.92,86.5
"2011","Plymouth 020E","E01015171","Total",1730,883,847,1585,145,17,20.96,82.5
"2011","Plymouth 021A","E01015055","Total",1433,696,737,1433,0,3,68.83,20.8
"2011","Plymouth 021B","E01015056","Total",1566,752,814,1533,33,7,39.23,39.9
"2011","Plymouth 021C","E01015057","Total",1493,689,804,1493,0,4,22.10,67.6
"2011","Plymouth 021D","E01015059","Total",1555,788,767,1555,0,8,21.17,73.5
"2011","Plymouth 021E","E01015060","Total",1573,761,812,1573,0,9,54.46,28.9
"2011","Plymouth 021F","E01015176","Total",1464,717,747,1427,37,6,30.55,47.9
"2011","Plymouth 022A","E01015108","Total",1952,951,1001,1952,0,15,37.15,52.5
"2011","Plymouth 022B","E01015109","Total",1457,714,743,1457,0,12,32.28,45.1
"2011","Plymouth 022C","E01015115","Total",1435,625,810,1362,73,17,50.07,28.7
"2011","Plymouth 022D","E01015116","Total",1497,739,758,1497,0,12,30.20,49.6
"2011","Plymouth 022E","E01015117","Total",1450,716,734,1450,0,13,41.39,35.0
"2011","Plymouth 023A","E01015031","Total",1608,825,783,1541,67,16,21.05,76.4
"2011","Plymouth 023B","E01015032","Total",2022,1176,846,1879,143,15,22.08,91.6
"2011","Plymouth 023C","E01015049","Total",1621,897,724,1578,43,12,12.44,130.3
"2011","Plymouth 023D","E01015050","Total",1855,1032,823,1756,99,9,14.76,125.7
"2011","Plymouth 023E","E01015051","Total",1935,1019,916,1539,396,24,19.66,98.4
"2011","Plymouth 024A","E01015169","Total",1990,1068,922,1832,158,33,30.08,66.2
"2011","Plymouth 024B","E01015170","Total",1614,792,822,1580,34,16,33.13,48.7
"2011","Plymouth 024C","E01015173","Total",1733,867,866,1658,75,21,36.24,47.8
"2011","Plymouth 024D","E01015174","Total",1639,796,843,1604,35,16,21.87,74.9
"2011","Plymouth 025A","E01015061","Total",1457,708,749,1452,5,9,16.56,88.0
"2011","Plymouth 025B","E01015062","Total",2104,1096,1008,1949,155,21,16.15,130.3
"2011","Plymouth 025C","E01015175","Total",1663,854,809,1633,30,13,14.77,112.6
"2011","Plymouth 025D","E01015177","Total",1744,897,847,1741,3,8,17.74,98.3
"2011","Plymouth 025E","E01015178","Total",2050,1089,961,2026,24,20,17.69,115.9
"2011","Plymouth 026A","E01015043","Total",1491,770,721,1491,0,6,16.16,92.3
"2011","Plymouth 026B","E01015045","Total",1469,741,728,1452,17,5,60.82,24.2
"2011","Plymouth 026C","E01015046","Total",2005,1044,961,1952,53,10,52.62,38.1
"2011","Plymouth 026D","E01015047","Total",1504,720,784,1504,0,5,61.87,24.3
"2011","Plymouth 026E","E01015048","Total",1176,642,534,1176,0,15,17.73,66.3
"2011","Plymouth 027A","E01015053","Total",1496,824,672,1320,176,10,8.69,172.2
"2011","Plymouth 027B","E01015054","Total",2275,1186,1089,1475,800,28,19.70,115.5
"2011","Plymouth 027C","E01015152","Total",1837,989,848,1796,41,8,31.57,58.2
"2011","Plymouth 027E","E01015156","Total",1492,851,641,1189,303,7,55.05,27.1
"2011","Plymouth 027F","E01032657","Total",1525,760,765,1444,81,7,17.71,86.1
"2011","Plymouth 027G","E01032658","Total",1261,634,627,1261,0,4,20.46,61.6
"2011","Plymouth 028A","E01015052","Total",1967,1001,966,1902,65,12,11.91,165.2
"2011","Plymouth 028B","E01015179","Total",1710,891,819,1669,41,15,13.89,123.1
"2011","Plymouth 028C","E01015180","Total",1760,930,830,1760,0,5,48.36,36.4
"2011","Plymouth 028D","E01015181","Total",2056,1094,962,2035,21,16,26.77,76.8
"2011","Plymouth 028E","E01015182","Total",1847,934,913,1847,0,10,94.39,19.6
"2011","Plymouth 029A","E01015151","Total",1917,1034,883,1915,2,18,18.78,102.1
"2011","Plymouth 029B","E01015153","Total",1762,917,845,1734,28,6,22.52,78.2
"2011","Plymouth 029C","E01015155","Total",1749,952,797,1719,30,4,23.85,73.3
"2011","Plymouth 029D","E01015157","Total",2079,1161,918,2019,60,9,58.76,35.4
"2011","Plymouth 029E","E01015158","Total",2163,1158,1005,2100,63,2,61.53,35.2
"2011","Plymouth 029F","E01015172","Total",1798,922,876,1790,8,21,41.23,43.6
"2011","Plymouth 030A","E01015126","Total",1429,643,786,1405,24,23,41.68,34.3
"2011","Plymouth 030B","E01015127","Total",1502,721,781,1428,74,20,37.46,40.1
"2011","Plymouth 030C","E01015131","Total",1476,706,770,1458,18,19,270.80,5.5
"2011","Plymouth 030D","E01015132","Total",1507,714,793,1507,0,12,64.74,23.3
"2011","Plymouth 030E","E01015133","Total",1535,727,808,1535,0,19,53.69,28.6
"2011","Plymouth 031A","E01015135","Total",1545,761,784,1532,13,10,420.97,3.7
"2011","Plymouth 031B","E01015136","Total",1517,709,808,1515,2,20,47.55,31.9
"2011","Plymouth 031C","E01015137","Total",1572,759,813,1555,17,22,49.41,31.8
"2011","Plymouth 031D","E01015138","Total",1518,781,737,1518,0,14,81.45,18.6
"2011","Plymouth 031E","E01015139","Total",1454,697,757,1423,31,3,121.92,11.9
"2011","Plymouth 031F","E01015141","Total",1820,879,941,1820,0,26,65.02,28.0
"2011","Plymouth 032A","E01015128","Total",1634,762,872,1634,0,9,43.76,37.3
"2011","Plymouth 032B","E01015129","Total",1481,712,769,1481,0,11,34.05,43.5
"2011","Plymouth 032C","E01015130","Total",1714,873,841,1714,0,17,76.80,22.3
"2011","Plymouth 032D","E01015134","Total",1538,722,816,1528,10,20,43.66,35.2
"2011","Plymouth 032E","E01015140","Total",1516,731,785,1516,0,22,41.90,36.2
"2011","Poole 001A","E01015431","Total",1487,740,747,1090,397,36,785.78,1.9
"2011","Poole 001B","E01015432","Total",1643,775,868,1643,0,25,103.36,15.9
"2011","Poole 001C","E01015433","Total",1480,735,745,1480,0,31,356.10,4.2
"2011","Poole 001D","E01015434","Total",1631,773,858,1582,49,42,185.43,8.8
"2011","Poole 002A","E01015379","Total",1461,689,772,1368,93,2,95.72,15.3
"2011","Poole 002B","E01015435","Total",1523,760,763,1523,0,7,149.21,10.2
"2011","Poole 002C","E01015436","Total",1348,675,673,1339,9,21,34.78,38.8
"2011","Poole 002D","E01015437","Total",1280,636,644,1280,0,20,30.61,41.8
"2011","Poole 003A","E01015395","Total",1327,623,704,1319,8,28,52.73,25.2
"2011","Poole 003B","E01015396","Total",1540,722,818,1508,32,36,87.90,17.5
"2011","Poole 003C","E01015397","Total",1496,726,770,1496,0,39,42.57,35.1
"2011","Poole 003D","E01015398","Total",1390,686,704,1390,0,28,38.40,36.2
"2011","Poole 003E","E01015399","Total",1509,701,808,1452,57,36,201.78,7.5
"2011","Poole 003F","E01015400","Total",1518,736,782,1518,0,29,56.71,26.8
"2011","Poole 003G","E01015401","Total",1523,725,798,1523,0,41,133.09,11.4
"2011","Poole 004A","E01015412","Total",1307,664,643,1307,0,37,133.72,9.8
"2011","Poole 004B","E01015413","Total",1457,702,755,1457,0,14,21.95,66.4
"2011","Poole 004C","E01015414","Total",1454,692,762,1454,0,17,44.20,32.9
"2011","Poole 004D","E01015415","Total",1262,626,636,1262,0,9,21.89,57.7
"2011","Poole 004E","E01015416","Total",1335,640,695,1335,0,27,98.03,13.6
"2011","Poole 005A","E01015407","Total",1478,706,772,1467,11,5,73.50,20.1
"2011","Poole 005B","E01015408","Total",1405,678,727,1365,40,8,34.22,41.1
"2011","Poole 005C","E01015409","Total",1507,741,766,1499,8,6,22.23,67.8
"2011","Poole 005D","E01015410","Total",1515,753,762,1515,0,10,27.99,54.1
"2011","Poole 005E","E01015411","Total",1359,649,710,1359,0,16,33.91,40.1
"2011","Poole 006A","E01015417","Total",1460,721,739,1460,0,2,42.97,34.0
"2011","Poole 006B","E01015418","Total",1522,755,767,1522,0,20,102.34,14.9
"2011","Poole 006C","E01015419","Total",1756,839,917,1756,0,17,42.75,41.1
"2011","Poole 006D","E01015420","Total",1560,739,821,1560,0,4,34.10,45.7
"2011","Poole 006E","E01015421","Total",1435,673,762,1422,13,11,121.84,11.8
"2011","Poole 006F","E01015422","Total",1447,706,741,1447,0,16,23.89,60.6
"2011","Poole 007A","E01015380","Total",1716,835,881,1697,19,9,85.13,20.2
"2011","Poole 007B","E01015381","Total",1629,811,818,1629,0,11,42.91,38.0
"2011","Poole 007C","E01015382","Total",1859,905,954,1853,6,15,30.56,60.8
"2011","Poole 007D","E01015383","Total",1419,692,727,1419,0,8,48.84,29.1
"2011","Poole 007E","E01015384","Total",1608,804,804,1608,0,18,26.09,61.6
"2011","Poole 007F","E01015385","Total",1731,836,895,1731,0,13,32.70,52.9
"2011","Poole 008A","E01015438","Total",1529,744,785,1529,0,16,31.28,48.9
"2011","Poole 008B","E01015439","Total",1723,879,844,1723,0,9,63.01,27.3
"2011","Poole 008C","E01015441","Total",1872,926,946,1872,0,19,24.58,76.2
"2011","Poole 008D","E01015442","Total",1923,919,1004,1920,3,9,29.53,65.1
"2011","Poole 008E","E01015443","Total",1791,885,906,1784,7,20,68.32,26.2
"2011","Poole 008F","E01015444","Total",1735,899,836,1735,0,6,29.49,58.8
"2011","Poole 009A","E01015386","Total",1666,853,813,1653,13,13,29.38,56.7
"2011","Poole 009B","E01015387","Total",1469,700,769,1469,0,17,82.82,17.7
"2011","Poole 009C","E01015388","Total",1597,786,811,1288,309,18,70.60,22.6
"2011","Poole 009D","E01015389","Total",1474,750,724,1453,21,12,67.31,21.9
"2011","Poole 010A","E01015390","Total",1688,846,842,1688,0,13,24.29,69.5
"2011","Poole 010B","E01015391","Total",1455,726,729,1455,0,15,33.10,44.0
"2011","Poole 010C","E01015392","Total",1421,682,739,1415,6,12,25.89,54.9
"2011","Poole 010D","E01015393","Total",1260,639,621,1260,0,12,17.42,72.3
"2011","Poole 010E","E01015394","Total",1591,779,812,1591,0,19,31.44,50.6
"2011","Poole 011A","E01015440","Total",1942,941,1001,1942,0,17,55.28,35.1
"2011","Poole 011B","E01015447","Total",1626,769,857,1574,52,19,41.93,38.8
"2011","Poole 011C","E01015449","Total",1690,780,910,1690,0,20,36.45,46.4
"2011","Poole 011D","E01015456","Total",1784,837,947,1731,53,15,46.26,38.6
"2011","Poole 011E","E01015457","Total",1648,808,840,1599,49,14,54.39,30.3
"2011","Poole 012A","E01015445","Total",1927,921,1006,1927,0,31,41.72,46.2
"2011","Poole 012B","E01015446","Total",1583,789,794,1583,0,12,30.93,51.2
"2011","Poole 012C","E01015448","Total",1525,748,777,1525,0,19,30.72,49.6
"2011","Poole 012D","E01015450","Total",1738,878,860,1738,0,29,77.63,22.4
"2011","Poole 012E","E01015451","Total",1465,706,759,1461,4,20,32.66,44.9
"2011","Poole 013A","E01015458","Total",1495,715,780,1469,26,32,87.56,17.1
"2011","Poole 013B","E01015460","Total",1746,858,888,1720,26,14,21.19,82.4
"2011","Poole 013C","E01015461","Total",1592,801,791,1554,38,14,23.89,66.6
"2011","Poole 013D","E01015462","Total",1592,827,765,1585,7,26,25.75,61.8
"2011","Poole 013E","E01015463","Total",1557,793,764,1538,19,31,35.21,44.2
"2011","Poole 013F","E01015464","Total",1614,783,831,1575,39,46,55.39,29.1
"2011","Poole 014A","E01015427","Total",1686,874,812,1628,58,16,99.93,16.9
"2011","Poole 014B","E01015428","Total",2164,1079,1085,2164,0,21,70.02,30.9
"2011","Poole 014C","E01015429","Total",1702,817,885,1702,0,6,105.70,16.1
"2011","Poole 014D","E01015430","Total",1547,763,784,1547,0,10,51.74,29.9
"2011","Poole 015A","E01015465","Total",1750,858,892,1748,2,19,64.90,27.0
"2011","Poole 015B","E01015466","Total",1714,816,898,1640,74,12,28.44,60.3
"2011","Poole 015D","E01015468","Total",1959,840,1119,1794,165,16,52.48,37.3
"2011","Poole 015F","E01032659","Total",1169,611,558,1116,53,5,40.82,28.6
"2011","Poole 015G","E01032660","Total",1669,815,854,1406,263,15,16.52,101.0
"2011","Poole 015H","E01032661","Total",1305,656,649,1303,2,9,72.88,17.9
"2011","Poole 015I","E01032662","Total",1117,527,590,1114,3,4,9.94,112.4
"2011","Poole 016A","E01015423","Total",2010,1039,971,2009,1,14,118.21,17.0
"2011","Poole 016B","E01015424","Total",1369,673,696,1369,0,5,29.86,45.8
"2011","Poole 016C","E01015425","Total",1292,618,674,1292,0,5,41.78,30.9
"2011","Poole 016D","E01015426","Total",1371,657,714,1324,47,6,23.17,59.2
"2011","Poole 017A","E01015452","Total",1800,860,940,1792,8,37,75.43,23.9
"2011","Poole 017B","E01015453","Total",1840,903,937,1840,0,8,37.22,49.4
"2011","Poole 017C","E01015454","Total",1829,916,913,1801,28,15,31.58,57.9
"2011","Poole 017D","E01015455","Total",1878,911,967,1878,0,18,65.23,28.8
"2011","Poole 017E","E01015459","Total",1759,860,899,1719,40,33,101.66,17.3
"2011","Poole 018A","E01015402","Total",1656,792,864,1544,112,34,111.89,14.8
"2011","Poole 018B","E01015403","Total",1752,787,965,1694,58,2,41.12,42.6
"2011","Poole 018C","E01015404","Total",1660,816,844,1645,15,50,152.08,10.9
"2011","Poole 018D","E01015405","Total",1811,889,922,1645,166,47,91.38,19.8
"2011","Poole 018E","E01015406","Total",1741,908,833,1708,33,28,116.00,15.0
"2011","South Gloucestershire 001A","E01014985","Total",1383,687,696,1383,0,39,32.88,42.1
"2011","South Gloucestershire 001B","E01014986","Total",1591,740,851,1523,68,17,242.79,6.6
"2011","South Gloucestershire 001C","E01014987","Total",1264,616,648,1228,36,19,56.15,22.5
"2011","South Gloucestershire 001D","E01014988","Total",1403,687,716,1359,44,28,123.00,11.4
"2011","South Gloucestershire 001E","E01014989","Total",1277,542,735,1055,222,33,1684.30,0.8
"2011","South Gloucestershire 002A","E01014990","Total",1484,730,754,1484,0,28,31.94,46.5
"2011","South Gloucestershire 002B","E01014991","Total",2164,1055,1109,2164,0,18,235.02,9.2
"2011","South Gloucestershire 002C","E01014992","Total",1483,765,718,1483,0,35,29.49,50.3
"2011","South Gloucestershire 002D","E01014993","Total",1442,738,704,1442,0,32,1096.89,1.3
"2011","South Gloucestershire 003A","E01014884","Total",2048,1290,758,1544,504,29,2009.97,1.0
"2011","South Gloucestershire 003B","E01014885","Total",1868,935,933,1867,1,24,269.23,6.9
"2011","South Gloucestershire 003C","E01014929","Total",2021,1015,1006,2005,16,37,2002.76,1.0
"2011","South Gloucestershire 003D","E01014930","Total",1978,940,1038,1926,52,55,1381.46,1.4
"2011","South Gloucestershire 004A","E01014863","Total",1496,737,759,1493,3,22,150.00,10.0
"2011","South Gloucestershire 004B","E01014864","Total",1457,732,725,1438,19,26,954.60,1.5
"2011","South Gloucestershire 004C","E01014962","Total",1748,849,899,1712,36,51,4468.92,0.4
"2011","South Gloucestershire 004D","E01014963","Total",1880,923,957,1871,9,49,1816.53,1.0
"2011","South Gloucestershire 005A","E01014861","Total",1864,926,938,1863,1,23,2062.11,0.9
"2011","South Gloucestershire 005B","E01014862","Total",2841,1388,1453,2797,44,58,848.35,3.3
"2011","South Gloucestershire 005C","E01014953","Total",2108,1051,1057,2108,0,22,1388.37,1.5
"2011","South Gloucestershire 005D","E01014954","Total",1539,794,745,1531,8,6,147.18,10.5
"2011","South Gloucestershire 006A","E01015014","Total",1466,754,712,1466,0,23,324.50,4.5
"2011","South Gloucestershire 006B","E01015015","Total",1469,734,735,1388,81,15,66.02,22.3
"2011","South Gloucestershire 006C","E01015016","Total",1217,602,615,1217,0,10,29.75,40.9
"2011","South Gloucestershire 006D","E01015017","Total",1447,690,757,1369,78,14,57.55,25.1
"2011","South Gloucestershire 006E","E01015018","Total",1524,728,796,1507,17,17,36.62,41.6
"2011","South Gloucestershire 007A","E01015019","Total",1776,827,949,1774,2,13,37.62,47.2
"2011","South Gloucestershire 007B","E01015020","Total",1556,763,793,1556,0,7,24.35,63.9
"2011","South Gloucestershire 007C","E01015021","Total",1571,807,764,1571,0,25,34.00,46.2
"2011","South Gloucestershire 007D","E01015022","Total",1550,775,775,1550,0,17,31.08,49.9
"2011","South Gloucestershire 008A","E01014886","Total",1803,862,941,1791,12,10,69.95,25.8
"2011","South Gloucestershire 008B","E01014887","Total",1397,677,720,1397,0,28,55.05,25.4
"2011","South Gloucestershire 008C","E01014888","Total",1453,708,745,1400,53,20,350.47,4.1
"2011","South Gloucestershire 008D","E01014889","Total",1567,768,799,1567,0,9,30.74,51.0
"2011","South Gloucestershire 009A","E01014872","Total",1593,808,785,1593,0,12,24.94,63.9
"2011","South Gloucestershire 009B","E01014874","Total",1498,759,739,1481,17,10,35.72,41.9
"2011","South Gloucestershire 009C","E01014876","Total",1716,865,851,1716,0,7,31.44,54.6
"2011","South Gloucestershire 009D","E01014877","Total",1563,787,776,1563,0,20,32.00,48.8
"2011","South Gloucestershire 009E","E01014879","Total",1712,882,830,1712,0,24,80.19,21.3
"2011","South Gloucestershire 009F","E01014881","Total",1956,960,996,1956,0,20,73.40,26.6
"2011","South Gloucestershire 010A","E01015009","Total",1384,672,712,1384,0,4,34.02,40.7
"2011","South Gloucestershire 010B","E01015010","Total",1322,663,659,1322,0,8,51.23,25.8
"2011","South Gloucestershire 010C","E01015011","Total",1556,769,787,1501,55,19,57.60,27.0
"2011","South Gloucestershire 010D","E01015012","Total",1214,575,639,1214,0,10,36.80,33.0
"2011","South Gloucestershire 010E","E01015013","Total",1349,689,660,1349,0,15,17.14,78.7
"2011","South Gloucestershire 011A","E01014946","Total",1574,789,785,1572,2,8,22.15,71.1
"2011","South Gloucestershire 011B","E01014947","Total",1422,701,721,1419,3,11,40.40,35.2
"2011","South Gloucestershire 011C","E01014948","Total",1693,821,872,1692,1,12,129.11,13.1
"2011","South Gloucestershire 011D","E01014949","Total",1420,722,698,1420,0,1,125.76,11.3
"2011","South Gloucestershire 011E","E01014950","Total",1428,727,701,1428,0,9,21.53,66.3
"2011","South Gloucestershire 011F","E01014951","Total",1322,635,687,1322,0,4,21.01,62.9
"2011","South Gloucestershire 011G","E01014952","Total",1652,844,808,1641,11,15,73.87,22.4
"2011","South Gloucestershire 012A","E01014873","Total",1507,750,757,1507,0,34,26.48,56.9
"2011","South Gloucestershire 012B","E01014875","Total",1792,928,864,1791,1,11,28.61,62.6
"2011","South Gloucestershire 012C","E01014878","Total",2113,1081,1032,2113,0,16,31.61,66.8
"2011","South Gloucestershire 012D","E01014880","Total",1833,919,914,1833,0,26,29.47,62.2
"2011","South Gloucestershire 012E","E01014882","Total",2084,1023,1061,2084,0,22,35.35,59.0
"2011","South Gloucestershire 012F","E01014883","Total",1232,618,614,1232,0,10,23.16,53.2
"2011","South Gloucestershire 013A","E01014911","Total",1386,676,710,1369,17,19,676.41,2.0
"2011","South Gloucestershire 013B","E01014912","Total",1835,923,912,1827,8,31,71.32,25.7
"2011","South Gloucestershire 013C","E01014913","Total",1622,818,804,1622,0,18,46.35,35.0
"2011","South Gloucestershire 013D","E01014914","Total",1677,841,836,1677,0,20,50.79,33.0
"2011","South Gloucestershire 014A","E01014892","Total",1660,792,868,1642,18,6,34.17,48.6
"2011","South Gloucestershire 014B","E01014893","Total",1494,753,741,1494,0,11,27.15,55.0
"2011","South Gloucestershire 014C","E01014894","Total",1308,670,638,1308,0,13,21.88,59.8
"2011","South Gloucestershire 014D","E01014895","Total",1422,706,716,1422,0,6,20.89,68.1
"2011","South Gloucestershire 014E","E01014896","Total",1332,663,669,1332,0,9,32.31,41.2
"2011","South Gloucestershire 015A","E01014979","Total",1515,766,749,1515,0,15,50.97,29.7
"2011","South Gloucestershire 015B","E01014980","Total",1621,802,819,1621,0,36,29.77,54.5
"2011","South Gloucestershire 015C","E01014982","Total",1519,756,763,1519,0,14,20.13,75.5
"2011","South Gloucestershire 015D","E01014983","Total",1518,717,801,1518,0,5,31.52,48.2
"2011","South Gloucestershire 015E","E01014984","Total",1481,740,741,1481,0,8,48.86,30.3
"2011","South Gloucestershire 016A","E01014998","Total",1553,717,836,1500,53,10,115.55,13.4
"2011","South Gloucestershire 016B","E01014999","Total",1594,778,816,1574,20,29,120.52,13.2
"2011","South Gloucestershire 016C","E01015000","Total",1542,760,782,1524,18,22,475.04,3.2
"2011","South Gloucestershire 016D","E01015001","Total",1609,779,830,1609,0,21,42.04,38.3
"2011","South Gloucestershire 017A","E01014978","Total",1530,773,757,1530,0,26,50.48,30.3
"2011","South Gloucestershire 017B","E01014981","Total",2874,1481,1393,2829,45,26,250.73,11.5
"2011","South Gloucestershire 017C","E01014996","Total",1629,794,835,1518,111,9,83.53,19.5
"2011","South Gloucestershire 017E","E01033331","Total",2230,1205,1025,1336,894,70,165.35,13.5
"2011","South Gloucestershire 017F","E01033333","Total",2244,1197,1047,1364,880,53,456.06,4.9
"2011","South Gloucestershire 018A","E01014904","Total",1487,765,722,1482,5,10,33.70,44.1
"2011","South Gloucestershire 018B","E01014905","Total",1639,858,781,1639,0,12,25.00,65.6
"2011","South Gloucestershire 018C","E01014906","Total",1672,804,868,1626,46,10,119.29,14.0
"2011","South Gloucestershire 018D","E01014907","Total",1530,798,732,1530,0,15,30.45,50.2
"2011","South Gloucestershire 018E","E01014908","Total",1320,672,648,1304,16,21,42.03,31.4
"2011","South Gloucestershire 018F","E01014909","Total",1488,793,695,1488,0,10,26.50,56.2
"2011","South Gloucestershire 018G","E01014910","Total",1471,755,716,1462,9,11,129.78,11.3
"2011","South Gloucestershire 019A","E01014867","Total",1352,707,645,1239,113,10,144.69,9.3
"2011","South Gloucestershire 019B","E01014868","Total",1552,783,769,1545,7,19,770.15,2.0
"2011","South Gloucestershire 019D","E01014994","Total",1733,873,860,1701,32,25,1455.75,1.2
"2011","South Gloucestershire 019E","E01014995","Total",1666,832,834,1666,0,19,109.03,15.3
"2011","South Gloucestershire 019F","E01033338","Total",1575,804,771,1575,0,8,633.07,2.5
"2011","South Gloucestershire 019G","E01033339","Total",1429,686,743,1418,11,13,65.70,21.8
"2011","South Gloucestershire 020A","E01014901","Total",1685,821,864,1685,0,22,38.41,43.9
"2011","South Gloucestershire 020B","E01014902","Total",1319,660,659,1319,0,18,35.51,37.1
"2011","South Gloucestershire 020C","E01014903","Total",1487,729,758,1487,0,24,40.44,36.8
"2011","South Gloucestershire 020D","E01014965","Total",1494,719,775,1494,0,17,34.50,43.3
"2011","South Gloucestershire 021A","E01014964","Total",1711,846,865,1711,0,28,58.34,29.3
"2011","South Gloucestershire 021B","E01014966","Total",1576,767,809,1576,0,15,107.43,14.7
"2011","South Gloucestershire 021C","E01014967","Total",2117,1061,1056,2117,0,26,51.22,41.3
"2011","South Gloucestershire 021D","E01014969","Total",1599,795,804,1590,9,17,30.40,52.6
"2011","South Gloucestershire 021F","E01033334","Total",1609,842,767,1609,0,61,67.10,24.0
"2011","South Gloucestershire 021G","E01033336","Total",1757,860,897,1757,0,19,26.96,65.2
"2011","South Gloucestershire 022A","E01014897","Total",1498,738,760,1498,0,14,41.58,36.0
"2011","South Gloucestershire 022B","E01014898","Total",1668,792,876,1650,18,12,43.10,38.7
"2011","South Gloucestershire 022C","E01014899","Total",1635,784,851,1625,10,20,39.50,41.4
"2011","South Gloucestershire 022D","E01014900","Total",1493,746,747,1433,60,27,26.05,57.3
"2011","South Gloucestershire 023A","E01014959","Total",1387,692,695,1387,0,13,27.08,51.2
"2011","South Gloucestershire 023B","E01014960","Total",1631,815,816,1631,0,7,31.63,51.6
"2011","South Gloucestershire 023C","E01014961","Total",1651,817,834,1651,0,14,27.93,59.1
"2011","South Gloucestershire 023D","E01014968","Total",1712,826,886,1712,0,7,31.14,55.0
"2011","South Gloucestershire 024A","E01014865","Total",1888,934,954,1888,0,41,1108.77,1.7
"2011","South Gloucestershire 024B","E01014869","Total",1716,864,852,1715,1,35,2388.65,0.7
"2011","South Gloucestershire 024C","E01014870","Total",1606,781,825,1600,6,44,3687.32,0.4
"2011","South Gloucestershire 024D","E01014871","Total",1220,597,623,1220,0,13,171.64,7.1
"2011","South Gloucestershire 024E","E01014890","Total",2072,1021,1051,2035,37,63,4854.65,0.4
"2011","South Gloucestershire 024F","E01014891","Total",1665,838,827,1659,6,35,4816.33,0.3
"2011","South Gloucestershire 025A","E01014955","Total",1304,638,666,1300,4,15,38.60,33.8
"2011","South Gloucestershire 025B","E01014956","Total",1579,788,791,1579,0,13,22.40,70.5
"2011","South Gloucestershire 025C","E01014957","Total",1255,622,633,1255,0,6,23.08,54.4
"2011","South Gloucestershire 025D","E01014974","Total",1575,772,803,1564,11,9,32.27,48.8
"2011","South Gloucestershire 025E","E01014977","Total",1275,603,672,1258,17,2,20.07,63.5
"2011","South Gloucestershire 026A","E01014922","Total",1383,701,682,1383,0,3,24.96,55.4
"2011","South Gloucestershire 026B","E01014923","Total",1523,728,795,1456,67,6,27.25,55.9
"2011","South Gloucestershire 026C","E01014924","Total",1765,858,907,1690,75,16,26.27,67.2
"2011","South Gloucestershire 026D","E01014973","Total",1464,703,761,1464,0,5,20.78,70.5
"2011","South Gloucestershire 026E","E01014975","Total",1574,788,786,1567,7,7,26.18,60.1
"2011","South Gloucestershire 026F","E01014976","Total",1450,721,729,1440,10,3,28.20,51.4
"2011","South Gloucestershire 027A","E01014925","Total",1494,716,778,1492,2,4,42.73,35.0
"2011","South Gloucestershire 027B","E01014926","Total",1685,800,885,1685,0,8,27.90,60.4
"2011","South Gloucestershire 027C","E01014927","Total",1677,802,875,1604,73,12,25.05,66.9
"2011","South Gloucestershire 027D","E01014928","Total",1526,751,775,1526,0,8,22.31,68.4
"2011","South Gloucestershire 027E","E01014958","Total",1175,546,629,1175,0,4,20.39,57.6
"2011","South Gloucestershire 028A","E01014915","Total",1569,767,802,1556,13,4,26.15,60.0
"2011","South Gloucestershire 028B","E01015003","Total",1621,795,826,1611,10,16,29.52,54.9
"2011","South Gloucestershire 028C","E01015005","Total",2000,1001,999,1996,4,8,49.07,40.8
"2011","South Gloucestershire 028D","E01015007","Total",1693,844,849,1674,19,9,39.80,42.5
"2011","South Gloucestershire 028E","E01015008","Total",1699,822,877,1625,74,5,23.81,71.4
"2011","South Gloucestershire 029A","E01014943","Total",1722,823,899,1722,0,8,38.56,44.7
"2011","South Gloucestershire 029B","E01014944","Total",1860,954,906,1860,0,16,27.56,67.5
"2011","South Gloucestershire 029C","E01014972","Total",1752,839,913,1681,71,13,167.73,10.4
"2011","South Gloucestershire 029D","E01015002","Total",1576,764,812,1544,32,11,27.11,58.1
"2011","South Gloucestershire 029E","E01015004","Total",1718,871,847,1713,5,2,59.30,29.0
"2011","South Gloucestershire 029F","E01015006","Total",1571,795,776,1571,0,14,29.68,52.9
"2011","South Gloucestershire 030A","E01014936","Total",1474,723,751,1439,35,12,123.57,11.9
"2011","South Gloucestershire 030B","E01014938","Total",1548,753,795,1548,0,12,33.30,46.5
"2011","South Gloucestershire 030C","E01014939","Total",1191,597,594,1191,0,2,18.64,63.9
"2011","South Gloucestershire 030D","E01014940","Total",1331,664,667,1331,0,15,121.69,10.9
"2011","South Gloucestershire 030E","E01014941","Total",1616,783,833,1588,28,7,36.73,44.0
"2011","South Gloucestershire 030F","E01014942","Total",1485,733,752,1485,0,6,24.74,60.0
"2011","South Gloucestershire 030G","E01014945","Total",1699,837,862,1677,22,15,35.58,47.8
"2011","South Gloucestershire 031A","E01014916","Total",1508,726,782,1508,0,13,28.46,53.0
"2011","South Gloucestershire 031B","E01014917","Total",1456,700,756,1428,28,12,41.93,34.7
"2011","South Gloucestershire 031C","E01014918","Total",1433,681,752,1433,0,12,62.75,22.8
"2011","South Gloucestershire 031D","E01014919","Total",1271,621,650,1267,4,11,37.90,33.5
"2011","South Gloucestershire 031E","E01014920","Total",1338,684,654,1328,10,20,38.62,34.6
"2011","South Gloucestershire 031F","E01014921","Total",1387,685,702,1369,18,14,109.56,12.7
"2011","South Gloucestershire 032A","E01014866","Total",1621,789,832,1574,47,26,56.52,28.7
"2011","South Gloucestershire 032B","E01014931","Total",1423,695,728,1395,28,22,65.65,21.7
"2011","South Gloucestershire 032C","E01014932","Total",1641,802,839,1641,0,19,98.92,16.6
"2011","South Gloucestershire 032D","E01014933","Total",1460,737,723,1460,0,17,27.75,52.6
"2011","South Gloucestershire 032E","E01014934","Total",1237,622,615,1237,0,19,126.29,9.8
"2011","South Gloucestershire 032F","E01014935","Total",1506,750,756,1506,0,14,56.52,26.6
"2011","South Gloucestershire 032G","E01014937","Total",1282,626,656,1282,0,14,47.44,27.0
"2011","Swindon 001A","E01015519","Total",1471,691,780,1446,25,15,28.88,50.9
"2011","Swindon 001B","E01015520","Total",1206,582,624,1189,17,10,276.27,4.4
"2011","Swindon 001C","E01015521","Total",1432,720,712,1432,0,20,179.78,8.0
"2011","Swindon 001D","E01015522","Total",1441,671,770,1441,0,22,25.59,56.3
"2011","Swindon 001E","E01015523","Total",1510,734,776,1505,5,33,2579.12,0.6
"2011","Swindon 001F","E01015524","Total",1199,607,592,1199,0,6,28.17,42.6
"2011","Swindon 003A","E01015543","Total",1362,662,700,1362,0,7,64.93,21.0
"2011","Swindon 003B","E01015544","Total",1666,799,867,1666,0,5,28.32,58.8
"2011","Swindon 003C","E01015545","Total",1598,774,824,1598,0,3,25.04,63.8
"2011","Swindon 003D","E01015546","Total",1702,798,904,1702,0,1,25.51,66.7
"2011","Swindon 004A","E01015513","Total",1555,769,786,1555,0,13,34.05,45.7
"2011","Swindon 004B","E01015514","Total",1266,615,651,1266,0,11,27.55,46.0
"2011","Swindon 004C","E01015515","Total",1431,731,700,1431,0,20,25.89,55.3
"2011","Swindon 004D","E01015516","Total",1303,619,684,1270,33,17,27.92,46.7
"2011","Swindon 004E","E01015517","Total",1438,698,740,1438,0,4,30.70,46.8
"2011","Swindon 005A","E01015555","Total",1466,708,758,1454,12,5,39.72,36.9
"2011","Swindon 005B","E01015556","Total",1600,775,825,1600,0,22,41.97,38.1
"2011","Swindon 005C","E01015557","Total",1395,708,687,1395,0,19,127.46,10.9
"2011","Swindon 005D","E01015558","Total",1543,735,808,1543,0,8,27.26,56.6
"2011","Swindon 005E","E01015559","Total",1472,736,736,1472,0,11,33.23,44.3
"2011","Swindon 005F","E01015560","Total",1619,794,825,1606,13,17,39.94,40.5
"2011","Swindon 006A","E01015526","Total",1480,759,721,1480,0,19,25.18,58.8
"2011","Swindon 006B","E01015528","Total",1817,897,920,1817,0,4,34.93,52.0
"2011","Swindon 006C","E01015529","Total",1541,757,784,1524,17,6,35.27,43.7
"2011","Swindon 006D","E01015530","Total",1677,816,861,1666,11,6,31.53,53.2
"2011","Swindon 007A","E01015506","Total",1551,785,766,1551,0,9,29.10,53.3
"2011","Swindon 007B","E01015507","Total",1613,761,852,1613,0,14,24.67,65.4
"2011","Swindon 007C","E01015527","Total",1751,841,910,1742,9,10,50.83,34.4
"2011","Swindon 007D","E01015580","Total",1660,800,860,1660,0,14,37.33,44.5
"2011","Swindon 008A","E01015473","Total",1716,830,886,1671,45,28,1505.10,1.1
"2011","Swindon 008B","E01015474","Total",1644,825,819,1644,0,46,3059.22,0.5
"2011","Swindon 008C","E01015547","Total",1749,895,854,1572,177,45,2155.13,0.8
"2011","Swindon 008D","E01015548","Total",1577,774,803,1575,2,40,3046.23,0.5
"2011","Swindon 009A","E01015549","Total",1765,867,898,1744,21,19,112.32,15.7
"2011","Swindon 009B","E01015550","Total",1802,895,907,1802,0,12,72.17,25.0
"2011","Swindon 009C","E01015551","Total",1534,725,809,1474,60,13,145.85,10.5
"2011","Swindon 009D","E01015552","Total",2106,1040,1066,2038,68,19,166.24,12.7
"2011","Swindon 009E","E01015553","Total",1631,814,817,1595,36,25,29.10,56.0
"2011","Swindon 009F","E01015554","Total",1436,696,740,1429,7,16,28.88,49.7
"2011","Swindon 010A","E01015508","Total",1400,696,704,1400,0,3,38.70,36.2
"2011","Swindon 010B","E01015509","Total",1620,838,782,1618,2,10,103.15,15.7
"2011","Swindon 010C","E01015510","Total",1874,948,926,1874,0,8,37.88,49.5
"2011","Swindon 010D","E01015511","Total",1556,807,749,1556,0,18,20.69,75.2
"2011","Swindon 011A","E01015562","Total",1537,749,788,1537,0,28,67.62,22.7
"2011","Swindon 011B","E01015563","Total",1569,811,758,1569,0,17,39.71,39.5
"2011","Swindon 011C","E01015565","Total",1607,759,848,1607,0,41,28.44,56.5
"2011","Swindon 011D","E01015566","Total",1593,808,785,1593,0,24,29.21,54.5
"2011","Swindon 012B","E01015578","Total",1606,822,784,1606,0,12,96.31,16.7
"2011","Swindon 012C","E01015579","Total",1585,804,781,1585,0,4,44.62,35.5
"2011","Swindon 012D","E01015581","Total",1516,769,747,1516,0,13,222.94,6.8
"2011","Swindon 012E","E01015582","Total",1874,940,934,1874,0,10,47.36,39.6
"2011","Swindon 012F","E01032708","Total",1642,885,757,1642,0,4,41.62,39.5
"2011","Swindon 012G","E01032716","Total",1449,774,675,1449,0,10,28.16,51.5
"2011","Swindon 013A","E01015481","Total",1744,844,900,1744,0,11,30.65,56.9
"2011","Swindon 013B","E01015482","Total",1278,656,622,1278,0,18,34.23,37.3
"2011","Swindon 013C","E01015483","Total",1438,692,746,1438,0,6,36.12,39.8
"2011","Swindon 013D","E01015484","Total",1403,685,718,1403,0,18,30.25,46.4
"2011","Swindon 013E","E01015485","Total",1440,722,718,1440,0,9,23.72,60.7
"2011","Swindon 013F","E01015486","Total",1439,729,710,1439,0,14,35.91,40.1
"2011","Swindon 014A","E01015561","Total",1466,761,705,1466,0,27,122.21,12.0
"2011","Swindon 014B","E01015564","Total",1566,773,793,1566,0,36,50.98,30.7
"2011","Swindon 014C","E01015567","Total",1492,761,731,1492,0,19,45.31,32.9
"2011","Swindon 014D","E01015568","Total",1432,712,720,1430,2,19,69.74,20.5
"2011","Swindon 015A","E01015475","Total",2182,1197,985,2176,6,18,20.21,108.0
"2011","Swindon 015B","E01015476","Total",2251,1275,976,2227,24,7,37.27,60.4
"2011","Swindon 015C","E01015477","Total",1548,828,720,1539,9,5,21.38,72.4
"2011","Swindon 015D","E01015480","Total",2371,1322,1049,2371,0,17,15.48,153.2
"2011","Swindon 016A","E01015538","Total",1767,849,918,1761,6,9,32.45,54.5
"2011","Swindon 016B","E01015572","Total",1250,615,635,1250,0,3,25.58,48.9
"2011","Swindon 016C","E01015573","Total",2138,1076,1062,2133,5,15,35.38,60.4
"2011","Swindon 016D","E01015575","Total",1184,587,597,1184,0,2,22.37,52.9
"2011","Swindon 017A","E01015479","Total",1618,825,793,1617,1,17,82.78,19.5
"2011","Swindon 017B","E01015493","Total",1773,927,846,1773,0,17,30.55,58.0
"2011","Swindon 017C","E01015574","Total",1640,804,836,1636,4,14,29.92,54.8
"2011","Swindon 017D","E01015576","Total",1559,741,818,1559,0,14,41.56,37.5
"2011","Swindon 018A","E01015499","Total",1270,659,611,1270,0,26,29.58,42.9
"2011","Swindon 018B","E01015500","Total",1523,731,792,1523,0,24,24.39,62.4
"2011","Swindon 018C","E01015504","Total",1372,662,710,1372,0,41,100.62,13.6
"2011","Swindon 018D","E01015505","Total",1496,740,756,1496,0,20,26.92,55.6
"2011","Swindon 019A","E01015494","Total",1783,985,798,1777,6,10,25.35,70.3
"2011","Swindon 019C","E01015496","Total",1614,867,747,1614,0,14,14.91,108.2
"2011","Swindon 019D","E01015497","Total",1592,837,755,1517,75,13,17.15,92.8
"2011","Swindon 019E","E01032714","Total",1286,734,552,1235,51,5,25.76,49.9
"2011","Swindon 019F","E01032715","Total",998,543,455,945,53,7,16.11,61.9
"2011","Swindon 020A","E01015537","Total",1773,827,946,1773,0,14,28.66,61.9
"2011","Swindon 020B","E01015539","Total",1620,803,817,1620,0,11,31.56,51.3
"2011","Swindon 020C","E01015540","Total",1859,913,946,1827,32,5,29.29,63.5
"2011","Swindon 020D","E01015541","Total",1791,869,922,1781,10,12,26.94,66.5
"2011","Swindon 020E","E01015542","Total",1471,707,764,1451,20,6,22.64,65.0
"2011","Swindon 021A","E01015478","Total",1483,765,718,1483,0,12,62.59,23.7
"2011","Swindon 021B","E01015498","Total",1732,903,829,1726,6,27,25.92,66.8
"2011","Swindon 021D","E01015532","Total",1556,820,736,1429,127,31,33.06,47.1
"2011","Swindon 021E","E01032706","Total",1498,800,698,1412,86,8,13.45,111.4
"2011","Swindon 021F","E01032707","Total",1876,951,925,1832,44,57,87.92,21.3
"2011","Swindon 022A","E01015501","Total",1369,694,675,1369,0,22,60.81,22.5
"2011","Swindon 022B","E01015502","Total",1545,761,784,1545,0,13,20.41,75.7
"2011","Swindon 022C","E01015503","Total",1314,633,681,1314,0,10,74.56,17.6
"2011","Swindon 022D","E01015569","Total",1510,743,767,1510,0,11,42.56,35.5
"2011","Swindon 022E","E01015570","Total",1531,800,731,1531,0,3,24.24,63.2
"2011","Swindon 022F","E01015571","Total",1590,808,782,1590,0,8,47.59,33.4
"2011","Swindon 023A","E01015487","Total",1615,814,801,1615,0,18,40.39,40.0
"2011","Swindon 023B","E01015488","Total",1439,700,739,1410,29,18,46.32,31.1
"2011","Swindon 023C","E01015489","Total",1438,720,718,1438,0,17,57.98,24.8
"2011","Swindon 023D","E01015490","Total",1285,626,659,1285,0,7,24.43,52.6
"2011","Swindon 023E","E01015491","Total",1473,723,750,1473,0,12,71.87,20.5
"2011","Swindon 023F","E01015492","Total",1434,696,738,1434,0,10,53.31,26.9
"2011","Swindon 024A","E01015533","Total",1504,719,785,1497,7,36,46.92,32.1
"2011","Swindon 024B","E01015534","Total",1904,959,945,1904,0,14,70.50,27.0
"2011","Swindon 024C","E01015535","Total",1494,734,760,1475,19,24,92.12,16.2
"2011","Swindon 024D","E01015536","Total",2400,1167,1233,2400,0,41,341.66,7.0
"2011","Swindon 025A","E01015583","Total",2282,1124,1158,2282,0,49,2006.00,1.1
"2011","Swindon 025B","E01015584","Total",1417,686,731,1400,17,13,34.05,41.6
"2011","Swindon 025C","E01015585","Total",1642,804,838,1608,34,30,2180.87,0.8
"2011","Swindon 025D","E01015586","Total",1437,677,760,1410,27,19,50.91,28.2
"2011","Swindon 025E","E01015587","Total",1897,907,990,1878,19,22,77.19,24.6
"2011","Swindon 025F","E01015588","Total",1837,898,939,1818,19,27,220.13,8.3
"2011","Swindon 026A","E01015525","Total",1578,797,781,1578,0,19,36.14,43.7
"2011","Swindon 026B","E01032700","Total",1612,832,780,1612,0,12,81.00,19.9
"2011","Swindon 026C","E01032703","Total",1468,718,750,1468,0,7,26.40,55.6
"2011","Swindon 026D","E01032705","Total",1479,728,751,1479,0,7,52.40,28.2
"2011","Swindon 026E","E01032709","Total",1358,684,674,1358,0,4,29.65,45.8
"2011","Swindon 026F","E01032713","Total",1762,900,862,1762,0,16,38.59,45.7
"2011","Swindon 027A","E01032701","Total",1219,621,598,1219,0,13,16.46,74.1
"2011","Swindon 027B","E01032702","Total",1413,713,700,1413,0,9,23.09,61.2
"2011","Swindon 027C","E01032704","Total",1419,723,696,1419,0,10,27.59,51.4
"2011","Swindon 027D","E01032711","Total",1330,675,655,1330,0,6,14.52,91.6
"2011","Swindon 027E","E01032712","Total",1408,699,709,1408,0,12,29.00,48.6
"2011","Swindon 028A","E01015471","Total",1655,836,819,1655,0,15,49.92,33.2
"2011","Swindon 028B","E01015472","Total",2754,1377,1377,2754,0,27,122.58,22.5
"2011","Swindon 028C","E01015512","Total",1715,853,862,1715,0,25,33.17,51.7
"2011","Swindon 028D","E01015518","Total",1561,784,777,1561,0,13,28.51,54.8
"2011","Swindon 028E","E01032710","Total",1343,675,668,1343,0,5,46.86,28.7
"2011","Torbay 001A","E01015262","Total",1352,630,722,1352,0,11,22.62,59.8
"2011","Torbay 001B","E01015263","Total",1538,731,807,1514,24,10,30.96,49.7
"2011","Torbay 001C","E01015264","Total",1323,616,707,1323,0,3,69.44,19.1
"2011","Torbay 001D","E01015265","Total",1471,737,734,1471,0,21,42.96,34.2
"2011","Torbay 001E","E01015266","Total",1494,699,795,1494,0,15,30.44,49.1
"2011","Torbay 002A","E01015236","Total",1484,744,740,1444,40,18,354.04,4.2
"2011","Torbay 002B","E01015237","Total",1358,673,685,1358,0,16,20.33,66.8
"2011","Torbay 002C","E01015238","Total",1451,679,772,1361,90,16,30.60,47.4
"2011","Torbay 002D","E01015239","Total",1529,686,843,1422,107,8,27.84,54.9
"2011","Torbay 003A","E01015249","Total",1478,691,787,1478,0,15,25.73,57.4
"2011","Torbay 003B","E01015250","Total",1438,682,756,1438,0,19,106.12,13.6
"2011","Torbay 003C","E01015251","Total",1200,593,607,1143,57,31,44.76,26.8
"2011","Torbay 003D","E01015252","Total",2383,1161,1222,2368,15,19,114.91,20.7
"2011","Torbay 003E","E01015253","Total",1627,779,848,1559,68,20,72.66,22.4
"2011","Torbay 003F","E01015254","Total",1399,675,724,1394,5,20,51.36,27.2
"2011","Torbay 004A","E01015257","Total",1354,654,700,1354,0,5,31.51,43.0
"2011","Torbay 004B","E01015258","Total",1929,963,966,1861,68,24,74.93,25.7
"2011","Torbay 004C","E01015259","Total",1396,683,713,1396,0,9,28.55,48.9
"2011","Torbay 004D","E01015260","Total",1544,809,735,1477,67,14,24.99,61.8
"2011","Torbay 005A","E01015240","Total",1463,662,801,1337,126,6,54.83,26.7
"2011","Torbay 005B","E01015241","Total",1479,699,780,1453,26,9,21.95,67.4
"2011","Torbay 005C","E01015242","Total",1238,589,649,1237,1,8,16.03,77.2
"2011","Torbay 005D","E01015243","Total",1260,592,668,1260,0,19,24.44,51.6
"2011","Torbay 006A","E01015214","Total",1407,692,715,1407,0,9,15.21,92.5
"2011","Torbay 006B","E01015215","Total",1458,720,738,1450,8,19,25.44,57.3
"2011","Torbay 006C","E01015216","Total",1429,685,744,1416,13,7,14.55,98.2
"2011","Torbay 006D","E01015218","Total",1453,688,765,1351,102,24,18.71,77.7
"2011","Torbay 008A","E01015217","Total",1528,773,755,1495,33,6,21.63,70.6
"2011","Torbay 008B","E01015255","Total",1619,890,729,1433,186,15,38.15,42.4
"2011","Torbay 008C","E01015256","Total",1793,971,822,1741,52,12,40.75,44.0
"2011","Torbay 008D","E01015261","Total",1957,966,991,1792,165,9,45.65,42.9
"2011","Torbay 010A","E01015267","Total",1527,777,750,1385,142,12,49.97,30.6
"2011","Torbay 010B","E01015268","Total",1570,788,782,1540,30,13,65.70,23.9
"2011","Torbay 010C","E01015269","Total",1631,784,847,1508,123,22,77.16,21.1
"2011","Torbay 010D","E01015270","Total",1627,809,818,1533,94,14,44.96,36.2
"2011","Torbay 010E","E01015271","Total",1422,668,754,1403,19,38,167.14,8.5
"2011","Torbay 011A","E01015224","Total",1493,731,762,1458,35,21,36.24,41.2
"2011","Torbay 011B","E01015225","Total",1467,693,774,1409,58,17,39.33,37.3
"2011","Torbay 011C","E01015226","Total",1411,674,737,1392,19,19,80.49,17.5
"2011","Torbay 011D","E01015227","Total",1535,744,791,1505,30,22,36.25,42.3
"2011","Torbay 011E","E01015228","Total",1505,685,820,1455,50,10,27.70,54.3
"2011","Torbay 011F","E01015230","Total",1415,661,754,1415,0,12,53.81,26.3
"2011","Torbay 012A","E01015202","Total",1513,745,768,1513,0,10,27.06,55.9
"2011","Torbay 012B","E01015203","Total",1272,602,670,1272,0,9,33.40,38.1
"2011","Torbay 012C","E01015204","Total",1375,685,690,1360,15,18,24.29,56.6
"2011","Torbay 012D","E01015205","Total",1489,697,792,1489,0,11,25.15,59.2
"2011","Torbay 012E","E01015206","Total",1484,696,788,1386,98,10,32.65,45.5
"2011","Torbay 013A","E01015190","Total",1666,842,824,1666,0,19,501.73,3.3
"2011","Torbay 013B","E01015191","Total",1662,797,865,1662,0,13,93.30,17.8
"2011","Torbay 013C","E01015192","Total",1450,718,732,1450,0,10,24.06,60.3
"2011","Torbay 013D","E01015193","Total",1283,595,688,1283,0,5,22.23,57.7
"2011","Torbay 013E","E01015194","Total",1400,679,721,1400,0,9,32.12,43.6
"2011","Torbay 013F","E01015195","Total",1508,738,770,1506,2,5,405.62,3.7
"2011","Torbay 013G","E01015196","Total",1508,727,781,1508,0,14,23.62,63.8
"2011","Torbay 014A","E01015229","Total",1368,626,742,1272,96,9,34.62,39.5
"2011","Torbay 014B","E01015231","Total",1593,785,808,1547,46,11,24.19,65.9
"2011","Torbay 014C","E01015232","Total",1651,797,854,1477,174,6,44.12,37.4
"2011","Torbay 014D","E01015233","Total",1399,659,740,1308,91,7,20.82,67.2
"2011","Torbay 014E","E01015234","Total",1318,623,695,1318,0,9,12.90,102.2
"2011","Torbay 014F","E01015235","Total",1689,796,893,1510,179,4,38.29,44.1
"2011","Torbay 015A","E01015219","Total",1393,635,758,1355,38,16,42.15,33.0
"2011","Torbay 015B","E01015220","Total",1370,638,732,1370,0,12,71.88,19.1
"2011","Torbay 015C","E01015221","Total",1430,665,765,1426,4,7,60.83,23.5
"2011","Torbay 015D","E01015222","Total",1413,656,757,1411,2,16,96.08,14.7
"2011","Torbay 015E","E01015223","Total",1304,648,656,1304,0,13,34.52,37.8
"2011","Torbay 016A","E01015197","Total",1439,683,756,1439,0,29,136.87,10.5
"2011","Torbay 016B","E01015198","Total",1567,736,831,1567,0,20,59.03,26.5
"2011","Torbay 016C","E01015199","Total",1299,624,675,1276,23,23,290.05,4.5
"2011","Torbay 016D","E01015200","Total",1016,483,533,1016,0,9,25.31,40.1
"2011","Torbay 016E","E01015201","Total",1336,655,681,1295,41,33,477.43,2.8
"2011","Torbay 017A","E01015183","Total",1320,638,682,1291,29,11,101.30,13.0
"2011","Torbay 017B","E01015184","Total",1311,620,691,1275,36,9,36.25,36.2
"2011","Torbay 017C","E01015185","Total",1325,637,688,1321,4,14,28.17,47.0
"2011","Torbay 017D","E01015186","Total",1339,660,679,1337,2,11,21.01,63.7
"2011","Torbay 017E","E01015187","Total",1384,643,741,1377,7,9,77.56,17.8
"2011","Torbay 017F","E01015188","Total",1482,686,796,1450,32,9,39.70,37.3
"2011","Torbay 017G","E01015189","Total",1170,560,610,1165,5,13,26.66,43.9
"2011","Torbay 018A","E01015244","Total",1463,697,766,1463,0,9,57.22,25.6
"2011","Torbay 018B","E01015245","Total",1312,646,666,1312,0,5,42.75,30.7
"2011","Torbay 018C","E01015246","Total",1440,671,769,1337,103,14,35.98,40.0
"2011","Torbay 018D","E01015247","Total",1707,828,879,1707,0,14,131.35,13.0
"2011","Torbay 018E","E01015248","Total",1440,682,758,1433,7,6,22.88,62.9
"2011","Torbay 019E","E01015207","Total",1577,750,827,1570,7,22,364.34,4.3
"2011","Torbay 019F","E01015208","Total",1852,878,974,1835,17,37,149.03,12.4
"2011","Torbay 019A","E01015209","Total",1395,667,728,1297,98,16,59.41,23.5
"2011","Torbay 019B","E01015210","Total",1507,680,827,1507,0,19,45.23,33.3
"2011","Torbay 019G","E01015211","Total",1478,699,779,1461,17,17,49.46,29.9
"2011","Torbay 019C","E01015212","Total",1394,696,698,1369,25,21,26.54,52.5
"2011","Torbay 019D","E01015213","Total",1433,716,717,1433,0,15,37.40,38.3
"2011","Wiltshire 012A","E01031841","Total",1833,904,929,1813,20,51,3442.14,0.5
"2011","Wiltshire 012B","E01031868","Total",1777,897,880,1762,15,83,7564.43,0.2
"2011","Wiltshire 012C","E01031873","Total",1869,897,972,1768,101,53,6471.39,0.3
"2011","Wiltshire 012D","E01031874","Total",1529,737,792,1529,0,43,306.73,5.0
"2011","Wiltshire 012E","E01031884","Total",1627,804,823,1612,15,50,5702.04,0.3
"2011","Wiltshire 019A","E01031861","Total",2409,1132,1277,2334,75,50,115.17,20.9
"2011","Wiltshire 019B","E01031862","Total",1554,747,807,1554,0,16,47.27,32.9
"2011","Wiltshire 019C","E01031863","Total",1171,550,621,1131,40,25,140.93,8.3
"2011","Wiltshire 019D","E01031864","Total",1329,639,690,1329,0,61,203.79,6.5
"2011","Wiltshire 019E","E01031865","Total",1932,971,961,1213,719,26,97.44,19.8
"2011","Wiltshire 024A","E01031866","Total",1567,777,790,1565,2,67,5655.10,0.3
"2011","Wiltshire 024B","E01031869","Total",1859,868,991,1839,20,14,1233.03,1.5
"2011","Wiltshire 024C","E01031870","Total",1775,865,910,1747,28,43,675.65,2.6
"2011","Wiltshire 024D","E01031871","Total",1659,796,863,1653,6,81,5107.90,0.3
"2011","Wiltshire 025A","E01031850","Total",1894,896,998,1855,39,26,51.36,36.9
"2011","Wiltshire 025B","E01031851","Total",1518,738,780,1512,6,12,29.40,51.6
"2011","Wiltshire 025C","E01031852","Total",2041,984,1057,2030,11,28,77.07,26.5
"2011","Wiltshire 025E","E01032688","Total",1331,646,685,1331,0,21,112.26,11.9
"2011","Wiltshire 025F","E01032689","Total",1350,645,705,1338,12,18,82.94,16.3
"2011","Wiltshire 025G","E01032692","Total",1238,601,637,1167,71,20,84.51,14.6
"2011","Wiltshire 025H","E01032693","Total",1371,680,691,1371,0,26,525.12,2.6
"2011","Wiltshire 026A","E01031853","Total",1420,696,724,1409,11,37,144.55,9.8
"2011","Wiltshire 026B","E01031854","Total",1767,846,921,1767,0,20,72.27,24.4
"2011","Wiltshire 026C","E01031855","Total",1511,725,786,1508,3,31,62.92,24.0
"2011","Wiltshire 026D","E01031856","Total",1564,756,808,1557,7,20,136.22,11.5
"2011","Wiltshire 028A","E01031845","Total",1577,783,794,1538,39,39,1666.05,0.9
"2011","Wiltshire 028B","E01031846","Total",1651,805,846,1627,24,32,1295.70,1.3
"2011","Wiltshire 028C","E01031848","Total",2142,1241,901,1782,360,63,2756.07,0.8
"2011","Wiltshire 028D","E01031872","Total",1622,775,847,1617,5,45,1245.00,1.3
"2011","Wiltshire 028E","E01031876","Total",1502,716,786,1502,0,31,1767.70,0.8
"2011","Wiltshire 029A","E01031843","Total",1782,862,920,1782,0,54,3720.37,0.5
"2011","Wiltshire 029B","E01031847","Total",1772,868,904,1772,0,49,1742.62,1.0
"2011","Wiltshire 029C","E01031849","Total",1679,859,820,1626,53,38,5632.14,0.3
"2011","Wiltshire 029D","E01031877","Total",1836,914,922,1833,3,89,8936.69,0.2
"2011","Wiltshire 034A","E01031844","Total",1926,927,999,1926,0,47,3954.18,0.5
"2011","Wiltshire 034B","E01031857","Total",1631,803,828,1535,96,37,3069.24,0.5
"2011","Wiltshire 034C","E01031858","Total",2084,1036,1048,1752,332,70,861.84,2.4
"2011","Wiltshire 034D","E01031883","Total",1775,854,921,1775,0,51,3576.27,0.5
"2011","Wiltshire 038A","E01031842","Total",1909,923,986,1907,2,47,4380.58,0.4
"2011","Wiltshire 038B","E01031867","Total",1828,905,923,1789,39,49,5587.44,0.3
"2011","Wiltshire 038C","E01031882","Total",2031,1004,1027,2018,13,79,5360.91,0.4
"2011","Wiltshire 041A","E01031859","Total",1743,808,935,1697,46,8,203.30,8.6
"2011","Wiltshire 041B","E01031860","Total",1510,740,770,1510,0,12,400.55,3.8
"2011","Wiltshire 041C","E01031878","Total",2621,1551,1070,2117,504,40,532.41,4.9
"2011","Wiltshire 041D","E01031879","Total",2120,1263,857,1733,387,17,517.93,4.1
"2011","Wiltshire 041E","E01031880","Total",3902,2842,1060,1942,1960,85,974.22,4.0
"2011","Wiltshire 041G","E01032697","Total",1481,745,736,1481,0,19,43.10,34.4
"2011","Wiltshire 041H","E01032698","Total",1671,818,853,1671,0,9,296.16,5.6
"2011","Wiltshire 001A","E01031887","Total",1762,861,901,1748,14,59,2048.45,0.9
"2011","Wiltshire 001B","E01031934","Total",1751,873,878,1749,2,46,1432.67,1.2
"2011","Wiltshire 001C","E01031935","Total",1753,847,906,1719,34,48,2343.44,0.7
"2011","Wiltshire 001D","E01031936","Total",1478,733,745,1478,0,12,41.79,35.4
"2011","Wiltshire 002A","E01031885","Total",1587,816,771,1581,6,65,2705.92,0.6
"2011","Wiltshire 002B","E01031947","Total",1657,805,852,1657,0,10,39.30,42.2
"2011","Wiltshire 002C","E01031948","Total",2105,1059,1046,2095,10,45,1219.36,1.7
"2011","Wiltshire 002D","E01031949","Total",1808,880,928,1771,37,45,111.39,16.2
"2011","Wiltshire 003A","E01031954","Total",1347,663,684,1342,5,27,1033.44,1.3
"2011","Wiltshire 003B","E01031955","Total",1623,768,855,1536,87,42,230.73,7.0
"2011","Wiltshire 003C","E01031956","Total",1301,622,679,1239,62,13,2158.99,0.6
"2011","Wiltshire 003D","E01031962","Total",1330,666,664,1330,0,43,290.61,4.6
"2011","Wiltshire 004A","E01031886","Total",1414,711,703,1414,0,49,1746.20,0.8
"2011","Wiltshire 004B","E01031892","Total",1390,671,719,1379,11,38,1869.59,0.7
"2011","Wiltshire 004C","E01031893","Total",1576,809,767,1576,0,47,3165.03,0.5
"2011","Wiltshire 004D","E01031894","Total",1517,765,752,1515,2,46,3995.28,0.4
"2011","Wiltshire 005A","E01031957","Total",1477,691,786,1477,0,47,2217.27,0.7
"2011","Wiltshire 005B","E01031958","Total",1375,676,699,1375,0,60,3665.34,0.4
"2011","Wiltshire 005C","E01031959","Total",1615,785,830,1551,64,32,1668.14,1.0
"2011","Wiltshire 005D","E01031960","Total",1388,697,691,1385,3,31,1328.54,1.0
"2011","Wiltshire 006A","E01031963","Total",1831,873,958,1771,60,17,50.34,36.4
"2011","Wiltshire 006B","E01031964","Total",1687,851,836,1681,6,34,38.51,43.8
"2011","Wiltshire 006C","E01031967","Total",1908,924,984,1869,39,22,71.16,26.8
"2011","Wiltshire 006D","E01031969","Total",1438,734,704,1438,0,58,26.65,54.0
"2011","Wiltshire 007B","E01031944","Total",1064,527,537,1062,2,28,2265.64,0.5
"2011","Wiltshire 007D","E01031946","Total",2090,1209,881,1561,529,47,146.70,14.2
"2011","Wiltshire 007E","E01031961","Total",1309,646,663,1301,8,39,2763.41,0.5
"2011","Wiltshire 007F","E01031965","Total",1385,671,714,1385,0,24,293.81,4.7
"2011","Wiltshire 007G","E01031966","Total",1537,753,784,1525,12,33,567.58,2.7
"2011","Wiltshire 007H","E01031968","Total",1599,784,815,1599,0,36,999.68,1.6
"2011","Wiltshire 007I","E01032699","Total",2306,1139,1167,2306,0,24,618.49,3.7
"2011","Wiltshire 008A","E01031939","Total",2171,1053,1118,2140,31,52,2003.24,1.1
"2011","Wiltshire 008B","E01031940","Total",2235,1109,1126,2214,21,56,3692.09,0.6
"2011","Wiltshire 008C","E01031950","Total",1397,681,716,1392,5,41,3398.90,0.4
"2011","Wiltshire 008D","E01031951","Total",1431,815,616,1199,232,35,2321.72,0.6
"2011","Wiltshire 009A","E01031907","Total",2524,1239,1285,2473,51,54,65.67,38.4
"2011","Wiltshire 009B","E01031910","Total",1453,722,731,1419,34,16,25.52,56.9
"2011","Wiltshire 009C","E01031914","Total",1325,636,689,1321,4,12,42.73,31.0
"2011","Wiltshire 009D","E01031915","Total",1383,676,707,1366,17,18,62.83,22.0
"2011","Wiltshire 009E","E01031919","Total",1594,780,814,1581,13,32,84.15,18.9
"2011","Wiltshire 009F","E01031920","Total",1262,636,626,1262,0,15,23.99,52.6
"2011","Wiltshire 010A","E01031905","Total",1465,726,739,1461,4,58,56.55,25.9
"2011","Wiltshire 010B","E01031906","Total",1467,740,727,1467,0,15,37.16,39.5
"2011","Wiltshire 010C","E01031908","Total",1628,793,835,1628,0,25,52.91,30.8
"2011","Wiltshire 010D","E01031909","Total",1276,621,655,1271,5,30,27.30,46.7
"2011","Wiltshire 010E","E01031925","Total",1180,566,614,1171,9,12,23.73,49.7
"2011","Wiltshire 010F","E01031926","Total",1507,744,763,1491,16,18,25.82,58.4
"2011","Wiltshire 010G","E01031927","Total",1306,653,653,1306,0,22,22.69,57.6
"2011","Wiltshire 011A","E01031911","Total",1369,651,718,1369,0,8,18.90,72.4
"2011","Wiltshire 011B","E01031912","Total",1366,688,678,1358,8,12,82.95,16.5
"2011","Wiltshire 011C","E01031913","Total",1397,690,707,1322,75,24,73.27,19.1
"2011","Wiltshire 011D","E01031917","Total",1416,704,712,1354,62,13,38.20,37.1
"2011","Wiltshire 011E","E01031918","Total",2460,1202,1258,2411,49,40,97.54,25.2
"2011","Wiltshire 011F","E01031928","Total",1345,635,710,1336,9,9,39.01,34.5
"2011","Wiltshire 013A","E01031891","Total",2301,1130,1171,2248,53,77,5737.81,0.4
"2011","Wiltshire 013B","E01031904","Total",2154,1027,1127,2098,56,48,2948.08,0.7
"2011","Wiltshire 013C","E01031937","Total",1131,558,573,1091,40,23,3849.06,0.3
"2011","Wiltshire 013D","E01031938","Total",1416,707,709,1416,0,25,2110.52,0.7
"2011","Wiltshire 014A","E01031916","Total",1299,638,661,1299,0,24,34.95,37.2
"2011","Wiltshire 014B","E01031921","Total",1468,747,721,1453,15,48,93.65,15.7
"2011","Wiltshire 014C","E01031922","Total",1273,667,606,1273,0,24,263.53,4.8
"2011","Wiltshire 014D","E01031923","Total",1374,695,679,1374,0,38,29.48,46.6
"2011","Wiltshire 014E","E01031924","Total",1663,813,850,1663,0,39,23.43,71.0
"2011","Wiltshire 015A","E01031895","Total",1594,794,800,1590,4,12,60.44,26.4
"2011","Wiltshire 015B","E01031896","Total",1184,516,668,1184,0,7,24.41,48.5
"2011","Wiltshire 015C","E01031897","Total",2209,1128,1081,2141,68,32,62.68,35.2
"2011","Wiltshire 015D","E01031898","Total",1808,735,1073,1536,272,26,33.38,54.2
"2011","Wiltshire 015F","E01032690","Total",1794,909,885,1794,0,15,71.02,25.3
"2011","Wiltshire 015G","E01032691","Total",1537,773,764,1537,0,14,27.69,55.5
"2011","Wiltshire 016A","E01031900","Total",2209,1048,1161,2181,28,30,95.23,23.2
"2011","Wiltshire 016B","E01031901","Total",1458,687,771,1453,5,15,43.05,33.9
"2011","Wiltshire 016C","E01031902","Total",1157,595,562,1157,0,17,30.68,37.7
"2011","Wiltshire 016D","E01031903","Total",2324,1142,1182,2320,4,32,106.06,21.9
"2011","Wiltshire 017A","E01031888","Total",1333,645,688,1303,30,41,1027.91,1.3
"2011","Wiltshire 017B","E01031889","Total",1859,925,934,1852,7,42,260.72,7.1
"2011","Wiltshire 017C","E01031890","Total",1484,730,754,1476,8,27,799.82,1.9
"2011","Wiltshire 017D","E01031929","Total",1318,643,675,1314,4,21,661.08,2.0
"2011","Wiltshire 017E","E01031930","Total",1654,942,712,1367,287,41,904.73,1.8
"2011","Wiltshire 018A","E01031931","Total",1641,790,851,1635,6,36,730.73,2.2
"2011","Wiltshire 018B","E01031932","Total",1447,680,767,1400,47,33,45.46,31.8
"2011","Wiltshire 018C","E01031933","Total",1586,759,827,1548,38,29,60.18,26.4
"2011","Wiltshire 018D","E01031941","Total",1598,768,830,1595,3,44,734.35,2.2
"2011","Wiltshire 018E","E01031942","Total",1431,723,708,1309,122,36,1901.88,0.8
"2011","Wiltshire 018F","E01031952","Total",2423,1137,1286,2359,64,30,423.19,5.7
"2011","Wiltshire 018G","E01031953","Total",2886,1391,1495,2880,6,44,102.24,28.2
"2011","Wiltshire 045B","E01031988","Total",1588,800,788,1588,0,36,305.55,5.2
"2011","Wiltshire 045C","E01031998","Total",3024,1823,1201,2331,693,81,777.77,3.9
"2011","Wiltshire 045D","E01032026","Total",1601,796,805,1599,2,47,3116.63,0.5
"2011","Wiltshire 045F","E01032696","Total",2980,1801,1179,2078,902,71,8436.34,0.4
"2011","Wiltshire 046A","E01031989","Total",1562,800,762,1543,19,18,267.64,5.8
"2011","Wiltshire 046B","E01031996","Total",1397,679,718,1397,0,16,66.08,21.1
"2011","Wiltshire 046C","E01031997","Total",1434,720,714,1434,0,16,80.21,17.9
"2011","Wiltshire 046D","E01031999","Total",1524,751,773,1524,0,24,167.47,9.1
"2011","Wiltshire 048A","E01031974","Total",1264,616,648,1264,0,17,148.75,8.5
"2011","Wiltshire 048B","E01031975","Total",1260,592,668,1260,0,5,24.20,52.1
"2011","Wiltshire 048C","E01031976","Total",1420,709,711,1420,0,43,49.65,28.6
"2011","Wiltshire 048D","E01031977","Total",2944,1467,1477,2878,66,41,867.07,3.4
"2011","Wiltshire 048E","E01031978","Total",1753,855,898,1753,0,19,39.64,44.2
"2011","Wiltshire 048F","E01031979","Total",2083,1011,1072,1960,123,27,1272.93,1.6
"2011","Wiltshire 049A","E01032013","Total",2099,1052,1047,1964,135,55,5363.28,0.4
"2011","Wiltshire 049B","E01032032","Total",1601,775,826,1598,3,27,2279.69,0.7
"2011","Wiltshire 049C","E01032033","Total",1424,714,710,1424,0,49,3307.25,0.4
"2011","Wiltshire 049D","E01032034","Total",1402,670,732,1398,4,38,444.93,3.2
"2011","Wiltshire 050A","E01032010","Total",2090,1005,1085,2057,33,107,6318.12,0.3
"2011","Wiltshire 050B","E01032035","Total",1535,748,787,1502,33,43,2242.35,0.7
"2011","Wiltshire 050C","E01032036","Total",1465,723,742,1457,8,53,5150.51,0.3
"2011","Wiltshire 050D","E01032037","Total",1470,709,761,1438,32,17,70.71,20.8
"2011","Wiltshire 051A","E01031984","Total",1600,764,836,1600,0,53,79.66,20.1
"2011","Wiltshire 051B","E01031985","Total",1309,621,688,1258,51,20,73.91,17.7
"2011","Wiltshire 051C","E01031986","Total",1248,591,657,1242,6,14,45.17,27.6
"2011","Wiltshire 051D","E01032017","Total",1488,691,797,1466,22,53,43.76,34.0
"2011","Wiltshire 052A","E01031980","Total",1538,763,775,1538,0,20,131.40,11.7
"2011","Wiltshire 052B","E01031981","Total",1636,766,870,1636,0,10,103.43,15.8
"2011","Wiltshire 052C","E01031982","Total",1448,710,738,1448,0,14,75.94,19.1
"2011","Wiltshire 052D","E01031983","Total",1747,826,921,1747,0,13,30.13,58.0
"2011","Wiltshire 053A","E01032018","Total",1608,789,819,1580,28,39,344.26,4.7
"2011","Wiltshire 053B","E01032019","Total",1529,704,825,1411,118,20,56.62,27.0
"2011","Wiltshire 053C","E01032020","Total",1495,725,770,1474,21,53,36.31,41.2
"2011","Wiltshire 053D","E01032025","Total",1472,747,725,1472,0,17,79.13,18.6
"2011","Wiltshire 054A","E01031990","Total",1965,938,1027,1964,1,75,8017.46,0.2
"2011","Wiltshire 054B","E01032004","Total",2269,1105,1164,2266,3,75,7215.52,0.3
"2011","Wiltshire 054C","E01032027","Total",1333,650,683,1326,7,63,5525.58,0.2
"2011","Wiltshire 054D","E01032038","Total",1321,619,702,1321,0,63,237.95,5.6
"2011","Wiltshire 054E","E01032039","Total",1363,627,736,1363,0,23,227.11,6.0
"2011","Wiltshire 054F","E01032040","Total",1459,684,775,1459,0,17,1406.62,1.0
"2011","Wiltshire 055A","E01032001","Total",1515,774,741,1496,19,27,67.65,22.4
"2011","Wiltshire 055B","E01032002","Total",1395,683,712,1321,74,12,26.69,52.3
"2011","Wiltshire 055C","E01032003","Total",1458,734,724,1414,44,8,72.49,20.1
"2011","Wiltshire 055D","E01032024","Total",2344,1152,1192,2344,0,18,48.09,48.7
"2011","Wiltshire 056A","E01032014","Total",1721,839,882,1610,111,28,45.72,37.6
"2011","Wiltshire 056B","E01032015","Total",1443,692,751,1342,101,25,27.67,52.2
"2011","Wiltshire 056C","E01032016","Total",1367,653,714,1360,7,49,17.92,76.3
"2011","Wiltshire 056D","E01032021","Total",1606,728,878,1426,180,22,100.08,16.0
"2011","Wiltshire 057A","E01032000","Total",2314,1095,1219,2245,69,77,4196.73,0.6
"2011","Wiltshire 057B","E01032011","Total",2532,1201,1331,2519,13,56,2438.25,1.0
"2011","Wiltshire 057C","E01032012","Total",1806,826,980,1733,73,31,179.03,10.1
"2011","Wiltshire 058A","E01032008","Total",1513,750,763,1513,0,22,34.25,44.2
"2011","Wiltshire 058B","E01032009","Total",1819,863,956,1792,27,42,110.03,16.5
"2011","Wiltshire 058C","E01032022","Total",1671,743,928,1617,54,31,60.12,27.8
"2011","Wiltshire 059A","E01032005","Total",1306,612,694,1265,41,34,73.07,17.9
"2011","Wiltshire 059B","E01032006","Total",1254,572,682,1254,0,41,49.18,25.5
"2011","Wiltshire 059C","E01032007","Total",1348,655,693,1348,0,22,53.75,25.1
"2011","Wiltshire 059D","E01032023","Total",1804,835,969,1702,102,23,36.71,49.1
"2011","Wiltshire 060A","E01031970","Total",1575,722,853,1575,0,50,608.77,2.6
"2011","Wiltshire 060B","E01031971","Total",1182,556,626,1177,5,32,1300.95,0.9
"2011","Wiltshire 060C","E01031972","Total",1504,745,759,1501,3,48,2419.38,0.6
"2011","Wiltshire 060D","E01032041","Total",1925,938,987,1925,0,61,3161.42,0.6
"2011","Wiltshire 060E","E01032042","Total",1723,828,895,1723,0,53,1680.97,1.0
"2011","Wiltshire 061A","E01031991","Total",2121,956,1165,1849,272,85,6882.35,0.3
"2011","Wiltshire 061B","E01032029","Total",1373,650,723,1373,0,64,3160.74,0.4
"2011","Wiltshire 061C","E01032030","Total",1550,740,810,1530,20,15,163.05,9.5
"2011","Wiltshire 061D","E01032031","Total",1075,523,552,1075,0,29,2252.32,0.5
"2011","Wiltshire 062A","E01031973","Total",1875,910,965,1822,53,32,1250.98,1.5
"2011","Wiltshire 062B","E01031992","Total",1483,725,758,1479,4,28,2184.84,0.7
"2011","Wiltshire 062C","E01031993","Total",1456,706,750,1456,0,25,246.79,5.9
"2011","Wiltshire 062D","E01031994","Total",1361,633,728,1288,73,39,226.48,6.0
"2011","Wiltshire 062E","E01031995","Total",1617,798,819,1617,0,27,2709.36,0.6
"2011","Wiltshire 020A","E01032063","Total",1910,958,952,1910,0,6,98.79,19.3
"2011","Wiltshire 020B","E01032064","Total",1335,649,686,1335,0,11,34.46,38.7
"2011","Wiltshire 020C","E01032065","Total",1569,771,798,1569,0,18,43.81,35.8
"2011","Wiltshire 020D","E01032073","Total",1422,712,710,1422,0,14,17.17,82.8
"2011","Wiltshire 020E","E01032074","Total",1108,535,573,1108,0,7,24.07,46.0
"2011","Wiltshire 021A","E01032043","Total",1321,574,747,1191,130,37,1114.02,1.2
"2011","Wiltshire 021B","E01032044","Total",1374,662,712,1324,50,13,493.16,2.8
"2011","Wiltshire 021C","E01032057","Total",1193,590,603,1171,22,21,726.59,1.6
"2011","Wiltshire 021D","E01032070","Total",1510,769,741,1506,4,11,505.29,3.0
"2011","Wiltshire 021E","E01032071","Total",2311,1168,1143,2295,16,50,1853.05,1.2
"2011","Wiltshire 021F","E01032072","Total",2035,1010,1025,2032,3,29,53.30,38.2
"2011","Wiltshire 022A","E01032062","Total",1635,793,842,1550,85,9,98.03,16.7
"2011","Wiltshire 022B","E01032066","Total",1514,725,789,1514,0,12,33.43,45.3
"2011","Wiltshire 022C","E01032067","Total",1531,773,758,1531,0,21,42.47,36.0
"2011","Wiltshire 022D","E01032068","Total",1387,683,704,1378,9,18,30.59,45.3
"2011","Wiltshire 022E","E01032069","Total",1266,625,641,1266,0,28,31.69,39.9
"2011","Wiltshire 023A","E01032058","Total",1415,697,718,1377,38,36,717.36,2.0
"2011","Wiltshire 023B","E01032059","Total",1813,869,944,1771,42,58,2385.35,0.8
"2011","Wiltshire 023C","E01032060","Total",1546,732,814,1517,29,47,499.34,3.1
"2011","Wiltshire 023D","E01032061","Total",1162,540,622,1162,0,20,385.93,3.0
"2011","Wiltshire 027A","E01032045","Total",1476,693,783,1469,7,37,280.14,5.3
"2011","Wiltshire 027B","E01032046","Total",1549,727,822,1547,2,35,52.47,29.5
"2011","Wiltshire 027C","E01032047","Total",1382,659,723,1382,0,29,98.98,14.0
"2011","Wiltshire 027D","E01032048","Total",1698,819,879,1698,0,10,71.50,23.7
"2011","Wiltshire 027E","E01032049","Total",1550,723,827,1550,0,29,179.60,8.6
"2011","Wiltshire 027F","E01032050","Total",1747,810,937,1739,8,44,184.38,9.5
"2011","Wiltshire 030A","E01032077","Total",1678,841,837,1665,13,29,1002.39,1.7
"2011","Wiltshire 030B","E01032078","Total",2872,1410,1462,2835,37,34,214.11,13.4
"2011","Wiltshire 030C","E01032079","Total",1496,741,755,1496,0,9,54.69,27.4
"2011","Wiltshire 030D","E01032080","Total",1719,825,894,1719,0,37,92.50,18.6
"2011","Wiltshire 031A","E01032085","Total",1652,794,858,1625,27,19,45.39,36.4
"2011","Wiltshire 031B","E01032086","Total",2401,1240,1161,2370,31,10,76.79,31.3
"2011","Wiltshire 031C","E01032087","Total",2113,1026,1087,2103,10,16,99.81,21.2
"2011","Wiltshire 032A","E01032099","Total",2959,1410,1549,2925,34,47,96.90,30.5
"2011","Wiltshire 032B","E01032100","Total",1507,731,776,1481,26,16,50.87,29.6
"2011","Wiltshire 032C","E01032101","Total",1670,827,843,1638,32,7,41.92,39.8
"2011","Wiltshire 032D","E01032102","Total",1563,750,813,1514,49,24,65.05,24.0
"2011","Wiltshire 033A","E01032096","Total",1876,892,984,1876,0,25,31.90,58.8
"2011","Wiltshire 033B","E01032097","Total",1857,898,959,1840,17,33,111.91,16.6
"2011","Wiltshire 033C","E01032098","Total",1748,862,886,1642,106,28,51.00,34.3
"2011","Wiltshire 035A","E01032092","Total",1402,691,711,1402,0,21,37.76,37.1
"2011","Wiltshire 035B","E01032093","Total",1860,882,978,1860,0,20,43.77,42.5
"2011","Wiltshire 035C","E01032094","Total",2329,1157,1172,2329,0,18,41.94,55.5
"2011","Wiltshire 035D","E01032095","Total",1698,848,850,1698,0,17,32.91,51.6
"2011","Wiltshire 036A","E01032088","Total",1524,732,792,1517,7,17,32.67,46.6
"2011","Wiltshire 036B","E01032089","Total",1478,758,720,1475,3,9,19.30,76.6
"2011","Wiltshire 036C","E01032090","Total",1435,688,747,1435,0,17,40.36,35.6
"2011","Wiltshire 036D","E01032091","Total",1232,609,623,1228,4,7,34.43,35.8
"2011","Wiltshire 037A","E01032053","Total",1424,709,715,1412,12,11,371.85,3.8
"2011","Wiltshire 037B","E01032083","Total",2274,1117,1157,2271,3,35,1729.57,1.3
"2011","Wiltshire 037C","E01032084","Total",2569,1212,1357,2569,0,49,3360.98,0.8
"2011","Wiltshire 039A","E01032052","Total",1274,630,644,1274,0,39,1140.85,1.1
"2011","Wiltshire 039B","E01032054","Total",1285,627,658,1285,0,22,1168.40,1.1
"2011","Wiltshire 039C","E01032055","Total",1235,601,634,1235,0,37,2851.87,0.4
"2011","Wiltshire 039D","E01032056","Total",1357,664,693,1357,0,32,1945.28,0.7
"2011","Wiltshire 039E","E01032121","Total",1565,769,796,1565,0,18,941.10,1.7
"2011","Wiltshire 040A","E01032115","Total",1749,852,897,1700,49,7,30.54,57.3
"2011","Wiltshire 040B","E01032116","Total",2582,1264,1318,2573,9,18,176.17,14.7
"2011","Wiltshire 040C","E01032117","Total",2657,1283,1374,2628,29,35,101.08,26.3
"2011","Wiltshire 040D","E01032118","Total",1551,739,812,1551,0,11,94.81,16.4
"2011","Wiltshire 040E","E01032119","Total",1866,890,976,1855,11,18,37.23,50.1
"2011","Wiltshire 040G","E01032694","Total",1648,792,856,1644,4,14,33.04,49.9
"2011","Wiltshire 040H","E01032695","Total",1437,692,745,1394,43,21,102.20,14.1
"2011","Wiltshire 042A","E01032104","Total",1349,690,659,1222,127,15,224.50,6.0
"2011","Wiltshire 042B","E01032105","Total",1458,696,762,1441,17,30,61.51,23.7
"2011","Wiltshire 042C","E01032107","Total",1554,800,754,1553,1,59,795.16,2.0
"2011","Wiltshire 042D","E01032108","Total",1336,610,726,1288,48,26,62.59,21.3
"2011","Wiltshire 043A","E01032110","Total",1604,791,813,1604,0,23,441.26,3.6
"2011","Wiltshire 043B","E01032111","Total",1272,620,652,1272,0,18,369.06,3.4
"2011","Wiltshire 043C","E01032112","Total",1479,701,778,1464,15,29,49.90,29.6
"2011","Wiltshire 043D","E01032113","Total",1373,661,712,1373,0,17,25.53,53.8
"2011","Wiltshire 044A","E01032103","Total",1680,811,869,1680,0,27,60.27,27.9
"2011","Wiltshire 044B","E01032106","Total",1397,645,752,1352,45,24,114.00,12.3
"2011","Wiltshire 044C","E01032109","Total",1472,709,763,1467,5,23,43.58,33.8
"2011","Wiltshire 044D","E01032114","Total",1516,744,772,1317,199,17,42.59,35.6
"2011","Wiltshire 047A","E01032051","Total",1324,641,683,1324,0,60,1906.00,0.7
"2011","Wiltshire 047B","E01032075","Total",1342,651,691,1342,0,38,4401.87,0.3
"2011","Wiltshire 047C","E01032076","Total",1221,577,644,1221,0,54,7412.15,0.2
"2011","Wiltshire 047D","E01032081","Total",1226,574,652,1203,23,38,5493.49,0.2
"2011","Wiltshire 047E","E01032082","Total",1225,591,634,1203,22,51,3729.93,0.3
"2011","East Devon 001A","E01019902","Total",2000,985,1015,1974,26,22,3191.27,0.6
"2011","East Devon 001B","E01019938","Total",2201,1114,1087,2186,15,35,7931.20,0.3
"2011","East Devon 001C","E01019967","Total",1291,638,653,1289,2,29,4769.07,0.3
"2011","East Devon 002A","E01019927","Total",1234,566,668,1234,0,13,20.94,58.9
"2011","East Devon 002B","E01019932","Total",1612,758,854,1612,0,23,66.02,24.4
"2011","East Devon 002C","E01019933","Total",1208,575,633,1208,0,14,38.66,31.2
"2011","East Devon 002D","E01019934","Total",1865,874,991,1827,38,23,435.55,4.3
"2011","East Devon 003A","E01019928","Total",1450,684,766,1424,26,8,33.82,42.9
"2011","East Devon 003B","E01019929","Total",1445,687,758,1445,0,9,41.04,35.2
"2011","East Devon 003C","E01019930","Total",1385,643,742,1385,0,16,119.76,11.6
"2011","East Devon 003D","E01019931","Total",1284,614,670,1253,31,19,540.85,2.4
"2011","East Devon 004A","E01019925","Total",1288,647,641,1288,0,8,79.89,16.1
"2011","East Devon 004D","E01019959","Total",1152,569,583,1152,0,21,2647.61,0.4
"2011","East Devon 004E","E01019960","Total",1362,671,691,1362,0,37,2476.08,0.6
"2011","East Devon 004F","E01019962","Total",2380,1142,1238,2375,5,39,2205.02,1.1
"2011","East Devon 004G","E01032628","Total",2049,996,1053,2026,23,50,3635.93,0.6
"2011","East Devon 005A","E01019886","Total",2603,1272,1331,2591,12,39,2386.86,1.1
"2011","East Devon 005B","E01019887","Total",1426,677,749,1408,18,11,62.78,22.7
"2011","East Devon 005C","E01019888","Total",1599,730,869,1511,88,12,814.90,2.0
"2011","East Devon 005D","E01019889","Total",1482,718,764,1482,0,9,740.15,2.0
"2011","East Devon 005E","E01019966","Total",1070,528,542,1068,2,15,1159.75,0.9
"2011","East Devon 006A","E01019891","Total",1462,733,729,1429,33,41,4132.91,0.4
"2011","East Devon 006B","E01019892","Total",1553,768,785,1515,38,37,1196.40,1.3
"2011","East Devon 006C","E01019893","Total",1827,868,959,1810,17,25,2248.67,0.8
"2011","East Devon 006D","E01019903","Total",2041,991,1050,2039,2,34,2950.62,0.7
"2011","East Devon 007A","E01019899","Total",1335,620,715,1335,0,22,48.28,27.7
"2011","East Devon 007B","E01019900","Total",1830,871,959,1789,41,43,2526.03,0.7
"2011","East Devon 007C","E01019935","Total",1237,589,648,1235,2,21,1893.39,0.7
"2011","East Devon 007D","E01019936","Total",1121,548,573,1095,26,15,1509.30,0.7
"2011","East Devon 007E","E01019961","Total",2521,1219,1302,2463,58,59,3638.29,0.7
"2011","East Devon 008A","E01019939","Total",1484,705,779,1484,0,30,1295.68,1.1
"2011","East Devon 008B","E01019940","Total",1577,742,835,1532,45,33,1428.48,1.1
"2011","East Devon 008C","E01019942","Total",1783,867,916,1778,5,37,191.33,9.3
"2011","East Devon 008D","E01019943","Total",1574,767,807,1574,0,28,608.78,2.6
"2011","East Devon 008E","E01019944","Total",1541,721,820,1526,15,17,71.21,21.6
"2011","East Devon 009A","E01019890","Total",1824,896,928,1823,1,29,2086.95,0.9
"2011","East Devon 009B","E01019901","Total",1328,651,677,1328,0,37,4315.92,0.3
"2011","East Devon 009C","E01019951","Total",2187,1012,1175,2121,66,37,3395.59,0.6
"2011","East Devon 010A","E01019946","Total",1401,668,733,1312,89,15,118.62,11.8
"2011","East Devon 010B","E01019947","Total",1787,794,993,1725,62,12,54.54,32.8
"2011","East Devon 010C","E01019948","Total",1267,589,678,1267,0,7,40.96,30.9
"2011","East Devon 010D","E01019949","Total",1421,644,777,1382,39,20,202.17,7.0
"2011","East Devon 010E","E01019950","Total",1220,565,655,1216,4,12,59.57,20.5
"2011","East Devon 011A","E01019952","Total",1711,758,953,1692,19,18,69.46,24.6
"2011","East Devon 011B","E01019953","Total",1533,736,797,1533,0,12,131.84,11.6
"2011","East Devon 011C","E01019954","Total",1483,668,815,1483,0,20,395.87,3.7
"2011","East Devon 011D","E01019955","Total",1645,785,860,1645,0,17,52.22,31.5
"2011","East Devon 012A","E01019956","Total",1639,715,924,1555,84,32,43.55,37.6
"2011","East Devon 012B","E01019957","Total",1727,763,964,1606,121,26,310.76,5.6
"2011","East Devon 012C","E01019958","Total",1812,844,968,1744,68,26,235.79,7.7
"2011","East Devon 013A","E01019937","Total",2095,997,1098,2095,0,39,1351.46,1.6
"2011","East Devon 013B","E01019945","Total",2120,1047,1073,1973,147,139,3926.99,0.5
"2011","East Devon 013C","E01019963","Total",1605,763,842,1605,0,41,260.89,6.2
"2011","East Devon 014A","E01019898","Total",2326,1169,1157,2314,12,49,1984.50,1.2
"2011","East Devon 014B","E01019964","Total",1892,1347,545,1021,871,40,1906.36,1.0
"2011","East Devon 014C","E01019965","Total",1763,855,908,1753,10,43,106.04,16.6
"2011","East Devon 015A","E01019904","Total",1359,623,736,1348,11,19,25.85,52.6
"2011","East Devon 015B","E01019905","Total",2020,995,1025,1944,76,32,211.71,9.5
"2011","East Devon 015C","E01019906","Total",1446,663,783,1446,0,12,31.66,45.7
"2011","East Devon 015D","E01019907","Total",1495,727,768,1495,0,14,33.11,45.2
"2011","East Devon 016A","E01019908","Total",1751,830,921,1751,0,24,24.67,71.0
"2011","East Devon 016B","E01019909","Total",1790,852,938,1790,0,17,52.04,34.4
"2011","East Devon 016C","E01019910","Total",1637,811,826,1602,35,33,54.73,29.9
"2011","East Devon 016D","E01019911","Total",1541,698,843,1527,14,19,124.13,12.4
"2011","East Devon 017A","E01019894","Total",1403,621,782,1403,0,17,76.99,18.2
"2011","East Devon 017B","E01019895","Total",1377,640,737,1357,20,20,984.92,1.4
"2011","East Devon 017C","E01019896","Total",1634,720,914,1531,103,27,256.62,6.4
"2011","East Devon 017D","E01019897","Total",1553,736,817,1553,0,7,49.35,31.5
"2011","East Devon 018A","E01019920","Total",1483,692,791,1449,34,14,43.80,33.9
"2011","East Devon 018B","E01019921","Total",1561,729,832,1546,15,24,35.39,44.1
"2011","East Devon 018C","E01019922","Total",1432,634,798,1432,0,13,37.73,38.0
"2011","East Devon 018D","E01019923","Total",1232,603,629,1224,8,9,29.36,42.0
"2011","East Devon 018E","E01019924","Total",1515,711,804,1515,0,7,258.55,5.9
"2011","East Devon 019A","E01019916","Total",1891,924,967,1891,0,12,29.51,64.1
"2011","East Devon 019B","E01019917","Total",1537,721,816,1515,22,19,17.27,89.0
"2011","East Devon 019C","E01019918","Total",1880,920,960,1803,77,20,46.96,40.0
"2011","East Devon 019D","E01019919","Total",1717,834,883,1717,0,12,15.41,111.4
"2011","East Devon 020A","E01019912","Total",1688,757,931,1626,62,13,34.84,48.5
"2011","East Devon 020B","E01019913","Total",1574,691,883,1421,153,22,142.77,11.0
"2011","East Devon 020C","E01019914","Total",2195,1051,1144,2157,38,10,558.35,3.9
"2011","East Devon 020D","E01019915","Total",1688,775,913,1588,100,30,72.37,23.3
"2011","Exeter 001C","E01019998","Total",1423,694,729,1423,0,17,37.46,38.0
"2011","Exeter 001D","E01019999","Total",1302,643,659,1302,0,26,28.92,45.0
"2011","Exeter 001E","E01020001","Total",1302,615,687,1302,0,25,288.34,4.5
"2011","Exeter 001F","E01033233","Total",4992,2433,2559,2150,2842,90,360.71,13.8
"2011","Exeter 002A","E01019990","Total",1344,637,707,1344,0,8,49.78,27.0
"2011","Exeter 002B","E01019991","Total",1500,726,774,1498,2,9,31.53,47.6
"2011","Exeter 002C","E01019993","Total",1174,598,576,1174,0,7,173.95,6.7
"2011","Exeter 002D","E01020000","Total",1316,616,700,1312,4,12,22.18,59.3
"2011","Exeter 002E","E01020007","Total",1491,775,716,1488,3,15,21.24,70.2
"2011","Exeter 003A","E01019992","Total",1503,701,802,1484,19,14,35.62,42.2
"2011","Exeter 003B","E01020002","Total",1482,677,805,1482,0,14,105.30,14.1
"2011","Exeter 003C","E01020003","Total",1631,767,864,1629,2,18,90.70,18.0
"2011","Exeter 003D","E01020004","Total",1480,702,778,1469,11,13,72.79,20.3
"2011","Exeter 003E","E01020005","Total",1861,915,946,1861,0,8,64.43,28.9
"2011","Exeter 004A","E01019997","Total",1530,748,782,1528,2,8,9.47,161.6
"2011","Exeter 004B","E01020019","Total",1783,757,1026,1711,72,25,14.47,123.2
"2011","Exeter 004C","E01020020","Total",1748,829,919,1491,257,32,20.45,85.5
"2011","Exeter 004D","E01020021","Total",1653,930,723,1373,280,30,42.09,39.3
"2011","Exeter 004E","E01020022","Total",1707,853,854,1623,84,11,17.76,96.1
"2011","Exeter 005A","E01019980","Total",1681,838,843,1681,0,20,40.84,41.2
"2011","Exeter 005B","E01019982","Total",1628,800,828,1628,0,16,183.42,8.9
"2011","Exeter 005C","E01019983","Total",1469,709,760,1445,24,6,34.72,42.3
"2011","Exeter 005D","E01019984","Total",1363,693,670,1363,0,6,26.63,51.2
"2011","Exeter 005E","E01019985","Total",1405,664,741,1405,0,8,49.05,28.6
"2011","Exeter 006A","E01019987","Total",1705,819,886,1342,363,20,18.74,91.0
"2011","Exeter 006B","E01019989","Total",1173,543,630,1172,1,14,11.89,98.7
"2011","Exeter 006C","E01020006","Total",2041,1036,1005,2041,0,22,41.61,49.1
"2011","Exeter 006D","E01020008","Total",1773,923,850,1767,6,24,13.46,131.7
"2011","Exeter 006E","E01020009","Total",1481,769,712,1476,5,31,22.62,65.5
"2011","Exeter 007A","E01019986","Total",1505,717,788,1505,0,16,29.29,51.4
"2011","Exeter 007B","E01020036","Total",1485,716,769,1485,0,29,41.43,35.8
"2011","Exeter 007C","E01020037","Total",1393,650,743,1369,24,16,26.20,53.2
"2011","Exeter 007D","E01020039","Total",1868,891,977,1868,0,7,29.18,64.0
"2011","Exeter 007E","E01020040","Total",1306,633,673,1306,0,15,32.38,40.3
"2011","Exeter 008A","E01019994","Total",1532,755,777,1436,96,31,19.97,76.7
"2011","Exeter 008B","E01019995","Total",1417,722,695,1397,20,8,34.29,41.3
"2011","Exeter 008C","E01020016","Total",2147,1145,1002,1868,279,12,60.69,35.4
"2011","Exeter 008D","E01020017","Total",2488,1287,1201,2007,481,20,45.25,55.0
"2011","Exeter 008E","E01020018","Total",2000,993,1007,1907,93,7,31.53,63.4
"2011","Exeter 009A","E01019996","Total",1372,637,735,1087,285,22,20.34,67.5
"2011","Exeter 009B","E01020023","Total",2203,1047,1156,2200,3,55,61.57,35.8
"2011","Exeter 009C","E01020024","Total",1531,688,843,1468,63,46,42.80,35.8
"2011","Exeter 009D","E01020025","Total",1481,699,782,1427,54,15,20.11,73.6
"2011","Exeter 010A","E01019975","Total",1369,670,699,1369,0,4,19.52,70.1
"2011","Exeter 010B","E01020029","Total",1601,810,791,1601,0,21,18.97,84.4
"2011","Exeter 010C","E01020030","Total",1812,866,946,1812,0,23,29.49,61.4
"2011","Exeter 010D","E01020031","Total",1590,747,843,1585,5,18,16.97,93.7
"2011","Exeter 010E","E01020032","Total",1452,747,705,1405,47,25,20.52,70.8
"2011","Exeter 011A","E01020026","Total",1736,850,886,1736,0,15,44.21,39.3
"2011","Exeter 011B","E01020027","Total",1586,797,789,1574,12,13,49.77,31.9
"2011","Exeter 011D","E01020035","Total",1615,780,835,1552,63,14,255.50,6.3
"2011","Exeter 011E","E01020038","Total",1436,697,739,1436,0,21,121.90,11.8
"2011","Exeter 011F","E01033232","Total",1462,743,719,1462,0,15,27.31,53.5
"2011","Exeter 011G","E01033234","Total",1472,739,733,1472,0,23,218.19,6.7
"2011","Exeter 012A","E01019973","Total",1451,703,748,1430,21,12,69.76,20.8
"2011","Exeter 012B","E01019974","Total",1422,677,745,1422,0,18,26.85,53.0
"2011","Exeter 012C","E01019976","Total",1378,623,755,1264,114,10,107.31,12.8
"2011","Exeter 012D","E01019977","Total",1481,716,765,1462,19,13,25.10,59.0
"2011","Exeter 012E","E01019981","Total",1443,719,724,1443,0,15,59.41,24.3
"2011","Exeter 013A","E01019988","Total",1441,671,770,1439,2,13,21.60,66.7
"2011","Exeter 013B","E01020010","Total",1825,848,977,1825,0,15,50.85,35.9
"2011","Exeter 013C","E01020013","Total",1323,643,680,1264,59,7,48.22,27.4
"2011","Exeter 013D","E01020014","Total",1568,764,804,1568,0,10,23.41,67.0
"2011","Exeter 013E","E01020015","Total",1819,891,928,1819,0,7,36.17,50.3
"2011","Exeter 014A","E01019968","Total",1541,723,818,1516,25,11,65.21,23.6
"2011","Exeter 014B","E01019969","Total",1310,659,651,1286,24,12,124.55,10.5
"2011","Exeter 014C","E01019970","Total",1363,637,726,1267,96,12,227.15,6.0
"2011","Exeter 014D","E01019971","Total",1616,827,789,1547,69,6,60.06,26.9
"2011","Exeter 014E","E01019972","Total",1401,675,726,1391,10,11,27.58,50.8
"2011","Exeter 015A","E01020011","Total",1219,592,627,1219,0,19,97.84,12.5
"2011","Exeter 015B","E01020012","Total",1468,668,800,1468,0,10,71.68,20.5
"2011","Exeter 015C","E01020033","Total",1655,769,886,1632,23,25,217.60,7.6
"2011","Exeter 015E","E01033235","Total",1232,517,715,1232,0,20,26.86,45.9
"2011","Exeter 015F","E01033236","Total",1017,453,564,1016,1,16,68.01,15.0
"2011","Mid Devon 001A","E01020046","Total",1571,781,790,1560,11,24,4309.42,0.4
"2011","Mid Devon 001B","E01020049","Total",1307,662,645,1307,0,29,6808.05,0.2
"2011","Mid Devon 001C","E01020050","Total",2105,998,1107,2059,46,39,4556.08,0.5
"2011","Mid Devon 001D","E01020077","Total",1603,804,799,1603,0,29,5109.66,0.3
"2011","Mid Devon 002A","E01020047","Total",2146,1014,1132,2089,57,36,1699.42,1.3
"2011","Mid Devon 002B","E01020051","Total",1800,861,939,1800,0,41,553.35,3.3
"2011","Mid Devon 002C","E01020066","Total",2835,1397,1438,2835,0,42,1559.26,1.8
"2011","Mid Devon 002D","E01020080","Total",1266,623,643,1266,0,22,1764.22,0.7
"2011","Mid Devon 003A","E01020063","Total",2448,1201,1247,2439,9,19,1110.68,2.2
"2011","Mid Devon 003B","E01020074","Total",2137,1058,1079,2135,2,46,4316.04,0.5
"2011","Mid Devon 003C","E01020075","Total",1902,935,967,1902,0,32,2842.39,0.7
"2011","Mid Devon 004A","E01020052","Total",1787,858,929,1762,25,21,208.96,8.6
"2011","Mid Devon 004B","E01020053","Total",1463,699,764,1463,0,9,26.32,55.6
"2011","Mid Devon 004C","E01020065","Total",1978,994,984,1780,198,14,98.21,20.1
"2011","Mid Devon 004D","E01020067","Total",1972,944,1028,1972,0,11,28.43,69.4
"2011","Mid Devon 005A","E01020048","Total",2079,1049,1030,2056,23,15,86.20,24.1
"2011","Mid Devon 005B","E01020078","Total",1367,667,700,1361,6,8,30.94,44.2
"2011","Mid Devon 005C","E01020079","Total",1361,658,703,1345,16,6,64.97,20.9
"2011","Mid Devon 005D","E01020081","Total",1281,629,652,1278,3,10,1029.54,1.2
"2011","Mid Devon 006A","E01020045","Total",1647,810,837,1642,5,34,1949.15,0.8
"2011","Mid Devon 006B","E01020059","Total",2096,1045,1051,2093,3,47,4352.41,0.5
"2011","Mid Devon 006C","E01020062","Total",1547,761,786,1547,0,31,160.99,9.6
"2011","Mid Devon 006D","E01020064","Total",1813,883,930,1783,30,9,248.00,7.3
"2011","Mid Devon 007A","E01020054","Total",2079,1032,1047,2075,4,25,203.98,10.2
"2011","Mid Devon 007B","E01020055","Total",1920,901,1019,1836,84,14,99.90,19.2
"2011","Mid Devon 007C","E01020057","Total",1716,821,895,1711,5,15,36.55,46.9
"2011","Mid Devon 007D","E01020058","Total",1928,962,966,1900,28,16,41.45,46.5
"2011","Mid Devon 008A","E01020043","Total",2041,975,1066,2020,21,32,626.27,3.3
"2011","Mid Devon 008B","E01020044","Total",1602,784,818,1599,3,24,4686.19,0.3
"2011","Mid Devon 008C","E01020056","Total",2044,1012,1032,1998,46,46,6096.54,0.3
"2011","Mid Devon 008D","E01020071","Total",1875,892,983,1875,0,27,1266.96,1.5
"2011","Mid Devon 009A","E01020072","Total",1660,796,864,1660,0,24,5782.13,0.3
"2011","Mid Devon 009B","E01020073","Total",1629,811,818,1605,24,19,3690.96,0.4
"2011","Mid Devon 009C","E01020076","Total",1708,832,876,1688,20,33,3388.20,0.5
"2011","Mid Devon 009D","E01020082","Total",1158,585,573,1146,12,30,3562.60,0.3
"2011","Mid Devon 010A","E01020068","Total",1520,738,782,1496,24,42,4013.59,0.4
"2011","Mid Devon 010B","E01020069","Total",1536,752,784,1523,13,33,4294.11,0.4
"2011","Mid Devon 010C","E01020070","Total",1893,943,950,1878,15,21,6408.26,0.3
"2011","Mid Devon 010D","E01020083","Total",2330,1192,1138,2315,15,43,3743.21,0.6
"2011","Mid Devon 011A","E01020041","Total",2176,1083,1093,2126,50,13,238.48,9.1
"2011","Mid Devon 011B","E01020042","Total",1648,824,824,1648,0,14,93.16,17.7
"2011","Mid Devon 011C","E01020060","Total",1682,811,871,1665,17,14,37.99,44.3
"2011","Mid Devon 011D","E01020061","Total",2094,993,1101,2025,69,43,70.26,29.8
"2011","North Devon 001A","E01020111","Total",1451,663,788,1428,23,13,28.22,51.4
"2011","North Devon 001B","E01020112","Total",1622,824,798,1499,123,9,23.90,67.9
"2011","North Devon 001C","E01020114","Total",1232,612,620,1200,32,10,38.38,32.1
"2011","North Devon 001D","E01020115","Total",1212,598,614,1185,27,15,613.62,2.0
"2011","North Devon 002A","E01020099","Total",1380,669,711,1364,16,13,2137.77,0.6
"2011","North Devon 002B","E01020100","Total",1095,545,550,1069,26,25,4849.16,0.2
"2011","North Devon 002C","E01020101","Total",1466,705,761,1462,4,12,71.26,20.6
"2011","North Devon 002D","E01020126","Total",1647,791,856,1450,197,21,6857.10,0.2
"2011","North Devon 003A","E01020113","Total",1455,711,744,1326,129,7,82.36,17.7
"2011","North Devon 003B","E01020116","Total",1651,816,835,1614,37,21,37.27,44.3
"2011","North Devon 003C","E01020117","Total",1498,714,784,1498,0,28,1317.96,1.1
"2011","North Devon 003D","E01020118","Total",1388,659,729,1359,29,10,69.14,20.1
"2011","North Devon 004A","E01020090","Total",1723,856,867,1657,66,44,1747.75,1.0
"2011","North Devon 004B","E01020108","Total",2308,1134,1174,2253,55,23,3194.92,0.7
"2011","North Devon 004C","E01020109","Total",1440,697,743,1432,8,33,1649.45,0.9
"2011","North Devon 005A","E01020089","Total",2276,1069,1207,2249,27,23,59.65,38.2
"2011","North Devon 005B","E01020091","Total",1296,645,651,1296,0,20,2076.01,0.6
"2011","North Devon 005C","E01020092","Total",1421,682,739,1402,19,23,155.20,9.2
"2011","North Devon 005D","E01020093","Total",1412,670,742,1409,3,18,178.89,7.9
"2011","North Devon 005E","E01020110","Total",2673,1535,1138,2164,509,55,1144.98,2.3
"2011","North Devon 006A","E01020088","Total",2117,1042,1075,2048,69,50,8002.56,0.3
"2011","North Devon 006B","E01020120","Total",1904,909,995,1877,27,35,2452.22,0.8
"2011","North Devon 006C","E01020127","Total",1879,934,945,1870,9,45,7704.37,0.2
"2011","North Devon 007A","E01020132","Total",1805,853,952,1802,3,26,154.21,11.7
"2011","North Devon 007B","E01020133","Total",1472,712,760,1472,0,24,49.00,30.0
"2011","North Devon 007C","E01020134","Total",1175,570,605,1128,47,15,71.40,16.5
"2011","North Devon 007D","E01020139","Total",1397,669,728,1392,5,16,24.42,57.2
"2011","North Devon 008A","E01020094","Total",1706,848,858,1688,18,15,40.17,42.5
"2011","North Devon 008B","E01020095","Total",1521,746,775,1515,6,11,17.95,84.7
"2011","North Devon 008C","E01020140","Total",1187,570,617,1187,0,9,189.13,6.3
"2011","North Devon 008D","E01020141","Total",1786,845,941,1786,0,10,56.66,31.5
"2011","North Devon 009A","E01020096","Total",1683,829,854,1649,34,15,36.77,45.8
"2011","North Devon 009B","E01020123","Total",1449,679,770,1445,4,15,54.72,26.5
"2011","North Devon 009C","E01020124","Total",1364,671,693,1326,38,21,102.23,13.3
"2011","North Devon 009D","E01020125","Total",1286,611,675,1286,0,9,41.32,31.1
"2011","North Devon 010A","E01020102","Total",1681,807,874,1681,0,19,39.29,42.8
"2011","North Devon 010B","E01020103","Total",1497,722,775,1497,0,5,24.68,60.7
"2011","North Devon 010C","E01020104","Total",1413,668,745,1406,7,9,20.46,69.1
"2011","North Devon 010D","E01020128","Total",1311,622,689,1259,52,27,94.43,13.9
"2011","North Devon 010E","E01020129","Total",1179,561,618,1179,0,17,41.55,28.4
"2011","North Devon 010F","E01020130","Total",1533,724,809,1530,3,19,14.75,103.9
"2011","North Devon 011A","E01020105","Total",1505,712,793,1505,0,12,135.04,11.1
"2011","North Devon 011B","E01020106","Total",1130,529,601,1126,4,14,289.37,3.9
"2011","North Devon 011C","E01020107","Total",1675,779,896,1617,58,26,612.90,2.7
"2011","North Devon 011D","E01020119","Total",1501,740,761,1476,25,28,2995.00,0.5
"2011","North Devon 012A","E01020084","Total",1502,707,795,1502,0,12,34.28,43.8
"2011","North Devon 012B","E01020085","Total",1549,742,807,1549,0,16,49.08,31.6
"2011","North Devon 012C","E01020086","Total",1514,735,779,1505,9,18,533.25,2.8
"2011","North Devon 012D","E01020121","Total",1951,945,1006,1938,13,28,1665.43,1.2
"2011","North Devon 012E","E01020122","Total",1708,842,866,1707,1,32,3863.54,0.4
"2011","North Devon 013A","E01020097","Total",2255,1098,1157,2232,23,40,9631.05,0.2
"2011","North Devon 013B","E01020131","Total",2206,1128,1078,2092,114,35,14129.39,0.2
"2011","North Devon 013C","E01020135","Total",1568,758,810,1568,0,14,61.02,25.7
"2011","North Devon 013D","E01020136","Total",1745,824,921,1715,30,26,1525.07,1.1
"2011","North Devon 013E","E01020137","Total",1562,745,817,1497,65,23,64.35,24.3
"2011","North Devon 014A","E01020087","Total",1911,938,973,1869,42,34,10257.74,0.2
"2011","North Devon 014B","E01020098","Total",2081,1015,1066,2072,9,47,8396.14,0.2
"2011","North Devon 014C","E01020138","Total",2313,1134,1179,2283,30,44,8797.17,0.3
"2011","South Hams 001A","E01020144","Total",1538,768,770,1538,0,15,42.62,36.1
"2011","South Hams 001B","E01020145","Total",2001,1090,911,1805,196,33,5614.34,0.4
"2011","South Hams 001C","E01020146","Total",1184,571,613,1118,66,9,191.22,6.2
"2011","South Hams 001D","E01020149","Total",1202,592,610,1202,0,10,2802.66,0.4
"2011","South Hams 002A","E01020148","Total",1119,538,581,1119,0,32,5448.68,0.2
"2011","South Hams 002B","E01020157","Total",2321,1115,1206,2259,62,50,11325.09,0.2
"2011","South Hams 002C","E01020160","Total",1884,929,955,1882,2,31,3481.51,0.5
"2011","South Hams 002D","E01020176","Total",1150,524,626,1113,37,18,1154.24,1.0
"2011","South Hams 002E","E01020177","Total",1409,658,751,1368,41,20,82.88,17.0
"2011","South Hams 003A","E01020180","Total",1872,837,1035,1865,7,27,125.17,15.0
"2011","South Hams 003B","E01020181","Total",1710,823,887,1693,17,24,45.22,37.8
"2011","South Hams 003C","E01020182","Total",1483,699,784,1474,9,26,74.04,20.0
"2011","South Hams 003D","E01020183","Total",1402,656,746,1383,19,12,33.72,41.6
"2011","South Hams 003E","E01020184","Total",1609,745,864,1609,0,26,320.98,5.0
"2011","South Hams 004A","E01020153","Total",1217,593,624,1215,2,13,1898.45,0.6
"2011","South Hams 004B","E01020156","Total",1877,913,964,1877,0,40,3133.35,0.6
"2011","South Hams 004C","E01020170","Total",2123,1046,1077,2114,9,36,851.49,2.5
"2011","South Hams 004D","E01020188","Total",1946,930,1016,1937,9,40,5322.38,0.4
"2011","South Hams 005A","E01020161","Total",2477,1140,1337,2384,93,32,86.67,28.6
"2011","South Hams 005B","E01020162","Total",1655,789,866,1655,0,28,28.58,57.9
"2011","South Hams 005C","E01020163","Total",1807,891,916,1797,10,42,42.06,43.0
"2011","South Hams 005D","E01020164","Total",1548,762,786,1530,18,24,40.93,37.8
"2011","South Hams 005E","E01020165","Total",1535,756,779,1535,0,33,24.99,61.4
"2011","South Hams 005F","E01020166","Total",1443,710,733,1416,27,18,32.64,44.2
"2011","South Hams 005G","E01020167","Total",1386,668,718,1386,0,43,60.97,22.7
"2011","South Hams 006A","E01020142","Total",2265,1083,1182,2265,0,37,5515.83,0.4
"2011","South Hams 006B","E01020143","Total",2217,1084,1133,2213,4,48,5349.40,0.4
"2011","South Hams 006C","E01020150","Total",1753,821,932,1685,68,38,1231.04,1.4
"2011","South Hams 007A","E01020151","Total",1584,764,820,1562,22,21,409.07,3.9
"2011","South Hams 007B","E01020152","Total",1424,680,744,1424,0,15,41.39,34.4
"2011","South Hams 007C","E01020154","Total",1559,885,674,1291,268,17,312.41,5.0
"2011","South Hams 007D","E01020155","Total",1038,520,518,1038,0,6,19.44,53.4
"2011","South Hams 008A","E01020147","Total",1951,944,1007,1918,33,46,4206.78,0.5
"2011","South Hams 008B","E01020158","Total",1677,799,878,1677,0,44,2375.75,0.7
"2011","South Hams 008C","E01020159","Total",1443,717,726,1408,35,53,3506.08,0.4
"2011","South Hams 008D","E01020190","Total",2049,961,1088,2031,18,42,1690.32,1.2
"2011","South Hams 009A","E01020171","Total",1814,894,920,1803,11,60,1881.39,1.0
"2011","South Hams 009B","E01020185","Total",1315,632,683,1315,0,19,638.03,2.1
"2011","South Hams 009C","E01020186","Total",1425,677,748,1420,5,18,891.16,1.6
"2011","South Hams 009D","E01020187","Total",1715,816,899,1691,24,20,1365.59,1.3
"2011","South Hams 010A","E01020168","Total",2074,986,1088,2025,49,28,183.50,11.3
"2011","South Hams 010B","E01020169","Total",2307,1091,1216,2307,0,40,181.26,12.7
"2011","South Hams 010C","E01020189","Total",2042,947,1095,2009,33,38,1095.96,1.9
"2011","South Hams 011A","E01020174","Total",1529,741,788,1529,0,28,4111.47,0.4
"2011","South Hams 011B","E01020175","Total",1927,920,1007,1927,0,25,3268.57,0.6
"2011","South Hams 011C","E01020178","Total",1895,905,990,1894,1,24,2398.40,0.8
"2011","South Hams 012A","E01020172","Total",1800,850,950,1751,49,28,2287.29,0.8
"2011","South Hams 012B","E01020173","Total",1553,745,808,1502,51,34,284.82,5.5
"2011","South Hams 012C","E01020179","Total",1886,911,975,1846,40,41,3139.95,0.6
"2011","Teignbridge 001A","E01020243","Total",1193,562,631,1193,0,22,1828.50,0.7
"2011","Teignbridge 001B","E01020262","Total",1243,592,651,1179,64,23,3641.59,0.3
"2011","Teignbridge 001C","E01020263","Total",1472,728,744,1472,0,11,1842.22,0.8
"2011","Teignbridge 001D","E01020274","Total",1285,636,649,1277,8,53,5402.18,0.2
"2011","Teignbridge 002A","E01020240","Total",1544,728,816,1494,50,17,902.90,1.7
"2011","Teignbridge 002B","E01020241","Total",1744,868,876,1740,4,34,2743.32,0.6
"2011","Teignbridge 002C","E01020242","Total",1425,681,744,1421,4,19,326.86,4.4
"2011","Teignbridge 002D","E01020244","Total",1412,673,739,1410,2,9,607.22,2.3
"2011","Teignbridge 002E","E01020245","Total",1634,804,830,1612,22,27,2772.54,0.6
"2011","Teignbridge 003A","E01020205","Total",1447,698,749,1380,67,38,3133.83,0.5
"2011","Teignbridge 003B","E01020258","Total",1703,829,874,1658,45,42,3199.32,0.5
"2011","Teignbridge 003C","E01020259","Total",1103,530,573,1099,4,25,9222.36,0.1
"2011","Teignbridge 003D","E01020273","Total",1383,680,703,1382,1,35,2094.84,0.7
"2011","Teignbridge 004A","E01020203","Total",1651,785,866,1649,2,19,236.53,7.0
"2011","Teignbridge 004B","E01020206","Total",1528,744,784,1524,4,30,60.98,25.1
"2011","Teignbridge 004C","E01020220","Total",1367,671,696,1324,43,27,247.96,5.5
"2011","Teignbridge 004D","E01020221","Total",1766,886,880,1743,23,25,2185.49,0.8
"2011","Teignbridge 004E","E01020222","Total",1245,599,646,1245,0,26,43.65,28.5
"2011","Teignbridge 004F","E01020223","Total",1747,876,871,1742,5,19,1598.44,1.1
"2011","Teignbridge 005A","E01020229","Total",1667,859,808,1595,72,28,920.25,1.8
"2011","Teignbridge 005B","E01020230","Total",1687,785,902,1645,42,19,82.63,20.4
"2011","Teignbridge 005C","E01020231","Total",1469,682,787,1454,15,12,90.67,16.2
"2011","Teignbridge 005D","E01020232","Total",1627,764,863,1607,20,21,43.33,37.5
"2011","Teignbridge 006A","E01020228","Total",1753,819,934,1619,134,16,28.76,61.0
"2011","Teignbridge 006B","E01020233","Total",1726,821,905,1672,54,33,193.44,8.9
"2011","Teignbridge 006C","E01020234","Total",1459,700,759,1444,15,14,28.79,50.7
"2011","Teignbridge 006D","E01020235","Total",1773,801,972,1715,58,18,783.10,2.3
"2011","Teignbridge 007A","E01020202","Total",1540,728,812,1527,13,18,513.10,3.0
"2011","Teignbridge 007B","E01020204","Total",1555,772,783,1555,0,15,63.17,24.6
"2011","Teignbridge 007C","E01020236","Total",1289,641,648,1289,0,15,386.18,3.3
"2011","Teignbridge 007D","E01020237","Total",1573,737,836,1572,1,38,3427.72,0.5
"2011","Teignbridge 008A","E01020265","Total",1698,806,892,1698,0,22,122.12,13.9
"2011","Teignbridge 008B","E01020266","Total",1729,887,842,1618,111,34,54.83,31.5
"2011","Teignbridge 008C","E01020267","Total",1497,726,771,1438,59,16,58.42,25.6
"2011","Teignbridge 008D","E01020268","Total",1437,664,773,1362,75,24,179.91,8.0
"2011","Teignbridge 008E","E01020270","Total",1608,778,830,1608,0,12,53.99,29.8
"2011","Teignbridge 009A","E01020250","Total",1580,751,829,1580,0,6,34.58,45.7
"2011","Teignbridge 009B","E01020252","Total",1385,649,736,1332,53,11,135.42,10.2
"2011","Teignbridge 009C","E01020253","Total",1508,719,789,1508,0,19,30.63,49.2
"2011","Teignbridge 009D","E01020254","Total",1316,670,646,1316,0,6,23.86,55.2
"2011","Teignbridge 009E","E01020255","Total",1302,627,675,1302,0,12,78.28,16.6
"2011","Teignbridge 009F","E01020257","Total",1215,582,633,1215,0,13,75.58,16.1
"2011","Teignbridge 010A","E01020264","Total",1515,675,840,1301,214,18,20.98,72.2
"2011","Teignbridge 010B","E01020269","Total",1854,845,1009,1835,19,8,34.45,53.8
"2011","Teignbridge 010C","E01020271","Total",1527,723,804,1509,18,18,21.49,71.1
"2011","Teignbridge 010D","E01020272","Total",1884,914,970,1881,3,18,60.69,31.0
"2011","Teignbridge 011A","E01020200","Total",1089,524,565,1085,4,15,1222.18,0.9
"2011","Teignbridge 011B","E01020201","Total",1481,672,809,1415,66,12,389.72,3.8
"2011","Teignbridge 011C","E01020251","Total",1464,710,754,1434,30,16,976.22,1.5
"2011","Teignbridge 011D","E01020260","Total",1269,596,673,1243,26,17,146.40,8.7
"2011","Teignbridge 011E","E01020261","Total",1196,597,599,1186,10,35,802.27,1.5
"2011","Teignbridge 012A","E01020208","Total",1261,603,658,1241,20,7,21.53,58.6
"2011","Teignbridge 012B","E01020209","Total",1442,693,749,1442,0,20,87.86,16.4
"2011","Teignbridge 012C","E01020210","Total",1177,579,598,1165,12,21,61.60,19.1
"2011","Teignbridge 012D","E01020219","Total",2059,990,1069,2033,26,33,65.02,31.7
"2011","Teignbridge 013A","E01020191","Total",1674,1167,507,952,722,15,1293.22,1.3
"2011","Teignbridge 013B","E01020194","Total",1454,732,722,1454,0,31,91.90,15.8
"2011","Teignbridge 013C","E01020207","Total",1163,550,613,1061,102,16,719.28,1.6
"2011","Teignbridge 013D","E01020256","Total",1377,643,734,1325,52,17,1435.38,1.0
"2011","Teignbridge 014A","E01020211","Total",1527,727,800,1527,0,7,38.23,39.9
"2011","Teignbridge 014B","E01020217","Total",1657,812,845,1649,8,16,99.74,16.6
"2011","Teignbridge 014C","E01020218","Total",1479,743,736,1479,0,7,23.35,63.3
"2011","Teignbridge 014D","E01020224","Total",1256,595,661,1251,5,16,8.75,143.5
"2011","Teignbridge 015A","E01020216","Total",1652,804,848,1636,16,10,36.51,45.2
"2011","Teignbridge 015B","E01020225","Total",1264,615,649,1254,10,18,31.87,39.7
"2011","Teignbridge 015C","E01020226","Total",1266,609,657,1134,132,33,138.28,9.2
"2011","Teignbridge 015D","E01020227","Total",1468,683,785,1383,85,19,187.88,7.8
"2011","Teignbridge 016A","E01020212","Total",1216,597,619,1216,0,15,18.79,64.7
"2011","Teignbridge 016B","E01020213","Total",1417,678,739,1417,0,20,41.13,34.5
"2011","Teignbridge 016C","E01020214","Total",1553,777,776,1553,0,25,50.71,30.6
"2011","Teignbridge 016D","E01020215","Total",1376,688,688,1376,0,24,84.62,16.3
"2011","Teignbridge 017A","E01020195","Total",1745,857,888,1745,0,26,1392.66,1.3
"2011","Teignbridge 017B","E01020196","Total",1686,777,909,1660,26,32,127.67,13.2
"2011","Teignbridge 017C","E01020197","Total",1258,610,648,1218,40,21,1991.99,0.6
"2011","Teignbridge 017D","E01020198","Total",1387,656,731,1387,0,18,93.04,14.9
"2011","Teignbridge 017E","E01020199","Total",1642,810,832,1597,45,8,320.45,5.1
"2011","Teignbridge 018A","E01020246","Total",1097,552,545,1097,0,30,1177.63,0.9
"2011","Teignbridge 018B","E01020247","Total",1624,773,851,1604,20,24,82.78,19.6
"2011","Teignbridge 018C","E01020248","Total",1616,797,819,1616,0,23,437.10,3.7
"2011","Teignbridge 018D","E01020249","Total",1342,640,702,1342,0,17,156.47,8.6
"2011","Teignbridge 019A","E01020192","Total",1560,739,821,1534,26,14,502.53,3.1
"2011","Teignbridge 019B","E01020193","Total",1492,744,748,1435,57,32,2227.55,0.7
"2011","Teignbridge 019C","E01020238","Total",1197,542,655,1197,0,14,39.31,30.5
"2011","Teignbridge 019D","E01020239","Total",1272,603,669,1253,19,35,1128.28,1.1
"2011","Torridge 001A","E01020275","Total",1309,644,665,1307,2,12,34.53,37.9
"2011","Torridge 001B","E01020276","Total",1508,722,786,1496,12,14,410.78,3.7
"2011","Torridge 001C","E01020297","Total",1558,732,826,1558,0,11,27.42,56.8
"2011","Torridge 001D","E01020299","Total",1809,870,939,1784,25,12,138.55,13.1
"2011","Torridge 002A","E01020298","Total",2060,943,1117,1953,107,30,178.01,11.6
"2011","Torridge 002B","E01020300","Total",1706,797,909,1625,81,31,178.55,9.6
"2011","Torridge 002C","E01020310","Total",2112,1035,1077,2030,82,26,166.34,12.7
"2011","Torridge 003A","E01020280","Total",2174,1115,1059,2158,16,11,30.99,70.2
"2011","Torridge 003B","E01020281","Total",1922,966,956,1869,53,32,80.21,24.0
"2011","Torridge 003C","E01020282","Total",1621,760,861,1614,7,12,49.32,32.9
"2011","Torridge 004A","E01020277","Total",2021,969,1052,2011,10,7,134.49,15.0
"2011","Torridge 004B","E01020278","Total",1664,825,839,1616,48,26,3000.15,0.6
"2011","Torridge 004C","E01020279","Total",2305,1135,1170,2305,0,25,135.83,17.0
"2011","Torridge 004D","E01020283","Total",1387,678,709,1387,0,15,315.32,4.4
"2011","Torridge 004E","E01020284","Total",1962,961,1001,1931,31,16,34.16,57.4
"2011","Torridge 004F","E01020285","Total",2009,954,1055,2009,0,11,33.14,60.6
"2011","Torridge 005A","E01020288","Total",1627,823,804,1627,0,23,4277.12,0.4
"2011","Torridge 005B","E01020292","Total",1450,723,727,1444,6,26,4311.55,0.3
"2011","Torridge 005C","E01020295","Total",1689,807,882,1623,66,32,4162.53,0.4
"2011","Torridge 005D","E01020296","Total",1488,727,761,1488,0,22,3321.54,0.4
"2011","Torridge 006A","E01020304","Total",1721,808,913,1693,28,15,104.00,16.5
"2011","Torridge 006B","E01020305","Total",1081,526,555,1058,23,7,63.55,17.0
"2011","Torridge 006C","E01020306","Total",1249,573,676,1249,0,19,34.41,36.3
"2011","Torridge 006D","E01020307","Total",1663,809,854,1619,44,18,1251.43,1.3
"2011","Torridge 007A","E01020287","Total",1537,779,758,1484,53,27,7318.00,0.2
"2011","Torridge 007B","E01020303","Total",1643,806,837,1639,4,26,4803.86,0.3
"2011","Torridge 007C","E01020308","Total",1668,839,829,1668,0,33,5074.33,0.3
"2011","Torridge 007D","E01020311","Total",2068,1027,1041,2061,7,27,6042.32,0.3
"2011","Torridge 008A","E01020291","Total",1569,796,773,1560,9,25,7383.33,0.2
"2011","Torridge 008B","E01020293","Total",2211,1068,1143,2192,19,31,5172.25,0.4
"2011","Torridge 008C","E01020294","Total",1736,818,918,1664,72,9,117.94,14.7
"2011","Torridge 008D","E01020302","Total",1734,880,854,1715,19,28,5250.86,0.3
"2011","Torridge 008E","E01020309","Total",1679,852,827,1678,1,20,7367.20,0.2
"2011","Torridge 009A","E01020286","Total",1650,809,841,1645,5,18,9629.29,0.2
"2011","Torridge 009B","E01020289","Total",1534,758,776,1521,13,20,6986.40,0.2
"2011","Torridge 009C","E01020290","Total",1716,836,880,1673,43,23,5714.51,0.3
"2011","Torridge 009D","E01020301","Total",1999,997,1002,1933,66,35,5051.11,0.4
"2011","West Devon 001A","E01020320","Total",1695,866,829,1661,34,25,8268.42,0.2
"2011","West Devon 001B","E01020321","Total",2218,1078,1140,2115,103,36,5560.41,0.4
"2011","West Devon 001C","E01020322","Total",2024,999,1025,1996,28,32,9210.51,0.2
"2011","West Devon 001D","E01020326","Total",2026,1030,996,2026,0,25,3073.70,0.7
"2011","West Devon 002A","E01020327","Total",1808,883,925,1791,17,22,44.00,41.1
"2011","West Devon 002B","E01020328","Total",2277,1096,1181,2277,0,12,94.82,24.0
"2011","West Devon 002C","E01020329","Total",1578,791,787,1512,66,33,3601.77,0.4
"2011","West Devon 002D","E01020330","Total",1837,892,945,1802,35,13,67.14,27.4
"2011","West Devon 003A","E01020318","Total",1449,693,756,1436,13,32,3018.45,0.5
"2011","West Devon 003B","E01020319","Total",1614,743,871,1589,25,52,7032.01,0.2
"2011","West Devon 003C","E01020323","Total",2047,1231,816,1544,503,19,21873.29,0.1
"2011","West Devon 003D","E01020339","Total",1683,819,864,1659,24,35,4386.06,0.4
"2011","West Devon 004A","E01020314","Total",1610,799,811,1576,34,13,9464.45,0.2
"2011","West Devon 004B","E01020325","Total",1617,805,812,1616,1,34,7167.97,0.2
"2011","West Devon 004C","E01020331","Total",1622,772,850,1547,75,30,5473.29,0.3
"2011","West Devon 004D","E01020340","Total",1680,832,848,1679,1,26,4743.57,0.4
"2011","West Devon 005A","E01020332","Total",1786,875,911,1784,2,46,46.27,38.6
"2011","West Devon 005B","E01020333","Total",1928,966,962,1907,21,37,636.87,3.0
"2011","West Devon 005C","E01020334","Total",1927,877,1050,1839,88,20,189.97,10.1
"2011","West Devon 005D","E01020335","Total",1526,701,825,1467,59,26,87.51,17.4
"2011","West Devon 005E","E01020336","Total",1360,638,722,1360,0,47,143.77,9.5
"2011","West Devon 005F","E01020337","Total",1419,682,737,1185,234,19,123.48,11.5
"2011","West Devon 005G","E01020338","Total",2334,1086,1248,2334,0,38,101.92,22.9
"2011","West Devon 006A","E01020317","Total",1445,692,753,1426,19,35,5940.15,0.2
"2011","West Devon 006B","E01020324","Total",1559,742,817,1499,60,50,7290.92,0.2
"2011","West Devon 006C","E01020341","Total",1606,759,847,1560,46,44,3116.33,0.5
"2011","West Devon 006D","E01020342","Total",1509,726,783,1498,11,10,117.10,12.9
"2011","West Devon 007A","E01020312","Total",1563,765,798,1537,26,23,2476.48,0.6
"2011","West Devon 007B","E01020313","Total",1426,701,725,1401,25,16,31.55,45.2
"2011","West Devon 007C","E01020315","Total",1539,720,819,1453,86,31,1333.94,1.2
"2011","West Devon 007D","E01020316","Total",1841,864,977,1838,3,65,1247.44,1.5
"2011","Christchurch 001A","E01020343","Total",1505,735,770,1505,0,15,256.48,5.9
"2011","Christchurch 001B","E01020344","Total",1460,718,742,1460,0,13,20.85,70.0
"2011","Christchurch 001C","E01020345","Total",1212,560,652,1189,23,17,591.57,2.0
"2011","Christchurch 001D","E01020365","Total",1596,793,803,1569,27,14,2522.32,0.6
"2011","Christchurch 002A","E01020351","Total",1309,649,660,1309,0,14,29.28,44.7
"2011","Christchurch 002B","E01020352","Total",1359,632,727,1323,36,17,53.35,25.5
"2011","Christchurch 002C","E01020353","Total",1698,816,882,1640,58,6,37.95,44.7
"2011","Christchurch 002D","E01020359","Total",1293,632,661,1292,1,11,36.24,35.7
"2011","Christchurch 002E","E01020366","Total",2124,1062,1062,2124,0,37,110.51,19.2
"2011","Christchurch 003A","E01020349","Total",1761,763,998,1694,67,12,53.63,32.8
"2011","Christchurch 003B","E01020350","Total",1695,768,927,1692,3,5,145.56,11.6
"2011","Christchurch 003C","E01020357","Total",2109,1030,1079,2104,5,35,84.23,25.0
"2011","Christchurch 003D","E01020358","Total",1529,730,799,1525,4,24,73.80,20.7
"2011","Christchurch 004A","E01020369","Total",1318,616,702,1283,35,17,54.92,24.0
"2011","Christchurch 004B","E01020370","Total",1493,722,771,1493,0,16,64.77,23.1
"2011","Christchurch 004C","E01020371","Total",1543,731,812,1543,0,15,67.54,22.8
"2011","Christchurch 004D","E01020372","Total",1233,584,649,1233,0,11,94.51,13.0
"2011","Christchurch 005A","E01020346","Total",1590,764,826,1590,0,15,35.45,44.9
"2011","Christchurch 005B","E01020347","Total",1612,800,812,1607,5,6,59.12,27.3
"2011","Christchurch 005C","E01020348","Total",1673,858,815,1673,0,2,37.90,44.1
"2011","Christchurch 005D","E01020363","Total",1202,586,616,1202,0,9,32.36,37.1
"2011","Christchurch 006A","E01020360","Total",1551,748,803,1537,14,6,37.58,41.3
"2011","Christchurch 006B","E01020361","Total",1626,808,818,1593,33,11,42.09,38.6
"2011","Christchurch 006C","E01020364","Total",1599,725,874,1597,2,14,148.11,10.8
"2011","Christchurch 006D","E01020367","Total",1851,869,982,1849,2,23,88.57,20.9
"2011","Christchurch 006E","E01020368","Total",2383,1174,1209,2349,34,21,42.26,56.4
"2011","Christchurch 007A","E01020354","Total",1483,694,789,1483,0,11,33.49,44.3
"2011","Christchurch 007B","E01020355","Total",1905,895,1010,1871,34,15,78.01,24.4
"2011","Christchurch 007C","E01020356","Total",1589,732,857,1529,60,23,65.30,24.3
"2011","Christchurch 007D","E01020362","Total",1451,680,771,1440,11,18,41.21,35.2
"2011","East Dorset 001A","E01020373","Total",1331,672,659,1324,7,26,571.10,2.3
"2011","East Dorset 001B","E01020374","Total",1517,732,785,1517,0,25,128.21,11.8
"2011","East Dorset 001C","E01020389","Total",2189,1097,1092,2134,55,60,6792.30,0.3
"2011","East Dorset 001D","E01020397","Total",1428,695,733,1428,0,28,3593.56,0.4
"2011","East Dorset 002A","E01020416","Total",1493,709,784,1493,0,13,27.67,54.0
"2011","East Dorset 002B","E01020417","Total",1074,517,557,1074,0,15,26.62,40.3
"2011","East Dorset 002C","E01020418","Total",1455,670,785,1455,0,20,297.94,4.9
"2011","East Dorset 002D","E01020419","Total",1865,906,959,1865,0,19,88.30,21.1
"2011","East Dorset 002E","E01020420","Total",1334,650,684,1320,14,12,197.13,6.8
"2011","East Dorset 003A","E01020411","Total",1154,535,619,1090,64,14,116.50,9.9
"2011","East Dorset 003B","E01020412","Total",1493,720,773,1493,0,15,569.17,2.6
"2011","East Dorset 003C","E01020413","Total",1463,728,735,1458,5,12,49.67,29.5
"2011","East Dorset 003D","E01020414","Total",1992,956,1036,1992,0,21,87.57,22.7
"2011","East Dorset 003E","E01020415","Total",1529,782,747,1529,0,24,291.59,5.2
"2011","East Dorset 004A","E01020403","Total",1560,765,795,1439,121,27,905.21,1.7
"2011","East Dorset 004B","E01020404","Total",1567,748,819,1518,49,24,87.94,17.8
"2011","East Dorset 004C","E01020405","Total",1461,718,743,1457,4,27,1181.67,1.2
"2011","East Dorset 004D","E01020406","Total",2271,1096,1175,2246,25,26,305.88,7.4
"2011","East Dorset 005A","E01020396","Total",1063,529,534,1063,0,29,4469.90,0.2
"2011","East Dorset 005B","E01020398","Total",2286,1105,1181,2263,23,58,4297.96,0.5
"2011","East Dorset 005C","E01020409","Total",1271,629,642,1240,31,28,778.54,1.6
"2011","East Dorset 005D","E01020410","Total",1311,675,636,1311,0,31,4752.15,0.3
"2011","East Dorset 006A","E01020421","Total",1391,661,730,1316,75,27,395.81,3.5
"2011","East Dorset 006B","E01020422","Total",1653,744,909,1600,53,7,122.19,13.5
"2011","East Dorset 006C","E01020423","Total",1453,689,764,1434,19,10,46.72,31.1
"2011","East Dorset 006D","E01020424","Total",1392,670,722,1392,0,2,195.90,7.1
"2011","East Dorset 006E","E01020425","Total",1672,799,873,1672,0,6,93.13,18.0
"2011","East Dorset 007A","E01020377","Total",1634,810,824,1634,0,38,92.37,17.7
"2011","East Dorset 007B","E01020379","Total",1458,717,741,1458,0,25,158.82,9.2
"2011","East Dorset 007C","E01020380","Total",1084,534,550,1084,0,33,313.03,3.5
"2011","East Dorset 007D","E01020381","Total",1217,595,622,1217,0,38,137.01,8.9
"2011","East Dorset 008A","E01020390","Total",1363,625,738,1355,8,9,86.76,15.7
"2011","East Dorset 008B","E01020391","Total",1433,696,737,1433,0,14,117.36,12.2
"2011","East Dorset 008C","E01020392","Total",1544,685,859,1473,71,9,53.95,28.6
"2011","East Dorset 008D","E01020393","Total",1571,754,817,1571,0,6,41.51,37.8
"2011","East Dorset 008E","E01020394","Total",1732,851,881,1715,17,10,82.97,20.9
"2011","East Dorset 009A","E01020375","Total",1370,626,744,1370,0,19,32.29,42.4
"2011","East Dorset 009B","E01020376","Total",1087,531,556,1087,0,13,38.29,28.4
"2011","East Dorset 009C","E01020378","Total",1534,744,790,1534,0,24,184.77,8.3
"2011","East Dorset 009D","E01020407","Total",1206,572,634,1187,19,12,154.77,7.8
"2011","East Dorset 009E","E01020408","Total",1137,526,611,1099,38,14,596.99,1.9
"2011","East Dorset 010A","E01020426","Total",1832,830,1002,1737,95,22,61.51,29.8
"2011","East Dorset 010B","E01020427","Total",1623,773,850,1623,0,13,133.72,12.1
"2011","East Dorset 010C","E01020428","Total",1894,851,1043,1894,0,11,139.58,13.6
"2011","East Dorset 010D","E01020429","Total",1665,798,867,1657,8,22,30.14,55.2
"2011","East Dorset 011A","E01020395","Total",1829,843,986,1743,86,26,172.42,10.6
"2011","East Dorset 011B","E01020399","Total",2502,1230,1272,2446,56,36,585.94,4.3
"2011","East Dorset 011C","E01020400","Total",1610,774,836,1587,23,17,343.50,4.7
"2011","East Dorset 011D","E01020401","Total",1511,711,800,1511,0,17,131.11,11.5
"2011","East Dorset 011E","E01020402","Total",1529,761,768,1529,0,36,50.47,30.3
"2011","East Dorset 012A","E01020382","Total",1525,749,776,1525,0,26,37.30,40.9
"2011","East Dorset 012B","E01020383","Total",1756,866,890,1756,0,17,59.98,29.3
"2011","East Dorset 012C","E01020384","Total",1757,835,922,1757,0,31,27.97,62.8
"2011","East Dorset 012D","E01020385","Total",1248,614,634,1248,0,20,554.66,2.3
"2011","East Dorset 012E","E01020386","Total",1209,598,611,1202,7,29,152.53,7.9
"2011","East Dorset 012F","E01020387","Total",1123,561,562,1123,0,14,54.13,20.7
"2011","East Dorset 012G","E01020388","Total",1515,733,782,1515,0,17,340.39,4.5
"2011","North Dorset 001A","E01020443","Total",2509,1246,1263,2483,26,31,149.54,16.8
"2011","North Dorset 001B","E01020447","Total",1773,825,948,1743,30,25,116.15,15.3
"2011","North Dorset 001C","E01020463","Total",1677,807,870,1674,3,39,59.92,28.0
"2011","North Dorset 001D","E01020464","Total",1543,760,783,1478,65,25,215.47,7.2
"2011","North Dorset 002A","E01020440","Total",1905,941,964,1901,4,53,3171.05,0.6
"2011","North Dorset 002B","E01020450","Total",2297,1139,1158,2297,0,45,1475.57,1.6
"2011","North Dorset 002D","E01020462","Total",1786,851,935,1786,0,37,3660.77,0.5
"2011","North Dorset 002E","E01033156","Total",1742,881,861,1730,12,25,299.75,5.8
"2011","North Dorset 002F","E01033158","Total",1474,731,743,1313,161,36,1972.82,0.7
"2011","North Dorset 003A","E01020454","Total",2121,1000,1121,2045,76,30,66.54,31.9
"2011","North Dorset 003B","E01020455","Total",1905,893,1012,1884,21,18,93.53,20.4
"2011","North Dorset 003C","E01020456","Total",1780,887,893,1780,0,22,67.09,26.5
"2011","North Dorset 003D","E01020457","Total",1508,708,800,1430,78,46,222.19,6.8
"2011","North Dorset 004A","E01020433","Total",1775,881,894,1775,0,41,4325.06,0.4
"2011","North Dorset 004B","E01020434","Total",1799,873,926,1751,48,22,238.24,7.6
"2011","North Dorset 004C","E01020449","Total",1998,967,1031,1973,25,60,1550.62,1.3
"2011","North Dorset 004D","E01020458","Total",2179,1066,1113,2159,20,42,2155.27,1.0
"2011","North Dorset 004E","E01020459","Total",2578,1281,1297,2577,1,33,952.62,2.7
"2011","North Dorset 005A","E01020444","Total",1774,833,941,1731,43,41,2456.19,0.7
"2011","North Dorset 005B","E01020445","Total",1519,733,786,1130,389,39,2529.47,0.6
"2011","North Dorset 005C","E01020446","Total",1525,757,768,1443,82,48,805.56,1.9
"2011","North Dorset 005D","E01020460","Total",2277,1268,1009,1953,324,63,4128.94,0.6
"2011","North Dorset 006A","E01020442","Total",1993,984,1009,1993,0,58,5495.89,0.4
"2011","North Dorset 006B","E01020452","Total",2436,1250,1186,1922,514,59,1685.42,1.4
"2011","North Dorset 006C","E01020453","Total",1711,831,880,1691,20,41,1838.92,0.9
"2011","North Dorset 006E","E01033154","Total",2205,1395,810,1475,730,57,596.98,3.7
"2011","North Dorset 006F","E01033159","Total",1097,550,547,1097,0,12,3291.99,0.3
"2011","North Dorset 007A","E01020435","Total",1781,902,879,1764,17,24,33.08,53.8
"2011","North Dorset 007B","E01020436","Total",2062,1050,1012,2062,0,31,103.65,19.9
"2011","North Dorset 007C","E01020437","Total",1876,920,956,1876,0,33,52.78,35.5
"2011","North Dorset 007D","E01020438","Total",1993,975,1018,1904,89,22,121.50,16.4
"2011","North Dorset 007E","E01020439","Total",2271,1135,1136,2228,43,36,38.44,59.1
"2011","North Dorset 008A","E01020430","Total",1439,704,735,1439,0,22,1700.19,0.8
"2011","North Dorset 008B","E01020431","Total",1232,683,549,1042,190,45,2997.85,0.4
"2011","North Dorset 008C","E01020432","Total",1226,626,600,1226,0,19,2659.94,0.5
"2011","North Dorset 008D","E01020441","Total",1850,898,952,1850,0,51,4732.37,0.4
"2011","North Dorset 008E","E01020448","Total",1967,985,982,1967,0,54,4860.40,0.4
"2011","Purbeck 001A","E01020465","Total",1945,969,976,1945,0,30,4406.23,0.4
"2011","Purbeck 001B","E01020469","Total",1931,961,970,1931,0,40,1774.53,1.1
"2011","Purbeck 001C","E01020470","Total",1816,854,962,1797,19,57,1092.95,1.7
"2011","Purbeck 002A","E01020471","Total",1398,682,716,1398,0,8,89.31,15.7
"2011","Purbeck 002B","E01020472","Total",1387,664,723,1387,0,11,227.37,6.1
"2011","Purbeck 002C","E01020473","Total",1459,679,780,1459,0,24,59.93,24.3
"2011","Purbeck 002D","E01020474","Total",1690,813,877,1690,0,30,1014.87,1.7
"2011","Purbeck 002E","E01020475","Total",2049,1014,1035,2049,0,20,57.25,35.8
"2011","Purbeck 003A","E01020476","Total",1235,614,621,1227,8,21,2357.75,0.5
"2011","Purbeck 003B","E01020477","Total",1539,783,756,1539,0,15,619.16,2.5
"2011","Purbeck 003C","E01020485","Total",1442,666,776,1409,33,20,237.38,6.1
"2011","Purbeck 003D","E01020486","Total",1306,590,716,1306,0,32,231.53,5.6
"2011","Purbeck 003E","E01020487","Total",1287,613,674,1287,0,16,71.99,17.9
"2011","Purbeck 003F","E01020488","Total",1461,694,767,1459,2,12,94.47,15.5
"2011","Purbeck 004A","E01020489","Total",1464,757,707,1391,73,26,5094.26,0.3
"2011","Purbeck 004B","E01020490","Total",1618,809,809,1602,16,32,6005.84,0.3
"2011","Purbeck 004C","E01020491","Total",1571,771,800,1571,0,15,790.49,2.0
"2011","Purbeck 004D","E01020492","Total",1153,541,612,1153,0,11,42.12,27.4
"2011","Purbeck 004E","E01020493","Total",2586,1435,1151,2338,248,45,638.44,4.1
"2011","Purbeck 005A","E01020466","Total",1780,876,904,1758,22,47,5787.45,0.3
"2011","Purbeck 005B","E01020467","Total",1764,884,880,1761,3,39,6633.00,0.3
"2011","Purbeck 005C","E01020468","Total",1491,738,753,1459,32,34,1993.86,0.7
"2011","Purbeck 006A","E01020478","Total",1091,525,566,1069,22,21,66.94,16.3
"2011","Purbeck 006B","E01020479","Total",1202,563,639,1126,76,17,47.72,25.2
"2011","Purbeck 006C","E01020480","Total",1478,705,773,1430,48,8,487.65,3.0
"2011","Purbeck 006D","E01020481","Total",1513,764,749,1488,25,40,91.28,16.6
"2011","Purbeck 006E","E01020482","Total",1618,767,851,1606,12,38,31.33,51.6
"2011","Purbeck 006F","E01020483","Total",1274,631,643,1274,0,14,40.76,31.3
"2011","Purbeck 006G","E01020484","Total",1425,666,759,1425,0,17,355.71,4.0
"2011","West Dorset 001A","E01020542","Total",1304,602,702,1291,13,36,103.49,12.6
"2011","West Dorset 001B","E01020543","Total",1452,682,770,1452,0,9,69.74,20.8
"2011","West Dorset 001C","E01020544","Total",1666,719,947,1438,228,18,55.19,30.2
"2011","West Dorset 001E","E01020546","Total",1818,946,872,997,821,39,54.08,33.6
"2011","West Dorset 001F","E01020547","Total",1117,520,597,1117,0,16,22.22,50.3
"2011","West Dorset 001H","E01032642","Total",2166,1030,1136,2125,41,41,363.38,6.0
"2011","West Dorset 002A","E01020497","Total",1914,913,1001,1914,0,36,1911.62,1.0
"2011","West Dorset 002B","E01020508","Total",2000,938,1062,1883,117,74,5133.19,0.4
"2011","West Dorset 002C","E01020541","Total",2011,1003,1008,2010,1,63,6233.34,0.3
"2011","West Dorset 002D","E01020550","Total",1564,755,809,1564,0,40,1645.89,1.0
"2011","West Dorset 003A","E01020494","Total",1150,571,579,1150,0,19,3191.50,0.4
"2011","West Dorset 003B","E01020495","Total",1387,646,741,1387,0,24,409.82,3.4
"2011","West Dorset 003C","E01020496","Total",1570,737,833,1561,9,11,181.46,8.7
"2011","West Dorset 003D","E01020506","Total",1736,865,871,1687,49,41,4636.91,0.4
"2011","West Dorset 003E","E01020530","Total",1848,938,910,1807,41,41,7411.93,0.2
"2011","West Dorset 003F","E01020534","Total",2081,1009,1072,2066,15,51,6203.43,0.3
"2011","West Dorset 004A","E01020509","Total",2799,1368,1431,2737,62,50,7055.13,0.4
"2011","West Dorset 004B","E01020510","Total",1969,924,1045,1943,26,29,694.03,2.8
"2011","West Dorset 004C","E01020529","Total",2210,1090,1120,2210,0,45,6149.24,0.4
"2011","West Dorset 004D","E01020539","Total",1988,986,1002,1988,0,60,7207.82,0.3
"2011","West Dorset 004E","E01020540","Total",2437,1192,1245,2437,0,35,6185.30,0.4
"2011","West Dorset 005A","E01020511","Total",1697,810,887,1646,51,25,1723.56,1.0
"2011","West Dorset 005B","E01020532","Total",1614,737,877,1536,78,31,153.37,10.5
"2011","West Dorset 005C","E01020533","Total",2057,906,1151,1997,60,32,347.86,5.9
"2011","West Dorset 005D","E01020535","Total",1717,846,871,1714,3,38,5801.46,0.3
"2011","West Dorset 006A","E01020498","Total",2038,973,1065,2004,34,27,279.23,7.3
"2011","West Dorset 006B","E01020499","Total",1394,671,723,1394,0,7,25.30,55.1
"2011","West Dorset 006C","E01020500","Total",1625,780,845,1622,3,26,56.30,28.9
"2011","West Dorset 006D","E01020501","Total",1403,665,738,1363,40,16,94.44,14.9
"2011","West Dorset 007A","E01020507","Total",1897,914,983,1892,5,30,3275.03,0.6
"2011","West Dorset 007B","E01020517","Total",1745,850,895,1740,5,28,2725.84,0.6
"2011","West Dorset 007C","E01020531","Total",1697,803,894,1675,22,44,3739.46,0.5
"2011","West Dorset 007D","E01020536","Total",2080,992,1088,2079,1,41,2857.13,0.7
"2011","West Dorset 008A","E01020502","Total",1657,781,876,1657,0,19,57.13,29.0
"2011","West Dorset 008B","E01020503","Total",1762,790,972,1742,20,13,54.53,32.3
"2011","West Dorset 008C","E01020504","Total",2256,1066,1190,2169,87,38,286.08,7.9
"2011","West Dorset 009C","E01020526","Total",1368,656,712,1281,87,27,50.01,27.4
"2011","West Dorset 009D","E01020527","Total",1508,739,769,1427,81,30,20.42,73.8
"2011","West Dorset 009E","E01020528","Total",1958,984,974,1953,5,24,76.65,25.5
"2011","West Dorset 009F","E01032641","Total",1607,765,842,1557,50,26,103.57,15.5
"2011","West Dorset 009G","E01032643","Total",1683,900,783,1519,164,16,124.08,13.6
"2011","West Dorset 009H","E01032644","Total",1073,483,590,1010,63,18,32.05,33.5
"2011","West Dorset 009I","E01032645","Total",1093,473,620,992,101,18,36.92,29.6
"2011","West Dorset 010A","E01020518","Total",1522,718,804,1522,0,17,39.27,38.8
"2011","West Dorset 010B","E01020519","Total",1805,835,970,1805,0,30,39.85,45.3
"2011","West Dorset 010C","E01020520","Total",1394,694,700,1390,4,22,63.83,21.8
"2011","West Dorset 010D","E01020523","Total",1264,607,657,1254,10,37,22.59,56.0
"2011","West Dorset 010E","E01020524","Total",1466,725,741,1460,6,29,50.84,28.8
"2011","West Dorset 010F","E01020525","Total",1319,636,683,1319,0,42,51.95,25.4
"2011","West Dorset 011A","E01020505","Total",1870,906,964,1854,16,48,1701.93,1.1
"2011","West Dorset 011B","E01020537","Total",1953,988,965,1828,125,54,3871.29,0.5
"2011","West Dorset 011C","E01020538","Total",1851,876,975,1851,0,18,978.03,1.9
"2011","West Dorset 011D","E01020549","Total",2095,990,1105,2006,89,37,5317.44,0.4
"2011","West Dorset 012A","E01020512","Total",2094,1039,1055,2090,4,39,7775.35,0.3
"2011","West Dorset 012B","E01020513","Total",1543,759,784,1542,1,16,73.95,20.9
"2011","West Dorset 012C","E01020514","Total",1252,618,634,1252,0,21,958.48,1.3
"2011","West Dorset 012D","E01020515","Total",1213,596,617,1183,30,7,186.54,6.5
"2011","West Dorset 012E","E01020516","Total",1507,726,781,1507,0,19,176.95,8.5
"2011","Weymouth and Portland 001A","E01020551","Total",1883,933,950,1883,0,19,60.63,31.1
"2011","Weymouth and Portland 001B","E01020552","Total",1805,851,954,1805,0,9,62.65,28.8
"2011","Weymouth and Portland 001C","E01020570","Total",1581,776,805,1572,9,24,600.45,2.6
"2011","Weymouth and Portland 001D","E01020571","Total",2047,982,1065,2035,12,20,43.40,47.2
"2011","Weymouth and Portland 002A","E01020557","Total",1527,723,804,1509,18,23,199.18,7.7
"2011","Weymouth and Portland 002B","E01020558","Total",1720,848,872,1720,0,28,356.60,4.8
"2011","Weymouth and Portland 002C","E01020559","Total",1583,762,821,1575,8,17,153.70,10.3
"2011","Weymouth and Portland 002D","E01020560","Total",1923,942,981,1923,0,39,69.25,27.8
"2011","Weymouth and Portland 002E","E01020561","Total",1888,852,1036,1727,161,18,35.10,53.8
"2011","Weymouth and Portland 003A","E01020574","Total",1892,905,987,1892,0,17,132.29,14.3
"2011","Weymouth and Portland 003B","E01020575","Total",1662,836,826,1662,0,14,24.60,67.6
"2011","Weymouth and Portland 003C","E01020576","Total",1711,853,858,1711,0,16,116.23,14.7
"2011","Weymouth and Portland 003D","E01020579","Total",1964,969,995,1911,53,31,361.09,5.4
"2011","Weymouth and Portland 003E","E01020580","Total",1440,698,742,1406,34,24,71.94,20.0
"2011","Weymouth and Portland 004A","E01020553","Total",1302,673,629,1213,89,18,20.41,63.8
"2011","Weymouth and Portland 004B","E01020554","Total",1778,928,850,1715,63,14,52.34,34.0
"2011","Weymouth and Portland 004C","E01020555","Total",1361,710,651,1340,21,9,10.74,126.7
"2011","Weymouth and Portland 004D","E01020556","Total",1437,718,719,1331,106,16,32.94,43.6
"2011","Weymouth and Portland 004E","E01020581","Total",2019,1015,1004,1949,70,24,75.24,26.8
"2011","Weymouth and Portland 004F","E01020582","Total",1573,764,809,1573,0,6,16.51,95.3
"2011","Weymouth and Portland 005A","E01020572","Total",1961,985,976,1950,11,14,18.94,103.5
"2011","Weymouth and Portland 005B","E01020573","Total",1822,892,930,1784,38,21,50.46,36.1
"2011","Weymouth and Portland 005C","E01020577","Total",1600,803,797,1600,0,11,57.79,27.7
"2011","Weymouth and Portland 005D","E01020578","Total",2082,952,1130,2024,58,18,46.40,44.9
"2011","Weymouth and Portland 006A","E01020583","Total",1930,974,956,1900,30,38,58.54,33.0
"2011","Weymouth and Portland 006B","E01020584","Total",1702,822,880,1681,21,15,30.79,55.3
"2011","Weymouth and Portland 006C","E01020585","Total",1559,774,785,1559,0,20,33.23,46.9
"2011","Weymouth and Portland 007A","E01020586","Total",1273,621,652,1273,0,19,44.44,28.6
"2011","Weymouth and Portland 007B","E01020587","Total",1490,710,780,1490,0,16,46.21,32.2
"2011","Weymouth and Portland 007C","E01020588","Total",1321,642,679,1310,11,20,45.48,29.0
"2011","Weymouth and Portland 007D","E01020589","Total",1487,722,765,1487,0,13,39.59,37.6
"2011","Weymouth and Portland 008A","E01020563","Total",1630,1031,599,1204,426,15,282.70,5.8
"2011","Weymouth and Portland 008D","E01020569","Total",1460,718,742,1456,4,6,70.01,20.9
"2011","Weymouth and Portland 008E","E01033200","Total",2553,1536,1017,2014,539,21,264.56,9.6
"2011","Weymouth and Portland 009A","E01020562","Total",2026,991,1035,2016,10,15,90.64,22.4
"2011","Weymouth and Portland 009B","E01020564","Total",1621,781,840,1621,0,13,130.21,12.4
"2011","Weymouth and Portland 009C","E01020565","Total",1464,714,750,1462,2,11,58.27,25.1
"2011","Weymouth and Portland 009D","E01020566","Total",2090,1026,1064,2090,0,19,312.33,6.7
"2011","Cheltenham 001A","E01022163","Total",1494,740,754,1494,0,12,41.65,35.9
"2011","Cheltenham 001B","E01022164","Total",1394,684,710,1394,0,11,45.63,30.6
"2011","Cheltenham 001C","E01022165","Total",1492,754,738,1485,7,21,287.35,5.2
"2011","Cheltenham 001D","E01022166","Total",1320,652,668,1320,0,11,152.50,8.7
"2011","Cheltenham 002A","E01022143","Total",1462,694,768,1458,4,27,252.20,5.8
"2011","Cheltenham 002B","E01022144","Total",1125,534,591,1125,0,20,35.93,31.3
"2011","Cheltenham 002C","E01022145","Total",1219,579,640,1213,6,26,32.69,37.3
"2011","Cheltenham 002D","E01022146","Total",1359,624,735,1305,54,22,88.39,15.4
"2011","Cheltenham 003A","E01022122","Total",1371,624,747,1303,68,10,29.83,46.0
"2011","Cheltenham 003B","E01022160","Total",2102,965,1137,2058,44,8,45.58,46.1
"2011","Cheltenham 003C","E01022161","Total",1416,682,734,1416,0,6,65.88,21.5
"2011","Cheltenham 003D","E01022162","Total",1543,745,798,1543,0,10,56.54,27.3
"2011","Cheltenham 004A","E01022139","Total",1272,616,656,1099,173,35,76.78,16.6
"2011","Cheltenham 004B","E01022151","Total",1711,818,893,1566,145,10,22.12,77.4
"2011","Cheltenham 004C","E01022152","Total",1140,532,608,1038,102,5,17.00,67.1
"2011","Cheltenham 004D","E01022153","Total",1641,821,820,1590,51,17,18.03,91.0
"2011","Cheltenham 004E","E01022154","Total",1911,878,1033,1909,2,28,12.46,153.4
"2011","Cheltenham 005A","E01022120","Total",1551,809,742,1548,3,9,20.37,76.1
"2011","Cheltenham 005B","E01022121","Total",1775,851,924,1775,0,9,23.09,76.9
"2011","Cheltenham 005C","E01022147","Total",1620,781,839,1614,6,8,25.89,62.6
"2011","Cheltenham 005D","E01022157","Total",1534,733,801,1534,0,19,25.31,60.6
"2011","Cheltenham 005E","E01022159","Total",1475,701,774,1475,0,9,27.41,53.8
"2011","Cheltenham 006A","E01022131","Total",1261,611,650,1252,9,10,22.91,55.0
"2011","Cheltenham 006B","E01022132","Total",1425,675,750,1425,0,13,64.59,22.1
"2011","Cheltenham 006C","E01022133","Total",1484,719,765,1484,0,10,20.54,72.2
"2011","Cheltenham 006D","E01022134","Total",1561,788,773,1556,5,14,30.19,51.7
"2011","Cheltenham 007A","E01022148","Total",1557,782,775,1505,52,21,33.37,46.7
"2011","Cheltenham 007B","E01022149","Total",1400,728,672,1400,0,15,38.52,36.3
"2011","Cheltenham 007C","E01022150","Total",1531,749,782,1490,41,9,32.53,47.1
"2011","Cheltenham 007D","E01022155","Total",1506,772,734,1503,3,15,41.17,36.6
"2011","Cheltenham 007E","E01022156","Total",1593,820,773,1515,78,15,31.95,49.9
"2011","Cheltenham 007F","E01022158","Total",2201,1170,1031,2184,17,13,43.44,50.7
"2011","Cheltenham 008A","E01022100","Total",1799,937,862,1756,43,35,29.90,60.2
"2011","Cheltenham 008B","E01022101","Total",1814,905,909,1801,13,20,21.78,83.3
"2011","Cheltenham 008C","E01022102","Total",1781,982,799,1776,5,6,24.41,73.0
"2011","Cheltenham 008D","E01022140","Total",1193,558,635,1166,27,13,36.15,33.0
"2011","Cheltenham 008E","E01022141","Total",1384,712,672,1383,1,15,36.15,38.3
"2011","Cheltenham 008F","E01022142","Total",1478,764,714,1478,0,17,14.01,105.5
"2011","Cheltenham 009A","E01022116","Total",1524,829,695,1032,492,31,39.67,38.4
"2011","Cheltenham 009B","E01022117","Total",1709,935,774,1580,129,19,29.68,57.6
"2011","Cheltenham 009C","E01022119","Total",1305,625,680,1305,0,22,27.93,46.7
"2011","Cheltenham 009D","E01022124","Total",1231,621,610,1142,89,4,23.93,51.4
"2011","Cheltenham 009E","E01022125","Total",1282,617,665,1208,74,37,30.11,42.6
"2011","Cheltenham 009F","E01022126","Total",1421,769,652,1419,2,19,26.25,54.1
"2011","Cheltenham 009G","E01022127","Total",1989,699,1290,1204,785,17,39.06,50.9
"2011","Cheltenham 010A","E01022106","Total",1758,868,890,1737,21,23,42.84,41.0
"2011","Cheltenham 010B","E01022107","Total",1527,758,769,1527,0,28,49.42,30.9
"2011","Cheltenham 010C","E01022108","Total",1786,875,911,1786,0,45,92.09,19.4
"2011","Cheltenham 010D","E01022123","Total",2205,1140,1065,2201,4,26,131.28,16.8
"2011","Cheltenham 011A","E01022135","Total",1718,824,894,1369,349,38,63.51,27.1
"2011","Cheltenham 011B","E01022136","Total",1503,682,821,1384,119,25,24.18,62.2
"2011","Cheltenham 011C","E01022137","Total",1716,861,855,1668,48,42,24.69,69.5
"2011","Cheltenham 011D","E01022138","Total",1752,866,886,1571,181,48,46.15,38.0
"2011","Cheltenham 011E","E01022174","Total",1347,650,697,1347,0,26,50.35,26.8
"2011","Cheltenham 012A","E01022103","Total",2393,1191,1202,2380,13,53,147.17,16.3
"2011","Cheltenham 012B","E01022104","Total",1636,793,843,1634,2,31,37.75,43.3
"2011","Cheltenham 012C","E01022105","Total",1431,689,742,1431,0,29,513.06,2.8
"2011","Cheltenham 012D","E01022109","Total",1476,720,756,1476,0,35,370.85,4.0
"2011","Cheltenham 012E","E01022110","Total",1388,656,732,1371,17,23,29.43,47.2
"2011","Cheltenham 012F","E01022111","Total",1466,689,777,1416,50,24,36.21,40.5
"2011","Cheltenham 012G","E01022112","Total",1298,579,719,1229,69,32,49.96,26.0
"2011","Cheltenham 013A","E01022167","Total",1223,595,628,1223,0,32,38.17,32.0
"2011","Cheltenham 013B","E01022168","Total",1104,530,574,1104,0,9,22.57,48.9
"2011","Cheltenham 013C","E01022169","Total",1506,729,777,1506,0,14,29.04,51.9
"2011","Cheltenham 013D","E01022170","Total",1483,715,768,1483,0,30,25.82,57.4
"2011","Cheltenham 013E","E01022171","Total",1350,680,670,1350,0,35,24.14,55.9
"2011","Cheltenham 013F","E01022172","Total",1433,686,747,1427,6,11,33.28,43.1
"2011","Cheltenham 013G","E01022173","Total",1338,631,707,1326,12,7,24.57,54.5
"2011","Cheltenham 014A","E01022113","Total",1675,782,893,1640,35,63,78.30,21.4
"2011","Cheltenham 014B","E01022114","Total",1552,704,848,1503,49,30,226.10,6.9
"2011","Cheltenham 014C","E01022115","Total",1624,791,833,1619,5,48,56.04,29.0
"2011","Cheltenham 014D","E01022118","Total",1413,694,719,1413,0,42,38.66,36.5
"2011","Cheltenham 015A","E01022128","Total",1606,775,831,1595,11,40,118.65,13.5
"2011","Cheltenham 015B","E01022129","Total",2091,1036,1055,2051,40,52,60.80,34.4
"2011","Cheltenham 015C","E01022130","Total",1578,739,839,1555,23,31,35.42,44.6
"2011","Cotswold 001A","E01022179","Total",2041,993,1048,2034,7,40,3051.87,0.7
"2011","Cotswold 001B","E01022182","Total",1498,714,784,1495,3,25,3347.33,0.4
"2011","Cotswold 001C","E01022183","Total",1506,705,801,1445,61,25,242.90,6.2
"2011","Cotswold 001D","E01022184","Total",1451,680,771,1445,6,39,2996.32,0.5
"2011","Cotswold 001E","E01022185","Total",1433,688,745,1414,19,13,488.63,2.9
"2011","Cotswold 002A","E01022177","Total",2042,956,1086,1983,59,32,149.71,13.6
"2011","Cotswold 002B","E01022178","Total",1323,646,677,1319,4,37,3519.84,0.4
"2011","Cotswold 002C","E01022205","Total",1794,858,936,1783,11,49,6338.81,0.3
"2011","Cotswold 002D","E01022211","Total",1845,847,998,1807,38,23,120.21,15.3
"2011","Cotswold 002E","E01022212","Total",1648,789,859,1648,0,21,489.02,3.4
"2011","Cotswold 003A","E01022180","Total",2088,996,1092,2050,38,28,221.90,9.4
"2011","Cotswold 003B","E01022181","Total",1588,760,828,1574,14,52,2069.96,0.8
"2011","Cotswold 003C","E01022214","Total",2103,1029,1074,2098,5,51,3218.36,0.7
"2011","Cotswold 003D","E01022222","Total",1900,914,986,1885,15,53,9794.18,0.2
"2011","Cotswold 004A","E01022186","Total",1705,845,860,1703,2,53,6856.28,0.2
"2011","Cotswold 004B","E01022187","Total",1970,999,971,1781,189,83,6262.80,0.3
"2011","Cotswold 004C","E01022201","Total",1793,885,908,1789,4,83,6951.95,0.3
"2011","Cotswold 004D","E01022216","Total",1829,921,908,1826,3,62,5910.45,0.3
"2011","Cotswold 005A","E01022175","Total",1884,924,960,1863,21,65,7039.89,0.3
"2011","Cotswold 005B","E01022207","Total",1789,884,905,1789,0,69,3357.25,0.5
"2011","Cotswold 005C","E01022213","Total",1854,862,992,1804,50,44,2196.27,0.8
"2011","Cotswold 005D","E01022215","Total",1766,873,893,1762,4,71,10428.65,0.2
"2011","Cotswold 006A","E01022188","Total",1352,665,687,1352,0,19,56.66,23.9
"2011","Cotswold 006B","E01022189","Total",1341,681,660,1341,0,20,33.58,39.9
"2011","Cotswold 006C","E01022190","Total",1379,693,686,1379,0,17,32.45,42.5
"2011","Cotswold 006D","E01022196","Total",1750,834,916,1750,0,36,240.50,7.3
"2011","Cotswold 006E","E01022197","Total",1864,901,963,1863,1,35,298.14,6.3
"2011","Cotswold 007A","E01022194","Total",1658,752,906,1637,21,23,67.51,24.6
"2011","Cotswold 007B","E01022195","Total",1638,770,868,1298,340,51,1131.29,1.4
"2011","Cotswold 007C","E01022199","Total",1739,846,893,1702,37,22,38.86,44.8
"2011","Cotswold 007D","E01022200","Total",1270,606,664,1194,76,5,27.03,47.0
"2011","Cotswold 008A","E01022191","Total",1376,646,730,1376,0,12,36.21,38.0
"2011","Cotswold 008B","E01022192","Total",1320,638,682,1320,0,15,21.31,61.9
"2011","Cotswold 008C","E01022193","Total",1083,527,556,1027,56,20,203.72,5.3
"2011","Cotswold 008D","E01022198","Total",1306,657,649,1306,0,18,72.61,18.0
"2011","Cotswold 008E","E01022225","Total",1786,902,884,1524,262,26,1154.81,1.5
"2011","Cotswold 009A","E01022202","Total",1095,542,553,1065,30,33,2125.88,0.5
"2011","Cotswold 009B","E01022203","Total",1478,709,769,1400,78,28,1010.84,1.5
"2011","Cotswold 009C","E01022204","Total",1458,687,771,1458,0,18,61.19,23.8
"2011","Cotswold 009D","E01022208","Total",1575,746,829,1573,2,64,1132.48,1.4
"2011","Cotswold 009E","E01022209","Total",1123,563,560,1123,0,31,1731.12,0.6
"2011","Cotswold 009F","E01022210","Total",1275,619,656,1275,0,16,489.04,2.6
"2011","Cotswold 010A","E01022221","Total",1955,958,997,1953,2,59,4066.27,0.5
"2011","Cotswold 010B","E01022223","Total",2374,1157,1217,2372,2,42,898.01,2.6
"2011","Cotswold 010C","E01022224","Total",1547,741,806,1547,0,43,2142.58,0.7
"2011","Cotswold 011A","E01022176","Total",1930,981,949,1925,5,61,5367.04,0.4
"2011","Cotswold 011B","E01022206","Total",1887,917,970,1856,31,78,8765.35,0.2
"2011","Cotswold 011C","E01022217","Total",1294,621,673,1294,0,14,33.21,39.0
"2011","Cotswold 011D","E01022218","Total",1314,640,674,1314,0,12,21.20,62.0
"2011","Cotswold 011E","E01022219","Total",1256,597,659,1226,30,22,67.21,18.7
"2011","Cotswold 011F","E01022220","Total",1608,740,868,1572,36,23,73.28,21.9
"2011","Forest of Dean 001A","E01022233","Total",1901,950,951,1876,25,48,4657.27,0.4
"2011","Forest of Dean 001B","E01022235","Total",1760,848,912,1733,27,24,1887.75,0.9
"2011","Forest of Dean 001C","E01022247","Total",2496,1192,1304,1638,858,80,3024.67,0.8
"2011","Forest of Dean 001D","E01022270","Total",1856,904,952,1832,24,36,2906.35,0.6
"2011","Forest of Dean 001E","E01022271","Total",1664,832,832,1657,7,34,3234.34,0.5
"2011","Forest of Dean 002A","E01022261","Total",1941,950,991,1941,0,23,150.41,12.9
"2011","Forest of Dean 002B","E01022262","Total",1826,883,943,1820,6,25,41.19,44.3
"2011","Forest of Dean 002C","E01022267","Total",1583,760,823,1515,68,30,2610.64,0.6
"2011","Forest of Dean 003A","E01022251","Total",1431,726,705,1431,0,10,407.82,3.5
"2011","Forest of Dean 003B","E01022252","Total",1721,879,842,1719,2,16,692.31,2.5
"2011","Forest of Dean 003C","E01022258","Total",1150,554,596,1107,43,8,138.95,8.3
"2011","Forest of Dean 003D","E01022259","Total",1633,810,823,1596,37,19,900.22,1.8
"2011","Forest of Dean 003E","E01022260","Total",1824,900,924,1794,30,12,346.93,5.3
"2011","Forest of Dean 004A","E01022236","Total",2050,1013,1037,2043,7,12,43.00,47.7
"2011","Forest of Dean 004B","E01022237","Total",1495,738,757,1495,0,15,52.96,28.2
"2011","Forest of Dean 004C","E01022238","Total",1276,600,676,1276,0,5,1104.23,1.2
"2011","Forest of Dean 004D","E01022239","Total",1629,814,815,1620,9,11,49.77,32.7
"2011","Forest of Dean 004E","E01022240","Total",2044,1005,1039,2022,22,10,336.86,6.1
"2011","Forest of Dean 004F","E01022249","Total",1976,1011,965,1955,21,22,1858.53,1.1
"2011","Forest of Dean 004G","E01022250","Total",1792,878,914,1790,2,10,273.24,6.6
"2011","Forest of Dean 005A","E01022228","Total",1714,852,862,1672,42,27,2040.31,0.8
"2011","Forest of Dean 005B","E01022230","Total",1754,848,906,1682,72,24,2025.81,0.9
"2011","Forest of Dean 005C","E01022265","Total",1667,840,827,1602,65,42,1480.49,1.1
"2011","Forest of Dean 005D","E01022266","Total",1421,706,715,1351,70,24,2703.14,0.5
"2011","Forest of Dean 006A","E01022234","Total",1520,759,761,1490,30,29,2689.47,0.6
"2011","Forest of Dean 006B","E01022253","Total",1667,819,848,1650,17,16,441.29,3.8
"2011","Forest of Dean 006C","E01022263","Total",1822,897,925,1804,18,51,3395.17,0.5
"2011","Forest of Dean 007A","E01022229","Total",1652,799,853,1652,0,16,71.23,23.2
"2011","Forest of Dean 007B","E01022241","Total",1598,780,818,1581,17,13,146.20,10.9
"2011","Forest of Dean 007C","E01022242","Total",1474,698,776,1437,37,20,495.10,3.0
"2011","Forest of Dean 007D","E01022243","Total",1224,600,624,1224,0,13,49.31,24.8
"2011","Forest of Dean 007E","E01022244","Total",1459,710,749,1459,0,14,58.53,24.9
"2011","Forest of Dean 007F","E01022245","Total",1314,658,656,1314,0,14,130.68,10.1
"2011","Forest of Dean 007G","E01022246","Total",1290,640,650,1290,0,9,141.11,9.1
"2011","Forest of Dean 008A","E01022231","Total",1642,808,834,1639,3,16,181.03,9.1
"2011","Forest of Dean 008B","E01022232","Total",1529,766,763,1529,0,15,534.07,2.9
"2011","Forest of Dean 008C","E01022264","Total",1475,715,760,1467,8,16,570.06,2.6
"2011","Forest of Dean 008D","E01022268","Total",1575,769,806,1575,0,18,434.43,3.6
"2011","Forest of Dean 008E","E01022269","Total",1947,963,984,1934,13,17,2238.29,0.9
"2011","Forest of Dean 009A","E01022226","Total",1548,747,801,1548,0,19,483.19,3.2
"2011","Forest of Dean 009B","E01022227","Total",1546,754,792,1546,0,20,1920.15,0.8
"2011","Forest of Dean 009C","E01022254","Total",1905,919,986,1851,54,12,94.70,20.1
"2011","Forest of Dean 009D","E01022255","Total",1557,775,782,1551,6,21,494.59,3.1
"2011","Forest of Dean 009E","E01022256","Total",1585,763,822,1572,13,11,70.95,22.3
"2011","Forest of Dean 009F","E01022257","Total",1852,900,952,1851,1,20,466.66,4.0
"2011","Forest of Dean 010A","E01022248","Total",1690,821,869,1690,0,31,1952.65,0.9
"2011","Forest of Dean 010B","E01022272","Total",1342,629,713,1263,79,9,146.69,9.1
"2011","Forest of Dean 010C","E01022273","Total",1371,745,626,1245,126,19,213.13,6.4
"2011","Forest of Dean 010D","E01022274","Total",1173,589,584,1173,0,21,2132.42,0.6
"2011","Forest of Dean 010E","E01022275","Total",1600,756,844,1538,62,34,132.34,12.1
"2011","Gloucester 001A","E01022313","Total",1689,836,853,1689,0,29,36.39,46.4
"2011","Gloucester 001B","E01022315","Total",1505,754,751,1500,5,24,29.71,50.7
"2011","Gloucester 001C","E01022316","Total",1581,759,822,1581,0,33,46.58,33.9
"2011","Gloucester 001D","E01022317","Total",1564,790,774,1564,0,15,38.12,41.0
"2011","Gloucester 001E","E01022318","Total",1742,876,866,1548,194,40,48.91,35.6
"2011","Gloucester 002A","E01022309","Total",1546,771,775,1470,76,20,30.14,51.3
"2011","Gloucester 002B","E01022310","Total",1737,833,904,1693,44,17,54.65,31.8
"2011","Gloucester 002C","E01022311","Total",1814,965,849,1704,110,8,40.67,44.6
"2011","Gloucester 002D","E01022312","Total",2314,1163,1151,2043,271,21,89.67,25.8
"2011","Gloucester 002E","E01022314","Total",1451,709,742,1451,0,28,82.32,17.6
"2011","Gloucester 003A","E01022295","Total",1430,697,733,1430,0,20,38.83,36.8
"2011","Gloucester 003B","E01022296","Total",1458,719,739,1450,8,9,41.13,35.4
"2011","Gloucester 003C","E01022297","Total",1276,646,630,1263,13,31,30.22,42.2
"2011","Gloucester 003D","E01022298","Total",1612,752,860,1527,85,26,33.93,47.5
"2011","Gloucester 004A","E01022332","Total",1612,830,782,1562,50,21,40.94,39.4
"2011","Gloucester 004B","E01022347","Total",1689,982,707,1630,59,11,47.42,35.6
"2011","Gloucester 004C","E01022348","Total",2610,1316,1294,2609,1,36,514.54,5.1
"2011","Gloucester 004E","E01032932","Total",1207,673,534,1047,160,6,128.15,9.4
"2011","Gloucester 004F","E01032937","Total",1101,605,496,994,107,9,46.34,23.8
"2011","Gloucester 005A","E01022288","Total",1739,844,895,1739,0,13,31.09,55.9
"2011","Gloucester 005B","E01022289","Total",1582,809,773,1582,0,10,24.12,65.6
"2011","Gloucester 005C","E01022290","Total",1375,680,695,1374,1,5,14.72,93.4
"2011","Gloucester 005D","E01022291","Total",1739,876,863,1722,17,11,14.50,119.9
"2011","Gloucester 005E","E01022292","Total",1411,726,685,1411,0,11,12.69,111.2
"2011","Gloucester 006A","E01022283","Total",1510,717,793,1482,28,25,46.01,32.8
"2011","Gloucester 006B","E01022303","Total",1407,664,743,1406,1,17,31.39,44.8
"2011","Gloucester 006C","E01022304","Total",1543,722,821,1543,0,15,45.83,33.7
"2011","Gloucester 006D","E01022305","Total",1391,661,730,1391,0,16,29.47,47.2
"2011","Gloucester 006E","E01022308","Total",1422,719,703,1413,9,15,26.53,53.6
"2011","Gloucester 007A","E01022278","Total",1588,779,809,1588,0,30,35.09,45.3
"2011","Gloucester 007B","E01022279","Total",1480,705,775,1480,0,21,24.82,59.6
"2011","Gloucester 007C","E01022282","Total",2857,1397,1460,2851,6,46,55.13,51.8
"2011","Gloucester 007D","E01022284","Total",1277,633,644,1277,0,8,47.73,26.8
"2011","Gloucester 007E","E01022285","Total",1409,687,722,1409,0,13,35.20,40.0
"2011","Gloucester 007F","E01022286","Total",1579,772,807,1579,0,3,41.49,38.1
"2011","Gloucester 007G","E01022287","Total",1685,866,819,1669,16,27,172.82,9.8
"2011","Gloucester 008A","E01022293","Total",1576,798,778,1555,21,20,17.46,90.3
"2011","Gloucester 008B","E01022294","Total",1531,756,775,1526,5,12,16.88,90.7
"2011","Gloucester 008C","E01022323","Total",1777,825,952,1777,0,14,31.60,56.2
"2011","Gloucester 008D","E01022328","Total",1328,648,680,1328,0,20,25.27,52.6
"2011","Gloucester 008E","E01022329","Total",1605,790,815,1585,20,12,24.09,66.6
"2011","Gloucester 009A","E01022326","Total",1307,623,684,1307,0,9,13.32,98.1
"2011","Gloucester 009B","E01022327","Total",1596,792,804,1561,35,20,30.89,51.7
"2011","Gloucester 009C","E01022330","Total",1443,728,715,1443,0,19,27.16,53.1
"2011","Gloucester 009D","E01022331","Total",1362,682,680,1362,0,6,21.14,64.4
"2011","Gloucester 009E","E01022333","Total",1393,669,724,1393,0,4,103.45,13.5
"2011","Gloucester 009F","E01022334","Total",1601,790,811,1586,15,19,71.49,22.4
"2011","Gloucester 010A","E01022276","Total",1627,801,826,1627,0,26,32.20,50.5
"2011","Gloucester 010B","E01022277","Total",1489,729,760,1484,5,21,40.60,36.7
"2011","Gloucester 010C","E01022280","Total",1541,763,778,1527,14,21,28.56,54.0
"2011","Gloucester 010D","E01022281","Total",1770,864,906,1770,0,33,35.26,50.2
"2011","Gloucester 010E","E01022306","Total",1404,691,713,1404,0,21,29.65,47.4
"2011","Gloucester 010F","E01022307","Total",1659,818,841,1659,0,27,31.23,53.1
"2011","Gloucester 011A","E01022319","Total",1419,688,731,1419,0,7,20.25,70.1
"2011","Gloucester 011B","E01022320","Total",1501,782,719,1437,64,14,195.98,7.7
"2011","Gloucester 011C","E01022321","Total",1510,737,773,1510,0,14,42.57,35.5
"2011","Gloucester 011D","E01022322","Total",1290,614,676,1290,0,6,34.27,37.6
"2011","Gloucester 011E","E01022324","Total",1446,701,745,1446,0,12,33.93,42.6
"2011","Gloucester 011F","E01022325","Total",1334,661,673,1334,0,9,127.51,10.5
"2011","Gloucester 012A","E01022343","Total",1377,651,726,1237,140,17,44.79,30.7
"2011","Gloucester 012B","E01022344","Total",1522,751,771,1522,0,13,34.79,43.7
"2011","Gloucester 012C","E01022345","Total",1470,715,755,1470,0,18,92.47,15.9
"2011","Gloucester 012D","E01022346","Total",1520,715,805,1520,0,17,22.39,67.9
"2011","Gloucester 013A","E01022299","Total",1392,662,730,1392,0,5,45.23,30.8
"2011","Gloucester 013B","E01022300","Total",1355,662,693,1355,0,7,24.84,54.5
"2011","Gloucester 013C","E01022301","Total",1544,757,787,1544,0,7,34.80,44.4
"2011","Gloucester 013D","E01022302","Total",1548,761,787,1538,10,8,35.96,43.0
"2011","Gloucester 014A","E01022339","Total",1720,829,891,1720,0,17,46.51,37.0
"2011","Gloucester 014B","E01022340","Total",1459,704,755,1459,0,9,22.19,65.8
"2011","Gloucester 014C","E01022341","Total",2211,1031,1180,2103,108,20,55.88,39.6
"2011","Gloucester 014D","E01022342","Total",1708,855,853,1708,0,17,102.44,16.7
"2011","Gloucester 015A","E01022335","Total",1500,716,784,1500,0,12,39.89,37.6
"2011","Gloucester 015B","E01022336","Total",1167,569,598,1167,0,11,28.77,40.6
"2011","Gloucester 015D","E01022338","Total",1348,653,695,1348,0,8,15.80,85.3
"2011","Gloucester 015E","E01032933","Total",1506,752,754,1505,1,27,49.80,30.2
"2011","Gloucester 015F","E01032934","Total",1444,733,711,1410,34,13,135.84,10.6
"2011","Gloucester 015G","E01032935","Total",1586,809,777,1586,0,14,23.67,67.0
"2011","Gloucester 015H","E01032936","Total",1870,896,974,1870,0,24,55.57,33.7
"2011","Stroud 001A","E01022378","Total",1822,913,909,1822,0,22,799.00,2.3
"2011","Stroud 001B","E01022379","Total",1436,710,726,1436,0,14,19.05,75.4
"2011","Stroud 001C","E01022380","Total",1525,756,769,1525,0,28,2436.93,0.6
"2011","Stroud 001D","E01022412","Total",2845,1383,1462,2803,42,45,2188.63,1.3
"2011","Stroud 002A","E01022354","Total",2142,1060,1082,2142,0,72,2922.24,0.7
"2011","Stroud 002B","E01022390","Total",1202,567,635,1202,0,21,124.25,9.7
"2011","Stroud 002C","E01022391","Total",1425,677,748,1424,1,38,1727.24,0.8
"2011","Stroud 002D","E01022392","Total",1531,739,792,1531,0,58,2801.40,0.5
"2011","Stroud 003A","E01022376","Total",1794,872,922,1769,25,24,1988.95,0.9
"2011","Stroud 003B","E01022396","Total",1711,856,855,1676,35,41,2037.68,0.8
"2011","Stroud 003C","E01022397","Total",1913,935,978,1891,22,37,1527.58,1.3
"2011","Stroud 003D","E01022398","Total",1136,582,554,1121,15,19,1635.69,0.7
"2011","Stroud 004A","E01022355","Total",1675,847,828,1675,0,25,52.92,31.7
"2011","Stroud 004B","E01022356","Total",2274,1127,1147,2240,34,32,80.45,28.3
"2011","Stroud 004C","E01022357","Total",1771,871,900,1771,0,10,36.40,48.7
"2011","Stroud 004D","E01022358","Total",1596,776,820,1589,7,8,32.29,49.4
"2011","Stroud 004E","E01022377","Total",2166,1047,1119,2137,29,24,69.14,31.3
"2011","Stroud 004F","E01022389","Total",1747,858,889,1747,0,42,348.55,5.0
"2011","Stroud 005A","E01022400","Total",1817,900,917,1816,1,23,126.44,14.4
"2011","Stroud 005B","E01022401","Total",1410,700,710,1410,0,20,95.14,14.8
"2011","Stroud 005C","E01022402","Total",1579,763,816,1579,0,13,29.10,54.3
"2011","Stroud 005D","E01022403","Total",1377,676,701,1377,0,11,93.83,14.7
"2011","Stroud 005E","E01022404","Total",1542,808,734,1240,302,32,149.27,10.3
"2011","Stroud 006A","E01022365","Total",2150,1113,1037,2067,83,18,142.70,15.1
"2011","Stroud 006B","E01022399","Total",2141,1090,1051,2131,10,24,54.99,38.9
"2011","Stroud 006C","E01022410","Total",2150,1025,1125,2114,36,41,161.61,13.3
"2011","Stroud 006D","E01022411","Total",2215,1065,1150,2178,37,17,197.13,11.2
"2011","Stroud 006E","E01022414","Total",2437,1219,1218,2427,10,49,109.72,22.2
"2011","Stroud 007A","E01022393","Total",1464,709,755,1454,10,27,205.19,7.1
"2011","Stroud 007B","E01022394","Total",1555,784,771,1553,2,19,58.38,26.6
"2011","Stroud 007C","E01022395","Total",1524,749,775,1524,0,33,71.16,21.4
"2011","Stroud 007D","E01022408","Total",1071,557,514,1071,0,28,188.35,5.7
"2011","Stroud 007E","E01022409","Total",1256,640,616,1256,0,31,319.46,3.9
"2011","Stroud 008A","E01022366","Total",1784,873,911,1784,0,30,157.10,11.4
"2011","Stroud 008B","E01022367","Total",1655,804,851,1655,0,39,184.74,9.0
"2011","Stroud 008C","E01022368","Total",1396,694,702,1385,11,36,102.20,13.7
"2011","Stroud 008D","E01022369","Total",1674,822,852,1674,0,20,34.87,48.0
"2011","Stroud 009A","E01022370","Total",1240,613,627,1240,0,34,1344.73,0.9
"2011","Stroud 009B","E01022371","Total",1059,524,535,1056,3,32,1191.61,0.9
"2011","Stroud 009C","E01022405","Total",1424,672,752,1424,0,12,256.47,5.6
"2011","Stroud 009D","E01022406","Total",1209,617,592,1207,2,29,401.42,3.0
"2011","Stroud 009E","E01022407","Total",1327,654,673,1304,23,23,1103.06,1.2
"2011","Stroud 010A","E01022350","Total",2116,1026,1090,2099,17,67,765.83,2.8
"2011","Stroud 010B","E01022382","Total",1611,738,873,1523,88,30,249.87,6.4
"2011","Stroud 010C","E01022383","Total",1325,637,688,1306,19,15,148.95,8.9
"2011","Stroud 010D","E01022384","Total",1421,697,724,1378,43,50,1252.41,1.1
"2011","Stroud 011A","E01022359","Total",1492,731,761,1492,0,25,40.18,37.1
"2011","Stroud 011B","E01022360","Total",1394,706,688,1394,0,24,449.80,3.1
"2011","Stroud 011C","E01022361","Total",1248,615,633,1248,0,10,105.99,11.8
"2011","Stroud 011D","E01022362","Total",1159,568,591,1159,0,33,294.97,3.9
"2011","Stroud 011E","E01022363","Total",1755,879,876,1755,0,22,246.00,7.1
"2011","Stroud 011F","E01022364","Total",1114,536,578,1114,0,9,44.94,24.8
"2011","Stroud 012A","E01022351","Total",1412,724,688,1412,0,16,810.32,1.7
"2011","Stroud 012B","E01022352","Total",1350,658,692,1320,30,19,1541.09,0.9
"2011","Stroud 012C","E01022353","Total",1419,681,738,1410,9,13,100.33,14.1
"2011","Stroud 012D","E01022413","Total",1879,955,924,1836,43,45,4233.15,0.4
"2011","Stroud 013A","E01022385","Total",1623,780,843,1616,7,48,1426.57,1.1
"2011","Stroud 013B","E01022386","Total",1630,765,865,1550,80,42,166.49,9.8
"2011","Stroud 013C","E01022387","Total",1609,778,831,1605,4,19,195.12,8.2
"2011","Stroud 013D","E01022388","Total",1752,849,903,1747,5,16,54.31,32.3
"2011","Stroud 014A","E01022372","Total",1772,877,895,1730,42,26,145.30,12.2
"2011","Stroud 014B","E01022373","Total",1701,835,866,1701,0,17,203.81,8.3
"2011","Stroud 014C","E01022374","Total",1963,980,983,1913,50,30,82.72,23.7
"2011","Stroud 014D","E01022375","Total",1261,613,648,1261,0,5,30.35,41.5
"2011","Stroud 015A","E01022381","Total",2096,1063,1033,2061,35,57,2657.78,0.8
"2011","Stroud 015B","E01022415","Total",1621,782,839,1560,61,48,2990.23,0.5
"2011","Stroud 015C","E01022416","Total",1453,732,721,1453,0,28,57.38,25.3
"2011","Stroud 015D","E01022417","Total",1714,812,902,1714,0,37,99.65,17.2
"2011","Stroud 015E","E01022418","Total",1722,850,872,1719,3,37,64.87,26.5
"2011","Tewkesbury 001B","E01022450","Total",2111,1080,1031,2044,67,9,44.93,47.0
"2011","Tewkesbury 001C","E01022451","Total",1521,738,783,1515,6,15,76.62,19.9
"2011","Tewkesbury 001D","E01022452","Total",1448,751,697,1448,0,7,54.85,26.4
"2011","Tewkesbury 001E","E01022455","Total",1969,1024,945,1966,3,38,190.34,10.3
"2011","Tewkesbury 001F","E01032938","Total",1518,793,725,1475,43,20,1433.00,1.1
"2011","Tewkesbury 001G","E01032939","Total",1610,790,820,1610,0,17,207.23,7.8
"2011","Tewkesbury 001H","E01032940","Total",1406,673,733,1406,0,19,28.00,50.2
"2011","Tewkesbury 002A","E01022456","Total",1304,640,664,1303,1,19,534.39,2.4
"2011","Tewkesbury 002B","E01022457","Total",1377,663,714,1359,18,9,37.90,36.3
"2011","Tewkesbury 002C","E01022458","Total",1413,690,723,1413,0,9,39.76,35.5
"2011","Tewkesbury 002D","E01022459","Total",1453,732,721,1450,3,14,127.74,11.4
"2011","Tewkesbury 002E","E01022460","Total",1700,857,843,1700,0,19,65.19,26.1
"2011","Tewkesbury 002F","E01022461","Total",1380,662,718,1380,0,16,36.28,38.0
"2011","Tewkesbury 002G","E01022462","Total",1668,831,837,1639,29,35,1496.38,1.1
"2011","Tewkesbury 003A","E01022449","Total",1955,950,1005,1947,8,61,6155.30,0.3
"2011","Tewkesbury 003B","E01022463","Total",1468,705,763,1468,0,32,3356.28,0.4
"2011","Tewkesbury 003C","E01022464","Total",1580,759,821,1580,0,18,65.17,24.2
"2011","Tewkesbury 003D","E01022465","Total",1526,766,760,1526,0,40,2263.60,0.7
"2011","Tewkesbury 003E","E01022466","Total",1721,853,868,1721,0,31,2121.51,0.8
"2011","Tewkesbury 004A","E01022434","Total",2123,1032,1091,2061,62,55,2388.52,0.9
"2011","Tewkesbury 004B","E01022441","Total",1520,739,781,1496,24,33,1950.18,0.8
"2011","Tewkesbury 004C","E01022445","Total",1368,687,681,1367,1,36,3254.57,0.4
"2011","Tewkesbury 004D","E01022453","Total",1592,770,822,1592,0,44,2439.60,0.7
"2011","Tewkesbury 005A","E01022432","Total",2009,974,1035,2009,0,24,288.53,7.0
"2011","Tewkesbury 005B","E01022433","Total",2081,993,1088,2081,0,52,136.19,15.3
"2011","Tewkesbury 005C","E01022435","Total",2327,1102,1225,2327,0,25,92.95,25.0
"2011","Tewkesbury 005D","E01022436","Total",1921,879,1042,1921,0,14,70.33,27.3
"2011","Tewkesbury 005E","E01022437","Total",1448,686,762,1402,46,30,225.37,6.4
"2011","Tewkesbury 005F","E01022438","Total",1352,637,715,1352,0,34,32.84,41.2
"2011","Tewkesbury 005G","E01022439","Total",1555,757,798,1555,0,25,67.18,23.1
"2011","Tewkesbury 006A","E01022440","Total",1527,779,748,1524,3,17,397.03,3.8
"2011","Tewkesbury 006B","E01022442","Total",1498,750,748,1498,0,43,2666.42,0.6
"2011","Tewkesbury 006C","E01022443","Total",1334,631,703,1334,0,38,959.91,1.4
"2011","Tewkesbury 006D","E01022444","Total",1504,728,776,1446,58,37,1567.33,1.0
"2011","Tewkesbury 007A","E01022425","Total",1215,581,634,1215,0,24,66.42,18.3
"2011","Tewkesbury 007B","E01022426","Total",1437,715,722,1433,4,34,359.32,4.0
"2011","Tewkesbury 007C","E01022427","Total",1446,690,756,1414,32,42,125.04,11.6
"2011","Tewkesbury 007D","E01022428","Total",1845,885,960,1839,6,20,61.01,30.2
"2011","Tewkesbury 007E","E01022429","Total",1561,795,766,1561,0,21,189.05,8.3
"2011","Tewkesbury 007F","E01022430","Total",1440,700,740,1440,0,16,28.46,50.6
"2011","Tewkesbury 007G","E01022431","Total",2046,980,1066,2046,0,22,169.99,12.0
"2011","Tewkesbury 007H","E01022447","Total",1530,845,685,1301,229,40,159.05,9.6
"2011","Tewkesbury 008A","E01022420","Total",2124,1046,1078,2071,53,33,2885.36,0.7
"2011","Tewkesbury 008B","E01022448","Total",1357,637,720,1342,15,17,529.37,2.6
"2011","Tewkesbury 008C","E01022454","Total",1936,917,1019,1910,26,29,860.90,2.2
"2011","Tewkesbury 009A","E01022421","Total",1755,813,942,1677,78,18,31.34,56.0
"2011","Tewkesbury 009B","E01022422","Total",1639,826,813,1639,0,27,394.67,4.2
"2011","Tewkesbury 009C","E01022423","Total",1915,907,1008,1911,4,21,317.73,6.0
"2011","Tewkesbury 009D","E01022424","Total",1664,809,855,1611,53,12,48.27,34.5
"2011","Tewkesbury 009E","E01022446","Total",1746,833,913,1728,18,22,344.43,5.1
"2011","Mendip 001A","E01029022","Total",1341,644,697,1337,4,41,1710.48,0.8
"2011","Mendip 001B","E01029023","Total",1193,603,590,1191,2,28,1042.63,1.1
"2011","Mendip 001C","E01029044","Total",1333,662,671,1333,0,8,65.85,20.2
"2011","Mendip 001D","E01029053","Total",2275,1147,1128,2262,13,59,6211.41,0.4
"2011","Mendip 001E","E01029057","Total",2041,1025,1016,2040,1,36,4549.81,0.4
"2011","Mendip 002A","E01029024","Total",2062,1029,1033,2062,0,46,706.25,2.9
"2011","Mendip 002B","E01029025","Total",1314,659,655,1314,0,18,92.64,14.2
"2011","Mendip 002C","E01029026","Total",999,492,507,967,32,12,490.58,2.0
"2011","Mendip 002D","E01029068","Total",1536,801,735,1161,375,32,1544.38,1.0
"2011","Mendip 002E","E01029069","Total",1060,528,532,1060,0,14,678.08,1.6
"2011","Mendip 003A","E01029030","Total",1939,954,985,1939,0,30,38.41,50.5
"2011","Mendip 003B","E01029031","Total",1655,773,882,1605,50,17,58.83,28.1
"2011","Mendip 003C","E01029032","Total",1018,464,554,1018,0,17,53.88,18.9
"2011","Mendip 003D","E01029033","Total",1433,720,713,1433,0,15,22.81,62.8
"2011","Mendip 003E","E01029034","Total",1373,692,681,1328,45,16,46.86,29.3
"2011","Mendip 004A","E01029036","Total",1611,802,809,1595,16,20,29.36,54.9
"2011","Mendip 004B","E01029041","Total",2001,967,1034,1963,38,35,38.43,52.1
"2011","Mendip 004C","E01029042","Total",1548,745,803,1490,58,10,17.93,86.3
"2011","Mendip 004D","E01029043","Total",1540,739,801,1504,36,28,41.17,37.4
"2011","Mendip 004E","E01029045","Total",1565,752,813,1553,12,19,51.57,30.3
"2011","Mendip 005A","E01029052","Total",2112,1054,1058,2027,85,53,2430.35,0.9
"2011","Mendip 005B","E01029060","Total",1950,928,1022,1906,44,42,5578.59,0.3
"2011","Mendip 005C","E01029061","Total",2236,1072,1164,2226,10,54,2878.28,0.8
"2011","Mendip 005D","E01029083","Total",1367,643,724,1149,218,54,125.80,10.9
"2011","Mendip 006A","E01029018","Total",2363,1160,1203,2283,80,52,3109.74,0.8
"2011","Mendip 006B","E01029056","Total",2338,1148,1190,2238,100,71,5702.50,0.4
"2011","Mendip 006C","E01029064","Total",1588,890,698,1407,181,14,417.30,3.8
"2011","Mendip 006D","E01029084","Total",1503,689,814,1494,9,16,34.03,44.2
"2011","Mendip 007A","E01029029","Total",1694,820,874,1646,48,19,45.56,37.2
"2011","Mendip 007B","E01029035","Total",1527,746,781,1527,0,31,109.43,14.0
"2011","Mendip 007C","E01029037","Total",1382,690,692,1376,6,14,56.48,24.5
"2011","Mendip 007D","E01029038","Total",1385,651,734,1385,0,8,59.90,23.1
"2011","Mendip 007E","E01029039","Total",1559,741,818,1479,80,9,26.01,59.9
"2011","Mendip 007F","E01029040","Total",1640,821,819,1640,0,11,69.87,23.5
"2011","Mendip 008A","E01029078","Total",1744,764,980,1731,13,20,113.64,15.3
"2011","Mendip 008B","E01029079","Total",1524,740,784,1505,19,21,35.53,42.9
"2011","Mendip 008C","E01029080","Total",1482,727,755,1469,13,23,75.78,19.6
"2011","Mendip 008D","E01029081","Total",1571,712,859,1499,72,37,73.31,21.4
"2011","Mendip 008E","E01029082","Total",1345,607,738,1339,6,21,89.24,15.1
"2011","Mendip 009A","E01029062","Total",1415,741,674,1414,1,10,25.88,54.7
"2011","Mendip 009B","E01029063","Total",2490,1212,1278,2445,45,24,270.25,9.2
"2011","Mendip 009C","E01029065","Total",1664,822,842,1656,8,13,96.20,17.3
"2011","Mendip 009D","E01029066","Total",1756,871,885,1737,19,16,50.12,35.0
"2011","Mendip 009E","E01029067","Total",1456,697,759,1456,0,15,64.51,22.6
"2011","Mendip 010A","E01029020","Total",1487,745,742,1409,78,18,2172.46,0.7
"2011","Mendip 010B","E01029021","Total",1238,606,632,1233,5,30,2528.27,0.5
"2011","Mendip 010C","E01029027","Total",1195,575,620,1145,50,29,2027.43,0.6
"2011","Mendip 010D","E01029028","Total",1139,548,591,1139,0,19,137.39,8.3
"2011","Mendip 010E","E01029058","Total",2299,1123,1176,2274,25,63,6185.10,0.4
"2011","Mendip 011A","E01029046","Total",1411,692,719,1323,88,13,26.35,53.5
"2011","Mendip 011D","E01029050","Total",2220,1073,1147,2216,4,42,299.17,7.4
"2011","Mendip 011E","E01029051","Total",1555,765,790,1550,5,31,192.72,8.1
"2011","Mendip 011F","E01032627","Total",2248,1072,1176,2063,185,35,1232.32,1.8
"2011","Mendip 012A","E01029047","Total",1498,715,783,1434,64,16,279.11,5.4
"2011","Mendip 012B","E01029054","Total",1541,760,781,1539,2,28,3348.97,0.5
"2011","Mendip 012C","E01029055","Total",1236,628,608,1236,0,13,1917.46,0.6
"2011","Mendip 012D","E01029074","Total",2122,1121,1001,1272,850,61,525.23,4.0
"2011","Mendip 012E","E01029076","Total",2059,1001,1058,2059,0,15,58.35,35.3
"2011","Mendip 013A","E01029019","Total",2357,1140,1217,2299,58,68,4166.81,0.6
"2011","Mendip 013B","E01029059","Total",2078,1036,1042,2070,8,52,4045.00,0.5
"2011","Mendip 013C","E01029077","Total",2044,1017,1027,2039,5,76,5188.67,0.4
"2011","Mendip 014A","E01029070","Total",1825,904,921,1815,10,17,77.72,23.5
"2011","Mendip 014B","E01029071","Total",1528,737,791,1528,0,16,294.14,5.2
"2011","Mendip 014C","E01029072","Total",1639,746,893,1639,0,11,145.95,11.2
"2011","Mendip 014D","E01029073","Total",1249,590,659,1245,4,27,37.47,33.3
"2011","Mendip 014E","E01029075","Total",1383,649,734,1315,68,6,27.76,49.8
"2011","Sedgemoor 001A","E01029085","Total",2057,986,1071,2001,56,53,474.21,4.3
"2011","Sedgemoor 001B","E01029126","Total",1515,739,776,1515,0,20,252.00,6.0
"2011","Sedgemoor 001C","E01029127","Total",1504,675,829,1478,26,18,68.67,21.9
"2011","Sedgemoor 001D","E01029128","Total",1883,931,952,1864,19,48,2584.64,0.7
"2011","Sedgemoor 001E","E01029129","Total",1940,950,990,1895,45,47,1302.77,1.5
"2011","Sedgemoor 002C","E01029089","Total",2262,1105,1157,2241,21,64,2434.14,0.9
"2011","Sedgemoor 002D","E01029113","Total",1641,777,864,1591,50,7,182.54,9.0
"2011","Sedgemoor 002E","E01029115","Total",1665,795,870,1665,0,10,108.48,15.3
"2011","Sedgemoor 002F","E01029140","Total",2907,1401,1506,2842,65,43,2125.10,1.4
"2011","Sedgemoor 002G","E01032633","Total",2169,1094,1075,2096,73,16,1443.77,1.5
"2011","Sedgemoor 003A","E01029086","Total",2204,1102,1102,2204,0,49,3022.70,0.7
"2011","Sedgemoor 003B","E01029147","Total",1736,876,860,1736,0,49,2873.59,0.6
"2011","Sedgemoor 003C","E01029148","Total",1582,757,825,1582,0,39,1291.78,1.2
"2011","Sedgemoor 003D","E01029149","Total",1478,747,731,1417,61,28,2145.60,0.7
"2011","Sedgemoor 004A","E01029114","Total",1536,705,831,1448,88,18,64.99,23.6
"2011","Sedgemoor 004B","E01029116","Total",1577,766,811,1470,107,15,43.56,36.2
"2011","Sedgemoor 004C","E01029117","Total",1606,789,817,1533,73,10,34.95,46.0
"2011","Sedgemoor 004D","E01029119","Total",1579,694,885,1529,50,6,33.35,47.3
"2011","Sedgemoor 004E","E01029120","Total",1509,704,805,1509,0,8,25.89,58.3
"2011","Sedgemoor 005A","E01029118","Total",1795,862,933,1795,0,21,28.75,62.4
"2011","Sedgemoor 005B","E01029131","Total",2035,1026,1009,2014,21,12,99.27,20.5
"2011","Sedgemoor 005C","E01029132","Total",1473,713,760,1459,14,11,47.15,31.2
"2011","Sedgemoor 005D","E01029133","Total",1292,634,658,1285,7,11,94.71,13.6
"2011","Sedgemoor 005E","E01029134","Total",1868,901,967,1868,0,10,133.55,14.0
"2011","Sedgemoor 006A","E01029135","Total",1627,800,827,1622,5,18,1874.97,0.9
"2011","Sedgemoor 006B","E01029136","Total",1971,988,983,1968,3,23,1750.35,1.1
"2011","Sedgemoor 006C","E01029145","Total",1968,945,1023,1964,4,26,667.61,2.9
"2011","Sedgemoor 006D","E01029152","Total",2115,992,1123,2115,0,13,716.63,3.0
"2011","Sedgemoor 007A","E01029121","Total",1294,619,675,1270,24,18,1930.24,0.7
"2011","Sedgemoor 007B","E01029122","Total",1485,764,721,1397,88,28,2099.58,0.7
"2011","Sedgemoor 007C","E01029123","Total",1116,542,574,1062,54,16,296.93,3.8
"2011","Sedgemoor 007D","E01029124","Total",1725,810,915,1723,2,37,1902.04,0.9
"2011","Sedgemoor 007E","E01029125","Total",1371,685,686,1367,4,35,4475.63,0.3
"2011","Sedgemoor 008A","E01029093","Total",1597,795,802,1597,0,2,20.57,77.6
"2011","Sedgemoor 008B","E01029096","Total",1435,726,709,1435,0,5,111.95,12.8
"2011","Sedgemoor 008C","E01029106","Total",1640,818,822,1579,61,5,49.85,32.9
"2011","Sedgemoor 008D","E01029107","Total",1502,729,773,1502,0,6,21.33,70.4
"2011","Sedgemoor 008E","E01029109","Total",1405,693,712,1405,0,9,45.75,30.7
"2011","Sedgemoor 009A","E01029094","Total",1617,803,814,1617,0,18,73.84,21.9
"2011","Sedgemoor 009B","E01029095","Total",1581,817,764,1539,42,8,33.88,46.7
"2011","Sedgemoor 009C","E01029110","Total",2151,1039,1112,2151,0,2,38.04,56.5
"2011","Sedgemoor 009D","E01029111","Total",2520,1228,1292,2520,0,20,32.35,77.9
"2011","Sedgemoor 009E","E01029112","Total",1876,1001,875,1828,48,11,46.67,40.2
"2011","Sedgemoor 010A","E01029090","Total",1525,749,776,1525,0,6,837.12,1.8
"2011","Sedgemoor 010B","E01029091","Total",1627,784,843,1627,0,11,23.78,68.4
"2011","Sedgemoor 010C","E01029092","Total",1546,757,789,1546,0,18,20.19,76.6
"2011","Sedgemoor 010D","E01029108","Total",2074,1027,1047,2074,0,13,46.01,45.1
"2011","Sedgemoor 011A","E01029102","Total",1504,697,807,1476,28,17,33.30,45.2
"2011","Sedgemoor 011B","E01029103","Total",1573,728,845,1476,97,10,466.85,3.4
"2011","Sedgemoor 011C","E01029104","Total",1523,729,794,1523,0,19,71.72,21.2
"2011","Sedgemoor 011E","E01032631","Total",1351,673,678,1351,0,12,33.47,40.4
"2011","Sedgemoor 011F","E01032632","Total",1265,639,626,1265,0,19,1107.05,1.1
"2011","Sedgemoor 011G","E01032634","Total",1257,642,615,1221,36,26,96.17,13.1
"2011","Sedgemoor 012A","E01029130","Total",2130,1073,1057,2050,80,55,3402.70,0.6
"2011","Sedgemoor 012B","E01029137","Total",1557,779,778,1548,9,31,2519.95,0.6
"2011","Sedgemoor 012C","E01029138","Total",1425,700,725,1425,0,15,251.41,5.7
"2011","Sedgemoor 012D","E01029139","Total",1482,733,749,1482,0,24,2300.15,0.6
"2011","Sedgemoor 012E","E01029150","Total",1291,622,669,1266,25,22,1867.65,0.7
"2011","Sedgemoor 012F","E01029151","Total",1262,615,647,1262,0,32,981.36,1.3
"2011","Sedgemoor 013A","E01029097","Total",1430,689,741,1430,0,9,19.78,72.3
"2011","Sedgemoor 013B","E01029098","Total",1393,721,672,1379,14,14,66.36,21.0
"2011","Sedgemoor 013C","E01029099","Total",1348,654,694,1281,67,5,30.14,44.7
"2011","Sedgemoor 013D","E01029100","Total",1362,683,679,1362,0,6,25.77,52.9
"2011","Sedgemoor 013E","E01029105","Total",1496,724,772,1453,43,24,46.65,32.1
"2011","Sedgemoor 014A","E01029101","Total",1137,535,602,1137,0,11,20.07,56.7
"2011","Sedgemoor 014C","E01029142","Total",1486,739,747,1469,17,18,104.64,14.2
"2011","Sedgemoor 014D","E01029143","Total",1383,645,738,1383,0,16,100.78,13.7
"2011","Sedgemoor 014E","E01029144","Total",1255,629,626,1255,0,26,2024.22,0.6
"2011","Sedgemoor 014F","E01032629","Total",1501,763,738,1498,3,34,2656.25,0.6
"2011","Sedgemoor 014G","E01032630","Total",1596,796,800,1594,2,18,178.37,8.9
"2011","South Somerset 001A","E01029157","Total",1356,697,659,1188,168,44,102.76,13.2
"2011","South Somerset 001B","E01029158","Total",1551,780,771,1325,226,52,1517.99,1.0
"2011","South Somerset 001C","E01029221","Total",2442,1108,1334,2331,111,131,8045.94,0.3
"2011","South Somerset 002A","E01029166","Total",2270,1126,1144,2268,2,80,5208.88,0.4
"2011","South Somerset 002B","E01029167","Total",1620,749,871,1535,85,18,79.06,20.5
"2011","South Somerset 002C","E01029168","Total",1612,761,851,1581,31,26,529.79,3.0
"2011","South Somerset 002D","E01029210","Total",1629,791,838,1581,48,52,1179.28,1.4
"2011","South Somerset 002E","E01029211","Total",1376,673,703,1376,0,31,2355.45,0.6
"2011","South Somerset 003A","E01029224","Total",1604,764,840,1604,0,28,3541.82,0.5
"2011","South Somerset 003B","E01029225","Total",2107,1024,1083,2107,0,38,140.69,15.0
"2011","South Somerset 003C","E01029226","Total",1691,768,923,1643,48,23,117.58,14.4
"2011","South Somerset 004A","E01029200","Total",1430,691,739,1365,65,9,83.68,17.1
"2011","South Somerset 004B","E01029201","Total",1442,691,751,1382,60,25,538.53,2.7
"2011","South Somerset 004C","E01029222","Total",1623,798,825,1621,2,39,3827.68,0.4
"2011","South Somerset 004D","E01029223","Total",1207,581,626,1204,3,29,2093.48,0.6
"2011","South Somerset 005A","E01029155","Total",1785,886,899,1726,59,62,4449.42,0.4
"2011","South Somerset 005B","E01029227","Total",1638,795,843,1565,73,25,342.59,4.8
"2011","South Somerset 005C","E01029228","Total",1642,777,865,1642,0,31,750.74,2.2
"2011","South Somerset 005D","E01029229","Total",1992,987,1005,1992,0,21,55.49,35.9
"2011","South Somerset 006A","E01029164","Total",1525,748,777,1416,109,33,1602.23,1.0
"2011","South Somerset 006B","E01029165","Total",1217,613,604,1197,20,26,1777.91,0.7
"2011","South Somerset 006C","E01029198","Total",1306,647,659,1306,0,50,176.72,7.4
"2011","South Somerset 006D","E01029199","Total",3013,1898,1115,1990,1023,57,3592.26,0.8
"2011","South Somerset 007A","E01029187","Total",1024,498,526,1005,19,14,1109.32,0.9
"2011","South Somerset 007B","E01029188","Total",1503,731,772,1501,2,38,1189.99,1.3
"2011","South Somerset 007C","E01029196","Total",1499,719,780,1499,0,27,2243.02,0.7
"2011","South Somerset 007D","E01029197","Total",1273,610,663,1273,0,22,2541.65,0.5
"2011","South Somerset 008A","E01029154","Total",1814,891,923,1814,0,26,1719.61,1.1
"2011","South Somerset 008B","E01029156","Total",1851,908,943,1834,17,29,1274.95,1.5
"2011","South Somerset 008C","E01029206","Total",1462,694,768,1462,0,27,475.91,3.1
"2011","South Somerset 008D","E01029207","Total",1340,678,662,1340,0,21,859.28,1.6
"2011","South Somerset 009A","E01029202","Total",1180,561,619,1177,3,15,328.11,3.6
"2011","South Somerset 009B","E01029203","Total",1518,764,754,1515,3,30,2122.41,0.7
"2011","South Somerset 009C","E01029204","Total",1244,583,661,1204,40,20,399.47,3.1
"2011","South Somerset 009D","E01029205","Total",1782,876,906,1781,1,17,69.41,25.7
"2011","South Somerset 010A","E01029163","Total",2211,1074,1137,2211,0,53,3129.13,0.7
"2011","South Somerset 010B","E01029216","Total",1448,694,754,1448,0,33,1133.36,1.3
"2011","South Somerset 010C","E01029217","Total",1514,723,791,1514,0,26,1293.50,1.2
"2011","South Somerset 010D","E01029218","Total",1904,891,1013,1871,33,21,106.25,17.9
"2011","South Somerset 011A","E01029238","Total",1542,734,808,1542,0,14,82.20,18.8
"2011","South Somerset 011B","E01029252","Total",1423,697,726,1423,0,30,73.20,19.4
"2011","South Somerset 011C","E01029253","Total",1525,731,794,1525,0,22,58.28,26.2
"2011","South Somerset 011D","E01029254","Total",1385,697,688,1385,0,17,77.80,17.8
"2011","South Somerset 012A","E01029160","Total",2659,1383,1276,2590,69,53,465.28,5.7
"2011","South Somerset 012B","E01029248","Total",1588,751,837,1584,4,17,26.91,59.0
"2011","South Somerset 012C","E01029250","Total",1363,679,684,1300,63,25,66.51,20.5
"2011","South Somerset 012D","E01029251","Total",1307,651,656,1290,17,12,488.35,2.7
"2011","South Somerset 013A","E01029161","Total",1597,804,793,1597,0,21,23.86,66.9
"2011","South Somerset 013B","E01029162","Total",1518,709,809,1438,80,8,42.26,35.9
"2011","South Somerset 013C","E01029247","Total",1627,753,874,1627,0,7,27.16,59.9
"2011","South Somerset 013D","E01029255","Total",1395,701,694,1395,0,17,29.33,47.6
"2011","South Somerset 014A","E01029231","Total",1564,781,783,1553,11,33,35.96,43.5
"2011","South Somerset 014B","E01029233","Total",1388,687,701,1388,0,13,28.90,48.0
"2011","South Somerset 014C","E01029235","Total",1405,709,696,1405,0,9,26.53,53.0
"2011","South Somerset 014D","E01029236","Total",1519,733,786,1519,0,13,24.19,62.8
"2011","South Somerset 014E","E01029237","Total",1481,712,769,1465,16,14,34.34,43.1
"2011","South Somerset 015A","E01029232","Total",1527,756,771,1493,34,30,18.49,82.6
"2011","South Somerset 015B","E01029234","Total",1832,955,877,1743,89,19,69.45,26.4
"2011","South Somerset 015C","E01029239","Total",1483,729,754,1452,31,14,39.62,37.4
"2011","South Somerset 015D","E01029240","Total",1550,794,756,1515,35,16,53.71,28.9
"2011","South Somerset 016A","E01029241","Total",1901,928,973,1885,16,9,33.37,57.0
"2011","South Somerset 016B","E01029245","Total",2249,1091,1158,2206,43,27,114.37,19.7
"2011","South Somerset 016C","E01029246","Total",1520,713,807,1396,124,24,39.31,38.7
"2011","South Somerset 016D","E01029249","Total",1351,623,728,1351,0,14,32.76,41.2
"2011","South Somerset 017A","E01029189","Total",1150,561,589,1150,0,8,71.69,16.0
"2011","South Somerset 017B","E01029190","Total",1271,610,661,1242,29,19,1884.84,0.7
"2011","South Somerset 017C","E01029191","Total",1249,616,633,1249,0,26,547.97,2.3
"2011","South Somerset 017D","E01029192","Total",1462,718,744,1462,0,18,285.61,5.1
"2011","South Somerset 017E","E01029212","Total",1047,500,547,1045,2,18,1235.21,0.8
"2011","South Somerset 017F","E01029213","Total",1289,636,653,1274,15,45,1460.81,0.9
"2011","South Somerset 017G","E01029214","Total",1154,585,569,1154,0,21,1537.03,0.8
"2011","South Somerset 017H","E01029215","Total",1153,578,575,1139,14,15,615.82,1.9
"2011","South Somerset 018A","E01029159","Total",1534,764,770,1534,0,35,79.73,19.2
"2011","South Somerset 018B","E01029242","Total",1488,763,725,1488,0,10,123.48,12.1
"2011","South Somerset 018C","E01029243","Total",1640,754,886,1574,66,27,116.31,14.1
"2011","South Somerset 018D","E01029244","Total",1520,791,729,1507,13,31,45.86,33.1
"2011","South Somerset 019A","E01029193","Total",1952,934,1018,1944,8,25,891.44,2.2
"2011","South Somerset 019B","E01029194","Total",2510,1243,1267,2475,35,26,264.74,9.5
"2011","South Somerset 019C","E01029195","Total",1555,712,843,1525,30,8,205.77,7.6
"2011","South Somerset 019D","E01029208","Total",1130,548,582,1089,41,19,1125.99,1.0
"2011","South Somerset 019E","E01029209","Total",1298,640,658,1298,0,24,1704.28,0.8
"2011","South Somerset 020A","E01029178","Total",1470,728,742,1470,0,27,1146.24,1.3
"2011","South Somerset 020B","E01029179","Total",1115,538,577,1115,0,10,135.79,8.2
"2011","South Somerset 020C","E01029180","Total",1404,687,717,1404,0,32,2709.73,0.5
"2011","South Somerset 020D","E01029181","Total",1321,660,661,1311,10,25,680.43,1.9
"2011","South Somerset 021A","E01029182","Total",1463,709,754,1460,3,18,601.41,2.4
"2011","South Somerset 021B","E01029183","Total",1467,701,766,1467,0,7,39.22,37.4
"2011","South Somerset 021C","E01029184","Total",1773,847,926,1773,0,24,262.33,6.8
"2011","South Somerset 021D","E01029185","Total",1654,799,855,1649,5,13,156.50,10.6
"2011","South Somerset 021E","E01029186","Total",1469,692,777,1433,36,9,40.15,36.6
"2011","South Somerset 022A","E01029169","Total",1529,750,779,1518,11,16,224.11,6.8
"2011","South Somerset 022B","E01029172","Total",1496,717,779,1496,0,17,52.27,28.6
"2011","South Somerset 022C","E01029173","Total",1247,632,615,1247,0,9,49.71,25.1
"2011","South Somerset 022D","E01029176","Total",1276,633,643,1239,37,18,90.70,14.1
"2011","South Somerset 022E","E01029177","Total",1156,557,599,1150,6,5,31.72,36.4
"2011","South Somerset 023A","E01029170","Total",1110,581,529,1091,19,6,19.13,58.0
"2011","South Somerset 023B","E01029171","Total",2070,999,1071,2028,42,22,84.17,24.6
"2011","South Somerset 023C","E01029174","Total",1088,527,561,1067,21,16,36.90,29.5
"2011","South Somerset 023D","E01029175","Total",2102,1063,1039,2097,5,10,42.84,49.1
"2011","South Somerset 024A","E01029153","Total",2334,1147,1187,2329,5,37,5495.50,0.4
"2011","South Somerset 024B","E01029219","Total",1447,721,726,1443,4,18,1446.77,1.0
"2011","South Somerset 024C","E01029220","Total",1213,589,624,1213,0,9,53.28,22.8
"2011","South Somerset 024D","E01029230","Total",2293,1127,1166,2293,0,53,6191.27,0.4
"2011","Taunton Deane 001A","E01029258","Total",1464,712,752,1464,0,24,1462.92,1.0
"2011","Taunton Deane 001B","E01029259","Total",1486,701,785,1426,60,23,858.06,1.7
"2011","Taunton Deane 001C","E01029260","Total",2309,1116,1193,2309,0,39,86.13,26.8
"2011","Taunton Deane 001D","E01029268","Total",1570,747,823,1566,4,37,3751.63,0.4
"2011","Taunton Deane 002A","E01029276","Total",1633,847,786,1273,360,36,114.72,14.2
"2011","Taunton Deane 002B","E01029278","Total",1333,637,696,1299,34,48,1825.34,0.7
"2011","Taunton Deane 002C","E01029290","Total",1415,698,717,1415,0,21,26.74,52.9
"2011","Taunton Deane 002D","E01029306","Total",1570,744,826,1490,80,29,53.25,29.5
"2011","Taunton Deane 002E","E01029319","Total",1517,747,770,1517,0,20,156.18,9.7
"2011","Taunton Deane 003A","E01029267","Total",1702,829,873,1696,6,50,1836.67,0.9
"2011","Taunton Deane 003B","E01029320","Total",1588,757,831,1532,56,21,62.85,25.3
"2011","Taunton Deane 003C","E01029321","Total",2312,1123,1189,2291,21,52,6806.40,0.3
"2011","Taunton Deane 004A","E01029297","Total",1269,605,664,1266,3,12,34.70,36.6
"2011","Taunton Deane 004B","E01029298","Total",1498,716,782,1498,0,12,32.58,46.0
"2011","Taunton Deane 004C","E01029304","Total",1529,699,830,1516,13,14,30.53,50.1
"2011","Taunton Deane 004D","E01029305","Total",1389,668,721,1389,0,3,34.14,40.7
"2011","Taunton Deane 004E","E01029307","Total",1456,682,774,1456,0,5,22.05,66.0
"2011","Taunton Deane 005A","E01029271","Total",1776,868,908,1756,20,39,2759.33,0.6
"2011","Taunton Deane 005B","E01029273","Total",1243,582,661,1243,0,3,164.13,7.6
"2011","Taunton Deane 005C","E01029274","Total",1497,737,760,1492,5,29,867.43,1.7
"2011","Taunton Deane 005D","E01029275","Total",1268,593,675,1228,40,11,657.88,1.9
"2011","Taunton Deane 005E","E01029279","Total",1450,711,739,1445,5,25,2100.17,0.7
"2011","Taunton Deane 006A","E01029282","Total",1385,660,725,1385,0,9,37.44,37.0
"2011","Taunton Deane 006B","E01029291","Total",1580,757,823,1559,21,15,45.81,34.5
"2011","Taunton Deane 006C","E01029294","Total",1792,862,930,1766,26,30,48.24,37.1
"2011","Taunton Deane 006D","E01029317","Total",1263,612,651,1263,0,22,206.89,6.1
"2011","Taunton Deane 006E","E01029318","Total",1524,722,802,1479,45,45,921.36,1.7
"2011","Taunton Deane 007A","E01029285","Total",2348,1180,1168,2339,9,23,45.27,51.9
"2011","Taunton Deane 007B","E01029287","Total",1508,734,774,1503,5,15,15.25,98.9
"2011","Taunton Deane 007C","E01029288","Total",1535,721,814,1493,42,23,47.23,32.5
"2011","Taunton Deane 007D","E01029289","Total",1863,885,978,1845,18,28,38.37,48.6
"2011","Taunton Deane 007E","E01029299","Total",1501,736,765,1443,58,16,39.37,38.1
"2011","Taunton Deane 007F","E01029300","Total",1550,759,791,1550,0,19,44.94,34.5
"2011","Taunton Deane 008A","E01029256","Total",1446,672,774,1373,73,22,390.97,3.7
"2011","Taunton Deane 008B","E01029257","Total",2174,1004,1170,2065,109,31,133.36,16.3
"2011","Taunton Deane 008D","E01029277","Total",1038,485,553,1038,0,11,64.32,16.1
"2011","Taunton Deane 008E","E01032651","Total",1886,1218,668,1264,622,31,562.93,3.4
"2011","Taunton Deane 008F","E01032652","Total",1160,564,596,1160,0,14,106.97,10.8
"2011","Taunton Deane 009A","E01029280","Total",1613,776,837,1613,0,16,26.72,60.4
"2011","Taunton Deane 009B","E01029281","Total",1683,781,902,1636,47,18,38.68,43.5
"2011","Taunton Deane 009C","E01029283","Total",1776,845,931,1776,0,13,47.79,37.2
"2011","Taunton Deane 009D","E01029292","Total",1435,684,751,1391,44,3,46.67,30.7
"2011","Taunton Deane 009E","E01029293","Total",1657,747,910,1648,9,12,31.41,52.8
"2011","Taunton Deane 010A","E01029266","Total",1375,665,710,1167,208,17,47.30,29.1
"2011","Taunton Deane 010B","E01029284","Total",1714,870,844,1473,241,14,47.93,35.8
"2011","Taunton Deane 010C","E01029286","Total",1662,864,798,1550,112,18,23.99,69.3
"2011","Taunton Deane 010D","E01029301","Total",1919,894,1025,1874,45,37,83.79,22.9
"2011","Taunton Deane 010E","E01029303","Total",1891,868,1023,1834,57,48,101.20,18.7
"2011","Taunton Deane 011A","E01029263","Total",1404,672,732,1404,0,26,22.73,61.8
"2011","Taunton Deane 011B","E01029264","Total",1294,609,685,1294,0,23,29.94,43.2
"2011","Taunton Deane 011C","E01029265","Total",1390,670,720,1390,0,27,39.14,35.5
"2011","Taunton Deane 011D","E01029302","Total",1695,797,898,1641,54,33,90.39,18.8
"2011","Taunton Deane 011E","E01029308","Total",2072,996,1076,1988,84,67,1033.41,2.0
"2011","Taunton Deane 012A","E01029309","Total",1996,964,1032,1996,0,29,87.03,22.9
"2011","Taunton Deane 012B","E01029311","Total",1484,704,780,1406,78,8,88.77,16.7
"2011","Taunton Deane 012C","E01029312","Total",1420,690,730,1420,0,18,67.73,21.0
"2011","Taunton Deane 012D","E01029313","Total",1355,678,677,1346,9,21,131.36,10.3
"2011","Taunton Deane 012E","E01029316","Total",1637,762,875,1562,75,29,59.17,27.7
"2011","Taunton Deane 013A","E01029262","Total",2337,1165,1172,2309,28,50,3273.95,0.7
"2011","Taunton Deane 013B","E01029269","Total",2184,1054,1130,2019,165,49,3580.44,0.6
"2011","Taunton Deane 013C","E01029310","Total",1869,915,954,1761,108,30,113.26,16.5
"2011","Taunton Deane 013D","E01029314","Total",2609,1271,1338,2575,34,20,274.26,9.5
"2011","Taunton Deane 013E","E01029315","Total",1452,663,789,1452,0,28,43.34,33.5
"2011","Taunton Deane 014A","E01029261","Total",2064,1024,1040,2063,1,65,5216.57,0.4
"2011","Taunton Deane 014B","E01029270","Total",2164,1044,1120,2104,60,48,4912.01,0.4
"2011","Taunton Deane 014C","E01029295","Total",1628,783,845,1628,0,28,45.88,35.5
"2011","Taunton Deane 014D","E01029296","Total",1581,735,846,1440,141,42,138.88,11.4
"2011","West Somerset 001B","E01029324","Total",1603,772,831,1603,0,13,37.35,42.9
"2011","West Somerset 001C","E01029329","Total",1780,807,973,1551,229,14,50.44,35.3
"2011","West Somerset 001D","E01029330","Total",2022,951,1071,1875,147,14,178.83,11.3
"2011","West Somerset 001F","E01032636","Total",1922,883,1039,1898,24,19,61.69,31.2
"2011","West Somerset 002A","E01029322","Total",2019,1025,994,1326,693,14,439.00,4.6
"2011","West Somerset 002B","E01029331","Total",1458,652,806,1410,48,12,137.82,10.6
"2011","West Somerset 002C","E01029333","Total",1177,545,632,1171,6,9,230.69,5.1
"2011","West Somerset 002D","E01029336","Total",2074,982,1092,2026,48,28,9268.08,0.2
"2011","West Somerset 003A","E01029326","Total",1158,547,611,1158,0,15,2472.34,0.5
"2011","West Somerset 003B","E01029334","Total",1111,512,599,1111,0,13,835.19,1.3
"2011","West Somerset 003C","E01029339","Total",1498,723,775,1498,0,13,36.41,41.1
"2011","West Somerset 003E","E01029341","Total",1291,636,655,1291,0,13,140.63,9.2
"2011","West Somerset 003G","E01032635","Total",2160,1046,1114,2096,64,24,504.02,4.3
"2011","West Somerset 004A","E01029327","Total",2029,1016,1013,2022,7,57,10270.52,0.2
"2011","West Somerset 004B","E01029335","Total",1085,526,559,1085,0,26,5039.12,0.2
"2011","West Somerset 004C","E01029337","Total",2121,1042,1079,2116,5,27,5161.97,0.4
"2011","West Somerset 004D","E01029342","Total",1088,539,549,1080,8,37,2720.61,0.4
"2011","West Somerset 004E","E01029343","Total",1533,734,799,1502,31,20,787.69,1.9
"2011","West Somerset 005A","E01029325","Total",1844,847,997,1811,33,26,6108.86,0.3
"2011","West Somerset 005B","E01029328","Total",1927,917,1010,1917,10,22,4686.42,0.4
"2011","West Somerset 005C","E01029338","Total",1775,873,902,1735,40,31,23366.83,0.1
"2011","Isle of Anglesey 001A","W01000003","Total",2507,1235,1272,2478,29,26,267.57,9.4
"2011","Isle of Anglesey 001B","W01000004","Total",1282,623,659,1282,0,14,1550.97,0.8
"2011","Isle of Anglesey 001C","W01000018","Total",1357,672,685,1357,0,7,1372.64,1.0
"2011","Isle of Anglesey 001D","W01000028","Total",1941,983,958,1937,4,14,6393.98,0.3
"2011","Isle of Anglesey 001E","W01000031","Total",1545,775,770,1543,2,18,3793.81,0.4
"2011","Isle of Anglesey 002A","W01000010","Total",1869,893,976,1866,3,36,527.38,3.5
"2011","Isle of Anglesey 002B","W01000020","Total",1315,647,668,1313,2,32,5463.44,0.2
"2011","Isle of Anglesey 002C","W01000021","Total",2264,1159,1105,2237,27,26,4607.68,0.5
"2011","Isle of Anglesey 002D","W01000032","Total",1064,506,558,1064,0,14,1390.45,0.8
"2011","Isle of Anglesey 003A","W01000016","Total",1203,627,576,1203,0,2,25.54,47.1
"2011","Isle of Anglesey 003B","W01000017","Total",1525,754,771,1525,0,8,118.70,12.8
"2011","Isle of Anglesey 003C","W01000029","Total",1493,717,776,1493,0,12,49.47,30.2
"2011","Isle of Anglesey 003D","W01000030","Total",2286,1097,1189,2258,28,21,136.45,16.8
"2011","Isle of Anglesey 003E","W01000033","Total",1504,756,748,1490,14,10,67.33,22.3
"2011","Isle of Anglesey 003F","W01000036","Total",1088,541,547,1088,0,6,28.05,38.8
"2011","Isle of Anglesey 003G","W01000037","Total",1178,627,551,1150,28,12,32.93,35.8
"2011","Isle of Anglesey 004A","W01000022","Total",1648,835,813,1648,0,20,3555.29,0.5
"2011","Isle of Anglesey 004B","W01000034","Total",1154,566,588,1154,0,8,210.05,5.5
"2011","Isle of Anglesey 004C","W01000039","Total",1060,528,532,1034,26,10,1238.44,0.9
"2011","Isle of Anglesey 004D","W01000040","Total",1168,543,625,1130,38,12,1584.10,0.7
"2011","Isle of Anglesey 004E","W01000043","Total",1217,577,640,1205,12,6,261.82,4.6
"2011","Isle of Anglesey 004F","W01000044","Total",1144,579,565,1144,0,11,609.64,1.9
"2011","Isle of Anglesey 005A","W01000005","Total",1938,933,1005,1936,2,40,855.72,2.3
"2011","Isle of Anglesey 005B","W01000013","Total",2254,1082,1172,2230,24,51,2312.59,1.0
"2011","Isle of Anglesey 005C","W01000019","Total",1513,742,771,1454,59,17,985.19,1.5
"2011","Isle of Anglesey 005D","W01000026","Total",1229,579,650,1192,37,16,925.71,1.3
"2011","Isle of Anglesey 005E","W01000035","Total",1869,914,955,1854,15,32,3086.00,0.6
"2011","Isle of Anglesey 006A","W01000006","Total",1534,776,758,1534,0,28,3507.40,0.4
"2011","Isle of Anglesey 006B","W01000012","Total",1484,684,800,1484,0,17,373.66,4.0
"2011","Isle of Anglesey 006C","W01000014","Total",2049,987,1062,2040,9,32,526.20,3.9
"2011","Isle of Anglesey 006D","W01000041","Total",1583,767,816,1561,22,9,210.66,7.5
"2011","Isle of Anglesey 007A","W01000001","Total",1115,546,569,1099,16,24,3080.73,0.4
"2011","Isle of Anglesey 007B","W01000002","Total",1263,625,638,1263,0,10,1084.73,1.2
"2011","Isle of Anglesey 007C","W01000009","Total",1903,924,979,1871,32,13,2367.44,0.8
"2011","Isle of Anglesey 007D","W01000023","Total",1406,697,709,1405,1,16,2161.87,0.7
"2011","Isle of Anglesey 007E","W01000024","Total",1519,814,705,1373,146,3,1376.28,1.1
"2011","Isle of Anglesey 008A","W01000008","Total",1519,718,801,1461,58,22,188.76,8.0
"2011","Isle of Anglesey 008B","W01000011","Total",1230,595,635,1221,9,20,98.70,12.5
"2011","Isle of Anglesey 008C","W01000015","Total",1588,769,819,1518,70,36,177.77,8.9
"2011","Isle of Anglesey 008D","W01000042","Total",2146,1056,1090,2140,6,28,251.50,8.5
"2011","Isle of Anglesey 009A","W01000007","Total",1704,823,881,1666,38,27,4088.48,0.4
"2011","Isle of Anglesey 009B","W01000025","Total",2016,1011,1005,2016,0,33,3384.33,0.6
"2011","Isle of Anglesey 009C","W01000027","Total",1851,920,931,1798,53,25,2747.58,0.7
"2011","Isle of Anglesey 009D","W01000038","Total",2226,1072,1154,2226,0,24,4047.08,0.6
"2011","Gwynedd 001A","W01000062","Total",1839,946,893,1492,347,26,53.10,34.6
"2011","Gwynedd 001B","W01000076","Total",1316,677,639,1044,272,20,54.23,24.3
"2011","Gwynedd 001C","W01000077","Total",1387,677,710,1387,0,10,28.61,48.5
"2011","Gwynedd 001D","W01000091","Total",1140,572,568,1140,0,4,41.32,27.6
"2011","Gwynedd 001E","W01000092","Total",4128,2021,2107,2147,1981,95,100.01,41.3
"2011","Gwynedd 002A","W01000064","Total",1849,916,933,1849,0,20,109.77,16.8
"2011","Gwynedd 002B","W01000072","Total",1777,837,940,1777,0,40,97.93,18.1
"2011","Gwynedd 002C","W01000075","Total",1496,741,755,1490,6,18,99.73,15.0
"2011","Gwynedd 002D","W01000090","Total",1426,651,775,1399,27,9,63.87,22.3
"2011","Gwynedd 002E","W01000102","Total",1217,610,607,1150,67,25,290.60,4.2
"2011","Gwynedd 003A","W01000050","Total",1398,696,702,1386,12,28,8168.24,0.2
"2011","Gwynedd 003B","W01000071","Total",2380,1192,1188,2380,0,33,263.18,9.0
"2011","Gwynedd 003C","W01000096","Total",1245,603,642,1222,23,15,34.41,36.2
"2011","Gwynedd 003D","W01000097","Total",1110,535,575,1110,0,8,91.72,12.1
"2011","Gwynedd 003E","W01000115","Total",2218,1088,1130,2214,4,24,2792.33,0.8
"2011","Gwynedd 004A","W01000052","Total",1171,574,597,1171,0,23,191.48,6.1
"2011","Gwynedd 004B","W01000053","Total",1219,622,597,1215,4,14,2149.88,0.6
"2011","Gwynedd 004C","W01000087","Total",1916,925,991,1901,15,19,187.88,10.2
"2011","Gwynedd 004D","W01000119","Total",2284,1145,1139,2212,72,33,589.92,3.9
"2011","Gwynedd 005A","W01000063","Total",1909,931,978,1899,10,14,1765.90,1.1
"2011","Gwynedd 005B","W01000081","Total",2026,998,1028,1965,61,35,4561.86,0.4
"2011","Gwynedd 005C","W01000099","Total",1768,885,883,1768,0,26,1378.93,1.3
"2011","Gwynedd 005D","W01000103","Total",1233,597,636,1233,0,16,1595.91,0.8
"2011","Gwynedd 006A","W01000059","Total",2060,1025,1035,2036,24,12,212.76,9.7
"2011","Gwynedd 006B","W01000093","Total",2196,1047,1149,2135,61,55,253.08,8.7
"2011","Gwynedd 006C","W01000098","Total",2321,1129,1192,2316,5,24,100.95,23.0
"2011","Gwynedd 006D","W01000110","Total",1506,711,795,1506,0,17,51.68,29.1
"2011","Gwynedd 007A","W01000054","Total",1162,571,591,1117,45,16,1005.12,1.2
"2011","Gwynedd 007B","W01000088","Total",1994,976,1018,1992,2,32,1573.12,1.3
"2011","Gwynedd 007C","W01000111","Total",1532,759,773,1530,2,21,318.23,4.8
"2011","Gwynedd 007D","W01000118","Total",1676,823,853,1671,5,19,5322.33,0.3
"2011","Gwynedd 008A","W01000073","Total",1695,840,855,1680,15,61,2061.42,0.8
"2011","Gwynedd 008B","W01000086","Total",2253,1105,1148,2249,4,28,7873.40,0.3
"2011","Gwynedd 008C","W01000104","Total",1793,839,954,1770,23,26,729.47,2.5
"2011","Gwynedd 008D","W01000112","Total",1930,951,979,1930,0,14,1154.88,1.7
"2011","Gwynedd 009A","W01000056","Total",1878,956,922,1875,3,13,2603.20,0.7
"2011","Gwynedd 009B","W01000065","Total",1126,542,584,1122,4,11,260.94,4.3
"2011","Gwynedd 009C","W01000113","Total",1871,899,972,1851,20,20,2835.00,0.7
"2011","Gwynedd 009D","W01000114","Total",1604,795,809,1594,10,26,15871.18,0.1
"2011","Gwynedd 010A","W01000066","Total",1219,611,608,1204,15,6,8608.85,0.1
"2011","Gwynedd 010B","W01000100","Total",1054,521,533,1046,8,24,3483.46,0.3
"2011","Gwynedd 010C","W01000105","Total",1775,888,887,1740,35,20,452.91,3.9
"2011","Gwynedd 010D","W01000106","Total",1732,844,888,1670,62,32,865.78,2.0
"2011","Gwynedd 010E","W01000107","Total",1257,598,659,1228,29,26,9923.96,0.1
"2011","Gwynedd 011A","W01000047","Total",1354,647,707,1354,0,20,2488.67,0.5
"2011","Gwynedd 011B","W01000061","Total",1753,823,930,1696,57,29,672.37,2.6
"2011","Gwynedd 011C","W01000078","Total",1683,840,843,1683,0,21,4810.29,0.3
"2011","Gwynedd 011D","W01000089","Total",2080,1013,1067,2080,0,31,6008.18,0.3
"2011","Gwynedd 012A","W01000070","Total",1275,652,623,1275,0,24,5570.70,0.2
"2011","Gwynedd 012B","W01000094","Total",1229,602,627,1213,16,19,1012.18,1.2
"2011","Gwynedd 012C","W01000095","Total",1373,670,703,1372,1,11,511.20,2.7
"2011","Gwynedd 012D","W01000108","Total",2190,1060,1130,2185,5,34,385.31,5.7
"2011","Gwynedd 012E","W01000109","Total",1886,964,922,1851,35,29,160.23,11.8
"2011","Gwynedd 013A","W01000069","Total",1540,742,798,1515,25,16,4555.37,0.3
"2011","Gwynedd 013B","W01000074","Total",1997,991,1006,1929,68,20,5847.52,0.3
"2011","Gwynedd 013C","W01000079","Total",1098,541,557,1079,19,16,6832.44,0.2
"2011","Gwynedd 013D","W01000101","Total",1533,756,777,1518,15,20,649.33,2.4
"2011","Gwynedd 014C","W01000080","Total",1785,875,910,1761,24,48,1510.99,1.2
"2011","Gwynedd 014D","W01000084","Total",1206,604,602,1206,0,18,2779.86,0.4
"2011","Gwynedd 014E","W01001932","Total",2931,1478,1453,2931,0,47,11750.55,0.2
"2011","Gwynedd 015A","W01000051","Total",1974,952,1022,1966,8,27,241.94,8.2
"2011","Gwynedd 015B","W01000060","Total",1345,675,670,1337,8,21,16489.94,0.1
"2011","Gwynedd 015C","W01000082","Total",1095,554,541,1070,25,14,11410.42,0.1
"2011","Gwynedd 015D","W01000083","Total",1293,668,625,1286,7,26,27611.17,0.0
"2011","Gwynedd 016A","W01000048","Total",1380,650,730,1348,32,18,1500.68,0.9
"2011","Gwynedd 016B","W01000049","Total",1142,587,555,1122,20,8,99.66,11.5
"2011","Gwynedd 016C","W01000057","Total",1444,751,693,1426,18,23,19594.34,0.1
"2011","Gwynedd 016D","W01000067","Total",1204,606,598,1148,56,19,3262.25,0.4
"2011","Gwynedd 016E","W01000068","Total",1484,684,800,1440,44,31,238.72,6.2
"2011","Gwynedd 017C","W01000085","Total",2007,1030,977,1981,26,42,8283.11,0.2
"2011","Gwynedd 017D","W01000116","Total",1685,777,908,1639,46,22,2493.64,0.7
"2011","Gwynedd 017E","W01000117","Total",1579,732,847,1523,56,18,293.83,5.4
"2011","Gwynedd 017F","W01001933","Total",2243,1113,1130,2227,16,41,16156.52,0.1
"2011","Conwy 001A","W01000132","Total",1537,729,808,1397,140,17,33.91,45.3
"2011","Conwy 001B","W01000146","Total",2254,1145,1109,1945,309,19,121.93,18.5
"2011","Conwy 001C","W01000147","Total",1493,693,800,1436,57,16,411.16,3.6
"2011","Conwy 001D","W01000169","Total",1855,925,930,1713,142,21,47.47,39.1
"2011","Conwy 001E","W01000186","Total",1711,805,906,1656,55,7,57.23,29.9
"2011","Conwy 002A","W01000133","Total",1887,870,1017,1809,78,21,253.57,7.4
"2011","Conwy 002B","W01000168","Total",1784,825,959,1775,9,33,77.37,23.1
"2011","Conwy 002C","W01000187","Total",1561,715,846,1561,0,6,94.61,16.5
"2011","Conwy 002D","W01000188","Total",1736,823,913,1736,0,16,62.74,27.7
"2011","Conwy 003A","W01000154","Total",1475,662,813,1331,144,14,106.32,13.9
"2011","Conwy 003B","W01000173","Total",1549,807,742,1425,124,40,588.45,2.6
"2011","Conwy 003C","W01000174","Total",1702,806,896,1694,8,21,38.75,43.9
"2011","Conwy 003D","W01000175","Total",1632,765,867,1632,0,16,149.17,10.9
"2011","Conwy 004A","W01000155","Total",1549,678,871,1390,159,23,45.77,33.8
"2011","Conwy 004B","W01000156","Total",1517,686,831,1496,21,33,38.37,39.5
"2011","Conwy 004C","W01000157","Total",1465,692,773,1465,0,19,38.14,38.4
"2011","Conwy 004D","W01000158","Total",1587,725,862,1571,16,16,83.63,19.0
"2011","Conwy 005A","W01000149","Total",1490,720,770,1474,16,14,81.01,18.4
"2011","Conwy 005B","W01000150","Total",1509,756,753,1509,0,16,238.68,6.3
"2011","Conwy 005C","W01000151","Total",1589,765,824,1589,0,13,91.73,17.3
"2011","Conwy 005D","W01000152","Total",1492,697,795,1446,46,8,58.85,25.4
"2011","Conwy 005E","W01000184","Total",2380,1120,1260,2322,58,16,566.80,4.2
"2011","Conwy 006A","W01000135","Total",2081,952,1129,2042,39,28,171.27,12.2
"2011","Conwy 006B","W01000136","Total",1855,923,932,1810,45,32,98.13,18.9
"2011","Conwy 006C","W01000165","Total",1930,959,971,1927,3,41,79.27,24.3
"2011","Conwy 006D","W01000166","Total",1949,896,1053,1911,38,14,161.69,12.1
"2011","Conwy 007A","W01000139","Total",1721,864,857,1680,41,34,49.86,34.5
"2011","Conwy 007B","W01000143","Total",1543,785,758,1543,0,20,15.74,98.0
"2011","Conwy 007C","W01000144","Total",1516,805,711,1482,34,16,74.88,20.2
"2011","Conwy 007D","W01000182","Total",1918,925,993,1724,194,27,51.23,37.4
"2011","Conwy 008A","W01000138","Total",1826,868,958,1826,0,22,169.55,10.8
"2011","Conwy 008B","W01000145","Total",1281,603,678,1256,25,24,197.01,6.5
"2011","Conwy 008C","W01000180","Total",1682,842,840,1598,84,57,308.22,5.5
"2011","Conwy 008D","W01000181","Total",1556,766,790,1556,0,30,55.02,28.3
"2011","Conwy 008E","W01000183","Total",1485,751,734,1263,222,40,77.47,19.2
"2011","Conwy 009A","W01000126","Total",1716,879,837,1695,21,29,84.27,20.4
"2011","Conwy 009B","W01000127","Total",1367,667,700,1354,13,12,53.00,25.8
"2011","Conwy 009C","W01000128","Total",1483,709,774,1463,20,26,37.07,40.0
"2011","Conwy 009D","W01000153","Total",1542,766,776,1537,5,20,509.80,3.0
"2011","Conwy 009E","W01000163","Total",1337,640,697,1337,0,13,308.28,4.3
"2011","Conwy 009F","W01000164","Total",1406,676,730,1406,0,17,258.54,5.4
"2011","Conwy 010B","W01000140","Total",1466,706,760,1464,2,20,951.92,1.5
"2011","Conwy 010C","W01000141","Total",1542,703,839,1534,8,17,47.41,32.5
"2011","Conwy 010D","W01000142","Total",1603,772,831,1583,20,17,274.63,5.8
"2011","Conwy 010E","W01000178","Total",1901,882,1019,1847,54,17,63.47,30.0
"2011","Conwy 010F","W01000179","Total",1604,741,863,1584,20,13,102.28,15.7
"2011","Conwy 010G","W01001927","Total",1331,626,705,1317,14,6,184.44,7.2
"2011","Conwy 010H","W01001928","Total",1130,594,536,1115,15,5,50.19,22.5
"2011","Conwy 011C","W01000167","Total",1923,943,980,1921,2,17,280.88,6.8
"2011","Conwy 011D","W01000176","Total",1606,786,820,1606,0,9,72.81,22.1
"2011","Conwy 011E","W01000177","Total",1237,596,641,1237,0,16,216.36,5.7
"2011","Conwy 011F","W01001926","Total",2196,1059,1137,2191,5,33,1747.78,1.3
"2011","Conwy 012A","W01000124","Total",2007,970,1037,2001,6,27,7581.94,0.3
"2011","Conwy 012B","W01000129","Total",1064,509,555,1056,8,19,346.75,3.1
"2011","Conwy 012C","W01000130","Total",1537,764,773,1527,10,27,88.68,17.3
"2011","Conwy 012D","W01000131","Total",1464,696,768,1458,6,18,170.76,8.6
"2011","Conwy 013A","W01000123","Total",1815,913,902,1702,113,19,972.05,1.9
"2011","Conwy 013B","W01000125","Total",1485,719,766,1481,4,11,507.78,2.9
"2011","Conwy 013C","W01000170","Total",1822,890,932,1811,11,15,819.99,2.2
"2011","Conwy 013D","W01000171","Total",1582,768,814,1546,36,20,779.27,2.0
"2011","Conwy 013E","W01000172","Total",1286,610,676,1283,3,12,239.76,5.4
"2011","Conwy 014A","W01000122","Total",2122,1047,1075,2093,29,54,9126.65,0.2
"2011","Conwy 014B","W01000159","Total",1435,721,714,1391,44,38,12385.79,0.1
"2011","Conwy 014C","W01000162","Total",1925,1015,910,1925,0,46,12614.88,0.2
"2011","Conwy 014D","W01000190","Total",1399,684,715,1386,13,22,12591.52,0.1
"2011","Conwy 015A","W01000121","Total",1244,637,607,1202,42,14,15562.31,0.1
"2011","Conwy 015B","W01000134","Total",2118,1000,1118,2065,53,17,398.17,5.3
"2011","Conwy 015C","W01000137","Total",1537,767,770,1532,5,26,5354.59,0.3
"2011","Conwy 015D","W01000148","Total",1205,563,642,1203,2,5,126.25,9.5
"2011","Conwy 015E","W01000185","Total",1229,619,610,1228,1,21,5169.14,0.2
"2011","Conwy 015F","W01000189","Total",1465,764,701,1460,5,32,17708.47,0.1
"2011","Denbighshire 001A","W01000218","Total",1546,737,809,1536,10,18,47.59,32.5
"2011","Denbighshire 001B","W01000219","Total",2566,1237,1329,2566,0,18,61.90,41.5
"2011","Denbighshire 001C","W01000220","Total",1604,772,832,1604,0,10,76.78,20.9
"2011","Denbighshire 002A","W01000213","Total",1343,628,715,1343,0,11,62.32,21.6
"2011","Denbighshire 002B","W01000214","Total",1171,563,608,1170,1,9,226.97,5.2
"2011","Denbighshire 002C","W01000215","Total",1435,688,747,1423,12,28,51.64,27.8
"2011","Denbighshire 002D","W01000216","Total",1409,677,732,1381,28,16,294.71,4.8
"2011","Denbighshire 003A","W01000212","Total",2189,1052,1137,2164,25,29,88.01,24.9
"2011","Denbighshire 003B","W01000221","Total",1348,647,701,1348,0,3,28.13,47.9
"2011","Denbighshire 003C","W01000222","Total",1660,771,889,1660,0,16,94.83,17.5
"2011","Denbighshire 004A","W01000226","Total",1515,753,762,1515,0,9,85.14,17.8
"2011","Denbighshire 004B","W01000227","Total",1556,741,815,1556,0,8,34.09,45.6
"2011","Denbighshire 004C","W01000228","Total",1146,576,570,1116,30,14,50.92,22.5
"2011","Denbighshire 004D","W01000239","Total",1781,952,829,1780,1,11,29.65,60.1
"2011","Denbighshire 004E","W01000240","Total",1316,755,561,1274,42,4,33.07,39.8
"2011","Denbighshire 004F","W01000241","Total",1289,630,659,1289,0,6,45.28,28.5
"2011","Denbighshire 006A","W01000236","Total",1875,897,978,1875,0,10,50.95,36.8
"2011","Denbighshire 006B","W01000237","Total",1806,868,938,1806,0,8,92.12,19.6
"2011","Denbighshire 006C","W01000238","Total",1702,826,876,1702,0,23,40.44,42.1
"2011","Denbighshire 008A","W01000200","Total",1283,628,655,1275,8,28,227.69,5.6
"2011","Denbighshire 008B","W01000201","Total",1498,723,775,1495,3,23,536.45,2.8
"2011","Denbighshire 008C","W01000217","Total",2066,1010,1056,2057,9,18,159.39,13.0
"2011","Denbighshire 008D","W01000248","Total",1649,819,830,1622,27,22,4493.98,0.4
"2011","Denbighshire 009A","W01000191","Total",2147,1051,1096,2129,18,20,1666.96,1.3
"2011","Denbighshire 009B","W01000223","Total",1325,633,692,1323,2,22,1059.08,1.3
"2011","Denbighshire 009C","W01000224","Total",1402,672,730,1402,0,17,133.61,10.5
"2011","Denbighshire 009D","W01000225","Total",1528,738,790,1528,0,14,176.11,8.7
"2011","Denbighshire 010A","W01000245","Total",1674,826,848,1640,34,36,367.49,4.6
"2011","Denbighshire 010B","W01000246","Total",1681,795,886,1623,58,21,277.96,6.0
"2011","Denbighshire 010C","W01000247","Total",1970,953,1017,1848,122,30,2552.10,0.8
"2011","Denbighshire 011A","W01000194","Total",2122,1050,1072,1973,149,34,106.80,19.9
"2011","Denbighshire 011B","W01000198","Total",1475,760,715,1472,3,9,20.65,71.4
"2011","Denbighshire 011C","W01000199","Total",1690,854,836,1677,13,24,1732.44,1.0
"2011","Denbighshire 012A","W01000195","Total",1379,655,724,1378,1,21,92.96,14.8
"2011","Denbighshire 012B","W01000196","Total",1506,744,762,1458,48,26,184.75,8.2
"2011","Denbighshire 012C","W01000197","Total",1676,832,844,1653,23,32,1463.73,1.1
"2011","Denbighshire 012D","W01000211","Total",1856,930,926,1832,24,43,10922.94,0.2
"2011","Denbighshire 013A","W01000203","Total",2456,1242,1214,2354,102,33,8542.41,0.3
"2011","Denbighshire 013B","W01000204","Total",1421,720,701,1391,30,52,2837.18,0.5
"2011","Denbighshire 013C","W01000206","Total",2156,1074,1082,2084,72,59,4603.79,0.5
"2011","Denbighshire 014A","W01000242","Total",1906,924,982,1875,31,22,253.89,7.5
"2011","Denbighshire 014B","W01000243","Total",1823,892,931,1675,148,30,310.98,5.9
"2011","Denbighshire 014C","W01000244","Total",1732,845,887,1732,0,37,252.44,6.9
"2011","Denbighshire 015A","W01000193","Total",1314,677,637,1310,4,21,1511.49,0.9
"2011","Denbighshire 015B","W01000202","Total",1686,826,860,1686,0,29,7365.86,0.2
"2011","Denbighshire 015C","W01000207","Total",2227,1124,1103,2223,4,55,9355.48,0.2
"2011","Denbighshire 016A","W01000192","Total",1011,513,498,980,31,14,5439.94,0.2
"2011","Denbighshire 016B","W01000205","Total",1122,582,540,1114,8,21,9243.67,0.1
"2011","Denbighshire 016C","W01000208","Total",1229,650,579,1160,69,13,4368.72,0.3
"2011","Denbighshire 016D","W01000209","Total",1496,731,765,1494,2,10,319.71,4.7
"2011","Denbighshire 016E","W01000210","Total",1354,639,715,1295,59,22,1327.41,1.0
"2011","Denbighshire 017E","W01000229","Total",1606,767,839,1606,0,6,39.90,40.3
"2011","Denbighshire 017F","W01000230","Total",1963,946,1017,1963,0,21,42.71,46.0
"2011","Denbighshire 017A","W01000231","Total",1432,676,756,1432,0,10,35.03,40.9
"2011","Denbighshire 017B","W01000232","Total",1605,777,828,1605,0,15,36.32,44.2
"2011","Denbighshire 017C","W01000233","Total",1276,616,660,1276,0,17,25.54,50.0
"2011","Denbighshire 017G","W01000234","Total",1405,665,740,1405,0,16,64.34,21.8
"2011","Denbighshire 017D","W01000235","Total",1330,658,672,1330,0,17,27.83,47.8
"2011","Flintshire 001A","W01000287","Total",1808,885,923,1794,14,11,899.00,2.0
"2011","Flintshire 001B","W01000298","Total",1527,762,765,1527,0,13,524.46,2.9
"2011","Flintshire 001C","W01000338","Total",1838,888,950,1838,0,26,1794.92,1.0
"2011","Flintshire 002A","W01000306","Total",2399,1211,1188,2357,42,32,264.42,9.1
"2011","Flintshire 002B","W01000320","Total",1844,902,942,1827,17,10,1178.46,1.6
"2011","Flintshire 002C","W01000340","Total",2322,1186,1136,2310,12,33,2141.92,1.1
"2011","Flintshire 003A","W01000253","Total",1941,964,977,1941,0,18,343.35,5.7
"2011","Flintshire 003B","W01000254","Total",2224,1094,1130,2211,13,21,615.79,3.6
"2011","Flintshire 003C","W01000296","Total",1506,748,758,1490,16,10,428.10,3.5
"2011","Flintshire 003D","W01000297","Total",1235,592,643,1235,0,15,33.11,37.3
"2011","Flintshire 003E","W01000304","Total",1988,966,1022,1963,25,11,94.12,21.1
"2011","Flintshire 003F","W01000305","Total",1758,874,884,1758,0,8,136.09,12.9
"2011","Flintshire 004A","W01000288","Total",2264,1073,1191,2264,0,18,89.06,25.4
"2011","Flintshire 004B","W01000290","Total",1269,622,647,1259,10,6,66.85,19.0
"2011","Flintshire 004C","W01000292","Total",1483,706,777,1470,13,5,20.63,71.9
"2011","Flintshire 004D","W01000293","Total",1568,825,743,1568,0,14,813.69,1.9
"2011","Flintshire 005A","W01000289","Total",1358,683,675,1358,0,36,363.14,3.7
"2011","Flintshire 005B","W01000291","Total",1401,665,736,1401,0,8,120.81,11.6
"2011","Flintshire 005C","W01000294","Total",1937,992,945,1914,23,28,387.16,5.0
"2011","Flintshire 005D","W01000295","Total",1673,801,872,1582,91,14,30.44,55.0
"2011","Flintshire 006A","W01000258","Total",2153,1081,1072,2153,0,19,1206.31,1.8
"2011","Flintshire 006B","W01000270","Total",1286,654,632,1286,0,24,2336.58,0.6
"2011","Flintshire 006C","W01000271","Total",1283,630,653,1263,20,28,1400.34,0.9
"2011","Flintshire 006D","W01000272","Total",1874,921,953,1852,22,45,3989.75,0.5
"2011","Flintshire 006E","W01000301","Total",1785,889,896,1785,0,29,2526.48,0.7
"2011","Flintshire 007A","W01000273","Total",1585,764,821,1585,0,8,41.56,38.1
"2011","Flintshire 007B","W01000274","Total",1771,892,879,1771,0,6,330.94,5.4
"2011","Flintshire 007C","W01000275","Total",1253,646,607,1253,0,7,620.06,2.0
"2011","Flintshire 007D","W01000278","Total",1495,723,772,1495,0,10,24.32,61.5
"2011","Flintshire 008A","W01000276","Total",1393,709,684,1393,0,9,22.53,61.8
"2011","Flintshire 008B","W01000277","Total",1363,636,727,1363,0,23,167.87,8.1
"2011","Flintshire 008C","W01000279","Total",1264,604,660,1231,33,14,53.91,23.4
"2011","Flintshire 008D","W01000281","Total",1222,611,611,1222,0,10,21.68,56.4
"2011","Flintshire 008E","W01000283","Total",2259,1120,1139,2259,0,13,411.15,5.5
"2011","Flintshire 009A","W01000332","Total",1568,792,776,1568,0,18,1652.86,0.9
"2011","Flintshire 009B","W01000333","Total",1428,700,728,1428,0,9,347.43,4.1
"2011","Flintshire 009C","W01000334","Total",1958,994,964,1958,0,12,74.13,26.4
"2011","Flintshire 009D","W01000335","Total",1111,526,585,1084,27,4,27.49,40.4
"2011","Flintshire 009E","W01000336","Total",1465,712,753,1465,0,9,44.97,32.6
"2011","Flintshire 009F","W01000337","Total",2129,1080,1049,2127,2,16,87.16,24.4
"2011","Flintshire 010A","W01000252","Total",1631,807,824,1619,12,7,274.83,5.9
"2011","Flintshire 010B","W01000280","Total",1426,713,713,1426,0,15,78.55,18.2
"2011","Flintshire 010C","W01000282","Total",1743,885,858,1742,1,22,103.21,16.9
"2011","Flintshire 010D","W01000325","Total",1530,745,785,1527,3,24,353.57,4.3
"2011","Flintshire 011A","W01000311","Total",1782,901,881,1782,0,19,387.52,4.6
"2011","Flintshire 011B","W01000312","Total",1714,851,863,1714,0,8,57.92,29.6
"2011","Flintshire 011C","W01000328","Total",2109,1106,1003,2109,0,13,408.68,5.2
"2011","Flintshire 012A","W01000264","Total",1701,844,857,1701,0,19,76.08,22.4
"2011","Flintshire 012B","W01000265","Total",1312,639,673,1312,0,19,276.66,4.7
"2011","Flintshire 012C","W01000323","Total",1545,760,785,1545,0,22,998.27,1.5
"2011","Flintshire 012D","W01000324","Total",1504,716,788,1504,0,35,139.31,10.8
"2011","Flintshire 013A","W01000251","Total",1486,716,770,1486,0,29,64.71,23.0
"2011","Flintshire 013B","W01000268","Total",1767,885,882,1767,0,22,105.46,16.8
"2011","Flintshire 013C","W01000284","Total",1708,845,863,1708,0,21,84.87,20.1
"2011","Flintshire 013D","W01000285","Total",1473,715,758,1464,9,34,212.94,6.9
"2011","Flintshire 013E","W01000286","Total",2239,1115,1124,2227,12,33,327.94,6.8
"2011","Flintshire 013F","W01000302","Total",1887,889,998,1860,27,31,323.13,5.8
"2011","Flintshire 014A","W01000249","Total",1258,597,661,1258,0,13,47.43,26.5
"2011","Flintshire 014B","W01000250","Total",1578,796,782,1578,0,18,309.02,5.1
"2011","Flintshire 014C","W01000261","Total",1549,761,788,1516,33,19,37.14,41.7
"2011","Flintshire 014D","W01000321","Total",1659,808,851,1659,0,18,124.10,13.4
"2011","Flintshire 014E","W01000322","Total",1342,642,700,1301,41,27,146.34,9.2
"2011","Flintshire 015A","W01000255","Total",2292,1137,1155,2292,0,23,921.11,2.5
"2011","Flintshire 015B","W01000256","Total",1561,763,798,1561,0,9,250.50,6.2
"2011","Flintshire 015C","W01000257","Total",2121,1091,1030,2121,0,11,59.41,35.7
"2011","Flintshire 015D","W01000329","Total",1373,674,699,1373,0,10,239.12,5.7
"2011","Flintshire 015E","W01000330","Total",2150,1068,1082,2150,0,11,34.72,61.9
"2011","Flintshire 015F","W01000331","Total",1609,799,810,1609,0,15,83.88,19.2
"2011","Flintshire 016A","W01000313","Total",1566,729,837,1566,0,18,90.24,17.4
"2011","Flintshire 016B","W01000314","Total",1129,548,581,1129,0,16,35.15,32.1
"2011","Flintshire 016C","W01000315","Total",2006,963,1043,1987,19,22,231.82,8.7
"2011","Flintshire 016D","W01000316","Total",1323,620,703,1282,41,26,64.53,20.5
"2011","Flintshire 016E","W01000317","Total",1393,708,685,1393,0,41,86.72,16.1
"2011","Flintshire 016F","W01000318","Total",1172,579,593,1172,0,5,32.12,36.5
"2011","Flintshire 016G","W01000319","Total",1469,733,736,1457,12,19,97.45,15.1
"2011","Flintshire 017A","W01000259","Total",1636,788,848,1581,55,16,263.60,6.2
"2011","Flintshire 017B","W01000260","Total",1809,880,929,1809,0,21,50.86,35.6
"2011","Flintshire 017C","W01000262","Total",1490,722,768,1490,0,8,39.93,37.3
"2011","Flintshire 017D","W01000263","Total",1488,745,743,1461,27,10,60.12,24.8
"2011","Flintshire 017E","W01000266","Total",1320,654,666,1320,0,6,34.74,38.0
"2011","Flintshire 017F","W01000267","Total",1593,787,806,1593,0,10,114.02,14.0
"2011","Flintshire 018A","W01000303","Total",1697,816,881,1697,0,40,891.00,1.9
"2011","Flintshire 018B","W01000326","Total",1677,814,863,1677,0,18,309.93,5.4
"2011","Flintshire 018C","W01000327","Total",2197,1111,1086,2177,20,37,578.80,3.8
"2011","Flintshire 019A","W01000299","Total",1942,955,987,1942,0,36,752.89,2.6
"2011","Flintshire 019B","W01000300","Total",1726,846,880,1718,8,27,1780.23,1.0
"2011","Flintshire 019C","W01000309","Total",2135,1064,1071,2135,0,39,1172.74,1.8
"2011","Flintshire 019D","W01000339","Total",1627,800,827,1627,0,18,1465.99,1.1
"2011","Flintshire 020A","W01000269","Total",1619,791,828,1572,47,16,116.80,13.9
"2011","Flintshire 020B","W01000307","Total",1363,670,693,1313,50,27,1127.13,1.2
"2011","Flintshire 020C","W01000308","Total",1242,616,626,1242,0,15,150.62,8.2
"2011","Flintshire 020D","W01000310","Total",1850,917,933,1820,30,31,1947.02,1.0
"2011","Wrexham 003A","W01000374","Total",1386,675,711,1386,0,6,57.80,24.0
"2011","Wrexham 003B","W01000375","Total",1997,977,1020,1997,0,24,188.90,10.6
"2011","Wrexham 003C","W01000376","Total",1390,706,684,1390,0,10,151.58,9.2
"2011","Wrexham 003D","W01000391","Total",1425,714,711,1425,0,7,205.15,6.9
"2011","Wrexham 003E","W01000392","Total",1720,831,889,1720,0,15,69.80,24.6
"2011","Wrexham 004A","W01000377","Total",1540,771,769,1520,20,16,181.81,8.5
"2011","Wrexham 004B","W01000378","Total",1324,621,703,1324,0,9,42.56,31.1
"2011","Wrexham 004C","W01000379","Total",1598,801,797,1589,9,8,61.40,26.0
"2011","Wrexham 004D","W01000380","Total",1442,718,724,1193,249,18,103.60,13.9
"2011","Wrexham 005A","W01000351","Total",2175,1066,1109,2140,35,23,208.38,10.4
"2011","Wrexham 005B","W01000373","Total",1831,904,927,1831,0,9,89.42,20.5
"2011","Wrexham 005C","W01000400","Total",1657,814,843,1657,0,14,115.56,14.3
"2011","Wrexham 005D","W01000401","Total",1791,879,912,1791,0,7,56.31,31.8
"2011","Wrexham 006A","W01000347","Total",2524,1272,1252,2480,44,21,641.85,3.9
"2011","Wrexham 006B","W01000348","Total",1457,713,744,1457,0,8,59.19,24.6
"2011","Wrexham 006C","W01000362","Total",1529,746,783,1529,0,16,86.43,17.7
"2011","Wrexham 006D","W01000363","Total",1524,740,784,1499,25,11,64.10,23.8
"2011","Wrexham 006E","W01000364","Total",1649,853,796,1626,23,11,385.72,4.3
"2011","Wrexham 007A","W01000343","Total",1054,510,544,1054,0,5,27.77,38.0
"2011","Wrexham 007B","W01000344","Total",1305,630,675,1305,0,5,32.73,39.9
"2011","Wrexham 007C","W01000415","Total",1484,730,754,1484,0,22,48.68,30.5
"2011","Wrexham 007D","W01000416","Total",1266,638,628,1266,0,22,25.88,48.9
"2011","Wrexham 008A","W01000368","Total",2036,1004,1032,2036,0,26,56.24,36.2
"2011","Wrexham 008B","W01000371","Total",1204,617,587,1204,0,11,18.43,65.3
"2011","Wrexham 008C","W01000372","Total",1486,762,724,1198,288,19,86.32,17.2
"2011","Wrexham 008D","W01000387","Total",1257,606,651,1257,0,16,27.51,45.7
"2011","Wrexham 008E","W01000388","Total",1065,515,550,1065,0,15,25.38,42.0
"2011","Wrexham 008F","W01000422","Total",2114,1044,1070,2048,66,14,58.99,35.8
"2011","Wrexham 009A","W01000341","Total",1582,749,833,1582,0,19,57.24,27.6
"2011","Wrexham 009B","W01000342","Total",1583,745,838,1573,10,6,31.62,50.1
"2011","Wrexham 009C","W01000393","Total",1950,955,995,1950,0,23,67.79,28.8
"2011","Wrexham 010A","W01000352","Total",1007,502,505,944,63,9,19.94,50.5
"2011","Wrexham 010B","W01000353","Total",1386,682,704,1386,0,8,24.92,55.6
"2011","Wrexham 010C","W01000413","Total",1422,683,739,1422,0,1,26.77,53.1
"2011","Wrexham 010D","W01000414","Total",1263,627,636,1263,0,2,21.55,58.6
"2011","Wrexham 010E","W01000425","Total",2323,1150,1173,2319,4,5,47.11,49.3
"2011","Wrexham 011A","W01000349","Total",1853,934,919,1840,13,13,173.10,10.7
"2011","Wrexham 011B","W01000350","Total",1595,870,725,1534,61,12,73.07,21.8
"2011","Wrexham 011C","W01000365","Total",2200,1125,1075,2097,103,42,90.85,24.2
"2011","Wrexham 011D","W01000402","Total",2648,1422,1226,2604,44,29,79.66,33.2
"2011","Wrexham 012A","W01000381","Total",1130,572,558,1126,4,13,22.22,50.9
"2011","Wrexham 012B","W01000382","Total",1075,548,527,1075,0,10,46.27,23.2
"2011","Wrexham 012D","W01000423","Total",2232,1102,1130,2232,0,9,58.58,38.1
"2011","Wrexham 012E","W01000424","Total",1264,636,628,1264,0,11,25.80,49.0
"2011","Wrexham 012F","W01001929","Total",1303,707,596,1285,18,6,21.69,60.1
"2011","Wrexham 012G","W01001931","Total",1368,723,645,1331,37,2,35.82,38.2
"2011","Wrexham 013A","W01000398","Total",1314,671,643,1314,0,10,983.62,1.3
"2011","Wrexham 013B","W01000399","Total",1158,584,574,1158,0,19,517.73,2.2
"2011","Wrexham 013C","W01000406","Total",2205,1093,1112,2205,0,20,153.63,14.4
"2011","Wrexham 013D","W01000408","Total",1184,587,597,1184,0,14,1755.82,0.7
"2011","Wrexham 014A","W01000366","Total",1454,725,729,1454,0,8,42.55,34.2
"2011","Wrexham 014B","W01000367","Total",1312,677,635,1306,6,10,177.94,7.4
"2011","Wrexham 014C","W01000385","Total",1750,873,877,1750,0,30,42.46,41.2
"2011","Wrexham 014D","W01000410","Total",1647,822,825,1629,18,15,502.85,3.3
"2011","Wrexham 015A","W01000386","Total",1516,739,777,1516,0,11,65.80,23.0
"2011","Wrexham 015B","W01000405","Total",2335,1114,1221,2266,69,13,73.10,31.9
"2011","Wrexham 015C","W01000411","Total",1599,779,820,1582,17,11,338.87,4.7
"2011","Wrexham 015D","W01000412","Total",1596,821,775,1589,7,14,1024.25,1.6
"2011","Wrexham 016A","W01000394","Total",1279,657,622,1275,4,35,3463.57,0.4
"2011","Wrexham 016B","W01000395","Total",1092,542,550,1092,0,12,306.33,3.6
"2011","Wrexham 016C","W01000407","Total",1349,659,690,1349,0,13,1427.77,0.9
"2011","Wrexham 016D","W01000419","Total",1539,774,765,1511,28,14,672.52,2.3
"2011","Wrexham 016E","W01000420","Total",1386,677,709,1385,1,9,215.87,6.4
"2011","Wrexham 017A","W01000354","Total",1731,871,860,1712,19,13,544.47,3.2
"2011","Wrexham 017B","W01000355","Total",1614,821,793,1594,20,9,87.26,18.5
"2011","Wrexham 017C","W01000356","Total",1729,861,868,1709,20,10,130.88,13.2
"2011","Wrexham 017D","W01000389","Total",2059,1028,1031,2056,3,9,532.81,3.9
"2011","Wrexham 017E","W01000409","Total",1977,958,1019,1977,0,16,41.58,47.5
"2011","Wrexham 018A","W01000345","Total",1583,783,800,1578,5,28,2022.47,0.8
"2011","Wrexham 018B","W01000346","Total",1596,786,810,1594,2,23,4455.28,0.4
"2011","Wrexham 018C","W01000403","Total",1327,668,659,1326,1,33,2948.14,0.5
"2011","Wrexham 018D","W01000404","Total",1988,984,1004,1986,2,45,2576.76,0.8
"2011","Wrexham 019C","W01000359","Total",1177,562,615,1170,7,3,496.18,2.4
"2011","Wrexham 019D","W01000360","Total",1255,615,640,1255,0,10,57.05,22.0
"2011","Wrexham 019E","W01000361","Total",2036,978,1058,2014,22,25,1355.55,1.5
"2011","Wrexham 019F","W01001930","Total",2179,1115,1064,2141,38,25,11343.67,0.2
"2011","Wrexham 020F","W01000369","Total",1270,602,668,1268,2,18,107.58,11.8
"2011","Wrexham 020G","W01000370","Total",1460,692,768,1361,99,17,488.41,3.0
"2011","Wrexham 020A","W01000383","Total",2441,1228,1213,2436,5,39,3733.75,0.7
"2011","Wrexham 020B","W01000384","Total",1113,528,585,1087,26,22,89.05,12.5
"2011","Wrexham 020C","W01000390","Total",1669,832,837,1607,62,19,631.85,2.6
"2011","Wrexham 020H","W01000396","Total",1235,607,628,1234,1,38,71.87,17.2
"2011","Wrexham 020I","W01000397","Total",1045,520,525,1045,0,28,241.89,4.3
"2011","Wrexham 020D","W01000417","Total",1568,783,785,1568,0,38,1137.90,1.4
"2011","Wrexham 020E","W01000418","Total",1663,847,816,1663,0,36,1416.88,1.2
"2011","Powys 001A","W01000461","Total",1532,806,726,1501,31,27,4177.72,0.4
"2011","Powys 001D","W01000470","Total",1880,914,966,1831,49,16,4186.77,0.4
"2011","Powys 001E","W01000475","Total",2371,1178,1193,2368,3,60,13559.46,0.2
"2011","Powys 001F","W01001906","Total",1916,974,942,1897,19,34,18700.35,0.1
"2011","Powys 001G","W01001907","Total",1415,721,694,1415,0,26,12313.69,0.1
"2011","Powys 002A","W01000444","Total",2319,1129,1190,2319,0,35,5734.22,0.4
"2011","Powys 002B","W01000457","Total",2191,1090,1101,2191,0,28,4408.31,0.5
"2011","Powys 002C","W01000458","Total",1789,888,901,1785,4,23,1887.54,0.9
"2011","Powys 003A","W01000498","Total",1538,746,792,1538,0,23,1795.07,0.9
"2011","Powys 003B","W01000499","Total",1290,626,664,1202,88,12,184.48,7.0
"2011","Powys 003C","W01000500","Total",1536,767,769,1522,14,32,1223.56,1.3
"2011","Powys 003D","W01000501","Total",2300,1134,1166,2194,106,25,696.51,3.3
"2011","Powys 004A","W01000442","Total",2040,1009,1031,2026,14,39,22167.57,0.1
"2011","Powys 004B","W01000452","Total",1931,1001,930,1930,1,28,28278.26,0.1
"2011","Powys 004C","W01000473","Total",2235,1074,1161,2197,38,17,506.03,4.4
"2011","Powys 005A","W01000428","Total",1334,683,651,1326,8,31,4721.07,0.3
"2011","Powys 005B","W01000441","Total",1426,702,724,1411,15,20,3483.06,0.4
"2011","Powys 005C","W01000476","Total",1295,616,679,1295,0,15,1359.16,1.0
"2011","Powys 005D","W01000497","Total",1430,715,715,1429,1,22,3213.90,0.4
"2011","Powys 006A","W01000433","Total",2316,1163,1153,2316,0,32,9071.11,0.3
"2011","Powys 006B","W01000460","Total",1810,891,919,1807,3,33,6253.82,0.3
"2011","Powys 006C","W01000488","Total",2180,1128,1052,2170,10,34,10921.88,0.2
"2011","Powys 007A","W01000434","Total",1691,845,846,1649,42,27,5430.76,0.3
"2011","Powys 007B","W01000439","Total",1972,977,995,1961,11,43,4753.69,0.4
"2011","Powys 007C","W01000447","Total",2057,1036,1021,2053,4,37,8820.77,0.2
"2011","Powys 008A","W01000480","Total",2069,1023,1046,2008,61,25,799.12,2.6
"2011","Powys 008B","W01000481","Total",2267,1102,1165,2267,0,28,704.46,3.2
"2011","Powys 008C","W01000482","Total",1844,937,907,1834,10,32,814.93,2.3
"2011","Powys 009A","W01000478","Total",1755,862,893,1755,0,11,38.72,45.3
"2011","Powys 009B","W01000479","Total",1523,722,801,1476,47,11,51.65,29.5
"2011","Powys 009C","W01000483","Total",1899,914,985,1886,13,20,299.71,6.3
"2011","Powys 010A","W01000429","Total",2294,1182,1112,2272,22,46,26669.30,0.1
"2011","Powys 010B","W01000453","Total",1405,712,693,1404,1,28,9678.40,0.1
"2011","Powys 010C","W01000466","Total",1425,664,761,1393,32,19,174.72,8.2
"2011","Powys 010D","W01000467","Total",1504,779,725,1493,11,23,364.89,4.1
"2011","Powys 011A","W01000427","Total",1411,715,696,1403,8,32,19163.64,0.1
"2011","Powys 011B","W01000448","Total",1406,676,730,1395,11,18,1438.90,1.0
"2011","Powys 011C","W01000449","Total",1601,816,785,1580,21,27,1183.39,1.4
"2011","Powys 011D","W01000464","Total",1255,629,626,1243,12,22,13065.30,0.1
"2011","Powys 011E","W01000484","Total",1562,803,759,1533,29,23,15355.30,0.1
"2011","Powys 011F","W01000485","Total",1547,732,815,1547,0,18,2081.95,0.7
"2011","Powys 011G","W01000486","Total",1163,587,576,1151,12,18,412.72,2.8
"2011","Powys 012A","W01000438","Total",1239,613,626,1236,3,20,3121.12,0.4
"2011","Powys 012B","W01000451","Total",1129,550,579,1123,6,29,5173.90,0.2
"2011","Powys 012C","W01000472","Total",1141,568,573,1137,4,20,2987.09,0.4
"2011","Powys 012D","W01000477","Total",1465,740,725,1455,10,27,18883.92,0.1
"2011","Powys 012E","W01000487","Total",2088,997,1091,2001,87,28,13731.03,0.2
"2011","Powys 013A","W01000454","Total",1227,622,605,1166,61,18,101.51,12.1
"2011","Powys 013B","W01000455","Total",2059,1001,1058,2058,1,24,353.08,5.8
"2011","Powys 013C","W01000456","Total",2023,964,1059,1987,36,29,813.86,2.5
"2011","Powys 014A","W01000431","Total",1335,671,664,1330,5,12,100.15,13.3
"2011","Powys 014B","W01000432","Total",1233,579,654,1210,23,30,202.94,6.1
"2011","Powys 014C","W01000450","Total",1386,687,699,1362,24,32,22200.60,0.1
"2011","Powys 014D","W01000459","Total",1206,598,608,1201,5,13,11801.31,0.1
"2011","Powys 014E","W01000471","Total",1875,949,926,1845,30,30,23896.08,0.1
"2011","Powys 015A","W01000430","Total",1282,632,650,1256,26,15,7002.23,0.2
"2011","Powys 015B","W01000443","Total",2299,1131,1168,2282,17,45,12697.90,0.2
"2011","Powys 015C","W01000445","Total",1527,775,752,1501,26,36,7001.95,0.2
"2011","Powys 015D","W01000446","Total",1598,769,829,1568,30,10,149.78,10.7
"2011","Powys 015E","W01000494","Total",1724,849,875,1686,38,28,5531.00,0.3
"2011","Powys 017A","W01000489","Total",1797,877,920,1534,263,26,322.69,5.6
"2011","Powys 017D","W01000492","Total",1591,782,809,1546,45,29,76.28,20.9
"2011","Powys 017E","W01000493","Total",1520,778,742,1465,55,32,480.94,3.2
"2011","Powys 017F","W01001901","Total",1930,880,1050,1930,0,45,81.60,23.7
"2011","Powys 017G","W01001902","Total",1412,649,763,1412,0,26,147.98,9.5
"2011","Powys 018E","W01000465","Total",1036,506,530,1013,23,22,4947.26,0.2
"2011","Powys 018F","W01001903","Total",2063,990,1073,2054,9,42,624.66,3.3
"2011","Powys 018G","W01001904","Total",1737,857,880,1707,30,51,4997.10,0.3
"2011","Powys 018H","W01001905","Total",2106,1047,1059,2071,35,48,13266.09,0.2
"2011","Powys 020A","W01000440","Total",1350,664,686,1349,1,31,9468.94,0.1
"2011","Powys 020B","W01000474","Total",1703,851,852,1697,6,29,25396.66,0.1
"2011","Powys 020C","W01000503","Total",1038,509,529,1038,0,46,15345.91,0.1
"2011","Powys 020D","W01001897","Total",1923,957,966,1846,77,34,20237.19,0.1
"2011","Powys 021A","W01000426","Total",1424,701,723,1424,0,11,959.95,1.5
"2011","Powys 021B","W01000496","Total",2118,1057,1061,2046,72,22,11243.16,0.2
"2011","Powys 021C","W01000502","Total",2071,992,1079,2038,33,18,379.95,5.5
"2011","Powys 021D","W01000504","Total",1161,587,574,1161,0,3,38.28,30.3
"2011","Powys 021E","W01000505","Total",1383,660,723,1383,0,17,2819.54,0.5
"2011","Powys 021F","W01001899","Total",2053,976,1077,1956,97,19,1307.52,1.6
"2011","Ceredigion 001C","W01000523","Total",1910,972,938,1909,1,40,12756.50,0.1
"2011","Ceredigion 001D","W01000548","Total",1901,911,990,1818,83,38,1453.28,1.3
"2011","Ceredigion 001E","W01000549","Total",1771,902,869,1764,7,40,2616.08,0.7
"2011","Ceredigion 001F","W01001937","Total",2078,1009,1069,2062,16,35,2548.61,0.8
"2011","Ceredigion 002A","W01000512","Total",2075,1105,970,1385,690,37,55.72,37.2
"2011","Ceredigion 002B","W01000513","Total",2471,1328,1143,2465,6,26,29.74,83.1
"2011","Ceredigion 002D","W01000517","Total",1472,807,665,1466,6,13,16.31,90.3
"2011","Ceredigion 002F","W01001934","Total",3980,2026,1954,2405,1575,56,477.24,8.3
"2011","Ceredigion 003A","W01000515","Total",1446,727,719,1419,27,15,117.13,12.3
"2011","Ceredigion 003B","W01000516","Total",1676,836,840,1676,0,22,72.62,23.1
"2011","Ceredigion 003C","W01000518","Total",1259,629,630,1259,0,3,66.62,18.9
"2011","Ceredigion 003E","W01001935","Total",1095,551,544,1095,0,20,103.49,10.6
"2011","Ceredigion 003F","W01001936","Total",2285,1139,1146,1172,1113,46,210.41,10.9
"2011","Ceredigion 005A","W01000506","Total",1422,673,749,1396,26,28,158.28,9.0
"2011","Ceredigion 005B","W01000524","Total",1974,986,988,1969,5,34,4005.45,0.5
"2011","Ceredigion 005C","W01000538","Total",1562,773,789,1562,0,33,5965.58,0.3
"2011","Ceredigion 005D","W01000539","Total",1222,628,594,1206,16,15,4748.19,0.3
"2011","Ceredigion 005E","W01000540","Total",1164,559,605,1143,21,14,1266.00,0.9
"2011","Ceredigion 007A","W01000529","Total",1616,826,790,1611,5,17,4594.08,0.4
"2011","Ceredigion 007B","W01000532","Total",1979,979,1000,1974,5,31,6671.51,0.3
"2011","Ceredigion 007C","W01000544","Total",1082,526,556,1071,11,19,230.58,4.7
"2011","Ceredigion 007D","W01000545","Total",2045,1016,1029,2045,0,40,5325.44,0.4
"2011","Ceredigion 008A","W01000527","Total",1510,807,703,1005,505,35,95.40,15.8
"2011","Ceredigion 008B","W01000528","Total",1460,700,760,1440,20,26,1169.06,1.2
"2011","Ceredigion 008C","W01000535","Total",2037,1025,1012,2037,0,31,7411.26,0.3
"2011","Ceredigion 008D","W01000537","Total",1484,736,748,1484,0,33,7280.36,0.2
"2011","Ceredigion 008E","W01000541","Total",1854,893,961,1821,33,17,6845.35,0.3
"2011","Ceredigion 009A","W01000507","Total",1196,582,614,1191,5,16,1292.18,0.9
"2011","Ceredigion 009B","W01000508","Total",1178,591,587,1178,0,15,353.75,3.3
"2011","Ceredigion 009C","W01000509","Total",1784,833,951,1771,13,23,611.65,2.9
"2011","Ceredigion 009D","W01000510","Total",1226,595,631,1204,22,3,205.12,6.0
"2011","Ceredigion 009E","W01000511","Total",1174,595,579,1174,0,14,476.68,2.5
"2011","Ceredigion 009F","W01000546","Total",1128,562,566,1128,0,11,1930.48,0.6
"2011","Ceredigion 009G","W01000547","Total",1180,558,622,1177,3,28,2818.69,0.4
"2011","Ceredigion 010A","W01000519","Total",1627,800,827,1627,0,19,5063.57,0.3
"2011","Ceredigion 010B","W01000522","Total",1293,655,638,1276,17,23,6081.18,0.2
"2011","Ceredigion 010C","W01000531","Total",1835,879,956,1778,57,16,2985.04,0.6
"2011","Ceredigion 010D","W01000533","Total",1439,691,748,1411,28,29,590.17,2.4
"2011","Ceredigion 010E","W01000551","Total",1310,639,671,1310,0,25,3259.07,0.4
"2011","Ceredigion 011A","W01000525","Total",1206,556,650,1132,74,32,328.38,3.7
"2011","Ceredigion 011B","W01000534","Total",1541,756,785,1533,8,35,3352.43,0.5
"2011","Ceredigion 011E","W01000536","Total",1459,715,744,1459,0,22,15095.07,0.1
"2011","Ceredigion 011F","W01000542","Total",2209,1085,1124,2195,14,33,22339.29,0.1
"2011","Ceredigion 011C","W01000543","Total",2020,999,1021,2019,1,35,19760.98,0.1
"2011","Ceredigion 011G","W01000550","Total",1213,595,618,1198,15,21,8596.99,0.1
"2011","Ceredigion 011D","W01000552","Total",2074,1038,1036,2024,50,39,7114.42,0.3
"2011","Pembrokeshire 001A","W01000558","Total",2058,1002,1056,2016,42,32,4427.09,0.5
"2011","Pembrokeshire 001B","W01000559","Total",1451,746,705,1446,5,17,6596.71,0.2
"2011","Pembrokeshire 001C","W01000560","Total",1207,630,577,1207,0,23,6819.04,0.2
"2011","Pembrokeshire 001D","W01000561","Total",1256,629,627,1256,0,16,2830.85,0.4
"2011","Pembrokeshire 001E","W01000613","Total",2218,1091,1127,2210,8,35,7856.98,0.3
"2011","Pembrokeshire 002A","W01000562","Total",1696,837,859,1686,10,25,10041.24,0.2
"2011","Pembrokeshire 002B","W01000565","Total",1873,881,992,1827,46,27,221.22,8.5
"2011","Pembrokeshire 002C","W01000566","Total",1546,742,804,1537,9,15,167.88,9.2
"2011","Pembrokeshire 002D","W01000567","Total",1988,997,991,1977,11,24,367.34,5.4
"2011","Pembrokeshire 002E","W01000597","Total",1161,520,641,1158,3,18,1767.76,0.7
"2011","Pembrokeshire 002F","W01000617","Total",1487,745,742,1464,23,21,7114.27,0.2
"2011","Pembrokeshire 003A","W01000579","Total",2352,1154,1198,2324,28,40,5889.73,0.4
"2011","Pembrokeshire 003B","W01000581","Total",1464,732,732,1450,14,32,5270.22,0.3
"2011","Pembrokeshire 003C","W01000612","Total",1841,914,927,1783,58,32,4560.30,0.4
"2011","Pembrokeshire 003D","W01000618","Total",1877,1046,831,1526,351,28,5004.98,0.4
"2011","Pembrokeshire 004A","W01000582","Total",1659,808,851,1659,0,41,9359.32,0.2
"2011","Pembrokeshire 004B","W01000583","Total",1445,701,744,1440,5,27,3003.27,0.5
"2011","Pembrokeshire 004C","W01000611","Total",1664,812,852,1662,2,27,3500.61,0.5
"2011","Pembrokeshire 004D","W01000623","Total",1973,970,1003,1917,56,47,7113.81,0.3
"2011","Pembrokeshire 005A","W01000568","Total",2301,1168,1133,2299,2,30,68.09,33.8
"2011","Pembrokeshire 005B","W01000569","Total",1327,642,685,1327,0,8,159.04,8.3
"2011","Pembrokeshire 005C","W01000570","Total",1474,691,783,1474,0,8,28.36,52.0
"2011","Pembrokeshire 005D","W01000572","Total",1850,873,977,1801,49,22,146.98,12.6
"2011","Pembrokeshire 006A","W01000571","Total",2260,1068,1192,2228,32,32,116.35,19.4
"2011","Pembrokeshire 006B","W01000573","Total",2496,1164,1332,2483,13,38,199.19,12.5
"2011","Pembrokeshire 006C","W01000586","Total",2202,1059,1143,2185,17,27,675.64,3.3
"2011","Pembrokeshire 007A","W01000577","Total",1598,774,824,1584,14,29,4565.90,0.3
"2011","Pembrokeshire 007B","W01000585","Total",1408,702,706,1344,64,27,8314.71,0.2
"2011","Pembrokeshire 007C","W01000595","Total",1923,894,1029,1900,23,23,88.25,21.8
"2011","Pembrokeshire 007D","W01000596","Total",1509,723,786,1459,50,34,2533.57,0.6
"2011","Pembrokeshire 008A","W01000555","Total",1416,726,690,1384,32,32,4530.38,0.3
"2011","Pembrokeshire 008B","W01000556","Total",1149,552,597,1136,13,16,2509.49,0.5
"2011","Pembrokeshire 008C","W01000575","Total",2517,1177,1340,2405,112,31,2502.00,1.0
"2011","Pembrokeshire 008D","W01000614","Total",1405,688,717,1390,15,35,4689.90,0.3
"2011","Pembrokeshire 008E","W01000622","Total",1536,751,785,1486,50,33,4219.90,0.4
"2011","Pembrokeshire 009A","W01000554","Total",1826,880,946,1786,40,24,2056.30,0.9
"2011","Pembrokeshire 009B","W01000580","Total",2336,1137,1199,2324,12,33,1477.99,1.6
"2011","Pembrokeshire 009C","W01000598","Total",2219,1055,1164,2209,10,35,128.86,17.2
"2011","Pembrokeshire 009D","W01000599","Total",2150,1042,1108,2150,0,24,1099.65,2.0
"2011","Pembrokeshire 010A","W01000587","Total",2003,1003,1000,2000,3,24,67.13,29.8
"2011","Pembrokeshire 010B","W01000588","Total",2157,1044,1113,2157,0,28,495.24,4.4
"2011","Pembrokeshire 010C","W01000593","Total",2763,1355,1408,2751,12,24,345.98,8.0
"2011","Pembrokeshire 011A","W01000553","Total",1232,609,623,1230,2,15,1818.94,0.7
"2011","Pembrokeshire 011B","W01000563","Total",1207,597,610,1168,39,27,2475.54,0.5
"2011","Pembrokeshire 011C","W01000564","Total",1211,598,613,1178,33,15,176.46,6.9
"2011","Pembrokeshire 011D","W01000576","Total",2262,1116,1146,2257,5,33,1955.13,1.2
"2011","Pembrokeshire 011E","W01000615","Total",1535,763,772,1485,50,23,333.69,4.6
"2011","Pembrokeshire 011F","W01000616","Total",1093,536,557,1083,10,18,343.31,3.2
"2011","Pembrokeshire 012A","W01000589","Total",1152,557,595,1152,0,6,24.89,46.3
"2011","Pembrokeshire 012B","W01000590","Total",1087,510,577,1087,0,15,41.46,26.2
"2011","Pembrokeshire 012C","W01000591","Total",1187,555,632,1187,0,18,439.71,2.7
"2011","Pembrokeshire 012D","W01000592","Total",1304,636,668,1304,0,7,53.92,24.2
"2011","Pembrokeshire 012E","W01000594","Total",2254,1142,1112,2228,26,16,73.04,30.9
"2011","Pembrokeshire 013A","W01000600","Total",1658,851,807,1635,23,8,35.03,47.3
"2011","Pembrokeshire 013B","W01000601","Total",1544,720,824,1544,0,5,188.88,8.2
"2011","Pembrokeshire 013C","W01000602","Total",1306,641,665,1268,38,19,68.98,18.9
"2011","Pembrokeshire 013D","W01000603","Total",1897,949,948,1877,20,24,124.43,15.2
"2011","Pembrokeshire 013E","W01000604","Total",1514,757,757,1514,0,9,97.46,15.5
"2011","Pembrokeshire 013F","W01000605","Total",1834,923,911,1834,0,14,116.84,15.7
"2011","Pembrokeshire 014A","W01000557","Total",1532,748,784,1532,0,23,2236.93,0.7
"2011","Pembrokeshire 014B","W01000578","Total",1671,830,841,1669,2,33,2431.10,0.7
"2011","Pembrokeshire 014C","W01000584","Total",2083,1024,1059,2068,15,31,2473.48,0.8
"2011","Pembrokeshire 014D","W01000609","Total",2408,1144,1264,2390,18,34,744.34,3.2
"2011","Pembrokeshire 015A","W01000574","Total",1877,938,939,1871,6,40,9583.38,0.2
"2011","Pembrokeshire 015B","W01000606","Total",1650,770,880,1650,0,14,137.51,12.0
"2011","Pembrokeshire 015C","W01000607","Total",2060,1006,1054,1966,94,23,155.83,13.2
"2011","Pembrokeshire 015D","W01000608","Total",1434,724,710,1421,13,23,130.92,11.0
"2011","Pembrokeshire 016A","W01000610","Total",1710,814,896,1619,91,23,2055.48,0.8
"2011","Pembrokeshire 016B","W01000619","Total",2112,979,1133,2059,53,36,233.22,9.1
"2011","Pembrokeshire 016C","W01000620","Total",1030,529,501,1013,17,10,20.30,50.7
"2011","Pembrokeshire 016D","W01000621","Total",1554,732,822,1449,105,22,372.15,4.2
"2011","Carmarthenshire 001A","W01000685","Total",1589,801,788,1566,23,13,3775.45,0.4
"2011","Carmarthenshire 001B","W01000686","Total",1262,630,632,1262,0,22,5152.04,0.2
"2011","Carmarthenshire 001C","W01000701","Total",1589,777,812,1542,47,14,6597.02,0.2
"2011","Carmarthenshire 001D","W01000702","Total",1218,604,614,1200,18,12,535.47,2.3
"2011","Carmarthenshire 002A","W01000647","Total",1518,743,775,1512,6,25,12748.16,0.1
"2011","Carmarthenshire 002B","W01000650","Total",1613,824,789,1611,2,27,16282.82,0.1
"2011","Carmarthenshire 002C","W01000678","Total",1421,702,719,1333,88,28,11089.12,0.1
"2011","Carmarthenshire 002D","W01000679","Total",1268,629,639,1182,86,32,510.64,2.5
"2011","Carmarthenshire 003A","W01000646","Total",2214,1072,1142,2134,80,22,4659.10,0.5
"2011","Carmarthenshire 003B","W01000688","Total",1808,900,908,1808,0,14,1889.68,1.0
"2011","Carmarthenshire 003C","W01000689","Total",1619,778,841,1619,0,31,4141.19,0.4
"2011","Carmarthenshire 003D","W01000728","Total",2072,1072,1000,2067,5,44,12477.81,0.2
"2011","Carmarthenshire 004A","W01000676","Total",1532,757,775,1513,19,31,4552.55,0.3
"2011","Carmarthenshire 004B","W01000677","Total",1439,667,772,1391,48,17,195.95,7.3
"2011","Carmarthenshire 004C","W01000687","Total",1929,971,958,1895,34,46,19242.88,0.1
"2011","Carmarthenshire 004D","W01000709","Total",2248,1118,1130,2220,28,43,8021.07,0.3
"2011","Carmarthenshire 005A","W01000624","Total",2315,1153,1162,2299,16,49,6276.64,0.4
"2011","Carmarthenshire 005B","W01000682","Total",1381,655,726,1381,0,31,3353.35,0.4
"2011","Carmarthenshire 005C","W01000683","Total",1059,542,517,1054,5,16,11519.68,0.1
"2011","Carmarthenshire 005D","W01000684","Total",1851,921,930,1847,4,37,4950.05,0.4
"2011","Carmarthenshire 006A","W01000643","Total",1689,773,916,1657,32,22,62.80,26.9
"2011","Carmarthenshire 006B","W01000644","Total",1857,820,1037,1405,452,27,753.87,2.5
"2011","Carmarthenshire 006C","W01000645","Total",1697,770,927,1697,0,15,50.03,33.9
"2011","Carmarthenshire 006D","W01000648","Total",1480,754,726,1452,28,20,7642.99,0.2
"2011","Carmarthenshire 006E","W01000649","Total",1538,762,776,1533,5,25,4312.44,0.4
"2011","Carmarthenshire 007A","W01000637","Total",1427,681,746,1423,4,8,209.59,6.8
"2011","Carmarthenshire 007B","W01000638","Total",1193,586,607,1193,0,16,26.08,45.7
"2011","Carmarthenshire 007C","W01000639","Total",1361,661,700,1352,9,26,43.21,31.5
"2011","Carmarthenshire 007D","W01000640","Total",1161,565,596,1132,29,24,282.23,4.1
"2011","Carmarthenshire 008A","W01000641","Total",2075,1038,1037,2053,22,19,143.39,14.5
"2011","Carmarthenshire 008B","W01000642","Total",1725,805,920,1610,115,22,516.45,3.3
"2011","Carmarthenshire 008C","W01000693","Total",1079,490,589,1079,0,20,43.93,24.6
"2011","Carmarthenshire 008D","W01000694","Total",1302,649,653,1283,19,32,2270.98,0.6
"2011","Carmarthenshire 010A","W01000656","Total",2139,1032,1107,2117,22,23,1518.31,1.4
"2011","Carmarthenshire 010B","W01000657","Total",1078,511,567,1073,5,11,809.43,1.3
"2011","Carmarthenshire 010C","W01000658","Total",1269,639,630,1269,0,10,418.39,3.0
"2011","Carmarthenshire 010D","W01000718","Total",1424,700,724,1424,0,15,145.12,9.8
"2011","Carmarthenshire 010E","W01000719","Total",1497,741,756,1497,0,13,3059.66,0.5
"2011","Carmarthenshire 011A","W01000680","Total",2011,975,1036,2011,0,31,1353.15,1.5
"2011","Carmarthenshire 011B","W01000681","Total",1983,986,997,1943,40,12,1114.28,1.8
"2011","Carmarthenshire 011C","W01000724","Total",1912,920,992,1853,59,17,466.79,4.1
"2011","Carmarthenshire 011D","W01000725","Total",2199,1053,1146,2074,125,26,520.55,4.2
"2011","Carmarthenshire 012A","W01000675","Total",1963,960,1003,1963,0,41,4448.00,0.4
"2011","Carmarthenshire 012B","W01000695","Total",1534,769,765,1534,0,20,998.79,1.5
"2011","Carmarthenshire 012C","W01000696","Total",1568,790,778,1568,0,10,3721.13,0.4
"2011","Carmarthenshire 012D","W01000722","Total",1304,646,658,1268,36,16,3466.14,0.4
"2011","Carmarthenshire 012E","W01000723","Total",1370,681,689,1358,12,14,1857.25,0.7
"2011","Carmarthenshire 013A","W01000625","Total",1200,575,625,1195,5,12,85.53,14.0
"2011","Carmarthenshire 013B","W01000626","Total",1462,717,745,1454,8,25,91.39,16.0
"2011","Carmarthenshire 013C","W01000627","Total",2175,1063,1112,2115,60,34,1115.68,1.9
"2011","Carmarthenshire 013D","W01000714","Total",1452,712,740,1426,26,13,59.03,24.6
"2011","Carmarthenshire 013E","W01000715","Total",1297,640,657,1290,7,22,75.83,17.1
"2011","Carmarthenshire 015A","W01000697","Total",1834,909,925,1795,39,12,365.82,5.0
"2011","Carmarthenshire 015B","W01000698","Total",1906,906,1000,1894,12,10,348.16,5.5
"2011","Carmarthenshire 015C","W01000699","Total",1530,773,757,1528,2,31,3134.78,0.5
"2011","Carmarthenshire 015D","W01000712","Total",1496,752,744,1492,4,7,345.86,4.3
"2011","Carmarthenshire 015E","W01000713","Total",1393,704,689,1391,2,6,363.70,3.8
"2011","Carmarthenshire 016A","W01000662","Total",2155,1060,1095,2153,2,28,2334.88,0.9
"2011","Carmarthenshire 016B","W01000663","Total",2261,1062,1199,2261,0,29,748.87,3.0
"2011","Carmarthenshire 016C","W01000664","Total",1805,887,918,1755,50,29,907.67,2.0
"2011","Carmarthenshire 016D","W01000716","Total",1337,659,678,1333,4,21,1100.58,1.2
"2011","Carmarthenshire 016E","W01000717","Total",1431,705,726,1431,0,14,234.20,6.1
"2011","Carmarthenshire 017A","W01000665","Total",1780,883,897,1775,5,33,1386.09,1.3
"2011","Carmarthenshire 017B","W01000666","Total",1446,707,739,1438,8,13,114.69,12.6
"2011","Carmarthenshire 017C","W01000731","Total",2438,1231,1207,2436,2,35,1125.17,2.2
"2011","Carmarthenshire 018A","W01000670","Total",1619,779,840,1619,0,10,91.10,17.8
"2011","Carmarthenshire 018B","W01000671","Total",1904,911,993,1882,22,20,1074.74,1.8
"2011","Carmarthenshire 018C","W01000729","Total",1265,590,675,1263,2,9,136.63,9.3
"2011","Carmarthenshire 018D","W01000730","Total",1276,636,640,1276,0,14,1851.94,0.7
"2011","Carmarthenshire 019A","W01000690","Total",1755,875,880,1728,27,26,845.54,2.1
"2011","Carmarthenshire 019B","W01000691","Total",1591,772,819,1591,0,17,154.81,10.3
"2011","Carmarthenshire 019C","W01000692","Total",1618,809,809,1592,26,16,221.48,7.3
"2011","Carmarthenshire 019D","W01000726","Total",1526,758,768,1520,6,36,978.65,1.6
"2011","Carmarthenshire 019E","W01000727","Total",1010,480,530,1010,0,2,33.73,29.9
"2011","Carmarthenshire 020A","W01000651","Total",1588,767,821,1588,0,19,188.77,8.4
"2011","Carmarthenshire 020B","W01000652","Total",2009,951,1058,1908,101,23,52.79,38.1
"2011","Carmarthenshire 020C","W01000655","Total",2054,970,1084,2017,37,10,238.29,8.6
"2011","Carmarthenshire 021A","W01000632","Total",1457,718,739,1457,0,11,31.05,46.9
"2011","Carmarthenshire 021B","W01000633","Total",1412,692,720,1412,0,4,142.94,9.9
"2011","Carmarthenshire 021C","W01000634","Total",1377,667,710,1377,0,10,242.91,5.7
"2011","Carmarthenshire 021D","W01000710","Total",2271,1119,1152,2236,35,30,2720.39,0.8
"2011","Carmarthenshire 021E","W01000711","Total",2030,968,1062,2026,4,8,1008.51,2.0
"2011","Carmarthenshire 022A","W01000703","Total",1863,896,967,1823,40,20,41.60,44.8
"2011","Carmarthenshire 022B","W01000704","Total",1640,785,855,1627,13,15,49.65,33.0
"2011","Carmarthenshire 022C","W01000705","Total",1954,937,1017,1946,8,18,68.02,28.7
"2011","Carmarthenshire 023A","W01000653","Total",1465,691,774,1421,44,21,37.12,39.5
"2011","Carmarthenshire 023B","W01000654","Total",1738,878,860,1705,33,22,60.33,28.8
"2011","Carmarthenshire 023C","W01000667","Total",1412,675,737,1412,0,8,119.49,11.8
"2011","Carmarthenshire 023F","W01001925","Total",2333,1146,1187,2292,41,35,1262.73,1.8
"2011","Carmarthenshire 024A","W01000628","Total",1593,782,811,1490,103,19,131.45,12.1
"2011","Carmarthenshire 024B","W01000629","Total",1731,834,897,1731,0,18,19.75,87.6
"2011","Carmarthenshire 024C","W01000630","Total",1661,819,842,1629,32,8,35.71,46.5
"2011","Carmarthenshire 024D","W01000631","Total",1776,874,902,1776,0,8,46.83,37.9
"2011","Carmarthenshire 025A","W01000635","Total",2265,1103,1162,2240,25,36,479.48,4.7
"2011","Carmarthenshire 025B","W01000636","Total",1942,925,1017,1907,35,10,133.67,14.5
"2011","Carmarthenshire 025C","W01000706","Total",1649,811,838,1647,2,4,67.27,24.5
"2011","Carmarthenshire 025D","W01000707","Total",1473,702,771,1473,0,11,32.20,45.7
"2011","Carmarthenshire 025E","W01000708","Total",1384,693,691,1383,1,7,289.61,4.8
"2011","Carmarthenshire 026A","W01000659","Total",1542,729,813,1542,0,9,74.67,20.7
"2011","Carmarthenshire 026B","W01000660","Total",1539,739,800,1532,7,7,35.25,43.7
"2011","Carmarthenshire 026D","W01000732","Total",1390,690,700,1362,28,19,16.28,85.4
"2011","Carmarthenshire 026E","W01000733","Total",1256,626,630,1253,3,5,27.02,46.5
"2011","Carmarthenshire 026F","W01000734","Total",1433,745,688,1433,0,12,20.32,70.5
"2011","Carmarthenshire 026G","W01001923","Total",1254,630,624,1254,0,8,259.92,4.8
"2011","Carmarthenshire 026H","W01001924","Total",1333,645,688,1333,0,6,34.58,38.5
"2011","Carmarthenshire 027E","W01000672","Total",1629,799,830,1629,0,28,7521.11,0.2
"2011","Carmarthenshire 027F","W01000673","Total",1222,598,624,1220,2,20,2571.67,0.5
"2011","Carmarthenshire 027A","W01000674","Total",2087,1080,1007,2067,20,35,10237.80,0.2
"2011","Carmarthenshire 027G","W01000700","Total",2006,969,1037,2001,5,35,5885.92,0.3
"2011","Carmarthenshire 027B","W01000720","Total",1632,802,830,1564,68,33,1334.14,1.2
"2011","Carmarthenshire 027C","W01000721","Total",1363,639,724,1342,21,24,1721.71,0.8
"2011","Carmarthenshire 027D","W01000735","Total",2272,1115,1157,2272,0,25,2242.31,1.0
"2011","Swansea 001A","W01000845","Total",2048,972,1076,2024,24,24,363.62,5.6
"2011","Swansea 001B","W01000846","Total",1730,847,883,1730,0,9,98.99,17.5
"2011","Swansea 001C","W01000847","Total",1306,665,641,1266,40,13,1045.41,1.2
"2011","Swansea 001D","W01000848","Total",1197,568,629,1197,0,8,50.28,23.8
"2011","Swansea 002A","W01000750","Total",1552,727,825,1545,7,12,233.70,6.6
"2011","Swansea 002B","W01000751","Total",1422,691,731,1407,15,14,420.19,3.4
"2011","Swansea 002C","W01000752","Total",1518,727,791,1518,0,5,58.23,26.1
"2011","Swansea 002D","W01000753","Total",1420,666,754,1420,0,23,61.68,23.0
"2011","Swansea 002E","W01000754","Total",1591,778,813,1576,15,11,74.21,21.4
"2011","Swansea 002F","W01000803","Total",1850,954,896,1850,0,19,5780.82,0.3
"2011","Swansea 003A","W01000806","Total",1515,730,785,1514,1,8,47.66,31.8
"2011","Swansea 003B","W01000807","Total",1421,714,707,1421,0,13,37.96,37.4
"2011","Swansea 003C","W01000808","Total",1465,701,764,1436,29,13,57.38,25.5
"2011","Swansea 003D","W01000810","Total",1376,644,732,1376,0,7,29.16,47.2
"2011","Swansea 003E","W01000815","Total",1599,790,809,1592,7,33,171.02,9.3
"2011","Swansea 003F","W01000816","Total",1735,852,883,1734,1,27,170.71,10.2
"2011","Swansea 004A","W01000791","Total",1504,736,768,1504,0,21,30.91,48.7
"2011","Swansea 004B","W01000792","Total",1645,795,850,1645,0,16,505.40,3.3
"2011","Swansea 004C","W01000793","Total",1890,930,960,1887,3,15,1175.15,1.6
"2011","Swansea 004D","W01000837","Total",1624,797,827,1610,14,27,341.61,4.8
"2011","Swansea 004E","W01000838","Total",1244,589,655,1244,0,7,259.62,4.8
"2011","Swansea 005A","W01000773","Total",2663,1312,1351,2663,0,19,178.66,14.9
"2011","Swansea 005B","W01000774","Total",1638,810,828,1614,24,18,47.11,34.8
"2011","Swansea 005C","W01000841","Total",1479,732,747,1479,0,15,30.95,47.8
"2011","Swansea 005D","W01000842","Total",1424,686,738,1379,45,8,484.73,2.9
"2011","Swansea 005E","W01000843","Total",1379,673,706,1377,2,13,37.69,36.6
"2011","Swansea 005F","W01000844","Total",1241,619,622,1188,53,18,311.37,4.0
"2011","Swansea 006A","W01000795","Total",1621,806,815,1617,4,22,344.28,4.7
"2011","Swansea 006B","W01000796","Total",2723,1358,1365,2720,3,13,246.63,11.0
"2011","Swansea 006C","W01000800","Total",1500,709,791,1460,40,26,284.66,5.3
"2011","Swansea 006D","W01000801","Total",1548,747,801,1548,0,9,31.86,48.6
"2011","Swansea 007A","W01000784","Total",1317,617,700,1317,0,16,29.21,45.1
"2011","Swansea 007B","W01000785","Total",1316,664,652,1316,0,18,94.67,13.9
"2011","Swansea 007C","W01000786","Total",1375,662,713,1346,29,11,357.63,3.8
"2011","Swansea 007D","W01000802","Total",2355,1148,1207,2355,0,14,104.09,22.6
"2011","Swansea 007E","W01000877","Total",1548,771,777,1548,0,28,121.05,12.8
"2011","Swansea 007F","W01000878","Total",1223,587,636,1223,0,13,40.81,30.0
"2011","Swansea 008A","W01000809","Total",1604,770,834,1571,33,14,43.63,36.8
"2011","Swansea 008B","W01000811","Total",1590,808,782,1590,0,14,32.90,48.3
"2011","Swansea 008C","W01000812","Total",1434,711,723,1416,18,4,51.68,27.7
"2011","Swansea 008D","W01000813","Total",1624,803,821,1618,6,10,50.74,32.0
"2011","Swansea 008E","W01000814","Total",1565,777,788,1499,66,8,41.78,37.5
"2011","Swansea 009A","W01000817","Total",1769,836,933,1769,0,14,67.45,26.2
"2011","Swansea 009B","W01000818","Total",1536,725,811,1536,0,5,58.70,26.2
"2011","Swansea 009C","W01000819","Total",1437,711,726,1437,0,13,51.82,27.7
"2011","Swansea 009D","W01000820","Total",1395,691,704,1363,32,5,40.53,34.4
"2011","Swansea 009E","W01000821","Total",1494,721,773,1461,33,5,37.74,39.6
"2011","Swansea 009F","W01000822","Total",1241,616,625,1236,5,4,101.02,12.3
"2011","Swansea 010A","W01000794","Total",2176,1078,1098,2172,4,17,453.15,4.8
"2011","Swansea 010B","W01000797","Total",1514,736,778,1509,5,8,96.71,15.7
"2011","Swansea 010C","W01000798","Total",1416,681,735,1416,0,9,42.26,33.5
"2011","Swansea 010D","W01000799","Total",1935,933,1002,1935,0,9,58.47,33.1
"2011","Swansea 011A","W01000830","Total",1693,794,899,1693,0,6,39.36,43.0
"2011","Swansea 011B","W01000832","Total",1604,820,784,1604,0,15,51.05,31.4
"2011","Swansea 011C","W01000833","Total",1750,847,903,1750,0,6,38.35,45.6
"2011","Swansea 011D","W01000834","Total",1545,709,836,1545,0,11,91.87,16.8
"2011","Swansea 011E","W01000836","Total",2274,1080,1194,2263,11,14,117.34,19.4
"2011","Swansea 012A","W01000759","Total",1566,753,813,1476,90,17,108.63,14.4
"2011","Swansea 012B","W01000777","Total",1782,844,938,1782,0,20,101.63,17.5
"2011","Swansea 012C","W01000778","Total",1890,915,975,1879,11,24,67.29,28.1
"2011","Swansea 012D","W01000779","Total",1540,759,781,1540,0,28,595.73,2.6
"2011","Swansea 013A","W01000760","Total",1670,820,850,1670,0,8,183.02,9.1
"2011","Swansea 013B","W01000761","Total",1569,784,785,1569,0,9,52.66,29.8
"2011","Swansea 013C","W01000762","Total",1594,797,797,1594,0,23,34.36,46.4
"2011","Swansea 013D","W01000831","Total",1806,850,956,1806,0,13,32.60,55.4
"2011","Swansea 013E","W01000835","Total",1447,649,798,1420,27,2,34.43,42.0
"2011","Swansea 014A","W01000738","Total",1768,851,917,1768,0,11,481.30,3.7
"2011","Swansea 014B","W01000739","Total",1840,921,919,1840,0,8,74.60,24.7
"2011","Swansea 014C","W01000740","Total",1658,773,885,1557,101,13,87.47,19.0
"2011","Swansea 014D","W01000741","Total",1591,748,843,1567,24,9,203.99,7.8
"2011","Swansea 015A","W01000763","Total",1524,723,801,1524,0,18,15.32,99.5
"2011","Swansea 015B","W01000764","Total",1649,836,813,1649,0,14,46.61,35.4
"2011","Swansea 015C","W01000765","Total",1660,839,821,1658,2,13,21.63,76.7
"2011","Swansea 015D","W01000766","Total",1585,740,845,1576,9,15,30.28,52.3
"2011","Swansea 015E","W01000767","Total",1554,763,791,1519,35,8,36.51,42.6
"2011","Swansea 016A","W01000742","Total",1581,827,754,1547,34,5,34.13,46.3
"2011","Swansea 016B","W01000744","Total",1492,763,729,1492,0,6,23.63,63.1
"2011","Swansea 016C","W01000787","Total",1551,790,761,1521,30,11,80.97,19.2
"2011","Swansea 016D","W01000788","Total",1456,722,734,1440,16,6,79.82,18.2
"2011","Swansea 016E","W01000789","Total",1423,685,738,1423,0,11,28.60,49.8
"2011","Swansea 016F","W01000790","Total",1738,883,855,1732,6,11,40.35,43.1
"2011","Swansea 017A","W01000755","Total",1957,950,1007,1957,0,8,65.70,29.8
"2011","Swansea 017B","W01000756","Total",1597,777,820,1591,6,13,260.42,6.1
"2011","Swansea 017C","W01000757","Total",1492,685,807,1485,7,22,100.88,14.8
"2011","Swansea 017D","W01000758","Total",1917,962,955,1894,23,16,53.87,35.6
"2011","Swansea 018A","W01000772","Total",1583,742,841,1583,0,27,842.86,1.9
"2011","Swansea 018B","W01000828","Total",1722,851,871,1722,0,34,1081.75,1.6
"2011","Swansea 018C","W01000829","Total",1913,920,993,1885,28,34,330.25,5.8
"2011","Swansea 019A","W01000862","Total",1599,748,851,1599,0,10,37.28,42.9
"2011","Swansea 019B","W01000863","Total",1586,773,813,1586,0,17,30.84,51.4
"2011","Swansea 019C","W01000864","Total",1651,794,857,1651,0,14,36.98,44.6
"2011","Swansea 019D","W01000865","Total",1352,623,729,1352,0,6,29.78,45.4
"2011","Swansea 019E","W01000866","Total",1209,558,651,1209,0,9,22.19,54.5
"2011","Swansea 019F","W01000867","Total",1299,589,710,1299,0,6,23.74,54.7
"2011","Swansea 020A","W01000768","Total",1395,691,704,1393,2,19,105.04,13.3
"2011","Swansea 020B","W01000769","Total",1412,666,746,1412,0,22,98.12,14.4
"2011","Swansea 020C","W01000770","Total",1576,786,790,1576,0,22,37.85,41.6
"2011","Swansea 020D","W01000771","Total",1331,659,672,1331,0,13,525.71,2.5
"2011","Swansea 021A","W01000849","Total",1872,911,961,1872,0,8,253.71,7.4
"2011","Swansea 021B","W01000850","Total",2260,1217,1043,2260,0,8,176.34,12.8
"2011","Swansea 021C","W01000851","Total",1544,752,792,1544,0,7,136.99,11.3
"2011","Swansea 021D","W01000852","Total",1511,737,774,1511,0,6,32.78,46.1
"2011","Swansea 022A","W01000853","Total",1470,737,733,1450,20,26,60.51,24.3
"2011","Swansea 022B","W01000854","Total",1418,705,713,1310,108,29,104.38,13.6
"2011","Swansea 022C","W01000855","Total",1517,733,784,1484,33,23,41.96,36.2
"2011","Swansea 022D","W01000856","Total",1765,864,901,1726,39,20,47.84,36.9
"2011","Swansea 022E","W01000857","Total",1785,836,949,1752,33,21,33.39,53.5
"2011","Swansea 023B","W01000781","Total",1701,814,887,1701,0,32,42.13,40.4
"2011","Swansea 023C","W01000782","Total",1080,514,566,1080,0,18,30.24,35.7
"2011","Swansea 023E","W01001956","Total",2921,1492,1429,1780,1141,68,250.03,11.7
"2011","Swansea 024A","W01000747","Total",1944,1135,809,1870,74,11,15.04,129.3
"2011","Swansea 024B","W01000868","Total",1348,652,696,1118,230,33,36.11,37.3
"2011","Swansea 024C","W01000869","Total",1590,840,750,1543,47,22,38.12,41.7
"2011","Swansea 024D","W01000870","Total",1611,834,777,1524,87,27,26.21,61.5
"2011","Swansea 024E","W01000872","Total",1384,668,716,1384,0,26,21.93,63.1
"2011","Swansea 024F","W01000874","Total",2085,1094,991,2085,0,26,22.80,91.4
"2011","Swansea 025B","W01000745","Total",2259,1329,930,2213,46,20,34.56,65.4
"2011","Swansea 025C","W01000746","Total",1705,923,782,1659,46,12,26.64,64.0
"2011","Swansea 025E","W01001938","Total",1169,716,453,1154,15,16,32.24,36.3
"2011","Swansea 025F","W01001955","Total",1555,942,613,1501,54,8,68.72,22.6
"2011","Swansea 025G","W01001957","Total",1036,669,367,800,236,11,21.38,48.5
"2011","Swansea 025H","W01001958","Total",1282,750,532,1282,0,9,31.22,41.1
"2011","Swansea 026A","W01000749","Total",1860,944,916,1853,7,4,20.20,92.1
"2011","Swansea 026B","W01000871","Total",1765,991,774,1765,0,19,17.51,100.8
"2011","Swansea 026C","W01000873","Total",1809,985,824,1713,96,19,32.88,55.0
"2011","Swansea 026D","W01000875","Total",2023,1131,892,2015,8,15,22.57,89.6
"2011","Swansea 026E","W01000876","Total",2050,1106,944,2050,0,14,11.94,171.7
"2011","Swansea 027A","W01000858","Total",1629,808,821,1629,0,59,33.76,48.3
"2011","Swansea 027B","W01000859","Total",1415,667,748,1415,0,35,87.10,16.2
"2011","Swansea 027C","W01000860","Total",1489,718,771,1461,28,31,151.86,9.8
"2011","Swansea 027D","W01000861","Total",1813,867,946,905,908,35,119.49,15.2
"2011","Swansea 028A","W01000736","Total",1715,822,893,1715,0,42,286.97,6.0
"2011","Swansea 028B","W01000737","Total",1536,719,817,1466,70,32,309.68,5.0
"2011","Swansea 028C","W01000804","Total",1483,700,783,1480,3,18,364.84,4.1
"2011","Swansea 028D","W01000805","Total",1193,573,620,1193,0,35,86.58,13.8
"2011","Swansea 029A","W01000879","Total",1758,839,919,1758,0,36,74.02,23.8
"2011","Swansea 029B","W01000880","Total",1579,764,815,1572,7,24,57.26,27.6
"2011","Swansea 029C","W01000881","Total",1382,661,721,1331,51,17,38.97,35.5
"2011","Swansea 029D","W01000882","Total",1729,795,934,1729,0,20,78.25,22.1
"2011","Swansea 030A","W01000775","Total",1843,905,938,1811,32,17,5231.57,0.4
"2011","Swansea 030B","W01000776","Total",1853,925,928,1773,80,44,6252.05,0.3
"2011","Swansea 030C","W01000839","Total",1011,497,514,1010,1,15,779.20,1.3
"2011","Swansea 030D","W01000840","Total",1677,829,848,1655,22,32,386.55,4.3
"2011","Swansea 031A","W01000823","Total",1728,802,926,1712,16,33,71.33,24.2
"2011","Swansea 031B","W01000824","Total",1588,748,840,1504,84,38,165.47,9.6
"2011","Swansea 031C","W01000825","Total",1437,683,754,1436,1,15,36.23,39.7
"2011","Swansea 031D","W01000826","Total",1365,649,716,1350,15,17,125.01,10.9
"2011","Swansea 031E","W01000827","Total",1358,665,693,1356,2,33,43.38,31.3
"2011","Neath Port Talbot 002A","W01000918","Total",1910,925,985,1906,4,18,2169.60,0.9
"2011","Neath Port Talbot 002B","W01000944","Total",1194,601,593,1191,3,10,1082.63,1.1
"2011","Neath Port Talbot 002C","W01000965","Total",2123,1052,1071,2094,29,4,1165.21,1.8
"2011","Neath Port Talbot 003A","W01000893","Total",1989,978,1011,1989,0,14,1489.64,1.3
"2011","Neath Port Talbot 003B","W01000925","Total",1571,773,798,1536,35,6,1921.06,0.8
"2011","Neath Port Talbot 003C","W01000926","Total",1859,921,938,1859,0,22,674.07,2.8
"2011","Neath Port Talbot 004A","W01000888","Total",2327,1151,1176,2295,32,29,438.33,5.3
"2011","Neath Port Talbot 004B","W01000946","Total",1604,778,826,1522,82,20,2708.77,0.6
"2011","Neath Port Talbot 004C","W01000947","Total",2033,984,1049,2033,0,20,70.87,28.7
"2011","Neath Port Talbot 004D","W01000948","Total",1784,911,873,1765,19,18,123.15,14.5
"2011","Neath Port Talbot 004E","W01000955","Total",1262,619,643,1261,1,17,1563.76,0.8
"2011","Neath Port Talbot 004F","W01000956","Total",1180,574,606,1180,0,13,59.49,19.8
"2011","Neath Port Talbot 004G","W01000971","Total",1411,683,728,1398,13,10,192.17,7.3
"2011","Neath Port Talbot 005A","W01000887","Total",2400,1182,1218,2400,0,30,954.50,2.5
"2011","Neath Port Talbot 005B","W01000953","Total",1720,855,865,1720,0,7,1120.05,1.5
"2011","Neath Port Talbot 005C","W01000954","Total",1415,697,718,1415,0,12,1854.48,0.8
"2011","Neath Port Talbot 005D","W01000970","Total",1239,592,647,1157,82,6,62.16,19.9
"2011","Neath Port Talbot 006A","W01000902","Total",1060,503,557,1018,42,8,488.48,2.2
"2011","Neath Port Talbot 006B","W01000903","Total",1116,528,588,1116,0,24,86.96,12.8
"2011","Neath Port Talbot 006C","W01000904","Total",1529,753,776,1529,0,39,42.45,36.0
"2011","Neath Port Talbot 006D","W01000905","Total",1563,754,809,1556,7,18,30.34,51.5
"2011","Neath Port Talbot 006E","W01000908","Total",1684,835,849,1681,3,20,415.42,4.1
"2011","Neath Port Talbot 007A","W01000906","Total",1047,503,544,1035,12,21,70.42,14.9
"2011","Neath Port Talbot 007B","W01000907","Total",1752,840,912,1750,2,12,40.88,42.9
"2011","Neath Port Talbot 007C","W01000922","Total",1690,826,864,1670,20,6,166.94,10.1
"2011","Neath Port Talbot 007D","W01000923","Total",1472,734,738,1472,0,11,522.51,2.8
"2011","Neath Port Talbot 008A","W01000934","Total",1263,627,636,1263,0,7,22.20,56.9
"2011","Neath Port Talbot 008B","W01000935","Total",1580,810,770,1580,0,11,23.06,68.5
"2011","Neath Port Talbot 008C","W01000938","Total",1396,660,736,1324,72,21,35.86,38.9
"2011","Neath Port Talbot 008D","W01000939","Total",1262,642,620,1222,40,12,47.42,26.6
"2011","Neath Port Talbot 008E","W01000940","Total",1284,608,676,1284,0,6,82.67,15.5
"2011","Neath Port Talbot 009A","W01000909","Total",1216,556,660,1151,65,7,60.20,20.2
"2011","Neath Port Talbot 009B","W01000910","Total",1470,712,758,1470,0,23,131.70,11.2
"2011","Neath Port Talbot 009C","W01000911","Total",1254,623,631,1254,0,21,198.31,6.3
"2011","Neath Port Talbot 009D","W01000969","Total",1260,620,640,1260,0,18,692.50,1.8
"2011","Neath Port Talbot 010A","W01000912","Total",1229,566,663,1162,67,6,31.25,39.3
"2011","Neath Port Talbot 010B","W01000913","Total",1162,562,600,1158,4,7,26.15,44.4
"2011","Neath Port Talbot 010C","W01000914","Total",1599,759,840,1563,36,6,65.56,24.4
"2011","Neath Port Talbot 010D","W01000915","Total",1205,589,616,1205,0,5,27.72,43.5
"2011","Neath Port Talbot 010E","W01000916","Total",1206,620,586,1162,44,15,142.18,8.5
"2011","Neath Port Talbot 010F","W01000917","Total",2652,1308,1344,2650,2,23,1319.99,2.0
"2011","Neath Port Talbot 011A","W01000920","Total",1256,644,612,1256,0,10,2128.12,0.6
"2011","Neath Port Talbot 011B","W01000921","Total",1569,763,806,1544,25,8,233.31,6.7
"2011","Neath Port Talbot 011C","W01000924","Total",1096,548,548,1096,0,0,1992.85,0.5
"2011","Neath Port Talbot 011D","W01000930","Total",1362,671,691,1362,0,4,1241.22,1.1
"2011","Neath Port Talbot 012A","W01000936","Total",1518,743,775,1518,0,6,124.91,12.2
"2011","Neath Port Talbot 012B","W01000941","Total",1541,756,785,1522,19,12,50.96,30.2
"2011","Neath Port Talbot 012C","W01000942","Total",1887,925,962,1887,0,6,58.08,32.5
"2011","Neath Port Talbot 012D","W01000943","Total",1547,772,775,1547,0,17,40.47,38.2
"2011","Neath Port Talbot 013A","W01000894","Total",1370,653,717,1355,15,15,363.28,3.8
"2011","Neath Port Talbot 013B","W01000895","Total",1539,772,767,1539,0,5,133.74,11.5
"2011","Neath Port Talbot 013C","W01000896","Total",1686,781,905,1686,0,8,135.77,12.4
"2011","Neath Port Talbot 013D","W01000897","Total",1316,643,673,1316,0,11,149.21,8.8
"2011","Neath Port Talbot 013E","W01000937","Total",2040,1033,1007,2025,15,19,141.37,14.4
"2011","Neath Port Talbot 014A","W01000898","Total",1470,738,732,1468,2,15,1732.55,0.8
"2011","Neath Port Talbot 014B","W01000899","Total",1679,811,868,1679,0,26,58.92,28.5
"2011","Neath Port Talbot 014C","W01000900","Total",1709,835,874,1674,35,15,242.02,7.1
"2011","Neath Port Talbot 014D","W01000901","Total",1680,802,878,1680,0,17,282.87,5.9
"2011","Neath Port Talbot 014E","W01000945","Total",1152,577,575,1152,0,3,2000.68,0.6
"2011","Neath Port Talbot 015A","W01000889","Total",1789,874,915,1789,0,22,325.27,5.5
"2011","Neath Port Talbot 015B","W01000890","Total",1656,806,850,1656,0,24,109.00,15.2
"2011","Neath Port Talbot 015C","W01000891","Total",1515,724,791,1465,50,8,46.45,32.6
"2011","Neath Port Talbot 015D","W01000892","Total",1859,901,958,1859,0,11,421.14,4.4
"2011","Neath Port Talbot 016A","W01000883","Total",1404,706,698,1404,0,10,90.69,15.5
"2011","Neath Port Talbot 016B","W01000958","Total",1679,777,902,1605,74,17,30.61,54.9
"2011","Neath Port Talbot 016C","W01000961","Total",1611,781,830,1611,0,12,47.49,33.9
"2011","Neath Port Talbot 016D","W01000962","Total",1577,757,820,1577,0,10,23.93,65.9
"2011","Neath Port Talbot 016E","W01000963","Total",1792,821,971,1789,3,6,38.32,46.8
"2011","Neath Port Talbot 016F","W01000964","Total",1745,832,913,1736,9,2,62.11,28.1
"2011","Neath Port Talbot 017A","W01000884","Total",1244,639,605,1244,0,6,27.59,45.1
"2011","Neath Port Talbot 017B","W01000885","Total",1325,629,696,1320,5,8,79.22,16.7
"2011","Neath Port Talbot 017C","W01000886","Total",1479,754,725,1478,1,8,27.45,53.9
"2011","Neath Port Talbot 017D","W01000957","Total",1676,777,899,1642,34,11,44.76,37.4
"2011","Neath Port Talbot 017E","W01000959","Total",1818,913,905,1818,0,12,56.42,32.2
"2011","Neath Port Talbot 017F","W01000960","Total",1722,839,883,1722,0,11,35.43,48.6
"2011","Neath Port Talbot 018A","W01000949","Total",1337,670,667,1337,0,20,290.97,4.6
"2011","Neath Port Talbot 018B","W01000950","Total",1550,772,778,1550,0,5,42.00,36.9
"2011","Neath Port Talbot 018C","W01000951","Total",1583,804,779,1538,45,15,33.95,46.6
"2011","Neath Port Talbot 018D","W01000952","Total",1171,555,616,1171,0,12,26.10,44.9
"2011","Neath Port Talbot 018E","W01000966","Total",1432,738,694,1413,19,12,475.72,3.0
"2011","Neath Port Talbot 019A","W01000932","Total",1043,526,517,1043,0,8,657.34,1.6
"2011","Neath Port Talbot 019B","W01000933","Total",1974,953,1021,1973,1,32,4255.27,0.5
"2011","Neath Port Talbot 019C","W01000967","Total",1470,713,757,1470,0,10,30.07,48.9
"2011","Neath Port Talbot 019D","W01000968","Total",1897,925,972,1897,0,16,44.90,42.2
"2011","Neath Port Talbot 020A","W01000919","Total",1172,579,593,1170,2,16,930.22,1.3
"2011","Neath Port Talbot 020B","W01000927","Total",1644,785,859,1644,0,7,307.10,5.4
"2011","Neath Port Talbot 020C","W01000928","Total",1603,784,819,1566,37,17,186.52,8.6
"2011","Neath Port Talbot 020D","W01000929","Total",1307,671,636,1307,0,11,387.15,3.4
"2011","Neath Port Talbot 020E","W01000931","Total",1330,663,667,1330,0,6,791.19,1.7
"2011","Neath Port Talbot 020F","W01000973","Total",1480,731,749,1457,23,14,66.84,22.1
"2011","Neath Port Talbot 020G","W01001900","Total",1539,770,769,1539,0,13,603.29,2.6
"2011","Bridgend 001A","W01000991","Total",1131,556,575,1131,0,5,172.61,6.6
"2011","Bridgend 001B","W01000992","Total",1505,736,769,1505,0,2,59.53,25.3
"2011","Bridgend 001C","W01000993","Total",1525,764,761,1525,0,6,30.75,49.6
"2011","Bridgend 001D","W01000994","Total",1398,698,700,1398,0,5,994.61,1.4
"2011","Bridgend 001E","W01000995","Total",1436,685,751,1436,0,10,198.94,7.2
"2011","Bridgend 002A","W01001014","Total",1640,801,839,1640,0,15,54.51,30.1
"2011","Bridgend 002B","W01001015","Total",1475,699,776,1473,2,15,401.69,3.7
"2011","Bridgend 002C","W01001017","Total",1477,707,770,1477,0,18,81.92,18.0
"2011","Bridgend 002D","W01001018","Total",1387,696,691,1387,0,12,29.38,47.2
"2011","Bridgend 002E","W01001020","Total",1436,715,721,1436,0,5,61.93,23.2
"2011","Bridgend 003A","W01000976","Total",1105,526,579,1105,0,10,1043.31,1.1
"2011","Bridgend 003B","W01000977","Total",1388,694,694,1388,0,5,635.75,2.2
"2011","Bridgend 003C","W01001024","Total",1144,568,576,1144,0,6,595.67,1.9
"2011","Bridgend 003D","W01001025","Total",1200,568,632,1200,0,2,424.49,2.8
"2011","Bridgend 003E","W01001033","Total",1738,837,901,1738,0,10,916.58,1.9
"2011","Bridgend 003F","W01001034","Total",1379,679,700,1379,0,9,231.16,6.0
"2011","Bridgend 004A","W01000975","Total",2253,1096,1157,2253,0,23,468.62,4.8
"2011","Bridgend 004B","W01000978","Total",1789,888,901,1789,0,14,808.57,2.2
"2011","Bridgend 004C","W01001009","Total",1243,642,601,1243,0,10,1182.27,1.1
"2011","Bridgend 004D","W01001042","Total",1338,676,662,1338,0,9,549.89,2.4
"2011","Bridgend 004E","W01001043","Total",1161,567,594,1161,0,6,80.52,14.4
"2011","Bridgend 005A","W01001012","Total",1563,791,772,1563,0,22,1206.39,1.3
"2011","Bridgend 005B","W01001013","Total",1469,709,760,1469,0,14,144.93,10.1
"2011","Bridgend 005C","W01001016","Total",1658,817,841,1658,0,9,96.98,17.1
"2011","Bridgend 005D","W01001019","Total",1512,751,761,1511,1,12,537.73,2.8
"2011","Bridgend 006A","W01000974","Total",2039,1022,1017,2039,0,24,1227.75,1.7
"2011","Bridgend 006B","W01001057","Total",1435,703,732,1415,20,6,118.68,12.1
"2011","Bridgend 006C","W01001058","Total",1932,929,1003,1903,29,16,72.66,26.6
"2011","Bridgend 007A","W01000986","Total",1319,639,680,1319,0,19,731.12,1.8
"2011","Bridgend 007B","W01000987","Total",2252,1102,1150,2252,0,9,158.94,14.2
"2011","Bridgend 007C","W01001055","Total",1225,609,616,1225,0,3,38.34,32.0
"2011","Bridgend 007D","W01001056","Total",1218,609,609,1218,0,12,105.22,11.6
"2011","Bridgend 008A","W01000996","Total",1481,713,768,1481,0,9,747.58,2.0
"2011","Bridgend 008B","W01001048","Total",1401,700,701,1401,0,10,85.69,16.3
"2011","Bridgend 008C","W01001049","Total",1315,640,675,1315,0,8,36.46,36.1
"2011","Bridgend 008D","W01001050","Total",1539,759,780,1539,0,9,85.04,18.1
"2011","Bridgend 008E","W01001051","Total",1796,920,876,1782,14,25,78.18,23.0
"2011","Bridgend 008F","W01001052","Total",1354,646,708,1354,0,6,37.79,35.8
"2011","Bridgend 009A","W01001004","Total",1086,552,534,1086,0,5,100.27,10.8
"2011","Bridgend 009B","W01001005","Total",1688,834,854,1657,31,13,151.21,11.2
"2011","Bridgend 009C","W01001006","Total",2377,1179,1198,2377,0,24,94.01,25.3
"2011","Bridgend 009D","W01001007","Total",1748,885,863,1748,0,14,220.21,7.9
"2011","Bridgend 009E","W01001039","Total",1664,841,823,1664,0,14,372.92,4.5
"2011","Bridgend 009F","W01001040","Total",1491,759,732,1491,0,13,1458.41,1.0
"2011","Bridgend 010A","W01000999","Total",1385,653,732,1381,4,12,79.98,17.3
"2011","Bridgend 010B","W01001000","Total",1776,854,922,1713,63,19,1454.50,1.2
"2011","Bridgend 010C","W01001001","Total",1449,696,753,1449,0,14,48.08,30.1
"2011","Bridgend 010D","W01001002","Total",2449,1209,1240,2449,0,11,78.75,31.1
"2011","Bridgend 011A","W01000998","Total",2593,1963,630,1215,1378,16,563.95,4.6
"2011","Bridgend 011B","W01001008","Total",2147,1056,1091,2147,0,41,121.00,17.7
"2011","Bridgend 011C","W01001038","Total",2221,1047,1174,2166,55,28,68.06,32.6
"2011","Bridgend 012A","W01000997","Total",1537,743,794,1537,0,24,73.38,20.9
"2011","Bridgend 012B","W01001010","Total",1219,577,642,1219,0,14,57.19,21.3
"2011","Bridgend 012C","W01001011","Total",1384,694,690,1384,0,21,23.94,57.8
"2011","Bridgend 012D","W01001026","Total",1995,977,1018,1967,28,14,57.63,34.6
"2011","Bridgend 013A","W01000989","Total",1413,681,732,1413,0,27,2161.53,0.7
"2011","Bridgend 013B","W01001037","Total",1593,764,829,1539,54,39,251.28,6.3
"2011","Bridgend 013C","W01001041","Total",2447,1210,1237,2336,111,43,323.69,7.6
"2011","Bridgend 014A","W01001021","Total",1603,810,793,1594,9,13,42.94,37.3
"2011","Bridgend 014B","W01001022","Total",1393,683,710,1393,0,4,23.26,59.9
"2011","Bridgend 014C","W01001023","Total",1696,851,845,1696,0,10,50.80,33.4
"2011","Bridgend 014D","W01001028","Total",1855,904,951,1846,9,35,73.11,25.4
"2011","Bridgend 014E","W01001035","Total",1622,835,787,1608,14,14,47.74,34.0
"2011","Bridgend 015A","W01000979","Total",1702,829,873,1702,0,13,41.50,41.0
"2011","Bridgend 015B","W01000983","Total",1539,776,763,1539,0,15,31.12,49.5
"2011","Bridgend 015C","W01000985","Total",1399,684,715,1399,0,38,33.90,41.3
"2011","Bridgend 015D","W01001003","Total",1365,635,730,1278,87,19,681.03,2.0
"2011","Bridgend 016A","W01000980","Total",1383,699,684,1383,0,17,29.97,46.1
"2011","Bridgend 016B","W01000981","Total",1186,537,649,1186,0,14,23.66,50.1
"2011","Bridgend 016C","W01000982","Total",1500,731,769,1459,41,27,49.41,30.4
"2011","Bridgend 016D","W01000984","Total",2157,1076,1081,2157,0,34,36.45,59.2
"2011","Bridgend 017B","W01000990","Total",1519,735,784,1519,0,10,45.03,33.7
"2011","Bridgend 017C","W01001027","Total",1571,733,838,1571,0,32,31.61,49.7
"2011","Bridgend 017D","W01001036","Total",1584,759,825,1541,43,49,71.88,22.0
"2011","Bridgend 017E","W01001918","Total",1593,793,800,1593,0,27,36.04,44.2
"2011","Bridgend 017F","W01001919","Total",1405,687,718,1405,0,15,31.67,44.4
"2011","Bridgend 017G","W01001920","Total",1206,607,599,1206,0,17,30.97,38.9
"2011","Bridgend 017H","W01001921","Total",1577,764,813,1577,0,24,31.69,49.8
"2011","Bridgend 018A","W01001031","Total",1524,695,829,1445,79,36,92.07,16.6
"2011","Bridgend 018B","W01001032","Total",1769,831,938,1769,0,39,319.71,5.5
"2011","Bridgend 018C","W01001046","Total",1775,848,927,1727,48,15,38.57,46.0
"2011","Bridgend 018D","W01001047","Total",1674,816,858,1669,5,26,52.73,31.7
"2011","Bridgend 018E","W01001053","Total",1010,499,511,1010,0,15,26.20,38.5
"2011","Bridgend 018F","W01001054","Total",1257,572,685,1181,76,28,171.89,7.3
"2011","Bridgend 019A","W01001029","Total",1799,872,927,1717,82,23,339.69,5.3
"2011","Bridgend 019B","W01001030","Total",1809,860,949,1763,46,21,120.97,15.0
"2011","Bridgend 019C","W01001044","Total",1663,811,852,1663,0,29,100.67,16.5
"2011","Bridgend 019D","W01001045","Total",1725,826,899,1718,7,26,76.29,22.6
"2011","The Vale of Glamorgan 001A","W01001105","Total",2643,1313,1330,2643,0,75,4241.39,0.6
"2011","The Vale of Glamorgan 001B","W01001127","Total",1199,586,613,1199,0,32,1399.88,0.9
"2011","The Vale of Glamorgan 001C","W01001128","Total",1439,714,725,1439,0,59,1303.66,1.1
"2011","The Vale of Glamorgan 002A","W01001082","Total",1500,715,785,1500,0,36,77.11,19.5
"2011","The Vale of Glamorgan 002B","W01001083","Total",1611,796,815,1592,19,49,1216.15,1.3
"2011","The Vale of Glamorgan 002C","W01001084","Total",1563,728,835,1534,29,50,943.39,1.7
"2011","The Vale of Glamorgan 002D","W01001085","Total",1506,765,741,1506,0,46,2067.93,0.7
"2011","The Vale of Glamorgan 003A","W01001113","Total",2289,1147,1142,2272,17,62,4390.71,0.5
"2011","The Vale of Glamorgan 003B","W01001119","Total",1731,848,883,1725,6,44,3304.55,0.5
"2011","The Vale of Glamorgan 003C","W01001135","Total",1494,721,773,1494,0,42,2918.02,0.5
"2011","The Vale of Glamorgan 003D","W01001136","Total",1165,556,609,1140,25,20,206.01,5.7
"2011","The Vale of Glamorgan 004A","W01001075","Total",1197,557,640,1197,0,23,21.54,55.6
"2011","The Vale of Glamorgan 004B","W01001076","Total",1461,696,765,1461,0,9,31.10,47.0
"2011","The Vale of Glamorgan 004C","W01001077","Total",1432,664,768,1391,41,19,68.40,20.9
"2011","The Vale of Glamorgan 004D","W01001078","Total",1263,605,658,1263,0,16,20.66,61.1
"2011","The Vale of Glamorgan 004E","W01001104","Total",1977,968,1009,1950,27,26,161.76,12.2
"2011","The Vale of Glamorgan 004F","W01001129","Total",1384,671,713,1384,0,21,33.32,41.5
"2011","The Vale of Glamorgan 005A","W01001116","Total",2101,969,1132,1876,225,70,52.67,39.9
"2011","The Vale of Glamorgan 005B","W01001123","Total",1633,798,835,1598,35,32,38.63,42.3
"2011","The Vale of Glamorgan 005C","W01001124","Total",1463,745,718,1463,0,20,18.18,80.5
"2011","The Vale of Glamorgan 005D","W01001125","Total",1471,720,751,1417,54,19,30.21,48.7
"2011","The Vale of Glamorgan 005E","W01001126","Total",1911,1009,902,1908,3,12,52.69,36.3
"2011","The Vale of Glamorgan 005F","W01001130","Total",1279,627,652,1279,0,33,25.63,49.9
"2011","The Vale of Glamorgan 006A","W01001086","Total",1491,726,765,1485,6,38,575.14,2.6
"2011","The Vale of Glamorgan 006B","W01001087","Total",1543,746,797,1543,0,29,38.28,40.3
"2011","The Vale of Glamorgan 006C","W01001088","Total",1827,848,979,1826,1,9,76.68,23.8
"2011","The Vale of Glamorgan 006D","W01001089","Total",1468,694,774,1427,41,19,359.80,4.1
"2011","The Vale of Glamorgan 006E","W01001090","Total",1470,708,762,1470,0,22,909.92,1.6
"2011","The Vale of Glamorgan 007A","W01001081","Total",1552,715,837,1532,20,5,34.00,45.6
"2011","The Vale of Glamorgan 007B","W01001092","Total",1706,813,893,1677,29,21,60.22,28.3
"2011","The Vale of Glamorgan 007C","W01001094","Total",1333,592,741,1333,0,8,23.86,55.9
"2011","The Vale of Glamorgan 007D","W01001095","Total",1509,696,813,1509,0,12,31.79,47.5
"2011","The Vale of Glamorgan 007E","W01001096","Total",1374,667,707,1372,2,15,28.08,48.9
"2011","The Vale of Glamorgan 007F","W01001097","Total",1679,801,878,1674,5,10,83.31,20.2
"2011","The Vale of Glamorgan 008A","W01001114","Total",1565,762,803,1565,0,55,106.35,14.7
"2011","The Vale of Glamorgan 008B","W01001115","Total",2170,1023,1147,2170,0,33,178.53,12.2
"2011","The Vale of Glamorgan 008C","W01001131","Total",1753,814,939,1720,33,21,36.24,48.4
"2011","The Vale of Glamorgan 008D","W01001132","Total",1370,650,720,1370,0,21,127.31,10.8
"2011","The Vale of Glamorgan 008E","W01001133","Total",2029,1014,1015,1996,33,41,268.12,7.6
"2011","The Vale of Glamorgan 008F","W01001134","Total",1144,536,608,1144,0,21,310.31,3.7
"2011","The Vale of Glamorgan 009A","W01001067","Total",1380,633,747,1364,16,8,20.89,66.1
"2011","The Vale of Glamorgan 009B","W01001068","Total",1767,833,934,1767,0,6,44.47,39.7
"2011","The Vale of Glamorgan 009C","W01001070","Total",1143,600,543,1143,0,7,12.45,91.8
"2011","The Vale of Glamorgan 009D","W01001071","Total",1577,787,790,1577,0,8,117.71,13.4
"2011","The Vale of Glamorgan 009E","W01001072","Total",2676,1358,1318,2676,0,38,99.64,26.9
"2011","The Vale of Glamorgan 010A","W01001091","Total",1662,820,842,1662,0,27,218.24,7.6
"2011","The Vale of Glamorgan 010B","W01001098","Total",1071,501,570,1071,0,19,104.96,10.2
"2011","The Vale of Glamorgan 010C","W01001100","Total",1500,722,778,1500,0,30,64.76,23.2
"2011","The Vale of Glamorgan 010D","W01001103","Total",1244,580,664,1244,0,19,51.51,24.2
"2011","The Vale of Glamorgan 011A","W01001106","Total",1423,693,730,1423,0,33,43.36,32.8
"2011","The Vale of Glamorgan 011B","W01001107","Total",1547,728,819,1547,0,22,136.56,11.3
"2011","The Vale of Glamorgan 011C","W01001109","Total",1473,701,772,1473,0,17,169.68,8.7
"2011","The Vale of Glamorgan 011D","W01001110","Total",1570,743,827,1231,339,39,2054.69,0.8
"2011","The Vale of Glamorgan 011E","W01001111","Total",1482,695,787,1482,0,15,21.75,68.1
"2011","The Vale of Glamorgan 011F","W01001112","Total",1441,705,736,1441,0,21,41.41,34.8
"2011","The Vale of Glamorgan 012A","W01001063","Total",1742,863,879,1737,5,10,18.29,95.2
"2011","The Vale of Glamorgan 012B","W01001065","Total",1595,767,828,1592,3,7,26.45,60.3
"2011","The Vale of Glamorgan 012C","W01001069","Total",1459,733,726,1459,0,10,23.36,62.5
"2011","The Vale of Glamorgan 012E","W01001079","Total",1615,745,870,1615,0,6,15.25,105.9
"2011","The Vale of Glamorgan 012F","W01001080","Total",1581,763,818,1576,5,9,30.22,52.3
"2011","The Vale of Glamorgan 012G","W01001910","Total",1656,842,814,1648,8,11,32.64,50.7
"2011","The Vale of Glamorgan 012H","W01001911","Total",1195,591,604,1195,0,4,11.76,101.6
"2011","The Vale of Glamorgan 013A","W01001062","Total",1381,669,712,1341,40,20,19.04,72.5
"2011","The Vale of Glamorgan 013B","W01001064","Total",1445,658,787,1326,119,10,28.22,51.2
"2011","The Vale of Glamorgan 013C","W01001093","Total",1798,850,948,1720,78,7,39.82,45.2
"2011","The Vale of Glamorgan 013D","W01001099","Total",1341,644,697,1341,0,11,27.26,49.2
"2011","The Vale of Glamorgan 013E","W01001101","Total",1500,763,737,1500,0,16,20.06,74.8
"2011","The Vale of Glamorgan 013F","W01001102","Total",1545,725,820,1505,40,15,17.53,88.1
"2011","The Vale of Glamorgan 014A","W01001108","Total",1685,866,819,1684,1,15,992.79,1.7
"2011","The Vale of Glamorgan 014B","W01001117","Total",1416,699,717,1416,0,11,204.41,6.9
"2011","The Vale of Glamorgan 014C","W01001118","Total",2380,1167,1213,2380,0,23,414.50,5.7
"2011","The Vale of Glamorgan 014D","W01001120","Total",1380,677,703,1380,0,23,390.47,3.5
"2011","The Vale of Glamorgan 014E","W01001121","Total",1545,781,764,1508,37,8,550.03,2.8
"2011","The Vale of Glamorgan 014F","W01001122","Total",2950,1793,1157,2267,683,33,610.78,4.8
"2011","The Vale of Glamorgan 015A","W01001059","Total",1320,659,661,1312,8,37,63.67,20.7
"2011","The Vale of Glamorgan 015B","W01001060","Total",1436,668,768,1436,0,24,92.42,15.5
"2011","The Vale of Glamorgan 015C","W01001061","Total",2144,1025,1119,2100,44,15,158.10,13.6
"2011","The Vale of Glamorgan 015D","W01001066","Total",1575,751,824,1575,0,14,34.58,45.5
"2011","The Vale of Glamorgan 015E","W01001073","Total",2001,1001,1000,2001,0,14,200.02,10.0
"2011","Cardiff 001A","W01001777","Total",1496,738,758,1496,0,37,338.95,4.4
"2011","Cardiff 001B","W01001778","Total",1873,930,943,1873,0,60,431.61,4.3
"2011","Cardiff 001C","W01001794","Total",1420,653,767,1420,0,29,29.42,48.3
"2011","Cardiff 001D","W01001799","Total",1279,604,675,1176,103,39,63.55,20.1
"2011","Cardiff 002A","W01001793","Total",1427,694,733,1427,0,36,24.56,58.1
"2011","Cardiff 002B","W01001795","Total",1547,746,801,1547,0,40,44.69,34.6
"2011","Cardiff 002C","W01001796","Total",1491,708,783,1491,0,25,30.09,49.6
"2011","Cardiff 002D","W01001798","Total",1481,697,784,1481,0,28,29.22,50.7
"2011","Cardiff 003A","W01001841","Total",2025,969,1056,2025,0,28,126.19,16.0
"2011","Cardiff 003B","W01001842","Total",1748,853,895,1748,0,13,310.61,5.6
"2011","Cardiff 003C","W01001843","Total",2167,1070,1097,2167,0,40,324.54,6.7
"2011","Cardiff 003D","W01001844","Total",2028,946,1082,2028,0,22,43.70,46.4
"2011","Cardiff 004A","W01001849","Total",1558,737,821,1558,0,34,97.70,15.9
"2011","Cardiff 004B","W01001852","Total",1817,848,969,1817,0,33,339.91,5.3
"2011","Cardiff 004C","W01001853","Total",1562,734,828,1562,0,26,38.41,40.7
"2011","Cardiff 004D","W01001854","Total",1572,711,861,1572,0,6,32.03,49.1
"2011","Cardiff 005A","W01001791","Total",1625,774,851,1625,0,34,92.08,17.6
"2011","Cardiff 005B","W01001792","Total",1701,837,864,1654,47,11,45.73,37.2
"2011","Cardiff 005C","W01001797","Total",1439,705,734,1439,0,28,39.93,36.0
"2011","Cardiff 005D","W01001800","Total",1565,735,830,1535,30,15,38.01,41.2
"2011","Cardiff 005F","W01001949","Total",1281,609,672,1281,0,7,12.96,98.8
"2011","Cardiff 005G","W01001953","Total",1499,731,768,1499,0,22,45.41,33.0
"2011","Cardiff 006A","W01001820","Total",1196,598,598,1196,0,29,228.47,5.2
"2011","Cardiff 006C","W01001846","Total",1727,851,876,1727,0,31,73.95,23.4
"2011","Cardiff 006D","W01001847","Total",1535,759,776,1529,6,54,99.44,15.4
"2011","Cardiff 006E","W01001948","Total",1618,782,836,1618,0,32,229.51,7.0
"2011","Cardiff 006F","W01001954","Total",1537,750,787,1505,32,56,64.01,24.0
"2011","Cardiff 007A","W01001802","Total",1588,746,842,1588,0,6,36.87,43.1
"2011","Cardiff 007B","W01001807","Total",1567,708,859,1567,0,11,24.47,64.0
"2011","Cardiff 007C","W01001808","Total",1634,739,895,1634,0,11,33.22,49.2
"2011","Cardiff 007D","W01001840","Total",1752,870,882,1752,0,14,51.16,34.2
"2011","Cardiff 008A","W01001730","Total",1489,707,782,1489,0,43,73.93,20.1
"2011","Cardiff 008B","W01001731","Total",1446,699,747,1446,0,39,49.70,29.1
"2011","Cardiff 008C","W01001736","Total",1395,656,739,1395,0,38,48.84,28.6
"2011","Cardiff 008D","W01001815","Total",1353,643,710,1353,0,22,31.89,42.4
"2011","Cardiff 009A","W01001811","Total",1503,706,797,1503,0,5,115.65,13.0
"2011","Cardiff 009B","W01001816","Total",2625,1227,1398,2521,104,21,52.70,49.8
"2011","Cardiff 009C","W01001817","Total",1406,665,741,1402,4,15,17.20,81.7
"2011","Cardiff 009D","W01001818","Total",1528,740,788,1528,0,12,26.28,58.1
"2011","Cardiff 010A","W01001888","Total",1686,824,862,1686,0,19,60.01,28.1
"2011","Cardiff 010B","W01001893","Total",1871,880,991,1871,0,20,428.85,4.4
"2011","Cardiff 010C","W01001894","Total",1589,767,822,1589,0,15,33.38,47.6
"2011","Cardiff 010D","W01001895","Total",1634,838,796,1546,88,22,136.03,12.0
"2011","Cardiff 011A","W01001877","Total",1710,839,871,1710,0,22,56.18,30.4
"2011","Cardiff 011B","W01001878","Total",1574,710,864,1494,80,17,33.63,46.8
"2011","Cardiff 011C","W01001882","Total",1824,893,931,1824,0,14,194.95,9.4
"2011","Cardiff 011D","W01001885","Total",2017,938,1079,2017,0,9,482.47,4.2
"2011","Cardiff 012A","W01001773","Total",2524,1234,1290,2517,7,24,33.11,76.2
"2011","Cardiff 012B","W01001848","Total",1447,704,743,1447,0,18,28.59,50.6
"2011","Cardiff 012C","W01001850","Total",1931,930,1001,1931,0,39,47.60,40.6
"2011","Cardiff 012D","W01001851","Total",1482,727,755,1482,0,22,57.62,25.7
"2011","Cardiff 013A","W01001879","Total",1904,876,1028,1904,0,7,44.72,42.6
"2011","Cardiff 013B","W01001880","Total",1554,691,863,1554,0,6,20.71,75.0
"2011","Cardiff 013C","W01001881","Total",1438,668,770,1438,0,8,24.91,57.7
"2011","Cardiff 013D","W01001884","Total",1374,592,782,1374,0,5,17.80,77.2
"2011","Cardiff 014A","W01001727","Total",1140,539,601,1109,31,36,627.41,1.8
"2011","Cardiff 014B","W01001728","Total",1478,739,739,1478,0,53,81.91,18.0
"2011","Cardiff 014C","W01001729","Total",2203,1058,1145,2140,63,47,1048.42,2.1
"2011","Cardiff 014D","W01001819","Total",2287,1095,1192,2272,15,80,901.94,2.5
"2011","Cardiff 015A","W01001803","Total",1573,734,839,1573,0,3,28.92,54.4
"2011","Cardiff 015B","W01001804","Total",1566,786,780,1566,0,5,33.13,47.3
"2011","Cardiff 015C","W01001805","Total",1490,726,764,1490,0,6,53.79,27.7
"2011","Cardiff 015D","W01001806","Total",1642,808,834,1642,0,5,94.61,17.4
"2011","Cardiff 016A","W01001866","Total",1510,701,809,1388,122,5,43.49,34.7
"2011","Cardiff 016B","W01001867","Total",1429,662,767,1429,0,4,33.35,42.8
"2011","Cardiff 016C","W01001883","Total",1600,754,846,1600,0,1,24.02,66.6
"2011","Cardiff 016D","W01001886","Total",1199,572,627,1199,0,5,22.05,54.4
"2011","Cardiff 017A","W01001809","Total",1309,641,668,1309,0,12,18.74,69.9
"2011","Cardiff 017B","W01001810","Total",1678,807,871,1678,0,10,27.76,60.4
"2011","Cardiff 017C","W01001812","Total",1292,608,684,1292,0,9,19.71,65.6
"2011","Cardiff 017D","W01001813","Total",1519,741,778,1519,0,7,31.32,48.5
"2011","Cardiff 017E","W01001814","Total",1421,683,738,1421,0,6,26.55,53.5
"2011","Cardiff 018A","W01001769","Total",1602,798,804,1602,0,49,35.40,45.3
"2011","Cardiff 018B","W01001770","Total",1107,554,553,990,117,20,98.78,11.2
"2011","Cardiff 018C","W01001771","Total",1645,819,826,1645,0,28,40.36,40.8
"2011","Cardiff 018D","W01001774","Total",1399,693,706,1399,0,16,23.15,60.4
"2011","Cardiff 019A","W01001732","Total",1591,774,817,1591,0,39,44.44,35.8
"2011","Cardiff 019B","W01001733","Total",2077,1073,1004,1379,698,83,49.63,41.8
"2011","Cardiff 019C","W01001734","Total",1526,736,790,1526,0,41,42.33,36.1
"2011","Cardiff 019D","W01001735","Total",1624,749,875,1543,81,40,62.78,25.9
"2011","Cardiff 020A","W01001887","Total",1573,779,794,1573,0,57,41.86,37.6
"2011","Cardiff 020B","W01001889","Total",1546,760,786,1538,8,20,40.22,38.4
"2011","Cardiff 020C","W01001891","Total",1659,763,896,1659,0,16,34.05,48.7
"2011","Cardiff 020D","W01001892","Total",1437,681,756,1437,0,23,26.99,53.2
"2011","Cardiff 020E","W01001896","Total",1533,722,811,1533,0,41,31.25,49.1
"2011","Cardiff 021A","W01001772","Total",1413,667,746,1409,4,16,29.26,48.3
"2011","Cardiff 021B","W01001775","Total",1592,779,813,1592,0,20,24.78,64.2
"2011","Cardiff 021C","W01001776","Total",1347,648,699,1339,8,22,30.04,44.8
"2011","Cardiff 021D","W01001890","Total",1610,758,852,1385,225,25,24.60,65.4
"2011","Cardiff 022A","W01001863","Total",1564,760,804,1564,0,10,42.76,36.6
"2011","Cardiff 022B","W01001864","Total",1505,723,782,1502,3,18,28.45,52.9
"2011","Cardiff 022C","W01001865","Total",1321,636,685,1297,24,11,169.31,7.8
"2011","Cardiff 022D","W01001868","Total",1498,680,818,1479,19,9,28.95,51.7
"2011","Cardiff 023A","W01001785","Total",1183,524,659,1183,0,12,22.02,53.7
"2011","Cardiff 023B","W01001786","Total",1555,755,800,1555,0,9,44.62,34.8
"2011","Cardiff 023C","W01001787","Total",1461,728,733,1461,0,16,30.98,47.2
"2011","Cardiff 023D","W01001788","Total",1431,726,705,1404,27,3,28.66,49.9
"2011","Cardiff 023E","W01001789","Total",1527,729,798,1527,0,8,48.96,31.2
"2011","Cardiff 023F","W01001790","Total",1187,539,648,1187,0,8,23.76,50.0
"2011","Cardiff 024A","W01001821","Total",1837,818,1019,1163,674,38,30.69,59.9
"2011","Cardiff 024B","W01001826","Total",1353,635,718,1353,0,27,39.02,34.7
"2011","Cardiff 024C","W01001827","Total",1610,745,865,1583,27,44,44.25,36.4
"2011","Cardiff 024D","W01001828","Total",1535,747,788,1535,0,31,59.68,25.7
"2011","Cardiff 025A","W01001755","Total",1432,734,698,1432,0,20,20.93,68.4
"2011","Cardiff 025B","W01001756","Total",3809,1678,2131,1750,2059,54,66.22,57.5
"2011","Cardiff 025C","W01001757","Total",1493,730,763,1493,0,9,18.29,81.6
"2011","Cardiff 025D","W01001758","Total",2056,916,1140,1784,272,24,21.54,95.5
"2011","Cardiff 026A","W01001779","Total",1445,703,742,1430,15,31,47.10,30.7
"2011","Cardiff 026B","W01001780","Total",1750,790,960,1402,348,55,54.03,32.4
"2011","Cardiff 026C","W01001781","Total",1736,849,887,1693,43,31,67.46,25.7
"2011","Cardiff 026D","W01001782","Total",1437,706,731,1427,10,36,31.70,45.3
"2011","Cardiff 026E","W01001783","Total",1268,603,665,1263,5,41,29.44,43.1
"2011","Cardiff 026F","W01001784","Total",1361,658,703,1340,21,36,25.69,53.0
"2011","Cardiff 027A","W01001747","Total",1624,771,853,1624,0,15,50.37,32.2
"2011","Cardiff 027B","W01001748","Total",1569,750,819,1569,0,3,29.63,53.0
"2011","Cardiff 027C","W01001749","Total",1488,727,761,1481,7,11,46.17,32.2
"2011","Cardiff 027D","W01001751","Total",1661,811,850,1661,0,12,29.86,55.6
"2011","Cardiff 028A","W01001718","Total",1680,887,793,1680,0,6,10.54,159.4
"2011","Cardiff 028B","W01001719","Total",2064,1001,1063,1565,499,26,22.32,92.5
"2011","Cardiff 028C","W01001720","Total",1892,922,970,1854,38,8,13.36,141.6
"2011","Cardiff 028D","W01001722","Total",1571,766,805,1565,6,10,8.91,176.3
"2011","Cardiff 028E","W01001726","Total",1715,840,875,1660,55,8,43.31,39.6
"2011","Cardiff 029A","W01001822","Total",1647,757,890,1647,0,26,64.05,25.7
"2011","Cardiff 029B","W01001823","Total",1334,648,686,1331,3,32,17.22,77.5
"2011","Cardiff 029C","W01001824","Total",1566,796,770,1537,29,19,14.98,104.5
"2011","Cardiff 029D","W01001825","Total",1775,883,892,1704,71,9,65.10,27.3
"2011","Cardiff 030A","W01001831","Total",1565,782,783,1565,0,9,12.01,130.3
"2011","Cardiff 030B","W01001836","Total",1599,843,756,1562,37,22,28.13,56.8
"2011","Cardiff 030C","W01001837","Total",1524,827,697,1373,151,19,9.88,154.3
"2011","Cardiff 030D","W01001838","Total",1782,908,874,1782,0,24,10.71,166.4
"2011","Cardiff 030E","W01001839","Total",1609,787,822,1609,0,12,10.00,160.9
"2011","Cardiff 031A","W01001750","Total",1650,776,874,1650,0,9,45.83,36.0
"2011","Cardiff 031B","W01001752","Total",1625,804,821,1625,0,21,41.18,39.5
"2011","Cardiff 031C","W01001753","Total",1653,756,897,1653,0,12,26.18,63.1
"2011","Cardiff 031D","W01001754","Total",1711,811,900,1711,0,16,36.90,46.4
"2011","Cardiff 032A","W01001721","Total",2906,1336,1570,1553,1353,40,30.86,94.2
"2011","Cardiff 032C","W01001724","Total",1984,909,1075,1982,2,13,10.55,188.1
"2011","Cardiff 032D","W01001725","Total",2214,1141,1073,2158,56,29,10.25,216.0
"2011","Cardiff 032E","W01001922","Total",1976,1108,868,1387,589,17,12.53,157.7
"2011","Cardiff 032F","W01001939","Total",1020,641,379,1020,0,11,146.37,7.0
"2011","Cardiff 032G","W01001941","Total",1099,679,420,1098,1,8,25.41,43.3
"2011","Cardiff 033A","W01001829","Total",1807,1006,801,1807,0,17,13.39,135.0
"2011","Cardiff 033B","W01001830","Total",1638,918,720,1628,10,6,9.77,167.7
"2011","Cardiff 033C","W01001832","Total",1787,1072,715,1698,89,21,12.94,138.1
"2011","Cardiff 033D","W01001833","Total",1626,857,769,1543,83,19,17.60,92.4
"2011","Cardiff 033E","W01001834","Total",1607,817,790,1604,3,4,12.25,131.2
"2011","Cardiff 033F","W01001835","Total",1622,901,721,1490,132,9,26.21,61.9
"2011","Cardiff 034A","W01001858","Total",1694,825,869,1642,52,7,119.51,14.2
"2011","Cardiff 034B","W01001859","Total",1421,716,705,1387,34,27,15.06,94.4
"2011","Cardiff 034C","W01001860","Total",1707,850,857,1699,8,15,17.98,94.9
"2011","Cardiff 034D","W01001861","Total",1709,874,835,1609,100,19,37.53,45.5
"2011","Cardiff 035A","W01001714","Total",1522,726,796,1522,0,24,32.67,46.6
"2011","Cardiff 035B","W01001715","Total",1571,799,772,1567,4,18,20.59,76.3
"2011","Cardiff 035C","W01001716","Total",1274,623,651,1270,4,22,22.62,56.3
"2011","Cardiff 035D","W01001717","Total",1580,745,835,1574,6,28,13.56,116.5
"2011","Cardiff 036A","W01001694","Total",1961,1055,906,1961,0,27,17.57,111.6
"2011","Cardiff 036B","W01001695","Total",3243,1868,1375,1654,1589,19,34.74,93.4
"2011","Cardiff 036C","W01001696","Total",1553,778,775,1533,20,5,18.43,84.3
"2011","Cardiff 036D","W01001697","Total",1646,818,828,1644,2,12,17.93,91.8
"2011","Cardiff 036E","W01001698","Total",1968,1073,895,1861,107,14,18.01,109.3
"2011","Cardiff 037A","W01001870","Total",1377,685,692,1377,0,7,24.36,56.5
"2011","Cardiff 037B","W01001871","Total",1594,741,853,1594,0,14,49.27,32.4
"2011","Cardiff 037C","W01001875","Total",2695,1307,1388,2695,0,17,217.07,12.4
"2011","Cardiff 037D","W01001876","Total",1547,756,791,1547,0,7,23.51,65.8
"2011","Cardiff 038A","W01001869","Total",1395,666,729,1352,43,2,17.63,79.1
"2011","Cardiff 038B","W01001872","Total",1525,769,756,1524,1,10,14.04,108.6
"2011","Cardiff 038C","W01001873","Total",1699,840,859,1692,7,6,31.02,54.8
"2011","Cardiff 038D","W01001874","Total",1429,697,732,1429,0,13,111.52,12.8
"2011","Cardiff 039A","W01001737","Total",1585,741,844,1585,0,8,29.24,54.2
"2011","Cardiff 039B","W01001738","Total",1421,665,756,1421,0,4,29.88,47.6
"2011","Cardiff 039C","W01001739","Total",1361,649,712,1361,0,4,23.18,58.7
"2011","Cardiff 039D","W01001740","Total",1521,715,806,1521,0,5,20.03,75.9
"2011","Cardiff 039E","W01001741","Total",1619,714,905,1619,0,8,23.12,70.0
"2011","Cardiff 040A","W01001709","Total",1898,939,959,1861,37,18,61.38,30.9
"2011","Cardiff 040B","W01001710","Total",1597,818,779,1593,4,5,15.76,101.3
"2011","Cardiff 040C","W01001711","Total",1632,780,852,1632,0,8,110.27,14.8
"2011","Cardiff 040D","W01001712","Total",1506,684,822,1417,89,15,17.30,87.1
"2011","Cardiff 040E","W01001713","Total",1724,893,831,1724,0,10,14.24,121.1
"2011","Cardiff 041A","W01001704","Total",1552,685,867,1550,2,6,31.03,50.0
"2011","Cardiff 041B","W01001706","Total",1244,594,650,1232,12,6,58.36,21.3
"2011","Cardiff 041C","W01001707","Total",2068,990,1078,2052,16,2,62.79,32.9
"2011","Cardiff 041D","W01001746","Total",1542,708,834,1465,77,4,28.69,53.7
"2011","Cardiff 042A","W01001855","Total",1799,923,876,1799,0,4,12.82,140.3
"2011","Cardiff 042B","W01001856","Total",1852,1073,779,1825,27,16,14.69,126.1
"2011","Cardiff 042C","W01001857","Total",1856,978,878,1790,66,12,22.81,81.4
"2011","Cardiff 042D","W01001862","Total",1733,976,757,1722,11,8,18.18,95.3
"2011","Cardiff 043A","W01001742","Total",1515,675,840,1515,0,9,22.51,67.3
"2011","Cardiff 043B","W01001743","Total",1424,694,730,1424,0,12,42.46,33.5
"2011","Cardiff 043C","W01001744","Total",1592,753,839,1592,0,1,47.26,33.7
"2011","Cardiff 043D","W01001745","Total",1355,656,699,1355,0,11,41.25,32.8
"2011","Cardiff 044A","W01001764","Total",1993,1039,954,1717,276,16,23.63,84.3
"2011","Cardiff 044B","W01001765","Total",1418,747,671,1413,5,4,12.24,115.8
"2011","Cardiff 044C","W01001766","Total",1663,846,817,1659,4,9,12.69,131.0
"2011","Cardiff 044D","W01001767","Total",1658,859,799,1658,0,4,16.25,102.0
"2011","Cardiff 044E","W01001768","Total",1691,876,815,1686,5,9,9.85,171.7
"2011","Cardiff 045A","W01001702","Total",1850,879,971,1847,3,10,42.39,43.6
"2011","Cardiff 045B","W01001703","Total",1266,622,644,1266,0,1,19.69,64.3
"2011","Cardiff 045C","W01001705","Total",1776,841,935,1736,40,7,58.09,30.6
"2011","Cardiff 045D","W01001708","Total",1562,764,798,1537,25,4,30.92,50.5
"2011","Cardiff 046A","W01001759","Total",1588,794,794,1588,0,5,134.41,11.8
"2011","Cardiff 046B","W01001760","Total",1693,807,886,1687,6,11,19.80,85.5
"2011","Cardiff 046C","W01001761","Total",1790,943,847,1755,35,6,15.51,115.4
"2011","Cardiff 046D","W01001762","Total",1745,865,880,1745,0,15,16.42,106.3
"2011","Cardiff 048A","W01001940","Total",1111,643,468,1111,0,3,205.83,5.4
"2011","Cardiff 048B","W01001943","Total",1098,608,490,1098,0,6,128.48,8.5
"2011","Cardiff 048C","W01001944","Total",1027,580,447,1027,0,4,18.23,56.3
"2011","Cardiff 048D","W01001945","Total",1303,760,543,1303,0,8,32.29,40.4
"2011","Cardiff 048E","W01001947","Total",1504,751,753,1504,0,3,113.56,13.2
"2011","Cardiff 049A","W01001699","Total",2198,1168,1030,2177,21,9,27.20,80.8
"2011","Cardiff 049B","W01001942","Total",1355,711,644,1306,49,8,31.20,43.4
"2011","Cardiff 049C","W01001946","Total",1339,702,637,1339,0,6,22.92,58.4
"2011","Cardiff 049D","W01001950","Total",1082,605,477,1082,0,2,7.41,146.0
"2011","Cardiff 049E","W01001951","Total",1016,582,434,1016,0,3,38.12,26.7
"2011","Cardiff 049F","W01001952","Total",1238,644,594,1120,118,2,55.73,22.2
"2011","Rhondda Cynon Taf 001A","W01001186","Total",1753,859,894,1753,0,21,45.40,38.6
"2011","Rhondda Cynon Taf 001B","W01001187","Total",1393,719,674,1389,4,4,87.30,16.0
"2011","Rhondda Cynon Taf 001C","W01001188","Total",1038,498,540,1038,0,9,257.88,4.0
"2011","Rhondda Cynon Taf 001D","W01001221","Total",1467,672,795,1461,6,4,197.60,7.4
"2011","Rhondda Cynon Taf 001E","W01001222","Total",1596,751,845,1596,0,8,176.18,9.1
"2011","Rhondda Cynon Taf 001F","W01001233","Total",1700,845,855,1699,1,18,7418.98,0.2
"2011","Rhondda Cynon Taf 002A","W01001148","Total",1662,810,852,1662,0,11,37.77,44.0
"2011","Rhondda Cynon Taf 002B","W01001152","Total",1584,779,805,1584,0,12,890.67,1.8
"2011","Rhondda Cynon Taf 002C","W01001153","Total",1499,732,767,1450,49,14,47.53,31.5
"2011","Rhondda Cynon Taf 002D","W01001155","Total",1534,718,816,1442,92,20,72.19,21.2
"2011","Rhondda Cynon Taf 003A","W01001149","Total",1428,692,736,1428,0,23,70.20,20.3
"2011","Rhondda Cynon Taf 003B","W01001150","Total",1670,780,890,1624,46,8,58.22,28.7
"2011","Rhondda Cynon Taf 003C","W01001151","Total",1679,820,859,1629,50,18,77.32,21.7
"2011","Rhondda Cynon Taf 003D","W01001154","Total",1405,676,729,1405,0,3,1050.86,1.3
"2011","Rhondda Cynon Taf 003E","W01001156","Total",1546,772,774,1546,0,27,41.08,37.6
"2011","Rhondda Cynon Taf 004A","W01001147","Total",1801,852,949,1755,46,25,507.45,3.5
"2011","Rhondda Cynon Taf 004B","W01001168","Total",1457,668,789,1457,0,4,187.64,7.8
"2011","Rhondda Cynon Taf 004C","W01001169","Total",1726,896,830,1726,0,7,344.11,5.0
"2011","Rhondda Cynon Taf 004D","W01001170","Total",1218,581,637,1218,0,13,76.43,15.9
"2011","Rhondda Cynon Taf 005A","W01001137","Total",2389,1152,1237,2358,31,18,383.14,6.2
"2011","Rhondda Cynon Taf 005B","W01001138","Total",1362,656,706,1362,0,10,27.71,49.2
"2011","Rhondda Cynon Taf 005C","W01001139","Total",1473,738,735,1470,3,6,20.07,73.4
"2011","Rhondda Cynon Taf 005D","W01001140","Total",1432,714,718,1432,0,15,362.48,4.0
"2011","Rhondda Cynon Taf 005E","W01001141","Total",1617,791,826,1584,33,7,469.80,3.4
"2011","Rhondda Cynon Taf 005F","W01001142","Total",1592,794,798,1592,0,9,422.37,3.8
"2011","Rhondda Cynon Taf 006A","W01001204","Total",1321,624,697,1321,0,15,411.85,3.2
"2011","Rhondda Cynon Taf 006B","W01001205","Total",1588,773,815,1563,25,7,438.29,3.6
"2011","Rhondda Cynon Taf 006C","W01001206","Total",1482,691,791,1433,49,7,127.08,11.7
"2011","Rhondda Cynon Taf 006D","W01001207","Total",1387,672,715,1387,0,15,172.93,8.0
"2011","Rhondda Cynon Taf 006E","W01001208","Total",1596,750,846,1585,11,16,50.72,31.5
"2011","Rhondda Cynon Taf 007A","W01001265","Total",1535,732,803,1535,0,10,34.48,44.5
"2011","Rhondda Cynon Taf 007B","W01001266","Total",1343,651,692,1295,48,6,503.03,2.7
"2011","Rhondda Cynon Taf 007C","W01001267","Total",1423,708,715,1423,0,10,1361.76,1.0
"2011","Rhondda Cynon Taf 007D","W01001268","Total",1426,710,716,1426,0,7,252.41,5.6
"2011","Rhondda Cynon Taf 008A","W01001209","Total",1403,696,707,1403,0,10,71.94,19.5
"2011","Rhondda Cynon Taf 008B","W01001210","Total",1449,700,749,1449,0,2,65.74,22.0
"2011","Rhondda Cynon Taf 008C","W01001211","Total",1595,768,827,1552,43,7,51.25,31.1
"2011","Rhondda Cynon Taf 008D","W01001212","Total",1342,645,697,1342,0,4,24.39,55.0
"2011","Rhondda Cynon Taf 009A","W01001175","Total",1439,684,755,1408,31,9,58.40,24.6
"2011","Rhondda Cynon Taf 009B","W01001177","Total",1279,634,645,1279,0,5,219.07,5.8
"2011","Rhondda Cynon Taf 009C","W01001202","Total",1780,899,881,1780,0,4,879.93,2.0
"2011","Rhondda Cynon Taf 009D","W01001203","Total",1380,660,720,1380,0,3,182.08,7.6
"2011","Rhondda Cynon Taf 010A","W01001269","Total",1416,681,735,1382,34,18,103.11,13.7
"2011","Rhondda Cynon Taf 010B","W01001270","Total",1445,702,743,1366,79,7,124.34,11.6
"2011","Rhondda Cynon Taf 010C","W01001271","Total",1620,815,805,1620,0,13,746.82,2.2
"2011","Rhondda Cynon Taf 010D","W01001272","Total",1545,752,793,1545,0,21,329.06,4.7
"2011","Rhondda Cynon Taf 010E","W01001273","Total",1668,802,866,1668,0,15,28.93,57.7
"2011","Rhondda Cynon Taf 011A","W01001213","Total",1361,634,727,1361,0,3,20.89,65.2
"2011","Rhondda Cynon Taf 011B","W01001214","Total",1299,634,665,1299,0,23,340.66,3.8
"2011","Rhondda Cynon Taf 011C","W01001215","Total",1037,514,523,1036,1,3,151.88,6.8
"2011","Rhondda Cynon Taf 011D","W01001216","Total",1535,747,788,1509,26,4,65.81,23.3
"2011","Rhondda Cynon Taf 012A","W01001143","Total",1600,789,811,1588,12,11,408.05,3.9
"2011","Rhondda Cynon Taf 012B","W01001144","Total",1606,781,825,1605,1,12,311.36,5.2
"2011","Rhondda Cynon Taf 012C","W01001145","Total",1765,883,882,1765,0,13,107.99,16.3
"2011","Rhondda Cynon Taf 012D","W01001146","Total",1419,693,726,1419,0,5,88.38,16.1
"2011","Rhondda Cynon Taf 013A","W01001176","Total",1460,715,745,1453,7,4,103.14,14.2
"2011","Rhondda Cynon Taf 013B","W01001274","Total",1344,652,692,1344,0,1,71.64,18.8
"2011","Rhondda Cynon Taf 013C","W01001275","Total",1807,891,916,1807,0,14,201.49,9.0
"2011","Rhondda Cynon Taf 013D","W01001276","Total",1395,684,711,1385,10,5,315.87,4.4
"2011","Rhondda Cynon Taf 014A","W01001200","Total",1009,479,530,991,18,3,154.92,6.5
"2011","Rhondda Cynon Taf 014B","W01001201","Total",1238,613,625,1215,23,8,103.43,12.0
"2011","Rhondda Cynon Taf 014C","W01001260","Total",1091,514,577,1091,0,6,58.90,18.5
"2011","Rhondda Cynon Taf 014D","W01001285","Total",1451,689,762,1332,119,15,82.72,17.5
"2011","Rhondda Cynon Taf 014E","W01001286","Total",1535,755,780,1527,8,5,19.02,80.7
"2011","Rhondda Cynon Taf 014F","W01001287","Total",1456,731,725,1456,0,17,301.15,4.8
"2011","Rhondda Cynon Taf 014G","W01001288","Total",1412,697,715,1412,0,6,313.25,4.5
"2011","Rhondda Cynon Taf 015A","W01001180","Total",1463,699,764,1463,0,2,96.55,15.2
"2011","Rhondda Cynon Taf 015B","W01001181","Total",1396,690,706,1396,0,14,113.23,12.3
"2011","Rhondda Cynon Taf 015C","W01001282","Total",2000,975,1025,2000,0,20,249.74,8.0
"2011","Rhondda Cynon Taf 015D","W01001283","Total",1503,715,788,1503,0,15,1683.44,0.9
"2011","Rhondda Cynon Taf 015E","W01001284","Total",1161,592,569,1161,0,20,21.56,53.8
"2011","Rhondda Cynon Taf 016A","W01001166","Total",1321,662,659,1300,21,10,389.69,3.4
"2011","Rhondda Cynon Taf 016B","W01001167","Total",1478,704,774,1478,0,11,95.77,15.4
"2011","Rhondda Cynon Taf 016C","W01001247","Total",1696,830,866,1696,0,5,42.41,40.0
"2011","Rhondda Cynon Taf 016D","W01001248","Total",2054,1060,994,2036,18,8,294.21,7.0
"2011","Rhondda Cynon Taf 017A","W01001171","Total",1260,605,655,1257,3,14,268.48,4.7
"2011","Rhondda Cynon Taf 017B","W01001229","Total",1433,749,684,1433,0,12,142.67,10.0
"2011","Rhondda Cynon Taf 017C","W01001230","Total",1603,788,815,1510,93,11,57.62,27.8
"2011","Rhondda Cynon Taf 017D","W01001231","Total",1540,746,794,1540,0,5,64.19,24.0
"2011","Rhondda Cynon Taf 017E","W01001280","Total",1631,796,835,1631,0,14,242.16,6.7
"2011","Rhondda Cynon Taf 017F","W01001281","Total",1689,823,866,1689,0,10,198.61,8.5
"2011","Rhondda Cynon Taf 018A","W01001217","Total",1202,601,601,1202,0,17,58.37,20.6
"2011","Rhondda Cynon Taf 018B","W01001218","Total",1541,761,780,1541,0,8,48.65,31.7
"2011","Rhondda Cynon Taf 018C","W01001219","Total",1332,662,670,1299,33,3,286.12,4.7
"2011","Rhondda Cynon Taf 018D","W01001220","Total",1479,725,754,1479,0,13,90.24,16.4
"2011","Rhondda Cynon Taf 018E","W01001259","Total",1691,818,873,1651,40,1,168.73,10.0
"2011","Rhondda Cynon Taf 018F","W01001261","Total",1258,632,626,1258,0,5,59.48,21.1
"2011","Rhondda Cynon Taf 019A","W01001164","Total",1551,763,788,1551,0,8,217.47,7.1
"2011","Rhondda Cynon Taf 019B","W01001165","Total",1304,615,689,1304,0,14,197.06,6.6
"2011","Rhondda Cynon Taf 019C","W01001256","Total",1222,596,626,1191,31,5,26.00,47.0
"2011","Rhondda Cynon Taf 019D","W01001257","Total",1267,618,649,1225,42,14,141.91,8.9
"2011","Rhondda Cynon Taf 019E","W01001258","Total",1265,613,652,1265,0,11,58.77,21.5
"2011","Rhondda Cynon Taf 020A","W01001172","Total",1492,722,770,1492,0,9,85.22,17.5
"2011","Rhondda Cynon Taf 020B","W01001173","Total",1368,686,682,1368,0,8,68.18,20.1
"2011","Rhondda Cynon Taf 020C","W01001174","Total",1385,649,736,1385,0,4,93.88,14.8
"2011","Rhondda Cynon Taf 020D","W01001232","Total",1394,690,704,1362,32,15,106.04,13.1
"2011","Rhondda Cynon Taf 021A","W01001182","Total",1479,734,745,1472,7,12,285.77,5.2
"2011","Rhondda Cynon Taf 021B","W01001183","Total",1011,525,486,1010,1,7,29.32,34.5
"2011","Rhondda Cynon Taf 021C","W01001227","Total",1334,656,678,1331,3,17,33.81,39.5
"2011","Rhondda Cynon Taf 021D","W01001228","Total",1502,751,751,1489,13,14,199.18,7.5
"2011","Rhondda Cynon Taf 021E","W01001234","Total",1456,706,750,1456,0,8,588.07,2.5
"2011","Rhondda Cynon Taf 021F","W01001235","Total",1685,792,893,1575,110,6,51.83,32.5
"2011","Rhondda Cynon Taf 021G","W01001236","Total",1516,715,801,1513,3,17,46.86,32.4
"2011","Rhondda Cynon Taf 022A","W01001185","Total",1625,798,827,1625,0,5,42.85,37.9
"2011","Rhondda Cynon Taf 022B","W01001237","Total",1467,682,785,1467,0,5,24.17,60.7
"2011","Rhondda Cynon Taf 022C","W01001238","Total",1673,774,899,1673,0,8,293.01,5.7
"2011","Rhondda Cynon Taf 022D","W01001262","Total",1356,724,632,1356,0,22,166.81,8.1
"2011","Rhondda Cynon Taf 022E","W01001263","Total",1711,932,779,1711,0,29,38.61,44.3
"2011","Rhondda Cynon Taf 022F","W01001264","Total",2083,1204,879,1394,689,37,171.85,12.1
"2011","Rhondda Cynon Taf 023A","W01001178","Total",1709,829,880,1709,0,5,261.15,6.5
"2011","Rhondda Cynon Taf 023B","W01001179","Total",1727,830,897,1727,0,9,342.23,5.0
"2011","Rhondda Cynon Taf 023C","W01001253","Total",1428,682,746,1428,0,6,287.35,5.0
"2011","Rhondda Cynon Taf 023E","W01001255","Total",1598,771,827,1598,0,14,136.89,11.7
"2011","Rhondda Cynon Taf 023F","W01001914","Total",1841,929,912,1749,92,17,463.54,4.0
"2011","Rhondda Cynon Taf 023G","W01001917","Total",1507,751,756,1492,15,14,86.94,17.3
"2011","Rhondda Cynon Taf 024A","W01001249","Total",1389,682,707,1389,0,10,42.99,32.3
"2011","Rhondda Cynon Taf 024B","W01001250","Total",1458,699,759,1413,45,9,1302.67,1.1
"2011","Rhondda Cynon Taf 024C","W01001251","Total",1557,742,815,1557,0,15,57.45,27.1
"2011","Rhondda Cynon Taf 024D","W01001252","Total",1523,747,776,1523,0,10,77.96,19.5
"2011","Rhondda Cynon Taf 025A","W01001162","Total",1718,844,874,1718,0,15,80.57,21.3
"2011","Rhondda Cynon Taf 025B","W01001244","Total",1364,642,722,1364,0,17,362.85,3.8
"2011","Rhondda Cynon Taf 025C","W01001245","Total",1303,640,663,1286,17,12,198.97,6.5
"2011","Rhondda Cynon Taf 025D","W01001246","Total",1381,664,717,1381,0,3,25.68,53.8
"2011","Rhondda Cynon Taf 026A","W01001184","Total",1963,961,1002,1932,31,21,409.96,4.8
"2011","Rhondda Cynon Taf 026B","W01001239","Total",1365,673,692,1365,0,2,53.49,25.5
"2011","Rhondda Cynon Taf 026C","W01001240","Total",1945,949,996,1867,78,18,545.14,3.6
"2011","Rhondda Cynon Taf 026D","W01001241","Total",1727,841,886,1727,0,16,127.15,13.6
"2011","Rhondda Cynon Taf 027B","W01001196","Total",1575,787,788,1558,17,31,87.38,18.0
"2011","Rhondda Cynon Taf 027C","W01001197","Total",1258,629,629,1247,11,23,525.89,2.4
"2011","Rhondda Cynon Taf 027D","W01001198","Total",1556,761,795,1556,0,18,49.79,31.3
"2011","Rhondda Cynon Taf 027E","W01001199","Total",1710,820,890,1710,0,18,328.21,5.2
"2011","Rhondda Cynon Taf 027F","W01001915","Total",1774,872,902,1746,28,18,49.54,35.8
"2011","Rhondda Cynon Taf 027G","W01001916","Total",1529,745,784,1525,4,15,52.55,29.1
"2011","Rhondda Cynon Taf 028A","W01001157","Total",1386,662,724,1386,0,4,21.29,65.1
"2011","Rhondda Cynon Taf 028B","W01001158","Total",1491,746,745,1448,43,16,406.54,3.7
"2011","Rhondda Cynon Taf 028C","W01001159","Total",1279,621,658,1279,0,14,79.45,16.1
"2011","Rhondda Cynon Taf 028D","W01001277","Total",1211,591,620,1211,0,11,42.77,28.3
"2011","Rhondda Cynon Taf 028E","W01001278","Total",1154,588,566,1154,0,8,27.73,41.6
"2011","Rhondda Cynon Taf 028F","W01001279","Total",1182,548,634,1182,0,2,21.55,54.8
"2011","Rhondda Cynon Taf 029A","W01001160","Total",1594,797,797,1594,0,14,470.57,3.4
"2011","Rhondda Cynon Taf 029B","W01001161","Total",2224,1083,1141,2224,0,32,772.80,2.9
"2011","Rhondda Cynon Taf 029C","W01001189","Total",1663,804,859,1663,0,17,46.81,35.5
"2011","Rhondda Cynon Taf 029D","W01001190","Total",2531,1250,1281,2531,0,40,1052.91,2.4
"2011","Rhondda Cynon Taf 030A","W01001193","Total",1213,593,620,1213,0,20,34.27,35.4
"2011","Rhondda Cynon Taf 030B","W01001194","Total",2165,1067,1098,2165,0,17,308.55,7.0
"2011","Rhondda Cynon Taf 030C","W01001195","Total",1498,741,757,1489,9,17,625.04,2.4
"2011","Rhondda Cynon Taf 030D","W01001242","Total",1357,675,682,1310,47,18,131.02,10.4
"2011","Rhondda Cynon Taf 030E","W01001243","Total",1377,652,725,1349,28,11,81.95,16.8
"2011","Rhondda Cynon Taf 031A","W01001191","Total",2494,1234,1260,2482,12,29,710.94,3.5
"2011","Rhondda Cynon Taf 031B","W01001192","Total",1491,726,765,1491,0,5,27.99,53.3
"2011","Rhondda Cynon Taf 031C","W01001223","Total",1593,780,813,1592,1,31,300.71,5.3
"2011","Rhondda Cynon Taf 031D","W01001224","Total",2129,1033,1096,2129,0,23,138.15,15.4
"2011","Rhondda Cynon Taf 031E","W01001225","Total",1574,767,807,1572,2,25,661.33,2.4
"2011","Rhondda Cynon Taf 031F","W01001226","Total",1719,800,919,1719,0,15,67.13,25.6
"2011","Merthyr Tydfil 002A","W01001295","Total",1574,754,820,1574,0,7,96.21,16.4
"2011","Merthyr Tydfil 002B","W01001296","Total",1677,822,855,1677,0,9,661.64,2.5
"2011","Merthyr Tydfil 002C","W01001297","Total",1890,958,932,1888,2,6,181.23,10.4
"2011","Merthyr Tydfil 002D","W01001298","Total",1785,865,920,1763,22,11,142.00,12.6
"2011","Merthyr Tydfil 002E","W01001310","Total",1630,798,832,1630,0,19,44.60,36.5
"2011","Merthyr Tydfil 002F","W01001311","Total",1192,608,584,1192,0,9,15.08,79.0
"2011","Merthyr Tydfil 003A","W01001291","Total",1845,906,939,1797,48,15,303.52,6.1
"2011","Merthyr Tydfil 003B","W01001294","Total",1644,818,826,1638,6,32,164.89,10.0
"2011","Merthyr Tydfil 003C","W01001305","Total",1292,617,675,1262,30,25,28.93,44.7
"2011","Merthyr Tydfil 003D","W01001306","Total",1549,758,791,1549,0,15,146.31,10.6
"2011","Merthyr Tydfil 003E","W01001324","Total",2033,984,1049,1986,47,15,380.36,5.3
"2011","Merthyr Tydfil 004A","W01001292","Total",1730,820,910,1730,0,10,67.26,25.7
"2011","Merthyr Tydfil 004B","W01001293","Total",1650,792,858,1650,0,6,169.45,9.7
"2011","Merthyr Tydfil 004C","W01001307","Total",1485,734,751,1448,37,7,30.99,47.9
"2011","Merthyr Tydfil 004D","W01001315","Total",1709,895,814,1672,37,10,56.17,30.4
"2011","Merthyr Tydfil 005A","W01001314","Total",2179,1078,1101,2179,0,20,162.39,13.4
"2011","Merthyr Tydfil 005B","W01001316","Total",2862,1420,1442,2848,14,34,93.59,30.6
"2011","Merthyr Tydfil 005C","W01001317","Total",1599,772,827,1599,0,8,574.03,2.8
"2011","Merthyr Tydfil 005D","W01001318","Total",1501,769,732,1501,0,15,41.63,36.1
"2011","Merthyr Tydfil 006A","W01001289","Total",1392,683,709,1392,0,5,1342.98,1.0
"2011","Merthyr Tydfil 006B","W01001302","Total",1124,580,544,1124,0,10,76.93,14.6
"2011","Merthyr Tydfil 006C","W01001303","Total",1200,583,617,1198,2,10,448.76,2.7
"2011","Merthyr Tydfil 006D","W01001304","Total",1507,758,749,1507,0,6,302.22,5.0
"2011","Merthyr Tydfil 006E","W01001312","Total",1557,738,819,1427,130,10,1808.02,0.9
"2011","Merthyr Tydfil 006F","W01001313","Total",1560,752,808,1551,9,21,143.59,10.9
"2011","Merthyr Tydfil 007A","W01001290","Total",1885,944,941,1874,11,12,178.48,10.6
"2011","Merthyr Tydfil 007B","W01001319","Total",1646,820,826,1643,3,38,136.44,12.1
"2011","Merthyr Tydfil 007C","W01001320","Total",1546,769,777,1536,10,12,110.98,13.9
"2011","Merthyr Tydfil 007D","W01001321","Total",1572,750,822,1564,8,11,497.77,3.2
"2011","Merthyr Tydfil 007E","W01001322","Total",1592,780,812,1570,22,16,62.55,25.5
"2011","Merthyr Tydfil 008A","W01001299","Total",1616,750,866,1616,0,5,60.46,26.7
"2011","Merthyr Tydfil 008B","W01001300","Total",1753,825,928,1723,30,15,64.40,27.2
"2011","Merthyr Tydfil 008C","W01001301","Total",1911,913,998,1911,0,11,28.33,67.5
"2011","Merthyr Tydfil 008D","W01001308","Total",1320,626,694,1320,0,2,28.02,47.1
"2011","Merthyr Tydfil 008E","W01001309","Total",1277,604,673,1277,0,3,25.23,50.6
"2011","Merthyr Tydfil 008F","W01001898","Total",1518,748,770,1518,0,14,2463.85,0.6
"2011","Caerphilly 001A","W01001374","Total",1462,722,740,1462,0,12,186.75,7.8
"2011","Caerphilly 001B","W01001375","Total",1475,710,765,1457,18,15,121.00,12.2
"2011","Caerphilly 001C","W01001376","Total",1530,736,794,1513,17,8,222.99,6.9
"2011","Caerphilly 001D","W01001406","Total",1924,957,967,1893,31,14,242.92,7.9
"2011","Caerphilly 001E","W01001428","Total",1297,628,669,1297,0,6,91.60,14.2
"2011","Caerphilly 001F","W01001429","Total",1157,561,596,1157,0,13,1292.84,0.9
"2011","Caerphilly 002A","W01001360","Total",1357,666,691,1357,0,6,1460.33,0.9
"2011","Caerphilly 002B","W01001361","Total",1250,611,639,1250,0,11,506.76,2.5
"2011","Caerphilly 002C","W01001384","Total",1647,826,821,1647,0,12,253.13,6.5
"2011","Caerphilly 002D","W01001385","Total",1576,766,810,1515,61,7,648.85,2.4
"2011","Caerphilly 002E","W01001386","Total",1743,877,866,1743,0,4,62.11,28.1
"2011","Caerphilly 003A","W01001325","Total",1540,770,770,1540,0,10,197.59,7.8
"2011","Caerphilly 003B","W01001326","Total",2102,1045,1057,2077,25,9,141.85,14.8
"2011","Caerphilly 003C","W01001362","Total",2062,1002,1060,2050,12,14,102.34,20.1
"2011","Caerphilly 004A","W01001336","Total",1437,735,702,1437,0,8,91.04,15.8
"2011","Caerphilly 004B","W01001337","Total",1558,774,784,1558,0,15,36.67,42.5
"2011","Caerphilly 004C","W01001338","Total",1744,887,857,1744,0,6,27.97,62.4
"2011","Caerphilly 004D","W01001339","Total",1457,668,789,1410,47,2,117.03,12.4
"2011","Caerphilly 005A","W01001334","Total",1495,732,763,1492,3,10,113.53,13.2
"2011","Caerphilly 005B","W01001335","Total",1274,638,636,1265,9,8,1453.95,0.9
"2011","Caerphilly 005C","W01001347","Total",1442,699,743,1429,13,12,56.67,25.4
"2011","Caerphilly 005D","W01001351","Total",1504,754,750,1497,7,19,232.35,6.5
"2011","Caerphilly 006A","W01001356","Total",1259,627,632,1259,0,13,44.38,28.4
"2011","Caerphilly 006B","W01001357","Total",1600,805,795,1600,0,11,545.83,2.9
"2011","Caerphilly 006C","W01001358","Total",1540,756,784,1540,0,13,212.39,7.3
"2011","Caerphilly 006D","W01001359","Total",1548,772,776,1509,39,18,494.28,3.1
"2011","Caerphilly 006E","W01001390","Total",1843,917,926,1797,46,8,203.07,9.1
"2011","Caerphilly 006F","W01001391","Total",1639,796,843,1639,0,13,45.58,36.0
"2011","Caerphilly 007A","W01001352","Total",1845,890,955,1845,0,16,30.53,60.4
"2011","Caerphilly 007B","W01001353","Total",1595,787,808,1590,5,8,33.36,47.8
"2011","Caerphilly 007C","W01001387","Total",1285,636,649,1281,4,8,87.35,14.7
"2011","Caerphilly 007D","W01001388","Total",1855,872,983,1851,4,8,112.58,16.5
"2011","Caerphilly 007E","W01001389","Total",1162,581,581,1130,32,13,36.85,31.5
"2011","Caerphilly 008A","W01001414","Total",1600,779,821,1600,0,10,77.78,20.6
"2011","Caerphilly 008B","W01001415","Total",1807,889,918,1799,8,14,88.21,20.5
"2011","Caerphilly 008C","W01001416","Total",1462,711,751,1459,3,12,104.60,14.0
"2011","Caerphilly 008D","W01001417","Total",1490,746,744,1490,0,9,62.55,23.8
"2011","Caerphilly 008E","W01001418","Total",1458,705,753,1458,0,10,872.65,1.7
"2011","Caerphilly 009A","W01001348","Total",1812,834,978,1812,0,9,32.25,56.2
"2011","Caerphilly 009B","W01001349","Total",1971,985,986,1932,39,21,38.40,51.3
"2011","Caerphilly 009C","W01001350","Total",1767,877,890,1757,10,9,63.38,27.9
"2011","Caerphilly 009D","W01001392","Total",1769,861,908,1769,0,11,230.76,7.7
"2011","Caerphilly 010A","W01001380","Total",1815,902,913,1811,4,17,211.67,8.6
"2011","Caerphilly 010B","W01001381","Total",1535,759,776,1535,0,8,562.37,2.7
"2011","Caerphilly 010C","W01001382","Total",1653,808,845,1580,73,18,123.04,13.4
"2011","Caerphilly 010D","W01001383","Total",1506,732,774,1487,19,12,139.43,10.8
"2011","Caerphilly 011A","W01001401","Total",1943,957,986,1922,21,10,252.59,7.7
"2011","Caerphilly 011B","W01001402","Total",1699,835,864,1699,0,16,42.16,40.3
"2011","Caerphilly 011C","W01001403","Total",1621,803,818,1591,30,4,86.47,18.7
"2011","Caerphilly 011D","W01001404","Total",1412,715,697,1406,6,19,34.37,41.1
"2011","Caerphilly 011E","W01001405","Total",1877,920,957,1875,2,7,159.51,11.8
"2011","Caerphilly 012A","W01001363","Total",1493,731,762,1493,0,14,105.82,14.1
"2011","Caerphilly 012B","W01001364","Total",1930,945,985,1868,62,10,39.86,48.4
"2011","Caerphilly 012C","W01001365","Total",2125,1031,1094,2121,4,17,61.43,34.6
"2011","Caerphilly 012D","W01001369","Total",2242,1111,1131,2223,19,20,752.15,3.0
"2011","Caerphilly 013A","W01001377","Total",1543,741,802,1539,4,24,790.70,2.0
"2011","Caerphilly 013B","W01001378","Total",1592,744,848,1541,51,10,193.66,8.2
"2011","Caerphilly 013C","W01001379","Total",1512,778,734,1512,0,14,114.27,13.2
"2011","Caerphilly 013D","W01001432","Total",2210,1082,1128,2204,6,33,233.84,9.5
"2011","Caerphilly 013E","W01001433","Total",1413,665,748,1413,0,5,51.25,27.6
"2011","Caerphilly 013F","W01001434","Total",1420,702,718,1420,0,16,340.99,4.2
"2011","Caerphilly 014A","W01001327","Total",2169,1087,1082,2169,0,19,1368.57,1.6
"2011","Caerphilly 014B","W01001328","Total",1606,812,794,1606,0,8,234.31,6.9
"2011","Caerphilly 014C","W01001329","Total",1577,761,816,1577,0,14,47.99,32.9
"2011","Caerphilly 014D","W01001354","Total",1646,816,830,1643,3,10,206.25,8.0
"2011","Caerphilly 015A","W01001355","Total",1619,814,805,1619,0,8,367.21,4.4
"2011","Caerphilly 015B","W01001430","Total",2367,1142,1225,2316,51,24,635.12,3.7
"2011","Caerphilly 015C","W01001431","Total",1581,775,806,1550,31,11,782.53,2.0
"2011","Caerphilly 016A","W01001407","Total",1416,702,714,1416,0,14,58.49,24.2
"2011","Caerphilly 016B","W01001408","Total",1515,724,791,1515,0,9,32.47,46.7
"2011","Caerphilly 016C","W01001409","Total",1677,800,877,1677,0,20,115.63,14.5
"2011","Caerphilly 016D","W01001410","Total",1856,941,915,1856,0,8,68.11,27.3
"2011","Caerphilly 017A","W01001411","Total",1709,815,894,1674,35,11,250.81,6.8
"2011","Caerphilly 017B","W01001412","Total",1693,838,855,1693,0,10,103.97,16.3
"2011","Caerphilly 017C","W01001413","Total",1827,868,959,1827,0,14,159.10,11.5
"2011","Caerphilly 018A","W01001330","Total",1473,741,732,1452,21,11,408.29,3.6
"2011","Caerphilly 018B","W01001331","Total",1785,884,901,1785,0,14,63.88,27.9
"2011","Caerphilly 018C","W01001332","Total",1926,982,944,1926,0,18,746.72,2.6
"2011","Caerphilly 018D","W01001333","Total",1615,770,845,1615,0,11,112.61,14.3
"2011","Caerphilly 019A","W01001366","Total",1692,836,856,1692,0,16,375.07,4.5
"2011","Caerphilly 019B","W01001367","Total",1516,767,749,1516,0,10,166.99,9.1
"2011","Caerphilly 019C","W01001368","Total",1553,757,796,1551,2,18,80.85,19.2
"2011","Caerphilly 019D","W01001393","Total",1345,672,673,1334,11,6,34.75,38.7
"2011","Caerphilly 019E","W01001397","Total",1732,860,872,1732,0,20,45.53,38.0
"2011","Caerphilly 019F","W01001400","Total",1454,685,769,1454,0,13,58.16,25.0
"2011","Caerphilly 020A","W01001340","Total",1809,915,894,1809,0,33,828.32,2.2
"2011","Caerphilly 020B","W01001341","Total",1807,850,957,1807,0,6,75.07,24.1
"2011","Caerphilly 020C","W01001344","Total",1708,836,872,1667,41,10,103.34,16.5
"2011","Caerphilly 020D","W01001346","Total",1535,742,793,1535,0,12,102.50,15.0
"2011","Caerphilly 021A","W01001342","Total",1168,567,601,1163,5,22,63.00,18.5
"2011","Caerphilly 021B","W01001343","Total",1194,591,603,1194,0,24,604.41,2.0
"2011","Caerphilly 021C","W01001345","Total",1537,738,799,1537,0,5,55.87,27.5
"2011","Caerphilly 021D","W01001419","Total",1556,800,756,1556,0,34,2546.33,0.6
"2011","Caerphilly 022A","W01001371","Total",1450,685,765,1450,0,11,82.67,17.5
"2011","Caerphilly 022B","W01001372","Total",1943,910,1033,1940,3,11,62.21,31.2
"2011","Caerphilly 022C","W01001373","Total",1692,839,853,1692,0,7,62.30,27.2
"2011","Caerphilly 022D","W01001420","Total",1305,629,676,1305,0,19,58.57,22.3
"2011","Caerphilly 022E","W01001421","Total",1543,729,814,1543,0,8,24.55,62.9
"2011","Caerphilly 022F","W01001422","Total",1572,766,806,1572,0,8,27.24,57.7
"2011","Caerphilly 023A","W01001370","Total",1686,818,868,1686,0,8,59.28,28.4
"2011","Caerphilly 023B","W01001394","Total",1377,705,672,1377,0,21,57.91,23.8
"2011","Caerphilly 023C","W01001395","Total",1455,692,763,1455,0,13,55.38,26.3
"2011","Caerphilly 023D","W01001396","Total",1666,796,870,1644,22,10,42.69,39.0
"2011","Caerphilly 023E","W01001399","Total",1316,652,664,1316,0,14,27.17,48.4
"2011","Caerphilly 024A","W01001398","Total",2507,1265,1242,2489,18,26,220.91,11.3
"2011","Caerphilly 024B","W01001423","Total",1417,690,727,1413,4,13,50.49,28.1
"2011","Caerphilly 024C","W01001424","Total",1497,693,804,1455,42,19,34.30,43.6
"2011","Caerphilly 024D","W01001425","Total",1620,792,828,1620,0,20,190.12,8.5
"2011","Caerphilly 024E","W01001426","Total",1381,698,683,1353,28,18,381.31,3.6
"2011","Caerphilly 024F","W01001427","Total",1835,903,932,1835,0,18,33.04,55.5
"2011","Blaenau Gwent 001A","W01001440","Total",1380,668,712,1380,0,10,120.00,11.5
"2011","Blaenau Gwent 001B","W01001441","Total",1248,611,637,1185,63,3,153.32,8.1
"2011","Blaenau Gwent 001C","W01001442","Total",1238,614,624,1232,6,10,70.56,17.5
"2011","Blaenau Gwent 001D","W01001470","Total",1482,734,748,1479,3,13,423.48,3.5
"2011","Blaenau Gwent 001E","W01001471","Total",1752,856,896,1752,0,9,58.73,29.8
"2011","Blaenau Gwent 002A","W01001446","Total",1273,603,670,1156,117,22,441.63,2.9
"2011","Blaenau Gwent 002B","W01001447","Total",1570,767,803,1570,0,9,55.23,28.4
"2011","Blaenau Gwent 002C","W01001448","Total",1238,648,590,1227,11,14,49.33,25.1
"2011","Blaenau Gwent 002D","W01001449","Total",1449,723,726,1449,0,13,36.11,40.1
"2011","Blaenau Gwent 003A","W01001472","Total",1473,742,731,1473,0,13,118.67,12.4
"2011","Blaenau Gwent 003B","W01001473","Total",1399,646,753,1399,0,8,42.56,32.9
"2011","Blaenau Gwent 003C","W01001474","Total",1549,784,765,1546,3,13,1402.06,1.1
"2011","Blaenau Gwent 003D","W01001475","Total",1209,584,625,1209,0,10,89.43,13.5
"2011","Blaenau Gwent 003E","W01001480","Total",1495,713,782,1471,24,6,96.96,15.4
"2011","Blaenau Gwent 004A","W01001438","Total",1425,675,750,1425,0,12,179.00,8.0
"2011","Blaenau Gwent 004B","W01001439","Total",1685,843,842,1685,0,19,88.65,19.0
"2011","Blaenau Gwent 004C","W01001456","Total",1321,627,694,1292,29,6,91.36,14.5
"2011","Blaenau Gwent 004D","W01001457","Total",1709,784,925,1707,2,8,101.59,16.8
"2011","Blaenau Gwent 004E","W01001458","Total",1531,760,771,1531,0,18,56.00,27.3
"2011","Blaenau Gwent 005A","W01001443","Total",1369,714,655,1342,27,4,128.75,10.6
"2011","Blaenau Gwent 005B","W01001444","Total",1933,939,994,1933,0,20,336.10,5.8
"2011","Blaenau Gwent 005C","W01001445","Total",1506,742,764,1506,0,9,329.41,4.6
"2011","Blaenau Gwent 005D","W01001467","Total",1946,937,1009,1944,2,14,472.11,4.1
"2011","Blaenau Gwent 005E","W01001468","Total",1378,677,701,1374,4,5,112.69,12.2
"2011","Blaenau Gwent 005F","W01001469","Total",1311,668,643,1311,0,10,149.87,8.7
"2011","Blaenau Gwent 006A","W01001462","Total",1518,720,798,1518,0,16,363.92,4.2
"2011","Blaenau Gwent 006B","W01001463","Total",1892,906,986,1892,0,21,44.52,42.5
"2011","Blaenau Gwent 006C","W01001478","Total",1471,714,757,1462,9,17,729.42,2.0
"2011","Blaenau Gwent 006D","W01001479","Total",1511,710,801,1511,0,3,200.73,7.5
"2011","Blaenau Gwent 006E","W01001481","Total",1586,798,788,1517,69,11,79.29,20.0
"2011","Blaenau Gwent 007A","W01001450","Total",1310,644,666,1310,0,15,215.10,6.1
"2011","Blaenau Gwent 007B","W01001451","Total",1429,712,717,1424,5,8,510.16,2.8
"2011","Blaenau Gwent 007C","W01001452","Total",1556,798,758,1555,1,13,253.33,6.1
"2011","Blaenau Gwent 007D","W01001459","Total",1111,529,582,1111,0,13,72.08,15.4
"2011","Blaenau Gwent 007E","W01001460","Total",1743,875,868,1683,60,16,558.51,3.1
"2011","Blaenau Gwent 007F","W01001461","Total",1420,705,715,1382,38,13,30.73,46.2
"2011","Blaenau Gwent 008A","W01001435","Total",1442,725,717,1442,0,18,240.60,6.0
"2011","Blaenau Gwent 008B","W01001436","Total",1413,708,705,1365,48,7,25.68,55.0
"2011","Blaenau Gwent 008C","W01001437","Total",1561,765,796,1558,3,7,193.73,8.1
"2011","Blaenau Gwent 008D","W01001453","Total",1563,773,790,1563,0,12,107.66,14.5
"2011","Blaenau Gwent 008E","W01001454","Total",1404,671,733,1404,0,6,847.92,1.7
"2011","Blaenau Gwent 008F","W01001455","Total",1736,843,893,1697,39,3,32.33,53.7
"2011","Blaenau Gwent 009A","W01001464","Total",1544,788,756,1532,12,6,156.97,9.8
"2011","Blaenau Gwent 009B","W01001465","Total",1566,769,797,1566,0,14,504.14,3.1
"2011","Blaenau Gwent 009C","W01001466","Total",1687,892,795,1687,0,9,79.74,21.2
"2011","Blaenau Gwent 009D","W01001476","Total",1039,504,535,1039,0,5,209.65,5.0
"2011","Blaenau Gwent 009E","W01001477","Total",1443,717,726,1443,0,10,216.35,6.7
"2011","Torfaen 001A","W01001487","Total",1550,791,759,1550,0,8,640.41,2.4
"2011","Torfaen 001B","W01001488","Total",1592,774,818,1567,25,8,38.86,41.0
"2011","Torfaen 001C","W01001489","Total",1616,783,833,1612,4,8,1083.30,1.5
"2011","Torfaen 001D","W01001490","Total",1297,630,667,1297,0,5,20.41,63.5
"2011","Torfaen 002A","W01001482","Total",1213,607,606,1212,1,10,1154.40,1.1
"2011","Torfaen 002B","W01001483","Total",1378,643,735,1378,0,4,41.84,32.9
"2011","Torfaen 002C","W01001484","Total",1740,845,895,1729,11,17,160.87,10.8
"2011","Torfaen 002D","W01001485","Total",1211,568,643,1208,3,6,893.85,1.4
"2011","Torfaen 002E","W01001486","Total",1522,762,760,1502,20,11,225.29,6.8
"2011","Torfaen 003A","W01001525","Total",1541,763,778,1541,0,5,205.56,7.5
"2011","Torfaen 003B","W01001529","Total",2063,1034,1029,2004,59,17,78.97,26.1
"2011","Torfaen 003C","W01001530","Total",1844,865,979,1844,0,10,30.77,59.9
"2011","Torfaen 003D","W01001531","Total",1762,883,879,1755,7,6,260.80,6.8
"2011","Torfaen 004A","W01001491","Total",1808,873,935,1808,0,12,38.04,47.5
"2011","Torfaen 004B","W01001496","Total",1438,691,747,1438,0,7,668.03,2.2
"2011","Torfaen 004C","W01001523","Total",1492,726,766,1488,4,7,360.94,4.1
"2011","Torfaen 004D","W01001524","Total",1836,934,902,1798,38,11,122.33,15.0
"2011","Torfaen 004E","W01001540","Total",1272,632,640,1252,20,10,39.08,32.5
"2011","Torfaen 004F","W01001541","Total",1162,550,612,1112,50,6,726.60,1.6
"2011","Torfaen 005A","W01001510","Total",1522,714,808,1500,22,7,457.84,3.3
"2011","Torfaen 005B","W01001511","Total",1604,771,833,1604,0,15,53.99,29.7
"2011","Torfaen 005C","W01001512","Total",1357,680,677,1354,3,12,30.57,44.4
"2011","Torfaen 005D","W01001513","Total",1503,753,750,1503,0,22,601.99,2.5
"2011","Torfaen 006A","W01001514","Total",1180,576,604,1153,27,19,34.57,34.1
"2011","Torfaen 006B","W01001515","Total",1512,732,780,1472,40,14,86.21,17.5
"2011","Torfaen 006C","W01001516","Total",1434,706,728,1434,0,10,63.42,22.6
"2011","Torfaen 006D","W01001517","Total",1984,997,987,1953,31,18,97.92,20.3
"2011","Torfaen 006E","W01001518","Total",1107,559,548,1107,0,13,40.18,27.6
"2011","Torfaen 007A","W01001519","Total",1351,683,668,1351,0,7,26.44,51.1
"2011","Torfaen 007B","W01001520","Total",1801,866,935,1765,36,17,125.79,14.3
"2011","Torfaen 007C","W01001521","Total",1452,729,723,1452,0,12,44.57,32.6
"2011","Torfaen 007D","W01001522","Total",1701,822,879,1701,0,18,39.37,43.2
"2011","Torfaen 007E","W01001537","Total",1200,604,596,1200,0,16,370.76,3.2
"2011","Torfaen 008A","W01001493","Total",1941,942,999,1941,0,13,37.27,52.1
"2011","Torfaen 008B","W01001494","Total",1509,732,777,1509,0,21,73.42,20.6
"2011","Torfaen 008C","W01001495","Total",1796,829,967,1796,0,24,107.76,16.7
"2011","Torfaen 008D","W01001507","Total",2013,945,1068,2013,0,22,201.17,10.0
"2011","Torfaen 009A","W01001501","Total",1344,665,679,1344,0,6,28.91,46.5
"2011","Torfaen 009B","W01001503","Total",1395,665,730,1395,0,5,20.67,67.5
"2011","Torfaen 009C","W01001536","Total",1229,578,651,1199,30,11,38.40,32.0
"2011","Torfaen 009D","W01001538","Total",1327,624,703,1327,0,7,31.35,42.3
"2011","Torfaen 009E","W01001539","Total",1472,690,782,1472,0,9,33.93,43.4
"2011","Torfaen 010A","W01001506","Total",1401,715,686,1355,46,6,118.93,11.8
"2011","Torfaen 010B","W01001526","Total",1341,634,707,1341,0,3,24.20,55.4
"2011","Torfaen 010C","W01001527","Total",1206,581,625,1203,3,6,25.42,47.4
"2011","Torfaen 010D","W01001528","Total",1118,540,578,1118,0,4,132.87,8.4
"2011","Torfaen 010E","W01001532","Total",1756,833,923,1729,27,10,28.75,61.1
"2011","Torfaen 011A","W01001497","Total",1527,720,807,1492,35,11,48.83,31.3
"2011","Torfaen 011B","W01001498","Total",1176,561,615,1176,0,14,23.64,49.7
"2011","Torfaen 011C","W01001499","Total",1203,604,599,1203,0,8,36.43,33.0
"2011","Torfaen 011D","W01001500","Total",1323,638,685,1282,41,25,79.47,16.6
"2011","Torfaen 011E","W01001502","Total",1329,645,684,1329,0,23,211.16,6.3
"2011","Torfaen 012A","W01001492","Total",2335,1142,1193,2335,0,36,74.38,31.4
"2011","Torfaen 012B","W01001533","Total",1637,827,810,1637,0,35,1029.17,1.6
"2011","Torfaen 012C","W01001534","Total",1484,746,738,1484,0,16,98.54,15.1
"2011","Torfaen 012D","W01001535","Total",1335,667,668,1335,0,14,95.18,14.0
"2011","Torfaen 013A","W01001504","Total",2045,983,1062,2045,0,11,105.37,19.4
"2011","Torfaen 013B","W01001505","Total",2080,1018,1062,1995,85,24,550.73,3.8
"2011","Torfaen 013C","W01001508","Total",1226,587,639,1179,47,18,100.79,12.2
"2011","Torfaen 013D","W01001509","Total",1482,725,757,1482,0,42,343.37,4.3
"2011","Monmouthshire 001A","W01001545","Total",1458,673,785,1378,80,37,672.50,2.2
"2011","Monmouthshire 001B","W01001548","Total",2121,1048,1073,2121,0,39,11825.19,0.2
"2011","Monmouthshire 001C","W01001557","Total",1853,868,985,1827,26,22,112.79,16.4
"2011","Monmouthshire 001D","W01001571","Total",1255,634,621,1238,17,23,1819.77,0.7
"2011","Monmouthshire 001E","W01001579","Total",1461,670,791,1433,28,31,62.63,23.3
"2011","Monmouthshire 002A","W01001546","Total",1537,753,784,1521,16,13,63.44,24.2
"2011","Monmouthshire 002C","W01001558","Total",1527,733,794,1527,0,16,36.13,42.3
"2011","Monmouthshire 002E","W01001580","Total",1791,866,925,1784,7,19,51.29,34.9
"2011","Monmouthshire 002F","W01001909","Total",2651,1281,1370,2651,0,22,90.24,29.4
"2011","Monmouthshire 003A","W01001561","Total",1480,722,758,1405,75,25,383.84,3.9
"2011","Monmouthshire 003B","W01001562","Total",1406,703,703,1395,11,26,1297.19,1.1
"2011","Monmouthshire 003C","W01001563","Total",1013,481,532,1013,0,23,144.37,7.0
"2011","Monmouthshire 003D","W01001564","Total",2319,1125,1194,2307,12,41,2958.35,0.8
"2011","Monmouthshire 003E","W01001569","Total",1447,704,743,1442,5,20,831.23,1.7
"2011","Monmouthshire 004A","W01001552","Total",1564,774,790,1564,0,62,457.97,3.4
"2011","Monmouthshire 004B","W01001553","Total",2746,1342,1404,2745,1,63,565.19,4.9
"2011","Monmouthshire 004C","W01001554","Total",1691,844,847,1399,292,57,453.47,3.7
"2011","Monmouthshire 004D","W01001576","Total",1088,529,559,1084,4,13,21.21,51.3
"2011","Monmouthshire 004E","W01001577","Total",1300,587,713,1193,107,15,230.50,5.6
"2011","Monmouthshire 004F","W01001599","Total",2119,1024,1095,2119,0,30,1055.27,2.0
"2011","Monmouthshire 005A","W01001566","Total",1268,659,609,1187,81,34,4304.95,0.3
"2011","Monmouthshire 005B","W01001567","Total",1016,481,535,981,35,21,3485.00,0.3
"2011","Monmouthshire 005C","W01001568","Total",1755,849,906,1748,7,42,9595.96,0.2
"2011","Monmouthshire 005D","W01001575","Total",1253,656,597,1235,18,23,4463.54,0.3
"2011","Monmouthshire 005E","W01001581","Total",1928,929,999,1927,1,40,3724.35,0.5
"2011","Monmouthshire 006A","W01001555","Total",1189,559,630,1186,3,16,1887.92,0.6
"2011","Monmouthshire 006B","W01001556","Total",1204,580,624,1184,20,15,294.88,4.1
"2011","Monmouthshire 006C","W01001560","Total",1299,663,636,1296,3,35,4195.73,0.3
"2011","Monmouthshire 006D","W01001565","Total",1861,944,917,1818,43,56,6459.74,0.3
"2011","Monmouthshire 006E","W01001596","Total",1332,817,515,941,391,14,118.20,11.3
"2011","Monmouthshire 006F","W01001597","Total",1502,746,756,1497,5,39,148.11,10.1
"2011","Monmouthshire 007A","W01001549","Total",1480,755,725,1469,11,43,5574.55,0.3
"2011","Monmouthshire 007B","W01001583","Total",1618,804,814,1618,0,47,2953.44,0.5
"2011","Monmouthshire 007C","W01001585","Total",1299,610,689,1269,30,30,45.77,28.4
"2011","Monmouthshire 007D","W01001586","Total",2517,1213,1304,2473,44,56,98.88,25.5
"2011","Monmouthshire 007E","W01001594","Total",1435,715,720,1377,58,45,2541.02,0.6
"2011","Monmouthshire 007F","W01001595","Total",1324,664,660,1299,25,39,1821.56,0.7
"2011","Monmouthshire 008A","W01001559","Total",1356,656,700,1330,26,23,41.70,32.5
"2011","Monmouthshire 008B","W01001584","Total",1891,931,960,1891,0,29,49.83,37.9
"2011","Monmouthshire 008C","W01001587","Total",1847,905,942,1821,26,19,82.96,22.3
"2011","Monmouthshire 008D","W01001592","Total",1713,811,902,1713,0,15,39.46,43.4
"2011","Monmouthshire 008E","W01001593","Total",1727,824,903,1727,0,18,173.60,9.9
"2011","Monmouthshire 009A","W01001542","Total",1791,905,886,1759,32,39,2341.78,0.8
"2011","Monmouthshire 009B","W01001543","Total",1440,710,730,1440,0,30,119.29,12.1
"2011","Monmouthshire 009C","W01001578","Total",2133,1089,1044,2126,7,37,743.01,2.9
"2011","Monmouthshire 009D","W01001590","Total",2201,1120,1081,2172,29,78,3751.44,0.6
"2011","Monmouthshire 010C","W01001551","Total",1179,578,601,1179,0,9,23.36,50.5
"2011","Monmouthshire 010D","W01001588","Total",1712,833,879,1712,0,18,193.24,8.9
"2011","Monmouthshire 010E","W01001589","Total",1467,734,733,1464,3,16,46.02,31.9
"2011","Monmouthshire 010F","W01001598","Total",1665,838,827,1624,41,11,35.73,46.6
"2011","Monmouthshire 010G","W01001908","Total",2141,1041,1100,2141,0,23,48.06,44.5
"2011","Monmouthshire 011A","W01001572","Total",1583,772,811,1574,9,29,76.75,20.6
"2011","Monmouthshire 011B","W01001573","Total",1503,763,740,1503,0,28,1093.68,1.4
"2011","Monmouthshire 011C","W01001574","Total",1487,749,738,1487,0,21,89.45,16.6
"2011","Monmouthshire 011D","W01001582","Total",1813,882,931,1813,0,21,847.40,2.1
"2011","Monmouthshire 011E","W01001591","Total",1567,776,791,1567,0,26,272.01,5.8
"2011","Newport 001A","W01001623","Total",1491,703,788,1416,75,42,113.53,13.1
"2011","Newport 001B","W01001624","Total",1275,597,678,1240,35,40,118.42,10.8
"2011","Newport 001C","W01001625","Total",1279,635,644,1277,2,22,786.83,1.6
"2011","Newport 001D","W01001626","Total",1394,712,682,1370,24,27,47.42,29.4
"2011","Newport 001E","W01001627","Total",1553,769,784,1553,0,41,284.91,5.5
"2011","Newport 001F","W01001628","Total",1069,498,571,1069,0,11,43.13,24.8
"2011","Newport 002A","W01001651","Total",1525,746,779,1518,7,26,38.57,39.5
"2011","Newport 002B","W01001652","Total",1773,825,948,1742,31,2,54.49,32.5
"2011","Newport 002C","W01001653","Total",1449,703,746,1449,0,16,40.46,35.8
"2011","Newport 002D","W01001654","Total",1629,790,839,1629,0,6,29.82,54.6
"2011","Newport 002E","W01001655","Total",1621,786,835,1587,34,16,43.76,37.0
"2011","Newport 003A","W01001617","Total",1289,626,663,1289,0,8,27.74,46.5
"2011","Newport 003B","W01001618","Total",1123,549,574,1115,8,5,42.31,26.5
"2011","Newport 003C","W01001619","Total",1386,671,715,1381,5,6,30.65,45.2
"2011","Newport 003D","W01001620","Total",1166,540,626,1162,4,2,221.83,5.3
"2011","Newport 003E","W01001621","Total",1368,645,723,1368,0,5,30.99,44.1
"2011","Newport 003F","W01001622","Total",1274,613,661,1241,33,0,160.14,8.0
"2011","Newport 004A","W01001639","Total",1911,920,991,1911,0,33,276.25,6.9
"2011","Newport 004B","W01001640","Total",1146,557,589,1140,6,22,1562.33,0.7
"2011","Newport 004C","W01001641","Total",1368,682,686,1310,58,31,1194.98,1.1
"2011","Newport 004D","W01001649","Total",1472,747,725,1470,2,18,3889.55,0.4
"2011","Newport 004E","W01001650","Total",1489,724,765,1489,0,7,98.45,15.1
"2011","Newport 005A","W01001614","Total",1496,707,789,1496,0,3,34.76,43.0
"2011","Newport 005B","W01001615","Total",1531,738,793,1531,0,18,32.43,47.2
"2011","Newport 005C","W01001616","Total",1436,706,730,1436,0,16,32.64,44.0
"2011","Newport 005D","W01001678","Total",1609,829,780,1609,0,15,33.58,47.9
"2011","Newport 006A","W01001601","Total",1463,731,732,1463,0,12,36.75,39.8
"2011","Newport 006B","W01001681","Total",1315,642,673,1315,0,12,43.18,30.5
"2011","Newport 006C","W01001682","Total",1307,601,706,1271,36,9,60.66,21.5
"2011","Newport 006D","W01001683","Total",1104,533,571,1104,0,3,39.00,28.3
"2011","Newport 006E","W01001684","Total",1409,696,713,1409,0,13,20.71,68.0
"2011","Newport 007A","W01001675","Total",1550,779,771,1550,0,17,15.70,98.7
"2011","Newport 007B","W01001676","Total",1653,843,810,1651,2,14,41.14,40.2
"2011","Newport 007C","W01001677","Total",1461,710,751,1461,0,4,56.70,25.8
"2011","Newport 007D","W01001679","Total",1155,566,589,1155,0,18,33.14,34.9
"2011","Newport 007E","W01001680","Total",1247,616,631,1242,5,19,13.80,90.4
"2011","Newport 008A","W01001606","Total",1277,602,675,1272,5,18,41.36,30.9
"2011","Newport 008B","W01001608","Total",1544,768,776,1541,3,12,28.13,54.9
"2011","Newport 008C","W01001663","Total",1500,675,825,1500,0,12,37.95,39.5
"2011","Newport 008D","W01001665","Total",1661,782,879,1605,56,7,40.57,40.9
"2011","Newport 009A","W01001669","Total",1350,678,672,1350,0,44,74.02,18.2
"2011","Newport 009B","W01001670","Total",2385,1202,1183,2341,44,43,498.30,4.8
"2011","Newport 009C","W01001672","Total",1761,837,924,1751,10,12,109.95,16.0
"2011","Newport 009D","W01001673","Total",1449,725,724,1449,0,23,55.49,26.1
"2011","Newport 009E","W01001674","Total",1489,717,772,1489,0,25,45.50,32.7
"2011","Newport 010A","W01001664","Total",1425,699,726,1425,0,7,41.77,34.1
"2011","Newport 010B","W01001666","Total",1477,683,794,1477,0,5,42.20,35.0
"2011","Newport 010C","W01001667","Total",1347,635,712,1347,0,6,18.98,71.0
"2011","Newport 010D","W01001668","Total",1140,576,564,1140,0,2,62.08,18.4
"2011","Newport 011A","W01001611","Total",1319,628,691,1319,0,7,13.26,99.5
"2011","Newport 011B","W01001612","Total",1559,799,760,1537,22,9,30.31,51.4
"2011","Newport 011C","W01001613","Total",1554,755,799,1554,0,9,19.93,78.0
"2011","Newport 011D","W01001691","Total",1479,737,742,1443,36,6,18.73,79.0
"2011","Newport 011E","W01001692","Total",1988,1058,930,1988,0,10,19.61,101.4
"2011","Newport 012A","W01001600","Total",1584,776,808,1558,26,29,74.21,21.3
"2011","Newport 012B","W01001602","Total",1513,718,795,1507,6,36,39.17,38.6
"2011","Newport 012C","W01001603","Total",1388,700,688,1336,52,22,38.37,36.2
"2011","Newport 012D","W01001604","Total",1466,717,749,1466,0,32,167.06,8.8
"2011","Newport 013A","W01001642","Total",1691,810,881,1691,0,2,30.15,56.1
"2011","Newport 013B","W01001643","Total",1486,716,770,1486,0,16,26.79,55.5
"2011","Newport 013C","W01001644","Total",2681,1348,1333,2681,0,10,47.31,56.7
"2011","Newport 013D","W01001690","Total",2216,1100,1116,2216,0,11,25.20,87.9
"2011","Newport 013E","W01001693","Total",1781,1012,769,1718,63,10,30.74,57.9
"2011","Newport 014A","W01001605","Total",1368,726,642,1315,53,13,27.85,49.1
"2011","Newport 014B","W01001685","Total",1652,862,790,1650,2,13,32.91,50.2
"2011","Newport 014C","W01001686","Total",1392,671,721,1292,100,20,47.28,29.4
"2011","Newport 014D","W01001687","Total",1729,945,784,1712,17,13,51.37,33.7
"2011","Newport 015A","W01001607","Total",1423,662,761,1421,2,14,26.96,52.8
"2011","Newport 015B","W01001609","Total",1467,659,808,1467,0,5,34.01,43.1
"2011","Newport 015C","W01001610","Total",1301,662,639,1301,0,9,32.83,39.6
"2011","Newport 015D","W01001645","Total",1363,659,704,1363,0,14,20.12,67.7
"2011","Newport 015E","W01001646","Total",2120,1032,1088,1529,591,25,74.67,28.4
"2011","Newport 015F","W01001647","Total",1483,717,766,1483,0,12,1291.39,1.1
"2011","Newport 015G","W01001648","Total",1529,730,799,1522,7,12,26.43,57.9
"2011","Newport 016A","W01001635","Total",1348,650,698,1348,0,34,91.81,14.7
"2011","Newport 016B","W01001637","Total",1724,837,887,1724,0,32,125.11,13.8
"2011","Newport 016C","W01001638","Total",1190,584,606,1190,0,22,65.47,18.2
"2011","Newport 016D","W01001671","Total",1724,823,901,1719,5,26,82.33,20.9
"2011","Newport 017A","W01001629","Total",1395,664,731,1342,53,9,45.76,30.5
"2011","Newport 017B","W01001630","Total",1462,714,748,1462,0,10,35.90,40.7
"2011","Newport 017C","W01001631","Total",1423,678,745,1399,24,12,21.32,66.7
"2011","Newport 017D","W01001632","Total",1377,659,718,1377,0,8,117.08,11.8
"2011","Newport 018A","W01001659","Total",1803,934,869,1790,13,14,23.61,76.4
"2011","Newport 018B","W01001660","Total",1569,769,800,1536,33,18,436.74,3.6
"2011","Newport 018C","W01001661","Total",2599,1329,1270,2599,0,27,59.75,43.5
"2011","Newport 018D","W01001662","Total",1347,659,688,1347,0,8,32.66,41.2
"2011","Newport 019A","W01001633","Total",1535,735,800,1535,0,5,36.83,41.7
"2011","Newport 019B","W01001634","Total",1529,706,823,1529,0,5,23.37,65.4
"2011","Newport 019C","W01001688","Total",2648,1277,1371,2648,0,23,108.94,24.3
"2011","Newport 019D","W01001689","Total",1773,801,972,1773,0,6,70.21,25.3
"2011","Newport 020A","W01001636","Total",1897,944,953,1897,0,25,1151.60,1.6
"2011","Newport 020C","W01001657","Total",1465,721,744,1463,2,38,881.84,1.7
"2011","Newport 020D","W01001658","Total",1885,891,994,1848,37,23,365.14,5.2
"2011","Newport 020E","W01001912","Total",1480,739,741,1476,4,22,1607.09,0.9
"2011","Newport 020F","W01001913","Total",1440,753,687,1440,0,8,695.33,2.1
